"","NAPS","City","P","Latitude","Longitude","Date_time","O3","NO2","Ox"
"1",10102,"St Johns","NL",47.56038,-52.71147,2018-01-01 01:00:00,35,5,40
"2",10102,"St Johns","NL",47.56038,-52.71147,2018-01-01 02:00:00,35,4,39
"3",10102,"St Johns","NL",47.56038,-52.71147,2018-01-01 03:00:00,33,6,39
"4",10102,"St Johns","NL",47.56038,-52.71147,2018-01-01 04:00:00,31,7,38
"5",10102,"St Johns","NL",47.56038,-52.71147,2018-01-01 05:00:00,34,4,38
"6",10102,"St Johns","NL",47.56038,-52.71147,2018-01-01 06:00:00,34,4,38
"7",10102,"St Johns","NL",47.56038,-52.71147,2018-01-01 07:00:00,32,5,37
"8",10102,"St Johns","NL",47.56038,-52.71147,2018-01-01 08:00:00,32,6,38
"9",10102,"St Johns","NL",47.56038,-52.71147,2018-01-01 09:00:00,34,4,38
"10",10102,"St Johns","NL",47.56038,-52.71147,2018-01-01 10:00:00,35,3,38
"11",10102,"St Johns","NL",47.56038,-52.71147,2018-01-01 11:00:00,32,3,35
"12",10102,"St Johns","NL",47.56038,-52.71147,2018-01-01 12:00:00,33,2,35
"13",10102,"St Johns","NL",47.56038,-52.71147,2018-01-01 13:00:00,37,2,39
"14",10102,"St Johns","NL",47.56038,-52.71147,2018-01-01 14:00:00,38,2,40
"15",10102,"St Johns","NL",47.56038,-52.71147,2018-01-01 15:00:00,38,3,41
"16",10102,"St Johns","NL",47.56038,-52.71147,2018-01-01 16:00:00,37,4,41
"17",10102,"St Johns","NL",47.56038,-52.71147,2018-01-01 17:00:00,32,7,39
"18",10102,"St Johns","NL",47.56038,-52.71147,2018-01-01 18:00:00,32,8,40
"19",10102,"St Johns","NL",47.56038,-52.71147,2018-01-01 19:00:00,35,5,40
"20",10102,"St Johns","NL",47.56038,-52.71147,2018-01-01 20:00:00,37,3,40
"21",10102,"St Johns","NL",47.56038,-52.71147,2018-01-01 21:00:00,38,3,41
"22",10102,"St Johns","NL",47.56038,-52.71147,2018-01-01 22:00:00,33,6,39
"23",10102,"St Johns","NL",47.56038,-52.71147,2018-01-01 23:00:00,37,4,41
"24",10102,"St Johns","NL",47.56038,-52.71147,2018-01-02 00:00:00,33,7,40
"25",10102,"St Johns","NL",47.56038,-52.71147,2018-01-02 01:00:00,34,5,39
"26",10102,"St Johns","NL",47.56038,-52.71147,2018-01-02 02:00:00,34,4,38
"27",10102,"St Johns","NL",47.56038,-52.71147,2018-01-02 03:00:00,35,4,39
"28",10102,"St Johns","NL",47.56038,-52.71147,2018-01-02 04:00:00,35,3,38
"29",10102,"St Johns","NL",47.56038,-52.71147,2018-01-02 05:00:00,34,4,38
"30",10102,"St Johns","NL",47.56038,-52.71147,2018-01-02 06:00:00,31,6,37
"31",10102,"St Johns","NL",47.56038,-52.71147,2018-01-02 07:00:00,28,9,37
"32",10102,"St Johns","NL",47.56038,-52.71147,2018-01-02 08:00:00,31,7,38
"33",10102,"St Johns","NL",47.56038,-52.71147,2018-01-02 09:00:00,27,13,40
"34",10102,"St Johns","NL",47.56038,-52.71147,2018-01-02 10:00:00,27,12,39
"35",10102,"St Johns","NL",47.56038,-52.71147,2018-01-02 11:00:00,20,17,37
"36",10102,"St Johns","NL",47.56038,-52.71147,2018-01-02 12:00:00,28,8,36
"37",10102,"St Johns","NL",47.56038,-52.71147,2018-01-02 13:00:00,35,5,40
"38",10102,"St Johns","NL",47.56038,-52.71147,2018-01-02 14:00:00,31,12,43
"39",10102,"St Johns","NL",47.56038,-52.71147,2018-01-02 15:00:00,32,10,42
"40",10102,"St Johns","NL",47.56038,-52.71147,2018-01-02 16:00:00,29,12,41
"41",10102,"St Johns","NL",47.56038,-52.71147,2018-01-02 17:00:00,28,13,41
"42",10102,"St Johns","NL",47.56038,-52.71147,2018-01-02 18:00:00,31,9,40
"43",10102,"St Johns","NL",47.56038,-52.71147,2018-01-02 19:00:00,27,12,39
"44",10102,"St Johns","NL",47.56038,-52.71147,2018-01-02 20:00:00,27,13,40
"45",10102,"St Johns","NL",47.56038,-52.71147,2018-01-02 21:00:00,34,4,38
"46",10102,"St Johns","NL",47.56038,-52.71147,2018-01-02 22:00:00,31,8,39
"47",10102,"St Johns","NL",47.56038,-52.71147,2018-01-02 23:00:00,35,5,40
"48",10102,"St Johns","NL",47.56038,-52.71147,2018-01-03 00:00:00,33,6,39
"49",10102,"St Johns","NL",47.56038,-52.71147,2018-01-03 01:00:00,35,5,40
"50",10102,"St Johns","NL",47.56038,-52.71147,2018-01-03 02:00:00,37,4,41
"51",10102,"St Johns","NL",47.56038,-52.71147,2018-01-03 03:00:00,38,4,42
"52",10102,"St Johns","NL",47.56038,-52.71147,2018-01-03 04:00:00,35,7,42
"53",10102,"St Johns","NL",47.56038,-52.71147,2018-01-03 05:00:00,36,4,40
"54",10102,"St Johns","NL",47.56038,-52.71147,2018-01-03 06:00:00,37,3,40
"55",10102,"St Johns","NL",47.56038,-52.71147,2018-01-03 07:00:00,36,4,40
"56",10102,"St Johns","NL",47.56038,-52.71147,2018-01-03 08:00:00,35,6,41
"57",10102,"St Johns","NL",47.56038,-52.71147,2018-01-03 09:00:00,31,10,41
"58",10102,"St Johns","NL",47.56038,-52.71147,2018-01-03 10:00:00,29,11,40
"59",10102,"St Johns","NL",47.56038,-52.71147,2018-01-03 11:00:00,29,7,36
"60",10102,"St Johns","NL",47.56038,-52.71147,2018-01-03 12:00:00,33,5,38
"61",10102,"St Johns","NL",47.56038,-52.71147,2018-01-03 13:00:00,39,4,43
"62",10102,"St Johns","NL",47.56038,-52.71147,2018-01-03 14:00:00,40,4,44
"63",10102,"St Johns","NL",47.56038,-52.71147,2018-01-03 15:00:00,NA,4,NA
"64",10102,"St Johns","NL",47.56038,-52.71147,2018-01-03 16:00:00,43,5,48
"65",10102,"St Johns","NL",47.56038,-52.71147,2018-01-03 17:00:00,43,5,48
"66",10102,"St Johns","NL",47.56038,-52.71147,2018-01-03 18:00:00,44,6,50
"67",10102,"St Johns","NL",47.56038,-52.71147,2018-01-03 19:00:00,45,4,49
"68",10102,"St Johns","NL",47.56038,-52.71147,2018-01-03 20:00:00,45,3,48
"69",10102,"St Johns","NL",47.56038,-52.71147,2018-01-03 21:00:00,45,3,48
"70",10102,"St Johns","NL",47.56038,-52.71147,2018-01-03 22:00:00,44,3,47
"71",10102,"St Johns","NL",47.56038,-52.71147,2018-01-03 23:00:00,44,3,47
"72",10102,"St Johns","NL",47.56038,-52.71147,2018-01-04 00:00:00,43,6,49
"73",10102,"St Johns","NL",47.56038,-52.71147,2018-01-04 01:00:00,44,4,48
"74",10102,"St Johns","NL",47.56038,-52.71147,2018-01-04 02:00:00,43,5,48
"75",10102,"St Johns","NL",47.56038,-52.71147,2018-01-04 03:00:00,43,4,47
"76",10102,"St Johns","NL",47.56038,-52.71147,2018-01-04 04:00:00,40,7,47
"77",10102,"St Johns","NL",47.56038,-52.71147,2018-01-04 05:00:00,37,10,47
"78",10102,"St Johns","NL",47.56038,-52.71147,2018-01-04 06:00:00,29,17,46
"79",10102,"St Johns","NL",47.56038,-52.71147,2018-01-04 07:00:00,26,20,46
"80",10102,"St Johns","NL",47.56038,-52.71147,2018-01-04 08:00:00,22,22,44
"81",10102,"St Johns","NL",47.56038,-52.71147,2018-01-04 09:00:00,19,25,44
"82",10102,"St Johns","NL",47.56038,-52.71147,2018-01-04 10:00:00,21,25,46
"83",10102,"St Johns","NL",47.56038,-52.71147,2018-01-04 11:00:00,20,25,45
"84",10102,"St Johns","NL",47.56038,-52.71147,2018-01-04 12:00:00,26,16,42
"85",10102,"St Johns","NL",47.56038,-52.71147,2018-01-04 13:00:00,23,26,49
"86",10102,"St Johns","NL",47.56038,-52.71147,2018-01-04 14:00:00,20,33,53
"87",10102,"St Johns","NL",47.56038,-52.71147,2018-01-04 15:00:00,28,22,50
"88",10102,"St Johns","NL",47.56038,-52.71147,2018-01-04 16:00:00,31,19,50
"89",10102,"St Johns","NL",47.56038,-52.71147,2018-01-04 17:00:00,42,9,51
"90",10102,"St Johns","NL",47.56038,-52.71147,2018-01-04 18:00:00,44,8,52
"91",10102,"St Johns","NL",47.56038,-52.71147,2018-01-04 19:00:00,47,5,52
"92",10102,"St Johns","NL",47.56038,-52.71147,2018-01-04 20:00:00,49,2,51
"93",10102,"St Johns","NL",47.56038,-52.71147,2018-01-04 21:00:00,48,5,53
"94",10102,"St Johns","NL",47.56038,-52.71147,2018-01-04 22:00:00,48,3,51
"95",10102,"St Johns","NL",47.56038,-52.71147,2018-01-04 23:00:00,48,3,51
"96",10102,"St Johns","NL",47.56038,-52.71147,2018-01-05 00:00:00,48,3,51
"97",10102,"St Johns","NL",47.56038,-52.71147,2018-01-05 01:00:00,49,3,52
"98",10102,"St Johns","NL",47.56038,-52.71147,2018-01-05 02:00:00,48,4,52
"99",10102,"St Johns","NL",47.56038,-52.71147,2018-01-05 03:00:00,46,5,51
"100",10102,"St Johns","NL",47.56038,-52.71147,2018-01-05 04:00:00,42,9,51
"101",10102,"St Johns","NL",47.56038,-52.71147,2018-01-05 05:00:00,42,9,51
"102",10102,"St Johns","NL",47.56038,-52.71147,2018-01-05 06:00:00,45,6,51
"103",10102,"St Johns","NL",47.56038,-52.71147,2018-01-05 07:00:00,44,6,50
"104",10102,"St Johns","NL",47.56038,-52.71147,2018-01-05 08:00:00,36,10,46
"105",10102,"St Johns","NL",47.56038,-52.71147,2018-01-05 09:00:00,14,36,50
"106",10102,"St Johns","NL",47.56038,-52.71147,2018-01-05 10:00:00,25,23,48
"107",10102,"St Johns","NL",47.56038,-52.71147,2018-01-05 11:00:00,35,4,39
"108",10102,"St Johns","NL",47.56038,-52.71147,2018-01-05 12:00:00,NA,5,NA
"109",10102,"St Johns","NL",47.56038,-52.71147,2018-01-05 13:00:00,NA,3,NA
"110",10102,"St Johns","NL",47.56038,-52.71147,2018-01-05 14:00:00,NA,3,NA
"111",10102,"St Johns","NL",47.56038,-52.71147,2018-01-05 15:00:00,NA,3,NA
"112",10102,"St Johns","NL",47.56038,-52.71147,2018-01-05 16:00:00,NA,5,NA
"113",10102,"St Johns","NL",47.56038,-52.71147,2018-01-05 17:00:00,NA,5,NA
"114",10102,"St Johns","NL",47.56038,-52.71147,2018-01-05 18:00:00,NA,3,NA
"115",10102,"St Johns","NL",47.56038,-52.71147,2018-01-05 19:00:00,NA,8,NA
"116",10102,"St Johns","NL",47.56038,-52.71147,2018-01-05 20:00:00,NA,12,NA
"117",10102,"St Johns","NL",47.56038,-52.71147,2018-01-05 21:00:00,NA,21,NA
"118",10102,"St Johns","NL",47.56038,-52.71147,2018-01-05 22:00:00,NA,12,NA
"119",10102,"St Johns","NL",47.56038,-52.71147,2018-01-05 23:00:00,NA,4,NA
"120",10102,"St Johns","NL",47.56038,-52.71147,2018-01-06 00:00:00,NA,5,NA
"121",10102,"St Johns","NL",47.56038,-52.71147,2018-01-06 01:00:00,NA,6,NA
"122",10102,"St Johns","NL",47.56038,-52.71147,2018-01-06 02:00:00,NA,1,NA
"123",10102,"St Johns","NL",47.56038,-52.71147,2018-01-06 03:00:00,NA,1,NA
"124",10102,"St Johns","NL",47.56038,-52.71147,2018-01-06 04:00:00,NA,2,NA
"125",10102,"St Johns","NL",47.56038,-52.71147,2018-01-06 05:00:00,NA,1,NA
"126",10102,"St Johns","NL",47.56038,-52.71147,2018-01-06 06:00:00,NA,2,NA
"127",10102,"St Johns","NL",47.56038,-52.71147,2018-01-06 07:00:00,NA,1,NA
"128",10102,"St Johns","NL",47.56038,-52.71147,2018-01-06 08:00:00,NA,2,NA
"129",10102,"St Johns","NL",47.56038,-52.71147,2018-01-06 09:00:00,NA,3,NA
"130",10102,"St Johns","NL",47.56038,-52.71147,2018-01-06 10:00:00,NA,1,NA
"131",10102,"St Johns","NL",47.56038,-52.71147,2018-01-06 11:00:00,NA,2,NA
"132",10102,"St Johns","NL",47.56038,-52.71147,2018-01-06 12:00:00,46,2,48
"133",10102,"St Johns","NL",47.56038,-52.71147,2018-01-06 13:00:00,48,1,49
"134",10102,"St Johns","NL",47.56038,-52.71147,2018-01-06 14:00:00,47,2,49
"135",10102,"St Johns","NL",47.56038,-52.71147,2018-01-06 15:00:00,45,2,47
"136",10102,"St Johns","NL",47.56038,-52.71147,2018-01-06 16:00:00,44,2,46
"137",10102,"St Johns","NL",47.56038,-52.71147,2018-01-06 17:00:00,43,2,45
"138",10102,"St Johns","NL",47.56038,-52.71147,2018-01-06 18:00:00,43,2,45
"139",10102,"St Johns","NL",47.56038,-52.71147,2018-01-06 19:00:00,44,2,46
"140",10102,"St Johns","NL",47.56038,-52.71147,2018-01-06 20:00:00,44,2,46
"141",10102,"St Johns","NL",47.56038,-52.71147,2018-01-06 21:00:00,45,1,46
"142",10102,"St Johns","NL",47.56038,-52.71147,2018-01-06 22:00:00,45,1,46
"143",10102,"St Johns","NL",47.56038,-52.71147,2018-01-06 23:00:00,45,1,46
"144",10102,"St Johns","NL",47.56038,-52.71147,2018-01-07 00:00:00,43,2,45
"145",10102,"St Johns","NL",47.56038,-52.71147,2018-01-07 01:00:00,41,2,43
"146",10102,"St Johns","NL",47.56038,-52.71147,2018-01-07 02:00:00,41,2,43
"147",10102,"St Johns","NL",47.56038,-52.71147,2018-01-07 03:00:00,41,3,44
"148",10102,"St Johns","NL",47.56038,-52.71147,2018-01-07 04:00:00,40,3,43
"149",10102,"St Johns","NL",47.56038,-52.71147,2018-01-07 05:00:00,40,2,42
"150",10102,"St Johns","NL",47.56038,-52.71147,2018-01-07 06:00:00,38,4,42
"151",10102,"St Johns","NL",47.56038,-52.71147,2018-01-07 07:00:00,40,3,43
"152",10102,"St Johns","NL",47.56038,-52.71147,2018-01-07 08:00:00,42,2,44
"153",10102,"St Johns","NL",47.56038,-52.71147,2018-01-07 09:00:00,41,2,43
"154",10102,"St Johns","NL",47.56038,-52.71147,2018-01-07 10:00:00,42,2,44
"155",10102,"St Johns","NL",47.56038,-52.71147,2018-01-07 11:00:00,44,1,45
"156",10102,"St Johns","NL",47.56038,-52.71147,2018-01-07 12:00:00,45,1,46
"157",10102,"St Johns","NL",47.56038,-52.71147,2018-01-07 13:00:00,45,2,47
"158",10102,"St Johns","NL",47.56038,-52.71147,2018-01-07 14:00:00,46,2,48
"159",10102,"St Johns","NL",47.56038,-52.71147,2018-01-07 15:00:00,46,2,48
"160",10102,"St Johns","NL",47.56038,-52.71147,2018-01-07 16:00:00,46,2,48
"161",10102,"St Johns","NL",47.56038,-52.71147,2018-01-07 17:00:00,46,3,49
"162",10102,"St Johns","NL",47.56038,-52.71147,2018-01-07 18:00:00,46,2,48
"163",10102,"St Johns","NL",47.56038,-52.71147,2018-01-07 19:00:00,45,2,47
"164",10102,"St Johns","NL",47.56038,-52.71147,2018-01-07 20:00:00,44,3,47
"165",10102,"St Johns","NL",47.56038,-52.71147,2018-01-07 21:00:00,45,2,47
"166",10102,"St Johns","NL",47.56038,-52.71147,2018-01-07 22:00:00,47,2,49
"167",10102,"St Johns","NL",47.56038,-52.71147,2018-01-07 23:00:00,47,2,49
"168",10102,"St Johns","NL",47.56038,-52.71147,2018-01-08 00:00:00,47,1,48
"169",10102,"St Johns","NL",47.56038,-52.71147,2018-01-08 01:00:00,48,1,49
"170",10102,"St Johns","NL",47.56038,-52.71147,2018-01-08 02:00:00,48,1,49
"171",10102,"St Johns","NL",47.56038,-52.71147,2018-01-08 03:00:00,49,0,49
"172",10102,"St Johns","NL",47.56038,-52.71147,2018-01-08 04:00:00,49,1,50
"173",10102,"St Johns","NL",47.56038,-52.71147,2018-01-08 05:00:00,50,1,51
"174",10102,"St Johns","NL",47.56038,-52.71147,2018-01-08 06:00:00,51,2,53
"175",10102,"St Johns","NL",47.56038,-52.71147,2018-01-08 07:00:00,50,2,52
"176",10102,"St Johns","NL",47.56038,-52.71147,2018-01-08 08:00:00,49,2,51
"177",10102,"St Johns","NL",47.56038,-52.71147,2018-01-08 09:00:00,48,4,52
"178",10102,"St Johns","NL",47.56038,-52.71147,2018-01-08 10:00:00,49,3,52
"179",10102,"St Johns","NL",47.56038,-52.71147,2018-01-08 11:00:00,NA,3,NA
"180",10102,"St Johns","NL",47.56038,-52.71147,2018-01-08 12:00:00,43,4,47
"181",10102,"St Johns","NL",47.56038,-52.71147,2018-01-08 13:00:00,43,4,47
"182",10102,"St Johns","NL",47.56038,-52.71147,2018-01-08 14:00:00,43,4,47
"183",10102,"St Johns","NL",47.56038,-52.71147,2018-01-08 15:00:00,42,4,46
"184",10102,"St Johns","NL",47.56038,-52.71147,2018-01-08 16:00:00,42,5,47
"185",10102,"St Johns","NL",47.56038,-52.71147,2018-01-08 17:00:00,41,6,47
"186",10102,"St Johns","NL",47.56038,-52.71147,2018-01-08 18:00:00,41,7,48
"187",10102,"St Johns","NL",47.56038,-52.71147,2018-01-08 19:00:00,41,5,46
"188",10102,"St Johns","NL",47.56038,-52.71147,2018-01-08 20:00:00,43,3,46
"189",10102,"St Johns","NL",47.56038,-52.71147,2018-01-08 21:00:00,42,3,45
"190",10102,"St Johns","NL",47.56038,-52.71147,2018-01-08 22:00:00,40,4,44
"191",10102,"St Johns","NL",47.56038,-52.71147,2018-01-08 23:00:00,42,3,45
"192",10102,"St Johns","NL",47.56038,-52.71147,2018-01-09 00:00:00,NA,2,NA
"193",10102,"St Johns","NL",47.56038,-52.71147,2018-01-09 01:00:00,40,4,44
"194",10102,"St Johns","NL",47.56038,-52.71147,2018-01-09 02:00:00,41,3,44
"195",10102,"St Johns","NL",47.56038,-52.71147,2018-01-09 03:00:00,41,3,44
"196",10102,"St Johns","NL",47.56038,-52.71147,2018-01-09 04:00:00,41,3,44
"197",10102,"St Johns","NL",47.56038,-52.71147,2018-01-09 05:00:00,39,4,43
"198",10102,"St Johns","NL",47.56038,-52.71147,2018-01-09 06:00:00,36,8,44
"199",10102,"St Johns","NL",47.56038,-52.71147,2018-01-09 07:00:00,35,8,43
"200",10102,"St Johns","NL",47.56038,-52.71147,2018-01-09 08:00:00,23,18,41
"201",10102,"St Johns","NL",47.56038,-52.71147,2018-01-09 09:00:00,23,21,44
"202",10102,"St Johns","NL",47.56038,-52.71147,2018-01-09 10:00:00,30,11,41
"203",10102,"St Johns","NL",47.56038,-52.71147,2018-01-09 11:00:00,15,27,42
"204",10102,"St Johns","NL",47.56038,-52.71147,2018-01-09 12:00:00,27,10,37
"205",10102,"St Johns","NL",47.56038,-52.71147,2018-01-09 13:00:00,35,9,44
"206",10102,"St Johns","NL",47.56038,-52.71147,2018-01-09 14:00:00,32,11,43
"207",10102,"St Johns","NL",47.56038,-52.71147,2018-01-09 15:00:00,31,11,42
"208",10102,"St Johns","NL",47.56038,-52.71147,2018-01-09 16:00:00,32,10,42
"209",10102,"St Johns","NL",47.56038,-52.71147,2018-01-09 17:00:00,34,8,42
"210",10102,"St Johns","NL",47.56038,-52.71147,2018-01-09 18:00:00,35,5,40
"211",10102,"St Johns","NL",47.56038,-52.71147,2018-01-09 19:00:00,35,6,41
"212",10102,"St Johns","NL",47.56038,-52.71147,2018-01-09 20:00:00,39,4,43
"213",10102,"St Johns","NL",47.56038,-52.71147,2018-01-09 21:00:00,37,4,41
"214",10102,"St Johns","NL",47.56038,-52.71147,2018-01-09 22:00:00,31,8,39
"215",10102,"St Johns","NL",47.56038,-52.71147,2018-01-09 23:00:00,36,4,40
"216",10102,"St Johns","NL",47.56038,-52.71147,2018-01-10 00:00:00,36,3,39
"217",10102,"St Johns","NL",47.56038,-52.71147,2018-01-10 01:00:00,37,3,40
"218",10102,"St Johns","NL",47.56038,-52.71147,2018-01-10 02:00:00,36,3,39
"219",10102,"St Johns","NL",47.56038,-52.71147,2018-01-10 03:00:00,35,3,38
"220",10102,"St Johns","NL",47.56038,-52.71147,2018-01-10 04:00:00,36,2,38
"221",10102,"St Johns","NL",47.56038,-52.71147,2018-01-10 05:00:00,35,3,38
"222",10102,"St Johns","NL",47.56038,-52.71147,2018-01-10 06:00:00,36,3,39
"223",10102,"St Johns","NL",47.56038,-52.71147,2018-01-10 07:00:00,39,3,42
"224",10102,"St Johns","NL",47.56038,-52.71147,2018-01-10 08:00:00,41,2,43
"225",10102,"St Johns","NL",47.56038,-52.71147,2018-01-10 09:00:00,40,3,43
"226",10102,"St Johns","NL",47.56038,-52.71147,2018-01-10 10:00:00,39,3,42
"227",10102,"St Johns","NL",47.56038,-52.71147,2018-01-10 11:00:00,35,3,38
"228",10102,"St Johns","NL",47.56038,-52.71147,2018-01-10 12:00:00,36,2,38
"229",10102,"St Johns","NL",47.56038,-52.71147,2018-01-10 13:00:00,40,2,42
"230",10102,"St Johns","NL",47.56038,-52.71147,2018-01-10 14:00:00,39,3,42
"231",10102,"St Johns","NL",47.56038,-52.71147,2018-01-10 15:00:00,40,1,41
"232",10102,"St Johns","NL",47.56038,-52.71147,2018-01-10 16:00:00,41,2,43
"233",10102,"St Johns","NL",47.56038,-52.71147,2018-01-10 17:00:00,42,3,45
"234",10102,"St Johns","NL",47.56038,-52.71147,2018-01-10 18:00:00,42,2,44
"235",10102,"St Johns","NL",47.56038,-52.71147,2018-01-10 19:00:00,42,2,44
"236",10102,"St Johns","NL",47.56038,-52.71147,2018-01-10 20:00:00,40,2,42
"237",10102,"St Johns","NL",47.56038,-52.71147,2018-01-10 21:00:00,40,2,42
"238",10102,"St Johns","NL",47.56038,-52.71147,2018-01-10 22:00:00,40,2,42
"239",10102,"St Johns","NL",47.56038,-52.71147,2018-01-10 23:00:00,39,3,42
"240",10102,"St Johns","NL",47.56038,-52.71147,2018-01-11 00:00:00,39,2,41
"241",10102,"St Johns","NL",47.56038,-52.71147,2018-01-11 01:00:00,40,2,42
"242",10102,"St Johns","NL",47.56038,-52.71147,2018-01-11 02:00:00,39,3,42
"243",10102,"St Johns","NL",47.56038,-52.71147,2018-01-11 03:00:00,40,1,41
"244",10102,"St Johns","NL",47.56038,-52.71147,2018-01-11 04:00:00,39,2,41
"245",10102,"St Johns","NL",47.56038,-52.71147,2018-01-11 05:00:00,37,2,39
"246",10102,"St Johns","NL",47.56038,-52.71147,2018-01-11 06:00:00,35,4,39
"247",10102,"St Johns","NL",47.56038,-52.71147,2018-01-11 07:00:00,33,6,39
"248",10102,"St Johns","NL",47.56038,-52.71147,2018-01-11 08:00:00,30,8,38
"249",10102,"St Johns","NL",47.56038,-52.71147,2018-01-11 09:00:00,27,12,39
"250",10102,"St Johns","NL",47.56038,-52.71147,2018-01-11 10:00:00,34,6,40
"251",10102,"St Johns","NL",47.56038,-52.71147,2018-01-11 11:00:00,33,4,37
"252",10102,"St Johns","NL",47.56038,-52.71147,2018-01-11 12:00:00,33,3,36
"253",10102,"St Johns","NL",47.56038,-52.71147,2018-01-11 13:00:00,37,6,43
"254",10102,"St Johns","NL",47.56038,-52.71147,2018-01-11 14:00:00,37,6,43
"255",10102,"St Johns","NL",47.56038,-52.71147,2018-01-11 15:00:00,37,6,43
"256",10102,"St Johns","NL",47.56038,-52.71147,2018-01-11 16:00:00,38,5,43
"257",10102,"St Johns","NL",47.56038,-52.71147,2018-01-11 17:00:00,38,5,43
"258",10102,"St Johns","NL",47.56038,-52.71147,2018-01-11 18:00:00,38,4,42
"259",10102,"St Johns","NL",47.56038,-52.71147,2018-01-11 19:00:00,38,3,41
"260",10102,"St Johns","NL",47.56038,-52.71147,2018-01-11 20:00:00,38,2,40
"261",10102,"St Johns","NL",47.56038,-52.71147,2018-01-11 21:00:00,37,2,39
"262",10102,"St Johns","NL",47.56038,-52.71147,2018-01-11 22:00:00,37,2,39
"263",10102,"St Johns","NL",47.56038,-52.71147,2018-01-11 23:00:00,20,2,22
"264",10102,"St Johns","NL",47.56038,-52.71147,2018-01-12 00:00:00,35,3,38
"265",10102,"St Johns","NL",47.56038,-52.71147,2018-01-12 01:00:00,34,3,37
"266",10102,"St Johns","NL",47.56038,-52.71147,2018-01-12 02:00:00,34,2,36
"267",10102,"St Johns","NL",47.56038,-52.71147,2018-01-12 03:00:00,34,2,36
"268",10102,"St Johns","NL",47.56038,-52.71147,2018-01-12 04:00:00,34,2,36
"269",10102,"St Johns","NL",47.56038,-52.71147,2018-01-12 05:00:00,30,5,35
"270",10102,"St Johns","NL",47.56038,-52.71147,2018-01-12 06:00:00,28,6,34
"271",10102,"St Johns","NL",47.56038,-52.71147,2018-01-12 07:00:00,26,9,35
"272",10102,"St Johns","NL",47.56038,-52.71147,2018-01-12 08:00:00,27,8,35
"273",10102,"St Johns","NL",47.56038,-52.71147,2018-01-12 09:00:00,25,11,36
"274",10102,"St Johns","NL",47.56038,-52.71147,2018-01-12 10:00:00,30,7,37
"275",10102,"St Johns","NL",47.56038,-52.71147,2018-01-12 11:00:00,27,6,33
"276",10102,"St Johns","NL",47.56038,-52.71147,2018-01-12 12:00:00,30,6,36
"277",10102,"St Johns","NL",47.56038,-52.71147,2018-01-12 13:00:00,27,7,34
"278",10102,"St Johns","NL",47.56038,-52.71147,2018-01-12 14:00:00,31,4,35
"279",10102,"St Johns","NL",47.56038,-52.71147,2018-01-12 15:00:00,34,3,37
"280",10102,"St Johns","NL",47.56038,-52.71147,2018-01-12 16:00:00,34,3,37
"281",10102,"St Johns","NL",47.56038,-52.71147,2018-01-12 17:00:00,35,3,38
"282",10102,"St Johns","NL",47.56038,-52.71147,2018-01-12 18:00:00,36,2,38
"283",10102,"St Johns","NL",47.56038,-52.71147,2018-01-12 19:00:00,37,2,39
"284",10102,"St Johns","NL",47.56038,-52.71147,2018-01-12 20:00:00,36,1,37
"285",10102,"St Johns","NL",47.56038,-52.71147,2018-01-12 21:00:00,36,1,37
"286",10102,"St Johns","NL",47.56038,-52.71147,2018-01-12 22:00:00,35,1,36
"287",10102,"St Johns","NL",47.56038,-52.71147,2018-01-12 23:00:00,35,1,36
"288",10102,"St Johns","NL",47.56038,-52.71147,2018-01-13 00:00:00,35,1,36
"289",10102,"St Johns","NL",47.56038,-52.71147,2018-01-13 01:00:00,35,1,36
"290",10102,"St Johns","NL",47.56038,-52.71147,2018-01-13 02:00:00,36,0,36
"291",10102,"St Johns","NL",47.56038,-52.71147,2018-01-13 03:00:00,36,1,37
"292",10102,"St Johns","NL",47.56038,-52.71147,2018-01-13 04:00:00,36,0,36
"293",10102,"St Johns","NL",47.56038,-52.71147,2018-01-13 05:00:00,37,0,37
"294",10102,"St Johns","NL",47.56038,-52.71147,2018-01-13 06:00:00,37,0,37
"295",10102,"St Johns","NL",47.56038,-52.71147,2018-01-13 07:00:00,38,1,39
"296",10102,"St Johns","NL",47.56038,-52.71147,2018-01-13 08:00:00,38,1,39
"297",10102,"St Johns","NL",47.56038,-52.71147,2018-01-13 09:00:00,39,1,40
"298",10102,"St Johns","NL",47.56038,-52.71147,2018-01-13 10:00:00,39,1,40
"299",10102,"St Johns","NL",47.56038,-52.71147,2018-01-13 11:00:00,39,1,40
"300",10102,"St Johns","NL",47.56038,-52.71147,2018-01-13 12:00:00,38,1,39
"301",10102,"St Johns","NL",47.56038,-52.71147,2018-01-13 13:00:00,39,1,40
"302",10102,"St Johns","NL",47.56038,-52.71147,2018-01-13 14:00:00,39,0,39
"303",10102,"St Johns","NL",47.56038,-52.71147,2018-01-13 15:00:00,39,1,40
"304",10102,"St Johns","NL",47.56038,-52.71147,2018-01-13 16:00:00,38,0,38
"305",10102,"St Johns","NL",47.56038,-52.71147,2018-01-13 17:00:00,39,1,40
"306",10102,"St Johns","NL",47.56038,-52.71147,2018-01-13 18:00:00,39,0,39
"307",10102,"St Johns","NL",47.56038,-52.71147,2018-01-13 19:00:00,39,1,40
"308",10102,"St Johns","NL",47.56038,-52.71147,2018-01-13 20:00:00,38,0,38
"309",10102,"St Johns","NL",47.56038,-52.71147,2018-01-13 21:00:00,38,0,38
"310",10102,"St Johns","NL",47.56038,-52.71147,2018-01-13 22:00:00,37,1,38
"311",10102,"St Johns","NL",47.56038,-52.71147,2018-01-13 23:00:00,37,0,37
"312",10102,"St Johns","NL",47.56038,-52.71147,2018-01-14 00:00:00,37,0,37
"313",10102,"St Johns","NL",47.56038,-52.71147,2018-01-14 01:00:00,37,1,38
"314",10102,"St Johns","NL",47.56038,-52.71147,2018-01-14 02:00:00,37,0,37
"315",10102,"St Johns","NL",47.56038,-52.71147,2018-01-14 03:00:00,38,0,38
"316",10102,"St Johns","NL",47.56038,-52.71147,2018-01-14 04:00:00,38,0,38
"317",10102,"St Johns","NL",47.56038,-52.71147,2018-01-14 05:00:00,38,0,38
"318",10102,"St Johns","NL",47.56038,-52.71147,2018-01-14 06:00:00,37,1,38
"319",10102,"St Johns","NL",47.56038,-52.71147,2018-01-14 07:00:00,37,0,37
"320",10102,"St Johns","NL",47.56038,-52.71147,2018-01-14 08:00:00,37,1,38
"321",10102,"St Johns","NL",47.56038,-52.71147,2018-01-14 09:00:00,36,1,37
"322",10102,"St Johns","NL",47.56038,-52.71147,2018-01-14 10:00:00,36,1,37
"323",10102,"St Johns","NL",47.56038,-52.71147,2018-01-14 11:00:00,36,1,37
"324",10102,"St Johns","NL",47.56038,-52.71147,2018-01-14 12:00:00,34,1,35
"325",10102,"St Johns","NL",47.56038,-52.71147,2018-01-14 13:00:00,31,1,32
"326",10102,"St Johns","NL",47.56038,-52.71147,2018-01-14 14:00:00,28,3,31
"327",10102,"St Johns","NL",47.56038,-52.71147,2018-01-14 15:00:00,29,1,30
"328",10102,"St Johns","NL",47.56038,-52.71147,2018-01-14 16:00:00,28,1,29
"329",10102,"St Johns","NL",47.56038,-52.71147,2018-01-14 17:00:00,28,1,29
"330",10102,"St Johns","NL",47.56038,-52.71147,2018-01-14 18:00:00,28,1,29
"331",10102,"St Johns","NL",47.56038,-52.71147,2018-01-14 19:00:00,26,3,29
"332",10102,"St Johns","NL",47.56038,-52.71147,2018-01-14 20:00:00,28,4,32
"333",10102,"St Johns","NL",47.56038,-52.71147,2018-01-14 21:00:00,29,5,34
"334",10102,"St Johns","NL",47.56038,-52.71147,2018-01-14 22:00:00,30,3,33
"335",10102,"St Johns","NL",47.56038,-52.71147,2018-01-14 23:00:00,31,2,33
"336",10102,"St Johns","NL",47.56038,-52.71147,2018-01-15 00:00:00,33,0,33
"337",10102,"St Johns","NL",47.56038,-52.71147,2018-01-15 01:00:00,35,1,36
"338",10102,"St Johns","NL",47.56038,-52.71147,2018-01-15 02:00:00,34,0,34
"339",10102,"St Johns","NL",47.56038,-52.71147,2018-01-15 03:00:00,35,0,35
"340",10102,"St Johns","NL",47.56038,-52.71147,2018-01-15 04:00:00,33,0,33
"341",10102,"St Johns","NL",47.56038,-52.71147,2018-01-15 05:00:00,32,0,32
"342",10102,"St Johns","NL",47.56038,-52.71147,2018-01-15 06:00:00,33,0,33
"343",10102,"St Johns","NL",47.56038,-52.71147,2018-01-15 07:00:00,34,1,35
"344",10102,"St Johns","NL",47.56038,-52.71147,2018-01-15 08:00:00,33,2,35
"345",10102,"St Johns","NL",47.56038,-52.71147,2018-01-15 09:00:00,32,6,38
"346",10102,"St Johns","NL",47.56038,-52.71147,2018-01-15 10:00:00,33,4,37
"347",10102,"St Johns","NL",47.56038,-52.71147,2018-01-15 11:00:00,34,2,36
"348",10102,"St Johns","NL",47.56038,-52.71147,2018-01-15 12:00:00,34,5,39
"349",10102,"St Johns","NL",47.56038,-52.71147,2018-01-15 13:00:00,33,7,40
"350",10102,"St Johns","NL",47.56038,-52.71147,2018-01-15 14:00:00,33,7,40
"351",10102,"St Johns","NL",47.56038,-52.71147,2018-01-15 15:00:00,34,5,39
"352",10102,"St Johns","NL",47.56038,-52.71147,2018-01-15 16:00:00,34,7,41
"353",10102,"St Johns","NL",47.56038,-52.71147,2018-01-15 17:00:00,32,8,40
"354",10102,"St Johns","NL",47.56038,-52.71147,2018-01-15 18:00:00,28,12,40
"355",10102,"St Johns","NL",47.56038,-52.71147,2018-01-15 19:00:00,26,13,39
"356",10102,"St Johns","NL",47.56038,-52.71147,2018-01-15 20:00:00,26,14,40
"357",10102,"St Johns","NL",47.56038,-52.71147,2018-01-15 21:00:00,27,14,41
"358",10102,"St Johns","NL",47.56038,-52.71147,2018-01-15 22:00:00,28,12,40
"359",10102,"St Johns","NL",47.56038,-52.71147,2018-01-15 23:00:00,25,15,40
"360",10102,"St Johns","NL",47.56038,-52.71147,2018-01-16 00:00:00,17,26,43
"361",10102,"St Johns","NL",47.56038,-52.71147,2018-01-16 01:00:00,27,16,43
"362",10102,"St Johns","NL",47.56038,-52.71147,2018-01-16 02:00:00,31,10,41
"363",10102,"St Johns","NL",47.56038,-52.71147,2018-01-16 03:00:00,33,7,40
"364",10102,"St Johns","NL",47.56038,-52.71147,2018-01-16 04:00:00,34,7,41
"365",10102,"St Johns","NL",47.56038,-52.71147,2018-01-16 05:00:00,34,7,41
"366",10102,"St Johns","NL",47.56038,-52.71147,2018-01-16 06:00:00,34,8,42
"367",10102,"St Johns","NL",47.56038,-52.71147,2018-01-16 07:00:00,34,7,41
"368",10102,"St Johns","NL",47.56038,-52.71147,2018-01-16 08:00:00,33,8,41
"369",10102,"St Johns","NL",47.56038,-52.71147,2018-01-16 09:00:00,33,9,42
"370",10102,"St Johns","NL",47.56038,-52.71147,2018-01-16 10:00:00,34,8,42
"371",10102,"St Johns","NL",47.56038,-52.71147,2018-01-16 11:00:00,33,10,43
"372",10102,"St Johns","NL",47.56038,-52.71147,2018-01-16 12:00:00,28,12,40
"373",10102,"St Johns","NL",47.56038,-52.71147,2018-01-16 13:00:00,34,6,40
"374",10102,"St Johns","NL",47.56038,-52.71147,2018-01-16 14:00:00,36,4,40
"375",10102,"St Johns","NL",47.56038,-52.71147,2018-01-16 15:00:00,38,3,41
"376",10102,"St Johns","NL",47.56038,-52.71147,2018-01-16 16:00:00,37,4,41
"377",10102,"St Johns","NL",47.56038,-52.71147,2018-01-16 17:00:00,36,4,40
"378",10102,"St Johns","NL",47.56038,-52.71147,2018-01-16 18:00:00,37,4,41
"379",10102,"St Johns","NL",47.56038,-52.71147,2018-01-16 19:00:00,36,5,41
"380",10102,"St Johns","NL",47.56038,-52.71147,2018-01-16 20:00:00,34,6,40
"381",10102,"St Johns","NL",47.56038,-52.71147,2018-01-16 21:00:00,32,12,44
"382",10102,"St Johns","NL",47.56038,-52.71147,2018-01-16 22:00:00,34,11,45
"383",10102,"St Johns","NL",47.56038,-52.71147,2018-01-16 23:00:00,37,4,41
"384",10102,"St Johns","NL",47.56038,-52.71147,2018-01-17 00:00:00,36,4,40
"385",10102,"St Johns","NL",47.56038,-52.71147,2018-01-17 01:00:00,35,6,41
"386",10102,"St Johns","NL",47.56038,-52.71147,2018-01-17 02:00:00,36,5,41
"387",10102,"St Johns","NL",47.56038,-52.71147,2018-01-17 03:00:00,37,3,40
"388",10102,"St Johns","NL",47.56038,-52.71147,2018-01-17 04:00:00,35,3,38
"389",10102,"St Johns","NL",47.56038,-52.71147,2018-01-17 05:00:00,36,3,39
"390",10102,"St Johns","NL",47.56038,-52.71147,2018-01-17 06:00:00,35,5,40
"391",10102,"St Johns","NL",47.56038,-52.71147,2018-01-17 07:00:00,36,6,42
"392",10102,"St Johns","NL",47.56038,-52.71147,2018-01-17 08:00:00,34,7,41
"393",10102,"St Johns","NL",47.56038,-52.71147,2018-01-17 09:00:00,30,10,40
"394",10102,"St Johns","NL",47.56038,-52.71147,2018-01-17 10:00:00,28,11,39
"395",10102,"St Johns","NL",47.56038,-52.71147,2018-01-17 11:00:00,32,7,39
"396",10102,"St Johns","NL",47.56038,-52.71147,2018-01-17 12:00:00,30,10,40
"397",10102,"St Johns","NL",47.56038,-52.71147,2018-01-17 13:00:00,33,6,39
"398",10102,"St Johns","NL",47.56038,-52.71147,2018-01-17 14:00:00,34,5,39
"399",10102,"St Johns","NL",47.56038,-52.71147,2018-01-17 15:00:00,32,8,40
"400",10102,"St Johns","NL",47.56038,-52.71147,2018-01-17 16:00:00,31,9,40
"401",10102,"St Johns","NL",47.56038,-52.71147,2018-01-17 17:00:00,31,9,40
"402",10102,"St Johns","NL",47.56038,-52.71147,2018-01-17 18:00:00,31,10,41
"403",10102,"St Johns","NL",47.56038,-52.71147,2018-01-17 19:00:00,30,10,40
"404",10102,"St Johns","NL",47.56038,-52.71147,2018-01-17 20:00:00,29,11,40
"405",10102,"St Johns","NL",47.56038,-52.71147,2018-01-17 21:00:00,25,14,39
"406",10102,"St Johns","NL",47.56038,-52.71147,2018-01-17 22:00:00,19,19,38
"407",10102,"St Johns","NL",47.56038,-52.71147,2018-01-17 23:00:00,14,23,37
"408",10102,"St Johns","NL",47.56038,-52.71147,2018-01-18 00:00:00,13,28,41
"409",10102,"St Johns","NL",47.56038,-52.71147,2018-01-18 01:00:00,28,8,36
"410",10102,"St Johns","NL",47.56038,-52.71147,2018-01-18 02:00:00,19,16,35
"411",10102,"St Johns","NL",47.56038,-52.71147,2018-01-18 03:00:00,17,23,40
"412",10102,"St Johns","NL",47.56038,-52.71147,2018-01-18 04:00:00,20,28,48
"413",10102,"St Johns","NL",47.56038,-52.71147,2018-01-18 05:00:00,26,19,45
"414",10102,"St Johns","NL",47.56038,-52.71147,2018-01-18 06:00:00,30,11,41
"415",10102,"St Johns","NL",47.56038,-52.71147,2018-01-18 07:00:00,35,8,43
"416",10102,"St Johns","NL",47.56038,-52.71147,2018-01-18 08:00:00,32,10,42
"417",10102,"St Johns","NL",47.56038,-52.71147,2018-01-18 09:00:00,32,10,42
"418",10102,"St Johns","NL",47.56038,-52.71147,2018-01-18 10:00:00,30,11,41
"419",10102,"St Johns","NL",47.56038,-52.71147,2018-01-18 11:00:00,29,13,42
"420",10102,"St Johns","NL",47.56038,-52.71147,2018-01-18 12:00:00,31,7,38
"421",10102,"St Johns","NL",47.56038,-52.71147,2018-01-18 13:00:00,34,5,39
"422",10102,"St Johns","NL",47.56038,-52.71147,2018-01-18 14:00:00,36,3,39
"423",10102,"St Johns","NL",47.56038,-52.71147,2018-01-18 15:00:00,35,3,38
"424",10102,"St Johns","NL",47.56038,-52.71147,2018-01-18 16:00:00,32,4,36
"425",10102,"St Johns","NL",47.56038,-52.71147,2018-01-18 17:00:00,31,4,35
"426",10102,"St Johns","NL",47.56038,-52.71147,2018-01-18 18:00:00,31,4,35
"427",10102,"St Johns","NL",47.56038,-52.71147,2018-01-18 19:00:00,33,3,36
"428",10102,"St Johns","NL",47.56038,-52.71147,2018-01-18 20:00:00,33,4,37
"429",10102,"St Johns","NL",47.56038,-52.71147,2018-01-18 21:00:00,33,4,37
"430",10102,"St Johns","NL",47.56038,-52.71147,2018-01-18 22:00:00,36,1,37
"431",10102,"St Johns","NL",47.56038,-52.71147,2018-01-18 23:00:00,36,2,38
"432",10102,"St Johns","NL",47.56038,-52.71147,2018-01-19 00:00:00,35,2,37
"433",10102,"St Johns","NL",47.56038,-52.71147,2018-01-19 01:00:00,33,1,34
"434",10102,"St Johns","NL",47.56038,-52.71147,2018-01-19 02:00:00,32,2,34
"435",10102,"St Johns","NL",47.56038,-52.71147,2018-01-19 03:00:00,34,1,35
"436",10102,"St Johns","NL",47.56038,-52.71147,2018-01-19 04:00:00,33,4,37
"437",10102,"St Johns","NL",47.56038,-52.71147,2018-01-19 05:00:00,30,9,39
"438",10102,"St Johns","NL",47.56038,-52.71147,2018-01-19 06:00:00,25,15,40
"439",10102,"St Johns","NL",47.56038,-52.71147,2018-01-19 07:00:00,22,15,37
"440",10102,"St Johns","NL",47.56038,-52.71147,2018-01-19 08:00:00,22,15,37
"441",10102,"St Johns","NL",47.56038,-52.71147,2018-01-19 09:00:00,19,16,35
"442",10102,"St Johns","NL",47.56038,-52.71147,2018-01-19 10:00:00,22,12,34
"443",10102,"St Johns","NL",47.56038,-52.71147,2018-01-19 11:00:00,26,10,36
"444",10102,"St Johns","NL",47.56038,-52.71147,2018-01-19 12:00:00,27,9,36
"445",10102,"St Johns","NL",47.56038,-52.71147,2018-01-19 13:00:00,29,6,35
"446",10102,"St Johns","NL",47.56038,-52.71147,2018-01-19 14:00:00,26,9,35
"447",10102,"St Johns","NL",47.56038,-52.71147,2018-01-19 15:00:00,22,15,37
"448",10102,"St Johns","NL",47.56038,-52.71147,2018-01-19 16:00:00,25,10,35
"449",10102,"St Johns","NL",47.56038,-52.71147,2018-01-19 17:00:00,28,7,35
"450",10102,"St Johns","NL",47.56038,-52.71147,2018-01-19 18:00:00,29,5,34
"451",10102,"St Johns","NL",47.56038,-52.71147,2018-01-19 19:00:00,29,5,34
"452",10102,"St Johns","NL",47.56038,-52.71147,2018-01-19 20:00:00,30,4,34
"453",10102,"St Johns","NL",47.56038,-52.71147,2018-01-19 21:00:00,30,5,35
"454",10102,"St Johns","NL",47.56038,-52.71147,2018-01-19 22:00:00,30,3,33
"455",10102,"St Johns","NL",47.56038,-52.71147,2018-01-19 23:00:00,31,3,34
"456",10102,"St Johns","NL",47.56038,-52.71147,2018-01-20 00:00:00,31,3,34
"457",10102,"St Johns","NL",47.56038,-52.71147,2018-01-20 01:00:00,30,4,34
"458",10102,"St Johns","NL",47.56038,-52.71147,2018-01-20 02:00:00,30,4,34
"459",10102,"St Johns","NL",47.56038,-52.71147,2018-01-20 03:00:00,30,3,33
"460",10102,"St Johns","NL",47.56038,-52.71147,2018-01-20 04:00:00,30,4,34
"461",10102,"St Johns","NL",47.56038,-52.71147,2018-01-20 05:00:00,28,6,34
"462",10102,"St Johns","NL",47.56038,-52.71147,2018-01-20 06:00:00,27,7,34
"463",10102,"St Johns","NL",47.56038,-52.71147,2018-01-20 07:00:00,27,6,33
"464",10102,"St Johns","NL",47.56038,-52.71147,2018-01-20 08:00:00,27,7,34
"465",10102,"St Johns","NL",47.56038,-52.71147,2018-01-20 09:00:00,26,5,31
"466",10102,"St Johns","NL",47.56038,-52.71147,2018-01-20 10:00:00,27,5,32
"467",10102,"St Johns","NL",47.56038,-52.71147,2018-01-20 11:00:00,30,4,34
"468",10102,"St Johns","NL",47.56038,-52.71147,2018-01-20 12:00:00,32,3,35
"469",10102,"St Johns","NL",47.56038,-52.71147,2018-01-20 13:00:00,33,3,36
"470",10102,"St Johns","NL",47.56038,-52.71147,2018-01-20 14:00:00,33,2,35
"471",10102,"St Johns","NL",47.56038,-52.71147,2018-01-20 15:00:00,33,4,37
"472",10102,"St Johns","NL",47.56038,-52.71147,2018-01-20 16:00:00,32,4,36
"473",10102,"St Johns","NL",47.56038,-52.71147,2018-01-20 17:00:00,37,3,40
"474",10102,"St Johns","NL",47.56038,-52.71147,2018-01-20 18:00:00,35,3,38
"475",10102,"St Johns","NL",47.56038,-52.71147,2018-01-20 19:00:00,35,2,37
"476",10102,"St Johns","NL",47.56038,-52.71147,2018-01-20 20:00:00,35,3,38
"477",10102,"St Johns","NL",47.56038,-52.71147,2018-01-20 21:00:00,35,2,37
"478",10102,"St Johns","NL",47.56038,-52.71147,2018-01-20 22:00:00,34,1,35
"479",10102,"St Johns","NL",47.56038,-52.71147,2018-01-20 23:00:00,35,3,38
"480",10102,"St Johns","NL",47.56038,-52.71147,2018-01-21 00:00:00,36,3,39
"481",10102,"St Johns","NL",47.56038,-52.71147,2018-01-21 01:00:00,35,3,38
"482",10102,"St Johns","NL",47.56038,-52.71147,2018-01-21 02:00:00,33,3,36
"483",10102,"St Johns","NL",47.56038,-52.71147,2018-01-21 03:00:00,33,3,36
"484",10102,"St Johns","NL",47.56038,-52.71147,2018-01-21 04:00:00,30,3,33
"485",10102,"St Johns","NL",47.56038,-52.71147,2018-01-21 05:00:00,30,2,32
"486",10102,"St Johns","NL",47.56038,-52.71147,2018-01-21 06:00:00,29,2,31
"487",10102,"St Johns","NL",47.56038,-52.71147,2018-01-21 07:00:00,28,2,30
"488",10102,"St Johns","NL",47.56038,-52.71147,2018-01-21 08:00:00,27,2,29
"489",10102,"St Johns","NL",47.56038,-52.71147,2018-01-21 09:00:00,24,2,26
"490",10102,"St Johns","NL",47.56038,-52.71147,2018-01-21 10:00:00,24,2,26
"491",10102,"St Johns","NL",47.56038,-52.71147,2018-01-21 11:00:00,25,2,27
"492",10102,"St Johns","NL",47.56038,-52.71147,2018-01-21 12:00:00,26,3,29
"493",10102,"St Johns","NL",47.56038,-52.71147,2018-01-21 13:00:00,28,2,30
"494",10102,"St Johns","NL",47.56038,-52.71147,2018-01-21 14:00:00,29,2,31
"495",10102,"St Johns","NL",47.56038,-52.71147,2018-01-21 15:00:00,29,2,31
"496",10102,"St Johns","NL",47.56038,-52.71147,2018-01-21 16:00:00,32,2,34
"497",10102,"St Johns","NL",47.56038,-52.71147,2018-01-21 17:00:00,34,2,36
"498",10102,"St Johns","NL",47.56038,-52.71147,2018-01-21 18:00:00,34,3,37
"499",10102,"St Johns","NL",47.56038,-52.71147,2018-01-21 19:00:00,35,2,37
"500",10102,"St Johns","NL",47.56038,-52.71147,2018-01-21 20:00:00,37,2,39
"501",10102,"St Johns","NL",47.56038,-52.71147,2018-01-21 21:00:00,38,1,39
"502",10102,"St Johns","NL",47.56038,-52.71147,2018-01-21 22:00:00,38,1,39
"503",10102,"St Johns","NL",47.56038,-52.71147,2018-01-21 23:00:00,38,2,40
"504",10102,"St Johns","NL",47.56038,-52.71147,2018-01-22 00:00:00,39,1,40
"505",10102,"St Johns","NL",47.56038,-52.71147,2018-01-22 01:00:00,37,2,39
"506",10102,"St Johns","NL",47.56038,-52.71147,2018-01-22 02:00:00,36,2,38
"507",10102,"St Johns","NL",47.56038,-52.71147,2018-01-22 03:00:00,35,3,38
"508",10102,"St Johns","NL",47.56038,-52.71147,2018-01-22 04:00:00,33,5,38
"509",10102,"St Johns","NL",47.56038,-52.71147,2018-01-22 05:00:00,34,3,37
"510",10102,"St Johns","NL",47.56038,-52.71147,2018-01-22 06:00:00,35,3,38
"511",10102,"St Johns","NL",47.56038,-52.71147,2018-01-22 07:00:00,35,2,37
"512",10102,"St Johns","NL",47.56038,-52.71147,2018-01-22 08:00:00,34,3,37
"513",10102,"St Johns","NL",47.56038,-52.71147,2018-01-22 09:00:00,35,3,38
"514",10102,"St Johns","NL",47.56038,-52.71147,2018-01-22 10:00:00,34,4,38
"515",10102,"St Johns","NL",47.56038,-52.71147,2018-01-22 11:00:00,35,3,38
"516",10102,"St Johns","NL",47.56038,-52.71147,2018-01-22 12:00:00,36,3,39
"517",10102,"St Johns","NL",47.56038,-52.71147,2018-01-22 13:00:00,36,3,39
"518",10102,"St Johns","NL",47.56038,-52.71147,2018-01-22 14:00:00,37,2,39
"519",10102,"St Johns","NL",47.56038,-52.71147,2018-01-22 15:00:00,37,1,38
"520",10102,"St Johns","NL",47.56038,-52.71147,2018-01-22 16:00:00,36,2,38
"521",10102,"St Johns","NL",47.56038,-52.71147,2018-01-22 17:00:00,36,2,38
"522",10102,"St Johns","NL",47.56038,-52.71147,2018-01-22 18:00:00,36,2,38
"523",10102,"St Johns","NL",47.56038,-52.71147,2018-01-22 19:00:00,36,1,37
"524",10102,"St Johns","NL",47.56038,-52.71147,2018-01-22 20:00:00,36,1,37
"525",10102,"St Johns","NL",47.56038,-52.71147,2018-01-22 21:00:00,35,2,37
"526",10102,"St Johns","NL",47.56038,-52.71147,2018-01-22 22:00:00,34,3,37
"527",10102,"St Johns","NL",47.56038,-52.71147,2018-01-22 23:00:00,33,3,36
"528",10102,"St Johns","NL",47.56038,-52.71147,2018-01-23 00:00:00,30,8,38
"529",10102,"St Johns","NL",47.56038,-52.71147,2018-01-23 01:00:00,35,2,37
"530",10102,"St Johns","NL",47.56038,-52.71147,2018-01-23 02:00:00,36,1,37
"531",10102,"St Johns","NL",47.56038,-52.71147,2018-01-23 03:00:00,36,1,37
"532",10102,"St Johns","NL",47.56038,-52.71147,2018-01-23 04:00:00,36,2,38
"533",10102,"St Johns","NL",47.56038,-52.71147,2018-01-23 05:00:00,34,3,37
"534",10102,"St Johns","NL",47.56038,-52.71147,2018-01-23 06:00:00,33,4,37
"535",10102,"St Johns","NL",47.56038,-52.71147,2018-01-23 07:00:00,33,4,37
"536",10102,"St Johns","NL",47.56038,-52.71147,2018-01-23 08:00:00,31,8,39
"537",10102,"St Johns","NL",47.56038,-52.71147,2018-01-23 09:00:00,30,9,39
"538",10102,"St Johns","NL",47.56038,-52.71147,2018-01-23 10:00:00,29,13,42
"539",10102,"St Johns","NL",47.56038,-52.71147,2018-01-23 11:00:00,32,10,42
"540",10102,"St Johns","NL",47.56038,-52.71147,2018-01-23 12:00:00,NA,6,NA
"541",10102,"St Johns","NL",47.56038,-52.71147,2018-01-23 13:00:00,36,NA,NA
"542",10102,"St Johns","NL",47.56038,-52.71147,2018-01-23 14:00:00,36,10,46
"543",10102,"St Johns","NL",47.56038,-52.71147,2018-01-23 15:00:00,34,8,42
"544",10102,"St Johns","NL",47.56038,-52.71147,2018-01-23 16:00:00,32,7,39
"545",10102,"St Johns","NL",47.56038,-52.71147,2018-01-23 17:00:00,26,13,39
"546",10102,"St Johns","NL",47.56038,-52.71147,2018-01-23 18:00:00,28,10,38
"547",10102,"St Johns","NL",47.56038,-52.71147,2018-01-23 19:00:00,28,8,36
"548",10102,"St Johns","NL",47.56038,-52.71147,2018-01-23 20:00:00,24,11,35
"549",10102,"St Johns","NL",47.56038,-52.71147,2018-01-23 21:00:00,26,9,35
"550",10102,"St Johns","NL",47.56038,-52.71147,2018-01-23 22:00:00,24,10,34
"551",10102,"St Johns","NL",47.56038,-52.71147,2018-01-23 23:00:00,18,14,32
"552",10102,"St Johns","NL",47.56038,-52.71147,2018-01-24 00:00:00,6,32,38
"553",10102,"St Johns","NL",47.56038,-52.71147,2018-01-24 01:00:00,33,3,36
"554",10102,"St Johns","NL",47.56038,-52.71147,2018-01-24 02:00:00,34,1,35
"555",10102,"St Johns","NL",47.56038,-52.71147,2018-01-24 03:00:00,34,2,36
"556",10102,"St Johns","NL",47.56038,-52.71147,2018-01-24 04:00:00,33,2,35
"557",10102,"St Johns","NL",47.56038,-52.71147,2018-01-24 05:00:00,34,2,36
"558",10102,"St Johns","NL",47.56038,-52.71147,2018-01-24 06:00:00,34,2,36
"559",10102,"St Johns","NL",47.56038,-52.71147,2018-01-24 07:00:00,34,3,37
"560",10102,"St Johns","NL",47.56038,-52.71147,2018-01-24 08:00:00,33,4,37
"561",10102,"St Johns","NL",47.56038,-52.71147,2018-01-24 09:00:00,32,4,36
"562",10102,"St Johns","NL",47.56038,-52.71147,2018-01-24 10:00:00,32,5,37
"563",10102,"St Johns","NL",47.56038,-52.71147,2018-01-24 11:00:00,34,4,38
"564",10102,"St Johns","NL",47.56038,-52.71147,2018-01-24 12:00:00,33,3,36
"565",10102,"St Johns","NL",47.56038,-52.71147,2018-01-24 13:00:00,33,5,38
"566",10102,"St Johns","NL",47.56038,-52.71147,2018-01-24 14:00:00,34,4,38
"567",10102,"St Johns","NL",47.56038,-52.71147,2018-01-24 15:00:00,34,5,39
"568",10102,"St Johns","NL",47.56038,-52.71147,2018-01-24 16:00:00,35,4,39
"569",10102,"St Johns","NL",47.56038,-52.71147,2018-01-24 17:00:00,35,5,40
"570",10102,"St Johns","NL",47.56038,-52.71147,2018-01-24 18:00:00,36,2,38
"571",10102,"St Johns","NL",47.56038,-52.71147,2018-01-24 19:00:00,35,3,38
"572",10102,"St Johns","NL",47.56038,-52.71147,2018-01-24 20:00:00,35,3,38
"573",10102,"St Johns","NL",47.56038,-52.71147,2018-01-24 21:00:00,35,3,38
"574",10102,"St Johns","NL",47.56038,-52.71147,2018-01-24 22:00:00,36,2,38
"575",10102,"St Johns","NL",47.56038,-52.71147,2018-01-24 23:00:00,35,2,37
"576",10102,"St Johns","NL",47.56038,-52.71147,2018-01-25 00:00:00,33,3,36
"577",10102,"St Johns","NL",47.56038,-52.71147,2018-01-25 01:00:00,31,3,34
"578",10102,"St Johns","NL",47.56038,-52.71147,2018-01-25 02:00:00,31,2,33
"579",10102,"St Johns","NL",47.56038,-52.71147,2018-01-25 03:00:00,31,2,33
"580",10102,"St Johns","NL",47.56038,-52.71147,2018-01-25 04:00:00,29,2,31
"581",10102,"St Johns","NL",47.56038,-52.71147,2018-01-25 05:00:00,25,2,27
"582",10102,"St Johns","NL",47.56038,-52.71147,2018-01-25 06:00:00,23,2,25
"583",10102,"St Johns","NL",47.56038,-52.71147,2018-01-25 07:00:00,23,2,25
"584",10102,"St Johns","NL",47.56038,-52.71147,2018-01-25 08:00:00,25,4,29
"585",10102,"St Johns","NL",47.56038,-52.71147,2018-01-25 09:00:00,30,4,34
"586",10102,"St Johns","NL",47.56038,-52.71147,2018-01-25 10:00:00,31,4,35
"587",10102,"St Johns","NL",47.56038,-52.71147,2018-01-25 11:00:00,32,4,36
"588",10102,"St Johns","NL",47.56038,-52.71147,2018-01-25 12:00:00,33,3,36
"589",10102,"St Johns","NL",47.56038,-52.71147,2018-01-25 13:00:00,34,4,38
"590",10102,"St Johns","NL",47.56038,-52.71147,2018-01-25 14:00:00,34,4,38
"591",10102,"St Johns","NL",47.56038,-52.71147,2018-01-25 15:00:00,34,4,38
"592",10102,"St Johns","NL",47.56038,-52.71147,2018-01-25 16:00:00,34,5,39
"593",10102,"St Johns","NL",47.56038,-52.71147,2018-01-25 17:00:00,34,5,39
"594",10102,"St Johns","NL",47.56038,-52.71147,2018-01-25 18:00:00,33,6,39
"595",10102,"St Johns","NL",47.56038,-52.71147,2018-01-25 19:00:00,35,4,39
"596",10102,"St Johns","NL",47.56038,-52.71147,2018-01-25 20:00:00,35,4,39
"597",10102,"St Johns","NL",47.56038,-52.71147,2018-01-25 21:00:00,35,4,39
"598",10102,"St Johns","NL",47.56038,-52.71147,2018-01-25 22:00:00,35,4,39
"599",10102,"St Johns","NL",47.56038,-52.71147,2018-01-25 23:00:00,36,2,38
"600",10102,"St Johns","NL",47.56038,-52.71147,2018-01-26 00:00:00,36,2,38
"601",10102,"St Johns","NL",47.56038,-52.71147,2018-01-26 01:00:00,36,2,38
"602",10102,"St Johns","NL",47.56038,-52.71147,2018-01-26 02:00:00,35,2,37
"603",10102,"St Johns","NL",47.56038,-52.71147,2018-01-26 03:00:00,35,2,37
"604",10102,"St Johns","NL",47.56038,-52.71147,2018-01-26 04:00:00,35,2,37
"605",10102,"St Johns","NL",47.56038,-52.71147,2018-01-26 05:00:00,34,1,35
"606",10102,"St Johns","NL",47.56038,-52.71147,2018-01-26 06:00:00,33,3,36
"607",10102,"St Johns","NL",47.56038,-52.71147,2018-01-26 07:00:00,31,3,34
"608",10102,"St Johns","NL",47.56038,-52.71147,2018-01-26 08:00:00,25,9,34
"609",10102,"St Johns","NL",47.56038,-52.71147,2018-01-26 09:00:00,16,19,35
"610",10102,"St Johns","NL",47.56038,-52.71147,2018-01-26 10:00:00,27,9,36
"611",10102,"St Johns","NL",47.56038,-52.71147,2018-01-26 11:00:00,28,7,35
"612",10102,"St Johns","NL",47.56038,-52.71147,2018-01-26 12:00:00,28,7,35
"613",10102,"St Johns","NL",47.56038,-52.71147,2018-01-26 13:00:00,30,6,36
"614",10102,"St Johns","NL",47.56038,-52.71147,2018-01-26 14:00:00,31,4,35
"615",10102,"St Johns","NL",47.56038,-52.71147,2018-01-26 15:00:00,30,5,35
"616",10102,"St Johns","NL",47.56038,-52.71147,2018-01-26 16:00:00,29,5,34
"617",10102,"St Johns","NL",47.56038,-52.71147,2018-01-26 17:00:00,28,7,35
"618",10102,"St Johns","NL",47.56038,-52.71147,2018-01-26 18:00:00,29,6,35
"619",10102,"St Johns","NL",47.56038,-52.71147,2018-01-26 19:00:00,29,5,34
"620",10102,"St Johns","NL",47.56038,-52.71147,2018-01-26 20:00:00,30,5,35
"621",10102,"St Johns","NL",47.56038,-52.71147,2018-01-26 21:00:00,29,5,34
"622",10102,"St Johns","NL",47.56038,-52.71147,2018-01-26 22:00:00,28,7,35
"623",10102,"St Johns","NL",47.56038,-52.71147,2018-01-26 23:00:00,29,6,35
"624",10102,"St Johns","NL",47.56038,-52.71147,2018-01-27 00:00:00,27,8,35
"625",10102,"St Johns","NL",47.56038,-52.71147,2018-01-27 01:00:00,28,8,36
"626",10102,"St Johns","NL",47.56038,-52.71147,2018-01-27 02:00:00,31,4,35
"627",10102,"St Johns","NL",47.56038,-52.71147,2018-01-27 03:00:00,31,4,35
"628",10102,"St Johns","NL",47.56038,-52.71147,2018-01-27 04:00:00,30,6,36
"629",10102,"St Johns","NL",47.56038,-52.71147,2018-01-27 05:00:00,32,5,37
"630",10102,"St Johns","NL",47.56038,-52.71147,2018-01-27 06:00:00,32,4,36
"631",10102,"St Johns","NL",47.56038,-52.71147,2018-01-27 07:00:00,33,4,37
"632",10102,"St Johns","NL",47.56038,-52.71147,2018-01-27 08:00:00,32,4,36
"633",10102,"St Johns","NL",47.56038,-52.71147,2018-01-27 09:00:00,33,5,38
"634",10102,"St Johns","NL",47.56038,-52.71147,2018-01-27 10:00:00,34,4,38
"635",10102,"St Johns","NL",47.56038,-52.71147,2018-01-27 11:00:00,35,5,40
"636",10102,"St Johns","NL",47.56038,-52.71147,2018-01-27 12:00:00,35,3,38
"637",10102,"St Johns","NL",47.56038,-52.71147,2018-01-27 13:00:00,34,3,37
"638",10102,"St Johns","NL",47.56038,-52.71147,2018-01-27 14:00:00,35,3,38
"639",10102,"St Johns","NL",47.56038,-52.71147,2018-01-27 15:00:00,35,3,38
"640",10102,"St Johns","NL",47.56038,-52.71147,2018-01-27 16:00:00,34,3,37
"641",10102,"St Johns","NL",47.56038,-52.71147,2018-01-27 17:00:00,33,4,37
"642",10102,"St Johns","NL",47.56038,-52.71147,2018-01-27 18:00:00,28,9,37
"643",10102,"St Johns","NL",47.56038,-52.71147,2018-01-27 19:00:00,27,8,35
"644",10102,"St Johns","NL",47.56038,-52.71147,2018-01-27 20:00:00,30,5,35
"645",10102,"St Johns","NL",47.56038,-52.71147,2018-01-27 21:00:00,29,6,35
"646",10102,"St Johns","NL",47.56038,-52.71147,2018-01-27 22:00:00,29,7,36
"647",10102,"St Johns","NL",47.56038,-52.71147,2018-01-27 23:00:00,30,5,35
"648",10102,"St Johns","NL",47.56038,-52.71147,2018-01-28 00:00:00,31,4,35
"649",10102,"St Johns","NL",47.56038,-52.71147,2018-01-28 01:00:00,31,5,36
"650",10102,"St Johns","NL",47.56038,-52.71147,2018-01-28 02:00:00,36,3,39
"651",10102,"St Johns","NL",47.56038,-52.71147,2018-01-28 03:00:00,36,2,38
"652",10102,"St Johns","NL",47.56038,-52.71147,2018-01-28 04:00:00,37,2,39
"653",10102,"St Johns","NL",47.56038,-52.71147,2018-01-28 05:00:00,38,1,39
"654",10102,"St Johns","NL",47.56038,-52.71147,2018-01-28 06:00:00,37,1,38
"655",10102,"St Johns","NL",47.56038,-52.71147,2018-01-28 07:00:00,37,1,38
"656",10102,"St Johns","NL",47.56038,-52.71147,2018-01-28 08:00:00,36,2,38
"657",10102,"St Johns","NL",47.56038,-52.71147,2018-01-28 09:00:00,36,2,38
"658",10102,"St Johns","NL",47.56038,-52.71147,2018-01-28 10:00:00,35,2,37
"659",10102,"St Johns","NL",47.56038,-52.71147,2018-01-28 11:00:00,35,2,37
"660",10102,"St Johns","NL",47.56038,-52.71147,2018-01-28 12:00:00,37,2,39
"661",10102,"St Johns","NL",47.56038,-52.71147,2018-01-28 13:00:00,39,3,42
"662",10102,"St Johns","NL",47.56038,-52.71147,2018-01-28 14:00:00,39,2,41
"663",10102,"St Johns","NL",47.56038,-52.71147,2018-01-28 15:00:00,39,2,41
"664",10102,"St Johns","NL",47.56038,-52.71147,2018-01-28 16:00:00,38,3,41
"665",10102,"St Johns","NL",47.56038,-52.71147,2018-01-28 17:00:00,38,2,40
"666",10102,"St Johns","NL",47.56038,-52.71147,2018-01-28 18:00:00,38,3,41
"667",10102,"St Johns","NL",47.56038,-52.71147,2018-01-28 19:00:00,37,3,40
"668",10102,"St Johns","NL",47.56038,-52.71147,2018-01-28 20:00:00,36,3,39
"669",10102,"St Johns","NL",47.56038,-52.71147,2018-01-28 21:00:00,36,3,39
"670",10102,"St Johns","NL",47.56038,-52.71147,2018-01-28 22:00:00,34,3,37
"671",10102,"St Johns","NL",47.56038,-52.71147,2018-01-28 23:00:00,34,3,37
"672",10102,"St Johns","NL",47.56038,-52.71147,2018-01-29 00:00:00,35,2,37
"673",10102,"St Johns","NL",47.56038,-52.71147,2018-01-29 01:00:00,33,3,36
"674",10102,"St Johns","NL",47.56038,-52.71147,2018-01-29 02:00:00,30,4,34
"675",10102,"St Johns","NL",47.56038,-52.71147,2018-01-29 03:00:00,31,4,35
"676",10102,"St Johns","NL",47.56038,-52.71147,2018-01-29 04:00:00,30,4,34
"677",10102,"St Johns","NL",47.56038,-52.71147,2018-01-29 05:00:00,26,6,32
"678",10102,"St Johns","NL",47.56038,-52.71147,2018-01-29 06:00:00,27,4,31
"679",10102,"St Johns","NL",47.56038,-52.71147,2018-01-29 07:00:00,24,7,31
"680",10102,"St Johns","NL",47.56038,-52.71147,2018-01-29 08:00:00,20,11,31
"681",10102,"St Johns","NL",47.56038,-52.71147,2018-01-29 09:00:00,14,20,34
"682",10102,"St Johns","NL",47.56038,-52.71147,2018-01-29 10:00:00,20,14,34
"683",10102,"St Johns","NL",47.56038,-52.71147,2018-01-29 11:00:00,20,11,31
"684",10102,"St Johns","NL",47.56038,-52.71147,2018-01-29 12:00:00,25,7,32
"685",10102,"St Johns","NL",47.56038,-52.71147,2018-01-29 13:00:00,26,5,31
"686",10102,"St Johns","NL",47.56038,-52.71147,2018-01-29 14:00:00,26,7,33
"687",10102,"St Johns","NL",47.56038,-52.71147,2018-01-29 15:00:00,26,5,31
"688",10102,"St Johns","NL",47.56038,-52.71147,2018-01-29 16:00:00,27,6,33
"689",10102,"St Johns","NL",47.56038,-52.71147,2018-01-29 17:00:00,28,6,34
"690",10102,"St Johns","NL",47.56038,-52.71147,2018-01-29 18:00:00,27,8,35
"691",10102,"St Johns","NL",47.56038,-52.71147,2018-01-29 19:00:00,14,23,37
"692",10102,"St Johns","NL",47.56038,-52.71147,2018-01-29 20:00:00,18,20,38
"693",10102,"St Johns","NL",47.56038,-52.71147,2018-01-29 21:00:00,18,21,39
"694",10102,"St Johns","NL",47.56038,-52.71147,2018-01-29 22:00:00,20,19,39
"695",10102,"St Johns","NL",47.56038,-52.71147,2018-01-29 23:00:00,23,16,39
"696",10102,"St Johns","NL",47.56038,-52.71147,2018-01-30 00:00:00,23,16,39
"697",10102,"St Johns","NL",47.56038,-52.71147,2018-01-30 01:00:00,25,16,41
"698",10102,"St Johns","NL",47.56038,-52.71147,2018-01-30 02:00:00,25,16,41
"699",10102,"St Johns","NL",47.56038,-52.71147,2018-01-30 03:00:00,26,15,41
"700",10102,"St Johns","NL",47.56038,-52.71147,2018-01-30 04:00:00,24,16,40
"701",10102,"St Johns","NL",47.56038,-52.71147,2018-01-30 05:00:00,26,14,40
"702",10102,"St Johns","NL",47.56038,-52.71147,2018-01-30 06:00:00,25,14,39
"703",10102,"St Johns","NL",47.56038,-52.71147,2018-01-30 07:00:00,26,14,40
"704",10102,"St Johns","NL",47.56038,-52.71147,2018-01-30 08:00:00,24,17,41
"705",10102,"St Johns","NL",47.56038,-52.71147,2018-01-30 09:00:00,26,14,40
"706",10102,"St Johns","NL",47.56038,-52.71147,2018-01-30 10:00:00,27,12,39
"707",10102,"St Johns","NL",47.56038,-52.71147,2018-01-30 11:00:00,25,23,48
"708",10102,"St Johns","NL",47.56038,-52.71147,2018-01-30 12:00:00,25,13,38
"709",10102,"St Johns","NL",47.56038,-52.71147,2018-01-30 13:00:00,28,11,39
"710",10102,"St Johns","NL",47.56038,-52.71147,2018-01-30 14:00:00,26,13,39
"711",10102,"St Johns","NL",47.56038,-52.71147,2018-01-30 15:00:00,18,27,45
"712",10102,"St Johns","NL",47.56038,-52.71147,2018-01-30 16:00:00,24,14,38
"713",10102,"St Johns","NL",47.56038,-52.71147,2018-01-30 17:00:00,21,18,39
"714",10102,"St Johns","NL",47.56038,-52.71147,2018-01-30 18:00:00,13,26,39
"715",10102,"St Johns","NL",47.56038,-52.71147,2018-01-30 19:00:00,10,28,38
"716",10102,"St Johns","NL",47.56038,-52.71147,2018-01-30 20:00:00,33,6,39
"717",10102,"St Johns","NL",47.56038,-52.71147,2018-01-30 21:00:00,39,2,41
"718",10102,"St Johns","NL",47.56038,-52.71147,2018-01-30 22:00:00,38,2,40
"719",10102,"St Johns","NL",47.56038,-52.71147,2018-01-30 23:00:00,36,3,39
"720",10102,"St Johns","NL",47.56038,-52.71147,2018-01-31 00:00:00,35,3,38
"721",10102,"St Johns","NL",47.56038,-52.71147,2018-01-31 01:00:00,33,4,37
"722",10102,"St Johns","NL",47.56038,-52.71147,2018-01-31 02:00:00,34,1,35
"723",10102,"St Johns","NL",47.56038,-52.71147,2018-01-31 03:00:00,33,3,36
"724",10102,"St Johns","NL",47.56038,-52.71147,2018-01-31 04:00:00,34,2,36
"725",10102,"St Johns","NL",47.56038,-52.71147,2018-01-31 05:00:00,33,2,35
"726",10102,"St Johns","NL",47.56038,-52.71147,2018-01-31 06:00:00,32,2,34
"727",10102,"St Johns","NL",47.56038,-52.71147,2018-01-31 07:00:00,33,2,35
"728",10102,"St Johns","NL",47.56038,-52.71147,2018-01-31 08:00:00,33,2,35
"729",10102,"St Johns","NL",47.56038,-52.71147,2018-01-31 09:00:00,33,3,36
"730",10102,"St Johns","NL",47.56038,-52.71147,2018-01-31 10:00:00,35,4,39
"731",10102,"St Johns","NL",47.56038,-52.71147,2018-01-31 11:00:00,39,3,42
"732",10102,"St Johns","NL",47.56038,-52.71147,2018-01-31 12:00:00,34,3,37
"733",10102,"St Johns","NL",47.56038,-52.71147,2018-01-31 13:00:00,31,4,35
"734",10102,"St Johns","NL",47.56038,-52.71147,2018-01-31 14:00:00,30,3,33
"735",10102,"St Johns","NL",47.56038,-52.71147,2018-01-31 15:00:00,31,3,34
"736",10102,"St Johns","NL",47.56038,-52.71147,2018-01-31 16:00:00,31,3,34
"737",10102,"St Johns","NL",47.56038,-52.71147,2018-01-31 17:00:00,32,4,36
"738",10102,"St Johns","NL",47.56038,-52.71147,2018-01-31 18:00:00,32,3,35
"739",10102,"St Johns","NL",47.56038,-52.71147,2018-01-31 19:00:00,33,2,35
"740",10102,"St Johns","NL",47.56038,-52.71147,2018-01-31 20:00:00,33,2,35
"741",10102,"St Johns","NL",47.56038,-52.71147,2018-01-31 21:00:00,33,2,35
"742",10102,"St Johns","NL",47.56038,-52.71147,2018-01-31 22:00:00,33,3,36
"743",10102,"St Johns","NL",47.56038,-52.71147,2018-01-31 23:00:00,33,3,36
"744",10102,"St Johns","NL",47.56038,-52.71147,2018-02-01 00:00:00,35,2,37
"745",10102,"St Johns","NL",47.56038,-52.71147,2018-02-01 01:00:00,36,2,38
"746",10102,"St Johns","NL",47.56038,-52.71147,2018-02-01 02:00:00,35,2,37
"747",10102,"St Johns","NL",47.56038,-52.71147,2018-02-01 03:00:00,35,2,37
"748",10102,"St Johns","NL",47.56038,-52.71147,2018-02-01 04:00:00,34,2,36
"749",10102,"St Johns","NL",47.56038,-52.71147,2018-02-01 05:00:00,33,3,36
"750",10102,"St Johns","NL",47.56038,-52.71147,2018-02-01 06:00:00,32,3,35
"751",10102,"St Johns","NL",47.56038,-52.71147,2018-02-01 07:00:00,33,3,36
"752",10102,"St Johns","NL",47.56038,-52.71147,2018-02-01 08:00:00,32,4,36
"753",10102,"St Johns","NL",47.56038,-52.71147,2018-02-01 09:00:00,31,4,35
"754",10102,"St Johns","NL",47.56038,-52.71147,2018-02-01 10:00:00,29,7,36
"755",10102,"St Johns","NL",47.56038,-52.71147,2018-02-01 11:00:00,30,6,36
"756",10102,"St Johns","NL",47.56038,-52.71147,2018-02-01 12:00:00,32,2,34
"757",10102,"St Johns","NL",47.56038,-52.71147,2018-02-01 13:00:00,33,2,35
"758",10102,"St Johns","NL",47.56038,-52.71147,2018-02-01 14:00:00,33,1,34
"759",10102,"St Johns","NL",47.56038,-52.71147,2018-02-01 15:00:00,32,2,34
"760",10102,"St Johns","NL",47.56038,-52.71147,2018-02-01 16:00:00,32,2,34
"761",10102,"St Johns","NL",47.56038,-52.71147,2018-02-01 17:00:00,33,3,36
"762",10102,"St Johns","NL",47.56038,-52.71147,2018-02-01 18:00:00,34,4,38
"763",10102,"St Johns","NL",47.56038,-52.71147,2018-02-01 19:00:00,35,2,37
"764",10102,"St Johns","NL",47.56038,-52.71147,2018-02-01 20:00:00,34,2,36
"765",10102,"St Johns","NL",47.56038,-52.71147,2018-02-01 21:00:00,33,3,36
"766",10102,"St Johns","NL",47.56038,-52.71147,2018-02-01 22:00:00,33,3,36
"767",10102,"St Johns","NL",47.56038,-52.71147,2018-02-01 23:00:00,35,1,36
"768",10102,"St Johns","NL",47.56038,-52.71147,2018-02-02 00:00:00,36,1,37
"769",10102,"St Johns","NL",47.56038,-52.71147,2018-02-02 01:00:00,37,0,37
"770",10102,"St Johns","NL",47.56038,-52.71147,2018-02-02 02:00:00,36,0,36
"771",10102,"St Johns","NL",47.56038,-52.71147,2018-02-02 03:00:00,37,0,37
"772",10102,"St Johns","NL",47.56038,-52.71147,2018-02-02 04:00:00,38,0,38
"773",10102,"St Johns","NL",47.56038,-52.71147,2018-02-02 05:00:00,38,0,38
"774",10102,"St Johns","NL",47.56038,-52.71147,2018-02-02 06:00:00,38,0,38
"775",10102,"St Johns","NL",47.56038,-52.71147,2018-02-02 07:00:00,37,1,38
"776",10102,"St Johns","NL",47.56038,-52.71147,2018-02-02 08:00:00,37,1,38
"777",10102,"St Johns","NL",47.56038,-52.71147,2018-02-02 09:00:00,36,2,38
"778",10102,"St Johns","NL",47.56038,-52.71147,2018-02-02 10:00:00,35,2,37
"779",10102,"St Johns","NL",47.56038,-52.71147,2018-02-02 11:00:00,35,3,38
"780",10102,"St Johns","NL",47.56038,-52.71147,2018-02-02 12:00:00,37,2,39
"781",10102,"St Johns","NL",47.56038,-52.71147,2018-02-02 13:00:00,38,2,40
"782",10102,"St Johns","NL",47.56038,-52.71147,2018-02-02 14:00:00,39,2,41
"783",10102,"St Johns","NL",47.56038,-52.71147,2018-02-02 15:00:00,38,1,39
"784",10102,"St Johns","NL",47.56038,-52.71147,2018-02-02 16:00:00,37,2,39
"785",10102,"St Johns","NL",47.56038,-52.71147,2018-02-02 17:00:00,35,4,39
"786",10102,"St Johns","NL",47.56038,-52.71147,2018-02-02 18:00:00,37,3,40
"787",10102,"St Johns","NL",47.56038,-52.71147,2018-02-02 19:00:00,38,2,40
"788",10102,"St Johns","NL",47.56038,-52.71147,2018-02-02 20:00:00,39,1,40
"789",10102,"St Johns","NL",47.56038,-52.71147,2018-02-02 21:00:00,41,1,42
"790",10102,"St Johns","NL",47.56038,-52.71147,2018-02-02 22:00:00,40,2,42
"791",10102,"St Johns","NL",47.56038,-52.71147,2018-02-02 23:00:00,41,1,42
"792",10102,"St Johns","NL",47.56038,-52.71147,2018-02-03 00:00:00,40,1,41
"793",10102,"St Johns","NL",47.56038,-52.71147,2018-02-03 01:00:00,41,1,42
"794",10102,"St Johns","NL",47.56038,-52.71147,2018-02-03 02:00:00,41,0,41
"795",10102,"St Johns","NL",47.56038,-52.71147,2018-02-03 03:00:00,41,0,41
"796",10102,"St Johns","NL",47.56038,-52.71147,2018-02-03 04:00:00,42,0,42
"797",10102,"St Johns","NL",47.56038,-52.71147,2018-02-03 05:00:00,45,0,45
"798",10102,"St Johns","NL",47.56038,-52.71147,2018-02-03 06:00:00,42,0,42
"799",10102,"St Johns","NL",47.56038,-52.71147,2018-02-03 07:00:00,35,1,36
"800",10102,"St Johns","NL",47.56038,-52.71147,2018-02-03 08:00:00,33,2,35
"801",10102,"St Johns","NL",47.56038,-52.71147,2018-02-03 09:00:00,30,2,32
"802",10102,"St Johns","NL",47.56038,-52.71147,2018-02-03 10:00:00,30,2,32
"803",10102,"St Johns","NL",47.56038,-52.71147,2018-02-03 11:00:00,29,2,31
"804",10102,"St Johns","NL",47.56038,-52.71147,2018-02-03 12:00:00,29,3,32
"805",10102,"St Johns","NL",47.56038,-52.71147,2018-02-03 13:00:00,30,4,34
"806",10102,"St Johns","NL",47.56038,-52.71147,2018-02-03 14:00:00,31,3,34
"807",10102,"St Johns","NL",47.56038,-52.71147,2018-02-03 15:00:00,31,4,35
"808",10102,"St Johns","NL",47.56038,-52.71147,2018-02-03 16:00:00,32,3,35
"809",10102,"St Johns","NL",47.56038,-52.71147,2018-02-03 17:00:00,32,3,35
"810",10102,"St Johns","NL",47.56038,-52.71147,2018-02-03 18:00:00,33,4,37
"811",10102,"St Johns","NL",47.56038,-52.71147,2018-02-03 19:00:00,35,4,39
"812",10102,"St Johns","NL",47.56038,-52.71147,2018-02-03 20:00:00,36,3,39
"813",10102,"St Johns","NL",47.56038,-52.71147,2018-02-03 21:00:00,36,4,40
"814",10102,"St Johns","NL",47.56038,-52.71147,2018-02-03 22:00:00,37,4,41
"815",10102,"St Johns","NL",47.56038,-52.71147,2018-02-03 23:00:00,36,4,40
"816",10102,"St Johns","NL",47.56038,-52.71147,2018-02-04 00:00:00,37,3,40
"817",10102,"St Johns","NL",47.56038,-52.71147,2018-02-04 01:00:00,36,3,39
"818",10102,"St Johns","NL",47.56038,-52.71147,2018-02-04 02:00:00,37,3,40
"819",10102,"St Johns","NL",47.56038,-52.71147,2018-02-04 03:00:00,36,3,39
"820",10102,"St Johns","NL",47.56038,-52.71147,2018-02-04 04:00:00,36,3,39
"821",10102,"St Johns","NL",47.56038,-52.71147,2018-02-04 05:00:00,36,4,40
"822",10102,"St Johns","NL",47.56038,-52.71147,2018-02-04 06:00:00,36,3,39
"823",10102,"St Johns","NL",47.56038,-52.71147,2018-02-04 07:00:00,35,4,39
"824",10102,"St Johns","NL",47.56038,-52.71147,2018-02-04 08:00:00,31,7,38
"825",10102,"St Johns","NL",47.56038,-52.71147,2018-02-04 09:00:00,33,4,37
"826",10102,"St Johns","NL",47.56038,-52.71147,2018-02-04 10:00:00,34,3,37
"827",10102,"St Johns","NL",47.56038,-52.71147,2018-02-04 11:00:00,34,3,37
"828",10102,"St Johns","NL",47.56038,-52.71147,2018-02-04 12:00:00,34,2,36
"829",10102,"St Johns","NL",47.56038,-52.71147,2018-02-04 13:00:00,36,2,38
"830",10102,"St Johns","NL",47.56038,-52.71147,2018-02-04 14:00:00,37,3,40
"831",10102,"St Johns","NL",47.56038,-52.71147,2018-02-04 15:00:00,38,2,40
"832",10102,"St Johns","NL",47.56038,-52.71147,2018-02-04 16:00:00,38,2,40
"833",10102,"St Johns","NL",47.56038,-52.71147,2018-02-04 17:00:00,37,2,39
"834",10102,"St Johns","NL",47.56038,-52.71147,2018-02-04 18:00:00,35,4,39
"835",10102,"St Johns","NL",47.56038,-52.71147,2018-02-04 19:00:00,33,5,38
"836",10102,"St Johns","NL",47.56038,-52.71147,2018-02-04 20:00:00,35,3,38
"837",10102,"St Johns","NL",47.56038,-52.71147,2018-02-04 21:00:00,36,3,39
"838",10102,"St Johns","NL",47.56038,-52.71147,2018-02-04 22:00:00,37,2,39
"839",10102,"St Johns","NL",47.56038,-52.71147,2018-02-04 23:00:00,37,2,39
"840",10102,"St Johns","NL",47.56038,-52.71147,2018-02-05 00:00:00,37,2,39
"841",10102,"St Johns","NL",47.56038,-52.71147,2018-02-05 01:00:00,37,1,38
"842",10102,"St Johns","NL",47.56038,-52.71147,2018-02-05 02:00:00,37,2,39
"843",10102,"St Johns","NL",47.56038,-52.71147,2018-02-05 03:00:00,38,1,39
"844",10102,"St Johns","NL",47.56038,-52.71147,2018-02-05 04:00:00,38,2,40
"845",10102,"St Johns","NL",47.56038,-52.71147,2018-02-05 05:00:00,38,2,40
"846",10102,"St Johns","NL",47.56038,-52.71147,2018-02-05 06:00:00,38,1,39
"847",10102,"St Johns","NL",47.56038,-52.71147,2018-02-05 07:00:00,38,2,40
"848",10102,"St Johns","NL",47.56038,-52.71147,2018-02-05 08:00:00,38,3,41
"849",10102,"St Johns","NL",47.56038,-52.71147,2018-02-05 09:00:00,37,4,41
"850",10102,"St Johns","NL",47.56038,-52.71147,2018-02-05 10:00:00,37,4,41
"851",10102,"St Johns","NL",47.56038,-52.71147,2018-02-05 11:00:00,36,5,41
"852",10102,"St Johns","NL",47.56038,-52.71147,2018-02-05 12:00:00,36,5,41
"853",10102,"St Johns","NL",47.56038,-52.71147,2018-02-05 13:00:00,37,5,42
"854",10102,"St Johns","NL",47.56038,-52.71147,2018-02-05 14:00:00,35,6,41
"855",10102,"St Johns","NL",47.56038,-52.71147,2018-02-05 15:00:00,36,5,41
"856",10102,"St Johns","NL",47.56038,-52.71147,2018-02-05 16:00:00,36,5,41
"857",10102,"St Johns","NL",47.56038,-52.71147,2018-02-05 17:00:00,37,5,42
"858",10102,"St Johns","NL",47.56038,-52.71147,2018-02-05 18:00:00,39,3,42
"859",10102,"St Johns","NL",47.56038,-52.71147,2018-02-05 19:00:00,39,3,42
"860",10102,"St Johns","NL",47.56038,-52.71147,2018-02-05 20:00:00,40,3,43
"861",10102,"St Johns","NL",47.56038,-52.71147,2018-02-05 21:00:00,41,3,44
"862",10102,"St Johns","NL",47.56038,-52.71147,2018-02-05 22:00:00,40,3,43
"863",10102,"St Johns","NL",47.56038,-52.71147,2018-02-05 23:00:00,38,3,41
"864",10102,"St Johns","NL",47.56038,-52.71147,2018-02-06 00:00:00,37,2,39
"865",10102,"St Johns","NL",47.56038,-52.71147,2018-02-06 01:00:00,35,2,37
"866",10102,"St Johns","NL",47.56038,-52.71147,2018-02-06 02:00:00,36,1,37
"867",10102,"St Johns","NL",47.56038,-52.71147,2018-02-06 03:00:00,36,2,38
"868",10102,"St Johns","NL",47.56038,-52.71147,2018-02-06 04:00:00,36,2,38
"869",10102,"St Johns","NL",47.56038,-52.71147,2018-02-06 05:00:00,35,2,37
"870",10102,"St Johns","NL",47.56038,-52.71147,2018-02-06 06:00:00,33,2,35
"871",10102,"St Johns","NL",47.56038,-52.71147,2018-02-06 07:00:00,31,3,34
"872",10102,"St Johns","NL",47.56038,-52.71147,2018-02-06 08:00:00,28,5,33
"873",10102,"St Johns","NL",47.56038,-52.71147,2018-02-06 09:00:00,26,6,32
"874",10102,"St Johns","NL",47.56038,-52.71147,2018-02-06 10:00:00,29,5,34
"875",10102,"St Johns","NL",47.56038,-52.71147,2018-02-06 11:00:00,33,3,36
"876",10102,"St Johns","NL",47.56038,-52.71147,2018-02-06 12:00:00,34,2,36
"877",10102,"St Johns","NL",47.56038,-52.71147,2018-02-06 13:00:00,33,3,36
"878",10102,"St Johns","NL",47.56038,-52.71147,2018-02-06 14:00:00,35,3,38
"879",10102,"St Johns","NL",47.56038,-52.71147,2018-02-06 15:00:00,34,5,39
"880",10102,"St Johns","NL",47.56038,-52.71147,2018-02-06 16:00:00,34,3,37
"881",10102,"St Johns","NL",47.56038,-52.71147,2018-02-06 17:00:00,33,5,38
"882",10102,"St Johns","NL",47.56038,-52.71147,2018-02-06 18:00:00,33,4,37
"883",10102,"St Johns","NL",47.56038,-52.71147,2018-02-06 19:00:00,34,4,38
"884",10102,"St Johns","NL",47.56038,-52.71147,2018-02-06 20:00:00,36,3,39
"885",10102,"St Johns","NL",47.56038,-52.71147,2018-02-06 21:00:00,35,2,37
"886",10102,"St Johns","NL",47.56038,-52.71147,2018-02-06 22:00:00,35,3,38
"887",10102,"St Johns","NL",47.56038,-52.71147,2018-02-06 23:00:00,36,2,38
"888",10102,"St Johns","NL",47.56038,-52.71147,2018-02-07 00:00:00,37,2,39
"889",10102,"St Johns","NL",47.56038,-52.71147,2018-02-07 01:00:00,36,2,38
"890",10102,"St Johns","NL",47.56038,-52.71147,2018-02-07 02:00:00,37,1,38
"891",10102,"St Johns","NL",47.56038,-52.71147,2018-02-07 03:00:00,37,1,38
"892",10102,"St Johns","NL",47.56038,-52.71147,2018-02-07 04:00:00,36,1,37
"893",10102,"St Johns","NL",47.56038,-52.71147,2018-02-07 05:00:00,36,2,38
"894",10102,"St Johns","NL",47.56038,-52.71147,2018-02-07 06:00:00,36,2,38
"895",10102,"St Johns","NL",47.56038,-52.71147,2018-02-07 07:00:00,35,3,38
"896",10102,"St Johns","NL",47.56038,-52.71147,2018-02-07 08:00:00,29,7,36
"897",10102,"St Johns","NL",47.56038,-52.71147,2018-02-07 09:00:00,29,9,38
"898",10102,"St Johns","NL",47.56038,-52.71147,2018-02-07 10:00:00,32,5,37
"899",10102,"St Johns","NL",47.56038,-52.71147,2018-02-07 11:00:00,32,8,40
"900",10102,"St Johns","NL",47.56038,-52.71147,2018-02-07 12:00:00,31,9,40
"901",10102,"St Johns","NL",47.56038,-52.71147,2018-02-07 13:00:00,27,12,39
"902",10102,"St Johns","NL",47.56038,-52.71147,2018-02-07 14:00:00,25,16,41
"903",10102,"St Johns","NL",47.56038,-52.71147,2018-02-07 15:00:00,31,7,38
"904",10102,"St Johns","NL",47.56038,-52.71147,2018-02-07 16:00:00,31,8,39
"905",10102,"St Johns","NL",47.56038,-52.71147,2018-02-07 17:00:00,29,9,38
"906",10102,"St Johns","NL",47.56038,-52.71147,2018-02-07 18:00:00,29,7,36
"907",10102,"St Johns","NL",47.56038,-52.71147,2018-02-07 19:00:00,27,8,35
"908",10102,"St Johns","NL",47.56038,-52.71147,2018-02-07 20:00:00,30,7,37
"909",10102,"St Johns","NL",47.56038,-52.71147,2018-02-07 21:00:00,35,3,38
"910",10102,"St Johns","NL",47.56038,-52.71147,2018-02-07 22:00:00,36,3,39
"911",10102,"St Johns","NL",47.56038,-52.71147,2018-02-07 23:00:00,36,2,38
"912",10102,"St Johns","NL",47.56038,-52.71147,2018-02-08 00:00:00,37,3,40
"913",10102,"St Johns","NL",47.56038,-52.71147,2018-02-08 01:00:00,37,2,39
"914",10102,"St Johns","NL",47.56038,-52.71147,2018-02-08 02:00:00,37,2,39
"915",10102,"St Johns","NL",47.56038,-52.71147,2018-02-08 03:00:00,37,1,38
"916",10102,"St Johns","NL",47.56038,-52.71147,2018-02-08 04:00:00,36,1,37
"917",10102,"St Johns","NL",47.56038,-52.71147,2018-02-08 05:00:00,35,1,36
"918",10102,"St Johns","NL",47.56038,-52.71147,2018-02-08 06:00:00,35,3,38
"919",10102,"St Johns","NL",47.56038,-52.71147,2018-02-08 07:00:00,36,2,38
"920",10102,"St Johns","NL",47.56038,-52.71147,2018-02-08 08:00:00,37,3,40
"921",10102,"St Johns","NL",47.56038,-52.71147,2018-02-08 09:00:00,37,4,41
"922",10102,"St Johns","NL",47.56038,-52.71147,2018-02-08 10:00:00,38,3,41
"923",10102,"St Johns","NL",47.56038,-52.71147,2018-02-08 11:00:00,39,3,42
"924",10102,"St Johns","NL",47.56038,-52.71147,2018-02-08 12:00:00,38,2,40
"925",10102,"St Johns","NL",47.56038,-52.71147,2018-02-08 13:00:00,38,2,40
"926",10102,"St Johns","NL",47.56038,-52.71147,2018-02-08 14:00:00,38,1,39
"927",10102,"St Johns","NL",47.56038,-52.71147,2018-02-08 15:00:00,38,2,40
"928",10102,"St Johns","NL",47.56038,-52.71147,2018-02-08 16:00:00,39,2,41
"929",10102,"St Johns","NL",47.56038,-52.71147,2018-02-08 17:00:00,38,3,41
"930",10102,"St Johns","NL",47.56038,-52.71147,2018-02-08 18:00:00,38,3,41
"931",10102,"St Johns","NL",47.56038,-52.71147,2018-02-08 19:00:00,37,2,39
"932",10102,"St Johns","NL",47.56038,-52.71147,2018-02-08 20:00:00,35,3,38
"933",10102,"St Johns","NL",47.56038,-52.71147,2018-02-08 21:00:00,35,2,37
"934",10102,"St Johns","NL",47.56038,-52.71147,2018-02-08 22:00:00,33,2,35
"935",10102,"St Johns","NL",47.56038,-52.71147,2018-02-08 23:00:00,NA,NA,NA
"936",10102,"St Johns","NL",47.56038,-52.71147,2018-02-09 00:00:00,NA,NA,NA
"937",10102,"St Johns","NL",47.56038,-52.71147,2018-02-09 01:00:00,NA,NA,NA
"938",10102,"St Johns","NL",47.56038,-52.71147,2018-02-09 02:00:00,NA,NA,NA
"939",10102,"St Johns","NL",47.56038,-52.71147,2018-02-09 03:00:00,NA,NA,NA
"940",10102,"St Johns","NL",47.56038,-52.71147,2018-02-09 04:00:00,NA,NA,NA
"941",10102,"St Johns","NL",47.56038,-52.71147,2018-02-09 05:00:00,NA,NA,NA
"942",10102,"St Johns","NL",47.56038,-52.71147,2018-02-09 06:00:00,NA,NA,NA
"943",10102,"St Johns","NL",47.56038,-52.71147,2018-02-09 07:00:00,NA,NA,NA
"944",10102,"St Johns","NL",47.56038,-52.71147,2018-02-09 08:00:00,NA,NA,NA
"945",10102,"St Johns","NL",47.56038,-52.71147,2018-02-09 09:00:00,NA,NA,NA
"946",10102,"St Johns","NL",47.56038,-52.71147,2018-02-09 10:00:00,NA,NA,NA
"947",10102,"St Johns","NL",47.56038,-52.71147,2018-02-09 11:00:00,NA,NA,NA
"948",10102,"St Johns","NL",47.56038,-52.71147,2018-02-09 12:00:00,35,2,37
"949",10102,"St Johns","NL",47.56038,-52.71147,2018-02-09 13:00:00,35,2,37
"950",10102,"St Johns","NL",47.56038,-52.71147,2018-02-09 14:00:00,34,3,37
"951",10102,"St Johns","NL",47.56038,-52.71147,2018-02-09 15:00:00,35,2,37
"952",10102,"St Johns","NL",47.56038,-52.71147,2018-02-09 16:00:00,34,3,37
"953",10102,"St Johns","NL",47.56038,-52.71147,2018-02-09 17:00:00,34,3,37
"954",10102,"St Johns","NL",47.56038,-52.71147,2018-02-09 18:00:00,31,5,36
"955",10102,"St Johns","NL",47.56038,-52.71147,2018-02-09 19:00:00,32,5,37
"956",10102,"St Johns","NL",47.56038,-52.71147,2018-02-09 20:00:00,30,5,35
"957",10102,"St Johns","NL",47.56038,-52.71147,2018-02-09 21:00:00,31,3,34
"958",10102,"St Johns","NL",47.56038,-52.71147,2018-02-09 22:00:00,31,4,35
"959",10102,"St Johns","NL",47.56038,-52.71147,2018-02-09 23:00:00,32,2,34
"960",10102,"St Johns","NL",47.56038,-52.71147,2018-02-10 00:00:00,32,3,35
"961",10102,"St Johns","NL",47.56038,-52.71147,2018-02-10 01:00:00,29,4,33
"962",10102,"St Johns","NL",47.56038,-52.71147,2018-02-10 02:00:00,28,4,32
"963",10102,"St Johns","NL",47.56038,-52.71147,2018-02-10 03:00:00,24,7,31
"964",10102,"St Johns","NL",47.56038,-52.71147,2018-02-10 04:00:00,19,8,27
"965",10102,"St Johns","NL",47.56038,-52.71147,2018-02-10 05:00:00,16,10,26
"966",10102,"St Johns","NL",47.56038,-52.71147,2018-02-10 06:00:00,14,11,25
"967",10102,"St Johns","NL",47.56038,-52.71147,2018-02-10 07:00:00,15,8,23
"968",10102,"St Johns","NL",47.56038,-52.71147,2018-02-10 08:00:00,15,9,24
"969",10102,"St Johns","NL",47.56038,-52.71147,2018-02-10 09:00:00,17,7,24
"970",10102,"St Johns","NL",47.56038,-52.71147,2018-02-10 10:00:00,28,5,33
"971",10102,"St Johns","NL",47.56038,-52.71147,2018-02-10 11:00:00,35,1,36
"972",10102,"St Johns","NL",47.56038,-52.71147,2018-02-10 12:00:00,36,2,38
"973",10102,"St Johns","NL",47.56038,-52.71147,2018-02-10 13:00:00,37,2,39
"974",10102,"St Johns","NL",47.56038,-52.71147,2018-02-10 14:00:00,37,2,39
"975",10102,"St Johns","NL",47.56038,-52.71147,2018-02-10 15:00:00,37,2,39
"976",10102,"St Johns","NL",47.56038,-52.71147,2018-02-10 16:00:00,37,2,39
"977",10102,"St Johns","NL",47.56038,-52.71147,2018-02-10 17:00:00,37,2,39
"978",10102,"St Johns","NL",47.56038,-52.71147,2018-02-10 18:00:00,36,3,39
"979",10102,"St Johns","NL",47.56038,-52.71147,2018-02-10 19:00:00,36,3,39
"980",10102,"St Johns","NL",47.56038,-52.71147,2018-02-10 20:00:00,36,2,38
"981",10102,"St Johns","NL",47.56038,-52.71147,2018-02-10 21:00:00,36,2,38
"982",10102,"St Johns","NL",47.56038,-52.71147,2018-02-10 22:00:00,36,2,38
"983",10102,"St Johns","NL",47.56038,-52.71147,2018-02-10 23:00:00,35,2,37
"984",10102,"St Johns","NL",47.56038,-52.71147,2018-02-11 00:00:00,34,2,36
"985",10102,"St Johns","NL",47.56038,-52.71147,2018-02-11 01:00:00,35,1,36
"986",10102,"St Johns","NL",47.56038,-52.71147,2018-02-11 02:00:00,36,1,37
"987",10102,"St Johns","NL",47.56038,-52.71147,2018-02-11 03:00:00,37,1,38
"988",10102,"St Johns","NL",47.56038,-52.71147,2018-02-11 04:00:00,38,1,39
"989",10102,"St Johns","NL",47.56038,-52.71147,2018-02-11 05:00:00,38,1,39
"990",10102,"St Johns","NL",47.56038,-52.71147,2018-02-11 06:00:00,39,0,39
"991",10102,"St Johns","NL",47.56038,-52.71147,2018-02-11 07:00:00,40,0,40
"992",10102,"St Johns","NL",47.56038,-52.71147,2018-02-11 08:00:00,40,1,41
"993",10102,"St Johns","NL",47.56038,-52.71147,2018-02-11 09:00:00,39,1,40
"994",10102,"St Johns","NL",47.56038,-52.71147,2018-02-11 10:00:00,39,2,41
"995",10102,"St Johns","NL",47.56038,-52.71147,2018-02-11 11:00:00,38,2,40
"996",10102,"St Johns","NL",47.56038,-52.71147,2018-02-11 12:00:00,35,2,37
"997",10102,"St Johns","NL",47.56038,-52.71147,2018-02-11 13:00:00,35,1,36
"998",10102,"St Johns","NL",47.56038,-52.71147,2018-02-11 14:00:00,37,0,37
"999",10102,"St Johns","NL",47.56038,-52.71147,2018-02-11 15:00:00,34,1,35
"1000",10102,"St Johns","NL",47.56038,-52.71147,2018-02-11 16:00:00,35,1,36
"1001",10102,"St Johns","NL",47.56038,-52.71147,2018-02-11 17:00:00,33,3,36
"1002",10102,"St Johns","NL",47.56038,-52.71147,2018-02-11 18:00:00,29,10,39
"1003",10102,"St Johns","NL",47.56038,-52.71147,2018-02-11 19:00:00,33,5,38
"1004",10102,"St Johns","NL",47.56038,-52.71147,2018-02-11 20:00:00,34,3,37
"1005",10102,"St Johns","NL",47.56038,-52.71147,2018-02-11 21:00:00,29,9,38
"1006",10102,"St Johns","NL",47.56038,-52.71147,2018-02-11 22:00:00,31,7,38
"1007",10102,"St Johns","NL",47.56038,-52.71147,2018-02-11 23:00:00,30,9,39
"1008",10102,"St Johns","NL",47.56038,-52.71147,2018-02-12 00:00:00,29,10,39
"1009",10102,"St Johns","NL",47.56038,-52.71147,2018-02-12 01:00:00,30,10,40
"1010",10102,"St Johns","NL",47.56038,-52.71147,2018-02-12 02:00:00,29,11,40
"1011",10102,"St Johns","NL",47.56038,-52.71147,2018-02-12 03:00:00,27,11,38
"1012",10102,"St Johns","NL",47.56038,-52.71147,2018-02-12 04:00:00,28,12,40
"1013",10102,"St Johns","NL",47.56038,-52.71147,2018-02-12 05:00:00,33,6,39
"1014",10102,"St Johns","NL",47.56038,-52.71147,2018-02-12 06:00:00,33,5,38
"1015",10102,"St Johns","NL",47.56038,-52.71147,2018-02-12 07:00:00,31,7,38
"1016",10102,"St Johns","NL",47.56038,-52.71147,2018-02-12 08:00:00,29,12,41
"1017",10102,"St Johns","NL",47.56038,-52.71147,2018-02-12 09:00:00,31,9,40
"1018",10102,"St Johns","NL",47.56038,-52.71147,2018-02-12 10:00:00,36,1,37
"1019",10102,"St Johns","NL",47.56038,-52.71147,2018-02-12 11:00:00,34,2,36
"1020",10102,"St Johns","NL",47.56038,-52.71147,2018-02-12 12:00:00,26,4,30
"1021",10102,"St Johns","NL",47.56038,-52.71147,2018-02-12 13:00:00,25,3,28
"1022",10102,"St Johns","NL",47.56038,-52.71147,2018-02-12 14:00:00,24,3,27
"1023",10102,"St Johns","NL",47.56038,-52.71147,2018-02-12 15:00:00,25,4,29
"1024",10102,"St Johns","NL",47.56038,-52.71147,2018-02-12 16:00:00,25,4,29
"1025",10102,"St Johns","NL",47.56038,-52.71147,2018-02-12 17:00:00,26,4,30
"1026",10102,"St Johns","NL",47.56038,-52.71147,2018-02-12 18:00:00,26,4,30
"1027",10102,"St Johns","NL",47.56038,-52.71147,2018-02-12 19:00:00,26,4,30
"1028",10102,"St Johns","NL",47.56038,-52.71147,2018-02-12 20:00:00,27,3,30
"1029",10102,"St Johns","NL",47.56038,-52.71147,2018-02-12 21:00:00,29,2,31
"1030",10102,"St Johns","NL",47.56038,-52.71147,2018-02-12 22:00:00,30,2,32
"1031",10102,"St Johns","NL",47.56038,-52.71147,2018-02-12 23:00:00,34,2,36
"1032",10102,"St Johns","NL",47.56038,-52.71147,2018-02-13 00:00:00,39,2,41
"1033",10102,"St Johns","NL",47.56038,-52.71147,2018-02-13 01:00:00,42,2,44
"1034",10102,"St Johns","NL",47.56038,-52.71147,2018-02-13 02:00:00,41,2,43
"1035",10102,"St Johns","NL",47.56038,-52.71147,2018-02-13 03:00:00,39,2,41
"1036",10102,"St Johns","NL",47.56038,-52.71147,2018-02-13 04:00:00,38,2,40
"1037",10102,"St Johns","NL",47.56038,-52.71147,2018-02-13 05:00:00,38,2,40
"1038",10102,"St Johns","NL",47.56038,-52.71147,2018-02-13 06:00:00,37,2,39
"1039",10102,"St Johns","NL",47.56038,-52.71147,2018-02-13 07:00:00,37,2,39
"1040",10102,"St Johns","NL",47.56038,-52.71147,2018-02-13 08:00:00,37,2,39
"1041",10102,"St Johns","NL",47.56038,-52.71147,2018-02-13 09:00:00,36,2,38
"1042",10102,"St Johns","NL",47.56038,-52.71147,2018-02-13 10:00:00,36,3,39
"1043",10102,"St Johns","NL",47.56038,-52.71147,2018-02-13 11:00:00,34,4,38
"1044",10102,"St Johns","NL",47.56038,-52.71147,2018-02-13 12:00:00,34,2,36
"1045",10102,"St Johns","NL",47.56038,-52.71147,2018-02-13 13:00:00,35,1,36
"1046",10102,"St Johns","NL",47.56038,-52.71147,2018-02-13 14:00:00,35,2,37
"1047",10102,"St Johns","NL",47.56038,-52.71147,2018-02-13 15:00:00,35,2,37
"1048",10102,"St Johns","NL",47.56038,-52.71147,2018-02-13 16:00:00,35,2,37
"1049",10102,"St Johns","NL",47.56038,-52.71147,2018-02-13 17:00:00,35,3,38
"1050",10102,"St Johns","NL",47.56038,-52.71147,2018-02-13 18:00:00,34,3,37
"1051",10102,"St Johns","NL",47.56038,-52.71147,2018-02-13 19:00:00,36,2,38
"1052",10102,"St Johns","NL",47.56038,-52.71147,2018-02-13 20:00:00,35,2,37
"1053",10102,"St Johns","NL",47.56038,-52.71147,2018-02-13 21:00:00,36,1,37
"1054",10102,"St Johns","NL",47.56038,-52.71147,2018-02-13 22:00:00,36,1,37
"1055",10102,"St Johns","NL",47.56038,-52.71147,2018-02-13 23:00:00,34,2,36
"1056",10102,"St Johns","NL",47.56038,-52.71147,2018-02-14 00:00:00,35,2,37
"1057",10102,"St Johns","NL",47.56038,-52.71147,2018-02-14 01:00:00,35,1,36
"1058",10102,"St Johns","NL",47.56038,-52.71147,2018-02-14 02:00:00,34,1,35
"1059",10102,"St Johns","NL",47.56038,-52.71147,2018-02-14 03:00:00,34,1,35
"1060",10102,"St Johns","NL",47.56038,-52.71147,2018-02-14 04:00:00,33,2,35
"1061",10102,"St Johns","NL",47.56038,-52.71147,2018-02-14 05:00:00,32,2,34
"1062",10102,"St Johns","NL",47.56038,-52.71147,2018-02-14 06:00:00,32,2,34
"1063",10102,"St Johns","NL",47.56038,-52.71147,2018-02-14 07:00:00,32,3,35
"1064",10102,"St Johns","NL",47.56038,-52.71147,2018-02-14 08:00:00,23,12,35
"1065",10102,"St Johns","NL",47.56038,-52.71147,2018-02-14 09:00:00,25,9,34
"1066",10102,"St Johns","NL",47.56038,-52.71147,2018-02-14 10:00:00,29,4,33
"1067",10102,"St Johns","NL",47.56038,-52.71147,2018-02-14 11:00:00,29,4,33
"1068",10102,"St Johns","NL",47.56038,-52.71147,2018-02-14 12:00:00,33,5,38
"1069",10102,"St Johns","NL",47.56038,-52.71147,2018-02-14 13:00:00,35,4,39
"1070",10102,"St Johns","NL",47.56038,-52.71147,2018-02-14 14:00:00,36,3,39
"1071",10102,"St Johns","NL",47.56038,-52.71147,2018-02-14 15:00:00,37,3,40
"1072",10102,"St Johns","NL",47.56038,-52.71147,2018-02-14 16:00:00,37,3,40
"1073",10102,"St Johns","NL",47.56038,-52.71147,2018-02-14 17:00:00,38,4,42
"1074",10102,"St Johns","NL",47.56038,-52.71147,2018-02-14 18:00:00,38,3,41
"1075",10102,"St Johns","NL",47.56038,-52.71147,2018-02-14 19:00:00,38,2,40
"1076",10102,"St Johns","NL",47.56038,-52.71147,2018-02-14 20:00:00,39,2,41
"1077",10102,"St Johns","NL",47.56038,-52.71147,2018-02-14 21:00:00,38,2,40
"1078",10102,"St Johns","NL",47.56038,-52.71147,2018-02-14 22:00:00,38,2,40
"1079",10102,"St Johns","NL",47.56038,-52.71147,2018-02-14 23:00:00,38,2,40
"1080",10102,"St Johns","NL",47.56038,-52.71147,2018-02-15 00:00:00,36,3,39
"1081",10102,"St Johns","NL",47.56038,-52.71147,2018-02-15 01:00:00,37,2,39
"1082",10102,"St Johns","NL",47.56038,-52.71147,2018-02-15 02:00:00,36,3,39
"1083",10102,"St Johns","NL",47.56038,-52.71147,2018-02-15 03:00:00,36,2,38
"1084",10102,"St Johns","NL",47.56038,-52.71147,2018-02-15 04:00:00,35,3,38
"1085",10102,"St Johns","NL",47.56038,-52.71147,2018-02-15 05:00:00,33,3,36
"1086",10102,"St Johns","NL",47.56038,-52.71147,2018-02-15 06:00:00,31,4,35
"1087",10102,"St Johns","NL",47.56038,-52.71147,2018-02-15 07:00:00,30,6,36
"1088",10102,"St Johns","NL",47.56038,-52.71147,2018-02-15 08:00:00,31,7,38
"1089",10102,"St Johns","NL",47.56038,-52.71147,2018-02-15 09:00:00,30,11,41
"1090",10102,"St Johns","NL",47.56038,-52.71147,2018-02-15 10:00:00,34,7,41
"1091",10102,"St Johns","NL",47.56038,-52.71147,2018-02-15 11:00:00,35,3,38
"1092",10102,"St Johns","NL",47.56038,-52.71147,2018-02-15 12:00:00,35,3,38
"1093",10102,"St Johns","NL",47.56038,-52.71147,2018-02-15 13:00:00,36,4,40
"1094",10102,"St Johns","NL",47.56038,-52.71147,2018-02-15 14:00:00,37,4,41
"1095",10102,"St Johns","NL",47.56038,-52.71147,2018-02-15 15:00:00,37,4,41
"1096",10102,"St Johns","NL",47.56038,-52.71147,2018-02-15 16:00:00,38,4,42
"1097",10102,"St Johns","NL",47.56038,-52.71147,2018-02-15 17:00:00,14,27,41
"1098",10102,"St Johns","NL",47.56038,-52.71147,2018-02-15 18:00:00,12,30,42
"1099",10102,"St Johns","NL",47.56038,-52.71147,2018-02-15 19:00:00,10,29,39
"1100",10102,"St Johns","NL",47.56038,-52.71147,2018-02-15 20:00:00,2,36,38
"1101",10102,"St Johns","NL",47.56038,-52.71147,2018-02-15 21:00:00,3,30,33
"1102",10102,"St Johns","NL",47.56038,-52.71147,2018-02-15 22:00:00,24,12,36
"1103",10102,"St Johns","NL",47.56038,-52.71147,2018-02-15 23:00:00,30,8,38
"1104",10102,"St Johns","NL",47.56038,-52.71147,2018-02-16 00:00:00,28,9,37
"1105",10102,"St Johns","NL",47.56038,-52.71147,2018-02-16 01:00:00,31,7,38
"1106",10102,"St Johns","NL",47.56038,-52.71147,2018-02-16 02:00:00,32,6,38
"1107",10102,"St Johns","NL",47.56038,-52.71147,2018-02-16 03:00:00,34,4,38
"1108",10102,"St Johns","NL",47.56038,-52.71147,2018-02-16 04:00:00,31,6,37
"1109",10102,"St Johns","NL",47.56038,-52.71147,2018-02-16 05:00:00,31,6,37
"1110",10102,"St Johns","NL",47.56038,-52.71147,2018-02-16 06:00:00,33,3,36
"1111",10102,"St Johns","NL",47.56038,-52.71147,2018-02-16 07:00:00,33,5,38
"1112",10102,"St Johns","NL",47.56038,-52.71147,2018-02-16 08:00:00,29,9,38
"1113",10102,"St Johns","NL",47.56038,-52.71147,2018-02-16 09:00:00,28,8,36
"1114",10102,"St Johns","NL",47.56038,-52.71147,2018-02-16 10:00:00,20,16,36
"1115",10102,"St Johns","NL",47.56038,-52.71147,2018-02-16 11:00:00,23,15,38
"1116",10102,"St Johns","NL",47.56038,-52.71147,2018-02-16 12:00:00,31,8,39
"1117",10102,"St Johns","NL",47.56038,-52.71147,2018-02-16 13:00:00,29,8,37
"1118",10102,"St Johns","NL",47.56038,-52.71147,2018-02-16 14:00:00,24,15,39
"1119",10102,"St Johns","NL",47.56038,-52.71147,2018-02-16 15:00:00,31,6,37
"1120",10102,"St Johns","NL",47.56038,-52.71147,2018-02-16 16:00:00,32,4,36
"1121",10102,"St Johns","NL",47.56038,-52.71147,2018-02-16 17:00:00,21,12,33
"1122",10102,"St Johns","NL",47.56038,-52.71147,2018-02-16 18:00:00,26,9,35
"1123",10102,"St Johns","NL",47.56038,-52.71147,2018-02-16 19:00:00,30,5,35
"1124",10102,"St Johns","NL",47.56038,-52.71147,2018-02-16 20:00:00,30,3,33
"1125",10102,"St Johns","NL",47.56038,-52.71147,2018-02-16 21:00:00,29,2,31
"1126",10102,"St Johns","NL",47.56038,-52.71147,2018-02-16 22:00:00,27,3,30
"1127",10102,"St Johns","NL",47.56038,-52.71147,2018-02-16 23:00:00,24,4,28
"1128",10102,"St Johns","NL",47.56038,-52.71147,2018-02-17 00:00:00,23,4,27
"1129",10102,"St Johns","NL",47.56038,-52.71147,2018-02-17 01:00:00,16,8,24
"1130",10102,"St Johns","NL",47.56038,-52.71147,2018-02-17 02:00:00,7,17,24
"1131",10102,"St Johns","NL",47.56038,-52.71147,2018-02-17 03:00:00,11,13,24
"1132",10102,"St Johns","NL",47.56038,-52.71147,2018-02-17 04:00:00,12,16,28
"1133",10102,"St Johns","NL",47.56038,-52.71147,2018-02-17 05:00:00,15,8,23
"1134",10102,"St Johns","NL",47.56038,-52.71147,2018-02-17 06:00:00,21,5,26
"1135",10102,"St Johns","NL",47.56038,-52.71147,2018-02-17 07:00:00,26,2,28
"1136",10102,"St Johns","NL",47.56038,-52.71147,2018-02-17 08:00:00,30,3,33
"1137",10102,"St Johns","NL",47.56038,-52.71147,2018-02-17 09:00:00,31,2,33
"1138",10102,"St Johns","NL",47.56038,-52.71147,2018-02-17 10:00:00,32,1,33
"1139",10102,"St Johns","NL",47.56038,-52.71147,2018-02-17 11:00:00,33,1,34
"1140",10102,"St Johns","NL",47.56038,-52.71147,2018-02-17 12:00:00,32,2,34
"1141",10102,"St Johns","NL",47.56038,-52.71147,2018-02-17 13:00:00,35,2,37
"1142",10102,"St Johns","NL",47.56038,-52.71147,2018-02-17 14:00:00,34,2,36
"1143",10102,"St Johns","NL",47.56038,-52.71147,2018-02-17 15:00:00,36,1,37
"1144",10102,"St Johns","NL",47.56038,-52.71147,2018-02-17 16:00:00,37,1,38
"1145",10102,"St Johns","NL",47.56038,-52.71147,2018-02-17 17:00:00,37,1,38
"1146",10102,"St Johns","NL",47.56038,-52.71147,2018-02-17 18:00:00,36,1,37
"1147",10102,"St Johns","NL",47.56038,-52.71147,2018-02-17 19:00:00,36,1,37
"1148",10102,"St Johns","NL",47.56038,-52.71147,2018-02-17 20:00:00,37,2,39
"1149",10102,"St Johns","NL",47.56038,-52.71147,2018-02-17 21:00:00,37,2,39
"1150",10102,"St Johns","NL",47.56038,-52.71147,2018-02-17 22:00:00,35,2,37
"1151",10102,"St Johns","NL",47.56038,-52.71147,2018-02-17 23:00:00,33,3,36
"1152",10102,"St Johns","NL",47.56038,-52.71147,2018-02-18 00:00:00,33,1,34
"1153",10102,"St Johns","NL",47.56038,-52.71147,2018-02-18 01:00:00,33,1,34
"1154",10102,"St Johns","NL",47.56038,-52.71147,2018-02-18 02:00:00,32,1,33
"1155",10102,"St Johns","NL",47.56038,-52.71147,2018-02-18 03:00:00,33,1,34
"1156",10102,"St Johns","NL",47.56038,-52.71147,2018-02-18 04:00:00,32,1,33
"1157",10102,"St Johns","NL",47.56038,-52.71147,2018-02-18 05:00:00,32,2,34
"1158",10102,"St Johns","NL",47.56038,-52.71147,2018-02-18 06:00:00,32,2,34
"1159",10102,"St Johns","NL",47.56038,-52.71147,2018-02-18 07:00:00,32,3,35
"1160",10102,"St Johns","NL",47.56038,-52.71147,2018-02-18 08:00:00,32,2,34
"1161",10102,"St Johns","NL",47.56038,-52.71147,2018-02-18 09:00:00,32,2,34
"1162",10102,"St Johns","NL",47.56038,-52.71147,2018-02-18 10:00:00,32,2,34
"1163",10102,"St Johns","NL",47.56038,-52.71147,2018-02-18 11:00:00,33,2,35
"1164",10102,"St Johns","NL",47.56038,-52.71147,2018-02-18 12:00:00,33,1,34
"1165",10102,"St Johns","NL",47.56038,-52.71147,2018-02-18 13:00:00,34,1,35
"1166",10102,"St Johns","NL",47.56038,-52.71147,2018-02-18 14:00:00,29,8,37
"1167",10102,"St Johns","NL",47.56038,-52.71147,2018-02-18 15:00:00,19,17,36
"1168",10102,"St Johns","NL",47.56038,-52.71147,2018-02-18 16:00:00,16,25,41
"1169",10102,"St Johns","NL",47.56038,-52.71147,2018-02-18 17:00:00,22,15,37
"1170",10102,"St Johns","NL",47.56038,-52.71147,2018-02-18 18:00:00,30,5,35
"1171",10102,"St Johns","NL",47.56038,-52.71147,2018-02-18 19:00:00,24,12,36
"1172",10102,"St Johns","NL",47.56038,-52.71147,2018-02-18 20:00:00,21,16,37
"1173",10102,"St Johns","NL",47.56038,-52.71147,2018-02-18 21:00:00,26,13,39
"1174",10102,"St Johns","NL",47.56038,-52.71147,2018-02-18 22:00:00,19,21,40
"1175",10102,"St Johns","NL",47.56038,-52.71147,2018-02-18 23:00:00,28,10,38
"1176",10102,"St Johns","NL",47.56038,-52.71147,2018-02-19 00:00:00,26,12,38
"1177",10102,"St Johns","NL",47.56038,-52.71147,2018-02-19 01:00:00,32,5,37
"1178",10102,"St Johns","NL",47.56038,-52.71147,2018-02-19 02:00:00,33,4,37
"1179",10102,"St Johns","NL",47.56038,-52.71147,2018-02-19 03:00:00,34,3,37
"1180",10102,"St Johns","NL",47.56038,-52.71147,2018-02-19 04:00:00,34,3,37
"1181",10102,"St Johns","NL",47.56038,-52.71147,2018-02-19 05:00:00,32,3,35
"1182",10102,"St Johns","NL",47.56038,-52.71147,2018-02-19 06:00:00,31,3,34
"1183",10102,"St Johns","NL",47.56038,-52.71147,2018-02-19 07:00:00,29,5,34
"1184",10102,"St Johns","NL",47.56038,-52.71147,2018-02-19 08:00:00,29,6,35
"1185",10102,"St Johns","NL",47.56038,-52.71147,2018-02-19 09:00:00,31,4,35
"1186",10102,"St Johns","NL",47.56038,-52.71147,2018-02-19 10:00:00,33,3,36
"1187",10102,"St Johns","NL",47.56038,-52.71147,2018-02-19 11:00:00,33,3,36
"1188",10102,"St Johns","NL",47.56038,-52.71147,2018-02-19 12:00:00,33,2,35
"1189",10102,"St Johns","NL",47.56038,-52.71147,2018-02-19 13:00:00,33,2,35
"1190",10102,"St Johns","NL",47.56038,-52.71147,2018-02-19 14:00:00,33,2,35
"1191",10102,"St Johns","NL",47.56038,-52.71147,2018-02-19 15:00:00,34,2,36
"1192",10102,"St Johns","NL",47.56038,-52.71147,2018-02-19 16:00:00,33,2,35
"1193",10102,"St Johns","NL",47.56038,-52.71147,2018-02-19 17:00:00,31,4,35
"1194",10102,"St Johns","NL",47.56038,-52.71147,2018-02-19 18:00:00,27,7,34
"1195",10102,"St Johns","NL",47.56038,-52.71147,2018-02-19 19:00:00,16,18,34
"1196",10102,"St Johns","NL",47.56038,-52.71147,2018-02-19 20:00:00,9,22,31
"1197",10102,"St Johns","NL",47.56038,-52.71147,2018-02-19 21:00:00,8,21,29
"1198",10102,"St Johns","NL",47.56038,-52.71147,2018-02-19 22:00:00,8,20,28
"1199",10102,"St Johns","NL",47.56038,-52.71147,2018-02-19 23:00:00,16,12,28
"1200",10102,"St Johns","NL",47.56038,-52.71147,2018-02-20 00:00:00,21,8,29
"1201",10102,"St Johns","NL",47.56038,-52.71147,2018-02-20 01:00:00,25,6,31
"1202",10102,"St Johns","NL",47.56038,-52.71147,2018-02-20 02:00:00,26,7,33
"1203",10102,"St Johns","NL",47.56038,-52.71147,2018-02-20 03:00:00,27,7,34
"1204",10102,"St Johns","NL",47.56038,-52.71147,2018-02-20 04:00:00,32,4,36
"1205",10102,"St Johns","NL",47.56038,-52.71147,2018-02-20 05:00:00,33,3,36
"1206",10102,"St Johns","NL",47.56038,-52.71147,2018-02-20 06:00:00,32,4,36
"1207",10102,"St Johns","NL",47.56038,-52.71147,2018-02-20 07:00:00,30,6,36
"1208",10102,"St Johns","NL",47.56038,-52.71147,2018-02-20 08:00:00,30,7,37
"1209",10102,"St Johns","NL",47.56038,-52.71147,2018-02-20 09:00:00,29,9,38
"1210",10102,"St Johns","NL",47.56038,-52.71147,2018-02-20 10:00:00,30,7,37
"1211",10102,"St Johns","NL",47.56038,-52.71147,2018-02-20 11:00:00,30,6,36
"1212",10102,"St Johns","NL",47.56038,-52.71147,2018-02-20 12:00:00,33,3,36
"1213",10102,"St Johns","NL",47.56038,-52.71147,2018-02-20 13:00:00,34,3,37
"1214",10102,"St Johns","NL",47.56038,-52.71147,2018-02-20 14:00:00,34,5,39
"1215",10102,"St Johns","NL",47.56038,-52.71147,2018-02-20 15:00:00,33,3,36
"1216",10102,"St Johns","NL",47.56038,-52.71147,2018-02-20 16:00:00,33,4,37
"1217",10102,"St Johns","NL",47.56038,-52.71147,2018-02-20 17:00:00,32,5,37
"1218",10102,"St Johns","NL",47.56038,-52.71147,2018-02-20 18:00:00,25,10,35
"1219",10102,"St Johns","NL",47.56038,-52.71147,2018-02-20 19:00:00,16,19,35
"1220",10102,"St Johns","NL",47.56038,-52.71147,2018-02-20 20:00:00,34,2,36
"1221",10102,"St Johns","NL",47.56038,-52.71147,2018-02-20 21:00:00,33,2,35
"1222",10102,"St Johns","NL",47.56038,-52.71147,2018-02-20 22:00:00,34,2,36
"1223",10102,"St Johns","NL",47.56038,-52.71147,2018-02-20 23:00:00,31,4,35
"1224",10102,"St Johns","NL",47.56038,-52.71147,2018-02-21 00:00:00,35,1,36
"1225",10102,"St Johns","NL",47.56038,-52.71147,2018-02-21 01:00:00,35,1,36
"1226",10102,"St Johns","NL",47.56038,-52.71147,2018-02-21 02:00:00,35,1,36
"1227",10102,"St Johns","NL",47.56038,-52.71147,2018-02-21 03:00:00,35,0,35
"1228",10102,"St Johns","NL",47.56038,-52.71147,2018-02-21 04:00:00,35,1,36
"1229",10102,"St Johns","NL",47.56038,-52.71147,2018-02-21 05:00:00,36,1,37
"1230",10102,"St Johns","NL",47.56038,-52.71147,2018-02-21 06:00:00,36,1,37
"1231",10102,"St Johns","NL",47.56038,-52.71147,2018-02-21 07:00:00,33,4,37
"1232",10102,"St Johns","NL",47.56038,-52.71147,2018-02-21 08:00:00,31,7,38
"1233",10102,"St Johns","NL",47.56038,-52.71147,2018-02-21 09:00:00,30,6,36
"1234",10102,"St Johns","NL",47.56038,-52.71147,2018-02-21 10:00:00,23,17,40
"1235",10102,"St Johns","NL",47.56038,-52.71147,2018-02-21 11:00:00,29,10,39
"1236",10102,"St Johns","NL",47.56038,-52.71147,2018-02-21 12:00:00,31,9,40
"1237",10102,"St Johns","NL",47.56038,-52.71147,2018-02-21 13:00:00,33,7,40
"1238",10102,"St Johns","NL",47.56038,-52.71147,2018-02-21 14:00:00,32,7,39
"1239",10102,"St Johns","NL",47.56038,-52.71147,2018-02-21 15:00:00,33,5,38
"1240",10102,"St Johns","NL",47.56038,-52.71147,2018-02-21 16:00:00,32,6,38
"1241",10102,"St Johns","NL",47.56038,-52.71147,2018-02-21 17:00:00,32,5,37
"1242",10102,"St Johns","NL",47.56038,-52.71147,2018-02-21 18:00:00,33,5,38
"1243",10102,"St Johns","NL",47.56038,-52.71147,2018-02-21 19:00:00,34,4,38
"1244",10102,"St Johns","NL",47.56038,-52.71147,2018-02-21 20:00:00,34,2,36
"1245",10102,"St Johns","NL",47.56038,-52.71147,2018-02-21 21:00:00,33,2,35
"1246",10102,"St Johns","NL",47.56038,-52.71147,2018-02-21 22:00:00,33,1,34
"1247",10102,"St Johns","NL",47.56038,-52.71147,2018-02-21 23:00:00,34,2,36
"1248",10102,"St Johns","NL",47.56038,-52.71147,2018-02-22 00:00:00,34,2,36
"1249",10102,"St Johns","NL",47.56038,-52.71147,2018-02-22 01:00:00,31,3,34
"1250",10102,"St Johns","NL",47.56038,-52.71147,2018-02-22 02:00:00,30,3,33
"1251",10102,"St Johns","NL",47.56038,-52.71147,2018-02-22 03:00:00,29,3,32
"1252",10102,"St Johns","NL",47.56038,-52.71147,2018-02-22 04:00:00,30,2,32
"1253",10102,"St Johns","NL",47.56038,-52.71147,2018-02-22 05:00:00,29,1,30
"1254",10102,"St Johns","NL",47.56038,-52.71147,2018-02-22 06:00:00,31,1,32
"1255",10102,"St Johns","NL",47.56038,-52.71147,2018-02-22 07:00:00,32,2,34
"1256",10102,"St Johns","NL",47.56038,-52.71147,2018-02-22 08:00:00,31,2,33
"1257",10102,"St Johns","NL",47.56038,-52.71147,2018-02-22 09:00:00,31,3,34
"1258",10102,"St Johns","NL",47.56038,-52.71147,2018-02-22 10:00:00,31,3,34
"1259",10102,"St Johns","NL",47.56038,-52.71147,2018-02-22 11:00:00,32,2,34
"1260",10102,"St Johns","NL",47.56038,-52.71147,2018-02-22 12:00:00,32,3,35
"1261",10102,"St Johns","NL",47.56038,-52.71147,2018-02-22 13:00:00,32,2,34
"1262",10102,"St Johns","NL",47.56038,-52.71147,2018-02-22 14:00:00,34,2,36
"1263",10102,"St Johns","NL",47.56038,-52.71147,2018-02-22 15:00:00,35,4,39
"1264",10102,"St Johns","NL",47.56038,-52.71147,2018-02-22 16:00:00,35,2,37
"1265",10102,"St Johns","NL",47.56038,-52.71147,2018-02-22 17:00:00,35,3,38
"1266",10102,"St Johns","NL",47.56038,-52.71147,2018-02-22 18:00:00,34,4,38
"1267",10102,"St Johns","NL",47.56038,-52.71147,2018-02-22 19:00:00,31,7,38
"1268",10102,"St Johns","NL",47.56038,-52.71147,2018-02-22 20:00:00,32,6,38
"1269",10102,"St Johns","NL",47.56038,-52.71147,2018-02-22 21:00:00,35,3,38
"1270",10102,"St Johns","NL",47.56038,-52.71147,2018-02-22 22:00:00,35,1,36
"1271",10102,"St Johns","NL",47.56038,-52.71147,2018-02-22 23:00:00,34,2,36
"1272",10102,"St Johns","NL",47.56038,-52.71147,2018-02-23 00:00:00,35,2,37
"1273",10102,"St Johns","NL",47.56038,-52.71147,2018-02-23 01:00:00,35,2,37
"1274",10102,"St Johns","NL",47.56038,-52.71147,2018-02-23 02:00:00,35,2,37
"1275",10102,"St Johns","NL",47.56038,-52.71147,2018-02-23 03:00:00,35,2,37
"1276",10102,"St Johns","NL",47.56038,-52.71147,2018-02-23 04:00:00,35,2,37
"1277",10102,"St Johns","NL",47.56038,-52.71147,2018-02-23 05:00:00,35,2,37
"1278",10102,"St Johns","NL",47.56038,-52.71147,2018-02-23 06:00:00,35,1,36
"1279",10102,"St Johns","NL",47.56038,-52.71147,2018-02-23 07:00:00,35,2,37
"1280",10102,"St Johns","NL",47.56038,-52.71147,2018-02-23 08:00:00,35,2,37
"1281",10102,"St Johns","NL",47.56038,-52.71147,2018-02-23 09:00:00,36,3,39
"1282",10102,"St Johns","NL",47.56038,-52.71147,2018-02-23 10:00:00,36,2,38
"1283",10102,"St Johns","NL",47.56038,-52.71147,2018-02-23 11:00:00,36,1,37
"1284",10102,"St Johns","NL",47.56038,-52.71147,2018-02-23 12:00:00,36,3,39
"1285",10102,"St Johns","NL",47.56038,-52.71147,2018-02-23 13:00:00,37,3,40
"1286",10102,"St Johns","NL",47.56038,-52.71147,2018-02-23 14:00:00,37,3,40
"1287",10102,"St Johns","NL",47.56038,-52.71147,2018-02-23 15:00:00,38,3,41
"1288",10102,"St Johns","NL",47.56038,-52.71147,2018-02-23 16:00:00,37,4,41
"1289",10102,"St Johns","NL",47.56038,-52.71147,2018-02-23 17:00:00,37,4,41
"1290",10102,"St Johns","NL",47.56038,-52.71147,2018-02-23 18:00:00,36,5,41
"1291",10102,"St Johns","NL",47.56038,-52.71147,2018-02-23 19:00:00,37,4,41
"1292",10102,"St Johns","NL",47.56038,-52.71147,2018-02-23 20:00:00,37,3,40
"1293",10102,"St Johns","NL",47.56038,-52.71147,2018-02-23 21:00:00,36,4,40
"1294",10102,"St Johns","NL",47.56038,-52.71147,2018-02-23 22:00:00,35,5,40
"1295",10102,"St Johns","NL",47.56038,-52.71147,2018-02-23 23:00:00,34,6,40
"1296",10102,"St Johns","NL",47.56038,-52.71147,2018-02-24 00:00:00,34,6,40
"1297",10102,"St Johns","NL",47.56038,-52.71147,2018-02-24 01:00:00,32,6,38
"1298",10102,"St Johns","NL",47.56038,-52.71147,2018-02-24 02:00:00,31,6,37
"1299",10102,"St Johns","NL",47.56038,-52.71147,2018-02-24 03:00:00,32,4,36
"1300",10102,"St Johns","NL",47.56038,-52.71147,2018-02-24 04:00:00,34,3,37
"1301",10102,"St Johns","NL",47.56038,-52.71147,2018-02-24 05:00:00,30,6,36
"1302",10102,"St Johns","NL",47.56038,-52.71147,2018-02-24 06:00:00,30,6,36
"1303",10102,"St Johns","NL",47.56038,-52.71147,2018-02-24 07:00:00,31,6,37
"1304",10102,"St Johns","NL",47.56038,-52.71147,2018-02-24 08:00:00,33,5,38
"1305",10102,"St Johns","NL",47.56038,-52.71147,2018-02-24 09:00:00,31,8,39
"1306",10102,"St Johns","NL",47.56038,-52.71147,2018-02-24 10:00:00,36,4,40
"1307",10102,"St Johns","NL",47.56038,-52.71147,2018-02-24 11:00:00,35,4,39
"1308",10102,"St Johns","NL",47.56038,-52.71147,2018-02-24 12:00:00,38,2,40
"1309",10102,"St Johns","NL",47.56038,-52.71147,2018-02-24 13:00:00,38,2,40
"1310",10102,"St Johns","NL",47.56038,-52.71147,2018-02-24 14:00:00,37,1,38
"1311",10102,"St Johns","NL",47.56038,-52.71147,2018-02-24 15:00:00,36,2,38
"1312",10102,"St Johns","NL",47.56038,-52.71147,2018-02-24 16:00:00,35,4,39
"1313",10102,"St Johns","NL",47.56038,-52.71147,2018-02-24 17:00:00,36,3,39
"1314",10102,"St Johns","NL",47.56038,-52.71147,2018-02-24 18:00:00,32,7,39
"1315",10102,"St Johns","NL",47.56038,-52.71147,2018-02-24 19:00:00,27,12,39
"1316",10102,"St Johns","NL",47.56038,-52.71147,2018-02-24 20:00:00,28,9,37
"1317",10102,"St Johns","NL",47.56038,-52.71147,2018-02-24 21:00:00,27,8,35
"1318",10102,"St Johns","NL",47.56038,-52.71147,2018-02-24 22:00:00,33,5,38
"1319",10102,"St Johns","NL",47.56038,-52.71147,2018-02-24 23:00:00,36,2,38
"1320",10102,"St Johns","NL",47.56038,-52.71147,2018-02-25 00:00:00,36,3,39
"1321",10102,"St Johns","NL",47.56038,-52.71147,2018-02-25 01:00:00,37,4,41
"1322",10102,"St Johns","NL",47.56038,-52.71147,2018-02-25 02:00:00,38,2,40
"1323",10102,"St Johns","NL",47.56038,-52.71147,2018-02-25 03:00:00,40,2,42
"1324",10102,"St Johns","NL",47.56038,-52.71147,2018-02-25 04:00:00,41,2,43
"1325",10102,"St Johns","NL",47.56038,-52.71147,2018-02-25 05:00:00,39,2,41
"1326",10102,"St Johns","NL",47.56038,-52.71147,2018-02-25 06:00:00,38,2,40
"1327",10102,"St Johns","NL",47.56038,-52.71147,2018-02-25 07:00:00,37,2,39
"1328",10102,"St Johns","NL",47.56038,-52.71147,2018-02-25 08:00:00,36,2,38
"1329",10102,"St Johns","NL",47.56038,-52.71147,2018-02-25 09:00:00,36,2,38
"1330",10102,"St Johns","NL",47.56038,-52.71147,2018-02-25 10:00:00,36,1,37
"1331",10102,"St Johns","NL",47.56038,-52.71147,2018-02-25 11:00:00,36,1,37
"1332",10102,"St Johns","NL",47.56038,-52.71147,2018-02-25 12:00:00,35,0,35
"1333",10102,"St Johns","NL",47.56038,-52.71147,2018-02-25 13:00:00,36,0,36
"1334",10102,"St Johns","NL",47.56038,-52.71147,2018-02-25 14:00:00,36,0,36
"1335",10102,"St Johns","NL",47.56038,-52.71147,2018-02-25 15:00:00,36,0,36
"1336",10102,"St Johns","NL",47.56038,-52.71147,2018-02-25 16:00:00,36,1,37
"1337",10102,"St Johns","NL",47.56038,-52.71147,2018-02-25 17:00:00,35,1,36
"1338",10102,"St Johns","NL",47.56038,-52.71147,2018-02-25 18:00:00,34,2,36
"1339",10102,"St Johns","NL",47.56038,-52.71147,2018-02-25 19:00:00,34,1,35
"1340",10102,"St Johns","NL",47.56038,-52.71147,2018-02-25 20:00:00,33,2,35
"1341",10102,"St Johns","NL",47.56038,-52.71147,2018-02-25 21:00:00,33,3,36
"1342",10102,"St Johns","NL",47.56038,-52.71147,2018-02-25 22:00:00,31,4,35
"1343",10102,"St Johns","NL",47.56038,-52.71147,2018-02-25 23:00:00,32,4,36
"1344",10102,"St Johns","NL",47.56038,-52.71147,2018-02-26 00:00:00,33,3,36
"1345",10102,"St Johns","NL",47.56038,-52.71147,2018-02-26 01:00:00,30,4,34
"1346",10102,"St Johns","NL",47.56038,-52.71147,2018-02-26 02:00:00,30,5,35
"1347",10102,"St Johns","NL",47.56038,-52.71147,2018-02-26 03:00:00,29,4,33
"1348",10102,"St Johns","NL",47.56038,-52.71147,2018-02-26 04:00:00,24,8,32
"1349",10102,"St Johns","NL",47.56038,-52.71147,2018-02-26 05:00:00,22,11,33
"1350",10102,"St Johns","NL",47.56038,-52.71147,2018-02-26 06:00:00,18,13,31
"1351",10102,"St Johns","NL",47.56038,-52.71147,2018-02-26 07:00:00,9,23,32
"1352",10102,"St Johns","NL",47.56038,-52.71147,2018-02-26 08:00:00,5,28,33
"1353",10102,"St Johns","NL",47.56038,-52.71147,2018-02-26 09:00:00,3,37,40
"1354",10102,"St Johns","NL",47.56038,-52.71147,2018-02-26 10:00:00,11,28,39
"1355",10102,"St Johns","NL",47.56038,-52.71147,2018-02-26 11:00:00,28,5,33
"1356",10102,"St Johns","NL",47.56038,-52.71147,2018-02-26 12:00:00,23,12,35
"1357",10102,"St Johns","NL",47.56038,-52.71147,2018-02-26 13:00:00,23,15,38
"1358",10102,"St Johns","NL",47.56038,-52.71147,2018-02-26 14:00:00,30,5,35
"1359",10102,"St Johns","NL",47.56038,-52.71147,2018-02-26 15:00:00,25,11,36
"1360",10102,"St Johns","NL",47.56038,-52.71147,2018-02-26 16:00:00,30,7,37
"1361",10102,"St Johns","NL",47.56038,-52.71147,2018-02-26 17:00:00,28,10,38
"1362",10102,"St Johns","NL",47.56038,-52.71147,2018-02-26 18:00:00,29,8,37
"1363",10102,"St Johns","NL",47.56038,-52.71147,2018-02-26 19:00:00,31,6,37
"1364",10102,"St Johns","NL",47.56038,-52.71147,2018-02-26 20:00:00,32,5,37
"1365",10102,"St Johns","NL",47.56038,-52.71147,2018-02-26 21:00:00,35,3,38
"1366",10102,"St Johns","NL",47.56038,-52.71147,2018-02-26 22:00:00,35,4,39
"1367",10102,"St Johns","NL",47.56038,-52.71147,2018-02-26 23:00:00,36,3,39
"1368",10102,"St Johns","NL",47.56038,-52.71147,2018-02-27 00:00:00,33,5,38
"1369",10102,"St Johns","NL",47.56038,-52.71147,2018-02-27 01:00:00,36,2,38
"1370",10102,"St Johns","NL",47.56038,-52.71147,2018-02-27 02:00:00,30,9,39
"1371",10102,"St Johns","NL",47.56038,-52.71147,2018-02-27 03:00:00,27,12,39
"1372",10102,"St Johns","NL",47.56038,-52.71147,2018-02-27 04:00:00,30,10,40
"1373",10102,"St Johns","NL",47.56038,-52.71147,2018-02-27 05:00:00,33,7,40
"1374",10102,"St Johns","NL",47.56038,-52.71147,2018-02-27 06:00:00,30,11,41
"1375",10102,"St Johns","NL",47.56038,-52.71147,2018-02-27 07:00:00,26,17,43
"1376",10102,"St Johns","NL",47.56038,-52.71147,2018-02-27 08:00:00,30,12,42
"1377",10102,"St Johns","NL",47.56038,-52.71147,2018-02-27 09:00:00,29,16,45
"1378",10102,"St Johns","NL",47.56038,-52.71147,2018-02-27 10:00:00,27,14,41
"1379",10102,"St Johns","NL",47.56038,-52.71147,2018-02-27 11:00:00,29,12,41
"1380",10102,"St Johns","NL",47.56038,-52.71147,2018-02-27 12:00:00,32,9,41
"1381",10102,"St Johns","NL",47.56038,-52.71147,2018-02-27 13:00:00,35,5,40
"1382",10102,"St Johns","NL",47.56038,-52.71147,2018-02-27 14:00:00,35,5,40
"1383",10102,"St Johns","NL",47.56038,-52.71147,2018-02-27 15:00:00,35,6,41
"1384",10102,"St Johns","NL",47.56038,-52.71147,2018-02-27 16:00:00,36,5,41
"1385",10102,"St Johns","NL",47.56038,-52.71147,2018-02-27 17:00:00,34,10,44
"1386",10102,"St Johns","NL",47.56038,-52.71147,2018-02-27 18:00:00,36,8,44
"1387",10102,"St Johns","NL",47.56038,-52.71147,2018-02-27 19:00:00,38,4,42
"1388",10102,"St Johns","NL",47.56038,-52.71147,2018-02-27 20:00:00,38,5,43
"1389",10102,"St Johns","NL",47.56038,-52.71147,2018-02-27 21:00:00,38,4,42
"1390",10102,"St Johns","NL",47.56038,-52.71147,2018-02-27 22:00:00,39,3,42
"1391",10102,"St Johns","NL",47.56038,-52.71147,2018-02-27 23:00:00,35,9,44
"1392",10102,"St Johns","NL",47.56038,-52.71147,2018-02-28 00:00:00,35,5,40
"1393",10102,"St Johns","NL",47.56038,-52.71147,2018-02-28 01:00:00,34,5,39
"1394",10102,"St Johns","NL",47.56038,-52.71147,2018-02-28 02:00:00,35,4,39
"1395",10102,"St Johns","NL",47.56038,-52.71147,2018-02-28 03:00:00,35,3,38
"1396",10102,"St Johns","NL",47.56038,-52.71147,2018-02-28 04:00:00,33,6,39
"1397",10102,"St Johns","NL",47.56038,-52.71147,2018-02-28 05:00:00,29,9,38
"1398",10102,"St Johns","NL",47.56038,-52.71147,2018-02-28 06:00:00,28,10,38
"1399",10102,"St Johns","NL",47.56038,-52.71147,2018-02-28 07:00:00,31,5,36
"1400",10102,"St Johns","NL",47.56038,-52.71147,2018-02-28 08:00:00,22,14,36
"1401",10102,"St Johns","NL",47.56038,-52.71147,2018-02-28 09:00:00,21,16,37
"1402",10102,"St Johns","NL",47.56038,-52.71147,2018-02-28 10:00:00,20,17,37
"1403",10102,"St Johns","NL",47.56038,-52.71147,2018-02-28 11:00:00,18,21,39
"1404",10102,"St Johns","NL",47.56038,-52.71147,2018-02-28 12:00:00,30,8,38
"1405",10102,"St Johns","NL",47.56038,-52.71147,2018-02-28 13:00:00,30,9,39
"1406",10102,"St Johns","NL",47.56038,-52.71147,2018-02-28 14:00:00,18,23,41
"1407",10102,"St Johns","NL",47.56038,-52.71147,2018-02-28 15:00:00,33,6,39
"1408",10102,"St Johns","NL",47.56038,-52.71147,2018-02-28 16:00:00,21,21,42
"1409",10102,"St Johns","NL",47.56038,-52.71147,2018-02-28 17:00:00,24,19,43
"1410",10102,"St Johns","NL",47.56038,-52.71147,2018-02-28 18:00:00,20,22,42
"1411",10102,"St Johns","NL",47.56038,-52.71147,2018-02-28 19:00:00,22,21,43
"1412",10102,"St Johns","NL",47.56038,-52.71147,2018-02-28 20:00:00,35,6,41
"1413",10102,"St Johns","NL",47.56038,-52.71147,2018-02-28 21:00:00,34,6,40
"1414",10102,"St Johns","NL",47.56038,-52.71147,2018-02-28 22:00:00,31,8,39
"1415",10102,"St Johns","NL",47.56038,-52.71147,2018-02-28 23:00:00,33,5,38
"1416",10102,"St Johns","NL",47.56038,-52.71147,2018-03-01 00:00:00,33,5,38
"1417",10102,"St Johns","NL",47.56038,-52.71147,2018-03-01 01:00:00,34,4,38
"1418",10102,"St Johns","NL",47.56038,-52.71147,2018-03-01 02:00:00,32,6,38
"1419",10102,"St Johns","NL",47.56038,-52.71147,2018-03-01 03:00:00,35,5,40
"1420",10102,"St Johns","NL",47.56038,-52.71147,2018-03-01 04:00:00,31,9,40
"1421",10102,"St Johns","NL",47.56038,-52.71147,2018-03-01 05:00:00,36,2,38
"1422",10102,"St Johns","NL",47.56038,-52.71147,2018-03-01 06:00:00,36,2,38
"1423",10102,"St Johns","NL",47.56038,-52.71147,2018-03-01 07:00:00,36,3,39
"1424",10102,"St Johns","NL",47.56038,-52.71147,2018-03-01 08:00:00,35,4,39
"1425",10102,"St Johns","NL",47.56038,-52.71147,2018-03-01 09:00:00,35,4,39
"1426",10102,"St Johns","NL",47.56038,-52.71147,2018-03-01 10:00:00,36,4,40
"1427",10102,"St Johns","NL",47.56038,-52.71147,2018-03-01 11:00:00,36,5,41
"1428",10102,"St Johns","NL",47.56038,-52.71147,2018-03-01 12:00:00,35,5,40
"1429",10102,"St Johns","NL",47.56038,-52.71147,2018-03-01 13:00:00,33,7,40
"1430",10102,"St Johns","NL",47.56038,-52.71147,2018-03-01 14:00:00,17,23,40
"1431",10102,"St Johns","NL",47.56038,-52.71147,2018-03-01 15:00:00,10,33,43
"1432",10102,"St Johns","NL",47.56038,-52.71147,2018-03-01 16:00:00,23,21,44
"1433",10102,"St Johns","NL",47.56038,-52.71147,2018-03-01 17:00:00,27,14,41
"1434",10102,"St Johns","NL",47.56038,-52.71147,2018-03-01 18:00:00,17,25,42
"1435",10102,"St Johns","NL",47.56038,-52.71147,2018-03-01 19:00:00,6,37,43
"1436",10102,"St Johns","NL",47.56038,-52.71147,2018-03-01 20:00:00,10,35,45
"1437",10102,"St Johns","NL",47.56038,-52.71147,2018-03-01 21:00:00,17,27,44
"1438",10102,"St Johns","NL",47.56038,-52.71147,2018-03-01 22:00:00,20,24,44
"1439",10102,"St Johns","NL",47.56038,-52.71147,2018-03-01 23:00:00,24,20,44
"1440",10102,"St Johns","NL",47.56038,-52.71147,2018-03-02 00:00:00,13,31,44
"1441",10102,"St Johns","NL",47.56038,-52.71147,2018-03-02 01:00:00,20,23,43
"1442",10102,"St Johns","NL",47.56038,-52.71147,2018-03-02 02:00:00,23,20,43
"1443",10102,"St Johns","NL",47.56038,-52.71147,2018-03-02 03:00:00,18,23,41
"1444",10102,"St Johns","NL",47.56038,-52.71147,2018-03-02 04:00:00,29,11,40
"1445",10102,"St Johns","NL",47.56038,-52.71147,2018-03-02 05:00:00,27,13,40
"1446",10102,"St Johns","NL",47.56038,-52.71147,2018-03-02 06:00:00,25,14,39
"1447",10102,"St Johns","NL",47.56038,-52.71147,2018-03-02 07:00:00,27,15,42
"1448",10102,"St Johns","NL",47.56038,-52.71147,2018-03-02 08:00:00,28,13,41
"1449",10102,"St Johns","NL",47.56038,-52.71147,2018-03-02 09:00:00,22,20,42
"1450",10102,"St Johns","NL",47.56038,-52.71147,2018-03-02 10:00:00,21,25,46
"1451",10102,"St Johns","NL",47.56038,-52.71147,2018-03-02 11:00:00,26,18,44
"1452",10102,"St Johns","NL",47.56038,-52.71147,2018-03-02 12:00:00,23,18,41
"1453",10102,"St Johns","NL",47.56038,-52.71147,2018-03-02 13:00:00,25,17,42
"1454",10102,"St Johns","NL",47.56038,-52.71147,2018-03-02 14:00:00,17,31,48
"1455",10102,"St Johns","NL",47.56038,-52.71147,2018-03-02 15:00:00,26,17,43
"1456",10102,"St Johns","NL",47.56038,-52.71147,2018-03-02 16:00:00,25,18,43
"1457",10102,"St Johns","NL",47.56038,-52.71147,2018-03-02 17:00:00,31,10,41
"1458",10102,"St Johns","NL",47.56038,-52.71147,2018-03-02 18:00:00,30,11,41
"1459",10102,"St Johns","NL",47.56038,-52.71147,2018-03-02 19:00:00,25,19,44
"1460",10102,"St Johns","NL",47.56038,-52.71147,2018-03-02 20:00:00,25,18,43
"1461",10102,"St Johns","NL",47.56038,-52.71147,2018-03-02 21:00:00,29,13,42
"1462",10102,"St Johns","NL",47.56038,-52.71147,2018-03-02 22:00:00,27,15,42
"1463",10102,"St Johns","NL",47.56038,-52.71147,2018-03-02 23:00:00,28,13,41
"1464",10102,"St Johns","NL",47.56038,-52.71147,2018-03-03 00:00:00,23,20,43
"1465",10102,"St Johns","NL",47.56038,-52.71147,2018-03-03 01:00:00,28,12,40
"1466",10102,"St Johns","NL",47.56038,-52.71147,2018-03-03 02:00:00,23,19,42
"1467",10102,"St Johns","NL",47.56038,-52.71147,2018-03-03 03:00:00,23,20,43
"1468",10102,"St Johns","NL",47.56038,-52.71147,2018-03-03 04:00:00,24,18,42
"1469",10102,"St Johns","NL",47.56038,-52.71147,2018-03-03 05:00:00,25,17,42
"1470",10102,"St Johns","NL",47.56038,-52.71147,2018-03-03 06:00:00,27,15,42
"1471",10102,"St Johns","NL",47.56038,-52.71147,2018-03-03 07:00:00,27,14,41
"1472",10102,"St Johns","NL",47.56038,-52.71147,2018-03-03 08:00:00,27,15,42
"1473",10102,"St Johns","NL",47.56038,-52.71147,2018-03-03 09:00:00,26,16,42
"1474",10102,"St Johns","NL",47.56038,-52.71147,2018-03-03 10:00:00,25,16,41
"1475",10102,"St Johns","NL",47.56038,-52.71147,2018-03-03 11:00:00,28,13,41
"1476",10102,"St Johns","NL",47.56038,-52.71147,2018-03-03 12:00:00,26,17,43
"1477",10102,"St Johns","NL",47.56038,-52.71147,2018-03-03 13:00:00,28,15,43
"1478",10102,"St Johns","NL",47.56038,-52.71147,2018-03-03 14:00:00,29,13,42
"1479",10102,"St Johns","NL",47.56038,-52.71147,2018-03-03 15:00:00,29,13,42
"1480",10102,"St Johns","NL",47.56038,-52.71147,2018-03-03 16:00:00,31,12,43
"1481",10102,"St Johns","NL",47.56038,-52.71147,2018-03-03 17:00:00,36,6,42
"1482",10102,"St Johns","NL",47.56038,-52.71147,2018-03-03 18:00:00,38,5,43
"1483",10102,"St Johns","NL",47.56038,-52.71147,2018-03-03 19:00:00,39,5,44
"1484",10102,"St Johns","NL",47.56038,-52.71147,2018-03-03 20:00:00,40,5,45
"1485",10102,"St Johns","NL",47.56038,-52.71147,2018-03-03 21:00:00,40,5,45
"1486",10102,"St Johns","NL",47.56038,-52.71147,2018-03-03 22:00:00,38,7,45
"1487",10102,"St Johns","NL",47.56038,-52.71147,2018-03-03 23:00:00,36,9,45
"1488",10102,"St Johns","NL",47.56038,-52.71147,2018-03-04 00:00:00,34,12,46
"1489",10102,"St Johns","NL",47.56038,-52.71147,2018-03-04 01:00:00,39,6,45
"1490",10102,"St Johns","NL",47.56038,-52.71147,2018-03-04 02:00:00,38,6,44
"1491",10102,"St Johns","NL",47.56038,-52.71147,2018-03-04 03:00:00,37,9,46
"1492",10102,"St Johns","NL",47.56038,-52.71147,2018-03-04 04:00:00,39,6,45
"1493",10102,"St Johns","NL",47.56038,-52.71147,2018-03-04 05:00:00,40,5,45
"1494",10102,"St Johns","NL",47.56038,-52.71147,2018-03-04 06:00:00,39,6,45
"1495",10102,"St Johns","NL",47.56038,-52.71147,2018-03-04 07:00:00,39,6,45
"1496",10102,"St Johns","NL",47.56038,-52.71147,2018-03-04 08:00:00,40,5,45
"1497",10102,"St Johns","NL",47.56038,-52.71147,2018-03-04 09:00:00,39,6,45
"1498",10102,"St Johns","NL",47.56038,-52.71147,2018-03-04 10:00:00,37,8,45
"1499",10102,"St Johns","NL",47.56038,-52.71147,2018-03-04 11:00:00,37,8,45
"1500",10102,"St Johns","NL",47.56038,-52.71147,2018-03-04 12:00:00,32,11,43
"1501",10102,"St Johns","NL",47.56038,-52.71147,2018-03-04 13:00:00,32,11,43
"1502",10102,"St Johns","NL",47.56038,-52.71147,2018-03-04 14:00:00,28,16,44
"1503",10102,"St Johns","NL",47.56038,-52.71147,2018-03-04 15:00:00,32,12,44
"1504",10102,"St Johns","NL",47.56038,-52.71147,2018-03-04 16:00:00,35,9,44
"1505",10102,"St Johns","NL",47.56038,-52.71147,2018-03-04 17:00:00,32,11,43
"1506",10102,"St Johns","NL",47.56038,-52.71147,2018-03-04 18:00:00,30,14,44
"1507",10102,"St Johns","NL",47.56038,-52.71147,2018-03-04 19:00:00,33,10,43
"1508",10102,"St Johns","NL",47.56038,-52.71147,2018-03-04 20:00:00,34,9,43
"1509",10102,"St Johns","NL",47.56038,-52.71147,2018-03-04 21:00:00,37,5,42
"1510",10102,"St Johns","NL",47.56038,-52.71147,2018-03-04 22:00:00,30,13,43
"1511",10102,"St Johns","NL",47.56038,-52.71147,2018-03-04 23:00:00,36,7,43
"1512",10102,"St Johns","NL",47.56038,-52.71147,2018-03-05 00:00:00,35,8,43
"1513",10102,"St Johns","NL",47.56038,-52.71147,2018-03-05 01:00:00,34,9,43
"1514",10102,"St Johns","NL",47.56038,-52.71147,2018-03-05 02:00:00,37,7,44
"1515",10102,"St Johns","NL",47.56038,-52.71147,2018-03-05 03:00:00,36,7,43
"1516",10102,"St Johns","NL",47.56038,-52.71147,2018-03-05 04:00:00,36,7,43
"1517",10102,"St Johns","NL",47.56038,-52.71147,2018-03-05 05:00:00,38,6,44
"1518",10102,"St Johns","NL",47.56038,-52.71147,2018-03-05 06:00:00,36,9,45
"1519",10102,"St Johns","NL",47.56038,-52.71147,2018-03-05 07:00:00,37,7,44
"1520",10102,"St Johns","NL",47.56038,-52.71147,2018-03-05 08:00:00,36,8,44
"1521",10102,"St Johns","NL",47.56038,-52.71147,2018-03-05 09:00:00,35,8,43
"1522",10102,"St Johns","NL",47.56038,-52.71147,2018-03-05 10:00:00,34,11,45
"1523",10102,"St Johns","NL",47.56038,-52.71147,2018-03-05 11:00:00,38,5,43
"1524",10102,"St Johns","NL",47.56038,-52.71147,2018-03-05 12:00:00,33,8,41
"1525",10102,"St Johns","NL",47.56038,-52.71147,2018-03-05 13:00:00,31,13,44
"1526",10102,"St Johns","NL",47.56038,-52.71147,2018-03-05 14:00:00,33,10,43
"1527",10102,"St Johns","NL",47.56038,-52.71147,2018-03-05 15:00:00,32,9,41
"1528",10102,"St Johns","NL",47.56038,-52.71147,2018-03-05 16:00:00,28,15,43
"1529",10102,"St Johns","NL",47.56038,-52.71147,2018-03-05 17:00:00,32,10,42
"1530",10102,"St Johns","NL",47.56038,-52.71147,2018-03-05 18:00:00,33,9,42
"1531",10102,"St Johns","NL",47.56038,-52.71147,2018-03-05 19:00:00,34,8,42
"1532",10102,"St Johns","NL",47.56038,-52.71147,2018-03-05 20:00:00,34,8,42
"1533",10102,"St Johns","NL",47.56038,-52.71147,2018-03-05 21:00:00,34,9,43
"1534",10102,"St Johns","NL",47.56038,-52.71147,2018-03-05 22:00:00,35,7,42
"1535",10102,"St Johns","NL",47.56038,-52.71147,2018-03-05 23:00:00,36,6,42
"1536",10102,"St Johns","NL",47.56038,-52.71147,2018-03-06 00:00:00,35,7,42
"1537",10102,"St Johns","NL",47.56038,-52.71147,2018-03-06 01:00:00,34,8,42
"1538",10102,"St Johns","NL",47.56038,-52.71147,2018-03-06 02:00:00,35,8,43
"1539",10102,"St Johns","NL",47.56038,-52.71147,2018-03-06 03:00:00,35,7,42
"1540",10102,"St Johns","NL",47.56038,-52.71147,2018-03-06 04:00:00,38,4,42
"1541",10102,"St Johns","NL",47.56038,-52.71147,2018-03-06 05:00:00,36,6,42
"1542",10102,"St Johns","NL",47.56038,-52.71147,2018-03-06 06:00:00,32,11,43
"1543",10102,"St Johns","NL",47.56038,-52.71147,2018-03-06 07:00:00,31,11,42
"1544",10102,"St Johns","NL",47.56038,-52.71147,2018-03-06 08:00:00,25,16,41
"1545",10102,"St Johns","NL",47.56038,-52.71147,2018-03-06 09:00:00,28,15,43
"1546",10102,"St Johns","NL",47.56038,-52.71147,2018-03-06 10:00:00,30,13,43
"1547",10102,"St Johns","NL",47.56038,-52.71147,2018-03-06 11:00:00,30,13,43
"1548",10102,"St Johns","NL",47.56038,-52.71147,2018-03-06 12:00:00,32,13,45
"1549",10102,"St Johns","NL",47.56038,-52.71147,2018-03-06 13:00:00,33,12,45
"1550",10102,"St Johns","NL",47.56038,-52.71147,2018-03-06 14:00:00,33,12,45
"1551",10102,"St Johns","NL",47.56038,-52.71147,2018-03-06 15:00:00,35,10,45
"1552",10102,"St Johns","NL",47.56038,-52.71147,2018-03-06 16:00:00,36,11,47
"1553",10102,"St Johns","NL",47.56038,-52.71147,2018-03-06 17:00:00,36,11,47
"1554",10102,"St Johns","NL",47.56038,-52.71147,2018-03-06 18:00:00,36,9,45
"1555",10102,"St Johns","NL",47.56038,-52.71147,2018-03-06 19:00:00,38,7,45
"1556",10102,"St Johns","NL",47.56038,-52.71147,2018-03-06 20:00:00,40,5,45
"1557",10102,"St Johns","NL",47.56038,-52.71147,2018-03-06 21:00:00,40,4,44
"1558",10102,"St Johns","NL",47.56038,-52.71147,2018-03-06 22:00:00,38,5,43
"1559",10102,"St Johns","NL",47.56038,-52.71147,2018-03-06 23:00:00,39,5,44
"1560",10102,"St Johns","NL",47.56038,-52.71147,2018-03-07 00:00:00,38,5,43
"1561",10102,"St Johns","NL",47.56038,-52.71147,2018-03-07 01:00:00,38,4,42
"1562",10102,"St Johns","NL",47.56038,-52.71147,2018-03-07 02:00:00,40,4,44
"1563",10102,"St Johns","NL",47.56038,-52.71147,2018-03-07 03:00:00,41,3,44
"1564",10102,"St Johns","NL",47.56038,-52.71147,2018-03-07 04:00:00,39,4,43
"1565",10102,"St Johns","NL",47.56038,-52.71147,2018-03-07 05:00:00,39,5,44
"1566",10102,"St Johns","NL",47.56038,-52.71147,2018-03-07 06:00:00,41,3,44
"1567",10102,"St Johns","NL",47.56038,-52.71147,2018-03-07 07:00:00,41,2,43
"1568",10102,"St Johns","NL",47.56038,-52.71147,2018-03-07 08:00:00,40,3,43
"1569",10102,"St Johns","NL",47.56038,-52.71147,2018-03-07 09:00:00,40,4,44
"1570",10102,"St Johns","NL",47.56038,-52.71147,2018-03-07 10:00:00,40,4,44
"1571",10102,"St Johns","NL",47.56038,-52.71147,2018-03-07 11:00:00,40,5,45
"1572",10102,"St Johns","NL",47.56038,-52.71147,2018-03-07 12:00:00,37,5,42
"1573",10102,"St Johns","NL",47.56038,-52.71147,2018-03-07 13:00:00,30,22,52
"1574",10102,"St Johns","NL",47.56038,-52.71147,2018-03-07 14:00:00,39,3,42
"1575",10102,"St Johns","NL",47.56038,-52.71147,2018-03-07 15:00:00,40,3,43
"1576",10102,"St Johns","NL",47.56038,-52.71147,2018-03-07 16:00:00,40,2,42
"1577",10102,"St Johns","NL",47.56038,-52.71147,2018-03-07 17:00:00,40,3,43
"1578",10102,"St Johns","NL",47.56038,-52.71147,2018-03-07 18:00:00,39,3,42
"1579",10102,"St Johns","NL",47.56038,-52.71147,2018-03-07 19:00:00,39,3,42
"1580",10102,"St Johns","NL",47.56038,-52.71147,2018-03-07 20:00:00,39,3,42
"1581",10102,"St Johns","NL",47.56038,-52.71147,2018-03-07 21:00:00,39,3,42
"1582",10102,"St Johns","NL",47.56038,-52.71147,2018-03-07 22:00:00,36,12,48
"1583",10102,"St Johns","NL",47.56038,-52.71147,2018-03-07 23:00:00,39,3,42
"1584",10102,"St Johns","NL",47.56038,-52.71147,2018-03-08 00:00:00,40,2,42
"1585",10102,"St Johns","NL",47.56038,-52.71147,2018-03-08 01:00:00,40,2,42
"1586",10102,"St Johns","NL",47.56038,-52.71147,2018-03-08 02:00:00,40,2,42
"1587",10102,"St Johns","NL",47.56038,-52.71147,2018-03-08 03:00:00,40,2,42
"1588",10102,"St Johns","NL",47.56038,-52.71147,2018-03-08 04:00:00,40,1,41
"1589",10102,"St Johns","NL",47.56038,-52.71147,2018-03-08 05:00:00,39,3,42
"1590",10102,"St Johns","NL",47.56038,-52.71147,2018-03-08 06:00:00,39,3,42
"1591",10102,"St Johns","NL",47.56038,-52.71147,2018-03-08 07:00:00,39,4,43
"1592",10102,"St Johns","NL",47.56038,-52.71147,2018-03-08 08:00:00,36,7,43
"1593",10102,"St Johns","NL",47.56038,-52.71147,2018-03-08 09:00:00,35,7,42
"1594",10102,"St Johns","NL",47.56038,-52.71147,2018-03-08 10:00:00,36,7,43
"1595",10102,"St Johns","NL",47.56038,-52.71147,2018-03-08 11:00:00,37,6,43
"1596",10102,"St Johns","NL",47.56038,-52.71147,2018-03-08 12:00:00,38,5,43
"1597",10102,"St Johns","NL",47.56038,-52.71147,2018-03-08 13:00:00,37,6,43
"1598",10102,"St Johns","NL",47.56038,-52.71147,2018-03-08 14:00:00,37,5,42
"1599",10102,"St Johns","NL",47.56038,-52.71147,2018-03-08 15:00:00,38,4,42
"1600",10102,"St Johns","NL",47.56038,-52.71147,2018-03-08 16:00:00,36,6,42
"1601",10102,"St Johns","NL",47.56038,-52.71147,2018-03-08 17:00:00,34,8,42
"1602",10102,"St Johns","NL",47.56038,-52.71147,2018-03-08 18:00:00,29,13,42
"1603",10102,"St Johns","NL",47.56038,-52.71147,2018-03-08 19:00:00,24,19,43
"1604",10102,"St Johns","NL",47.56038,-52.71147,2018-03-08 20:00:00,23,20,43
"1605",10102,"St Johns","NL",47.56038,-52.71147,2018-03-08 21:00:00,28,14,42
"1606",10102,"St Johns","NL",47.56038,-52.71147,2018-03-08 22:00:00,23,20,43
"1607",10102,"St Johns","NL",47.56038,-52.71147,2018-03-08 23:00:00,29,14,43
"1608",10102,"St Johns","NL",47.56038,-52.71147,2018-03-09 00:00:00,31,12,43
"1609",10102,"St Johns","NL",47.56038,-52.71147,2018-03-09 01:00:00,32,11,43
"1610",10102,"St Johns","NL",47.56038,-52.71147,2018-03-09 02:00:00,36,7,43
"1611",10102,"St Johns","NL",47.56038,-52.71147,2018-03-09 03:00:00,36,6,42
"1612",10102,"St Johns","NL",47.56038,-52.71147,2018-03-09 04:00:00,34,8,42
"1613",10102,"St Johns","NL",47.56038,-52.71147,2018-03-09 05:00:00,32,10,42
"1614",10102,"St Johns","NL",47.56038,-52.71147,2018-03-09 06:00:00,32,10,42
"1615",10102,"St Johns","NL",47.56038,-52.71147,2018-03-09 07:00:00,33,9,42
"1616",10102,"St Johns","NL",47.56038,-52.71147,2018-03-09 08:00:00,22,20,42
"1617",10102,"St Johns","NL",47.56038,-52.71147,2018-03-09 09:00:00,25,17,42
"1618",10102,"St Johns","NL",47.56038,-52.71147,2018-03-09 10:00:00,32,10,42
"1619",10102,"St Johns","NL",47.56038,-52.71147,2018-03-09 11:00:00,33,8,41
"1620",10102,"St Johns","NL",47.56038,-52.71147,2018-03-09 12:00:00,35,4,39
"1621",10102,"St Johns","NL",47.56038,-52.71147,2018-03-09 13:00:00,36,5,41
"1622",10102,"St Johns","NL",47.56038,-52.71147,2018-03-09 14:00:00,36,5,41
"1623",10102,"St Johns","NL",47.56038,-52.71147,2018-03-09 15:00:00,37,4,41
"1624",10102,"St Johns","NL",47.56038,-52.71147,2018-03-09 16:00:00,33,8,41
"1625",10102,"St Johns","NL",47.56038,-52.71147,2018-03-09 17:00:00,37,5,42
"1626",10102,"St Johns","NL",47.56038,-52.71147,2018-03-09 18:00:00,38,2,40
"1627",10102,"St Johns","NL",47.56038,-52.71147,2018-03-09 19:00:00,36,5,41
"1628",10102,"St Johns","NL",47.56038,-52.71147,2018-03-09 20:00:00,39,3,42
"1629",10102,"St Johns","NL",47.56038,-52.71147,2018-03-09 21:00:00,40,2,42
"1630",10102,"St Johns","NL",47.56038,-52.71147,2018-03-09 22:00:00,37,6,43
"1631",10102,"St Johns","NL",47.56038,-52.71147,2018-03-09 23:00:00,41,2,43
"1632",10102,"St Johns","NL",47.56038,-52.71147,2018-03-10 00:00:00,41,2,43
"1633",10102,"St Johns","NL",47.56038,-52.71147,2018-03-10 01:00:00,37,6,43
"1634",10102,"St Johns","NL",47.56038,-52.71147,2018-03-10 02:00:00,41,3,44
"1635",10102,"St Johns","NL",47.56038,-52.71147,2018-03-10 03:00:00,41,2,43
"1636",10102,"St Johns","NL",47.56038,-52.71147,2018-03-10 04:00:00,40,4,44
"1637",10102,"St Johns","NL",47.56038,-52.71147,2018-03-10 05:00:00,40,2,42
"1638",10102,"St Johns","NL",47.56038,-52.71147,2018-03-10 06:00:00,39,3,42
"1639",10102,"St Johns","NL",47.56038,-52.71147,2018-03-10 07:00:00,38,4,42
"1640",10102,"St Johns","NL",47.56038,-52.71147,2018-03-10 08:00:00,36,6,42
"1641",10102,"St Johns","NL",47.56038,-52.71147,2018-03-10 09:00:00,35,8,43
"1642",10102,"St Johns","NL",47.56038,-52.71147,2018-03-10 10:00:00,33,10,43
"1643",10102,"St Johns","NL",47.56038,-52.71147,2018-03-10 11:00:00,30,13,43
"1644",10102,"St Johns","NL",47.56038,-52.71147,2018-03-10 12:00:00,34,8,42
"1645",10102,"St Johns","NL",47.56038,-52.71147,2018-03-10 13:00:00,24,22,46
"1646",10102,"St Johns","NL",47.56038,-52.71147,2018-03-10 14:00:00,27,18,45
"1647",10102,"St Johns","NL",47.56038,-52.71147,2018-03-10 15:00:00,37,6,43
"1648",10102,"St Johns","NL",47.56038,-52.71147,2018-03-10 16:00:00,28,15,43
"1649",10102,"St Johns","NL",47.56038,-52.71147,2018-03-10 17:00:00,28,15,43
"1650",10102,"St Johns","NL",47.56038,-52.71147,2018-03-10 18:00:00,35,9,44
"1651",10102,"St Johns","NL",47.56038,-52.71147,2018-03-10 19:00:00,32,11,43
"1652",10102,"St Johns","NL",47.56038,-52.71147,2018-03-10 20:00:00,32,11,43
"1653",10102,"St Johns","NL",47.56038,-52.71147,2018-03-10 21:00:00,32,11,43
"1654",10102,"St Johns","NL",47.56038,-52.71147,2018-03-10 22:00:00,27,15,42
"1655",10102,"St Johns","NL",47.56038,-52.71147,2018-03-10 23:00:00,35,6,41
"1656",10102,"St Johns","NL",47.56038,-52.71147,2018-03-11 00:00:00,36,4,40
"1657",10102,"St Johns","NL",47.56038,-52.71147,2018-03-11 01:00:00,34,6,40
"1658",10102,"St Johns","NL",47.56038,-52.71147,2018-03-11 01:00:00,34,7,41
"1659",10102,"St Johns","NL",47.56038,-52.71147,2018-03-11 01:00:00,33,6,39
"1660",10102,"St Johns","NL",47.56038,-52.71147,2018-03-11 01:00:00,33,7,40
"1661",10102,"St Johns","NL",47.56038,-52.71147,2018-03-11 03:00:00,34,4,38
"1662",10102,"St Johns","NL",47.56038,-52.71147,2018-03-11 04:00:00,32,5,37
"1663",10102,"St Johns","NL",47.56038,-52.71147,2018-03-11 05:00:00,28,11,39
"1664",10102,"St Johns","NL",47.56038,-52.71147,2018-03-11 06:00:00,26,10,36
"1665",10102,"St Johns","NL",47.56038,-52.71147,2018-03-11 07:00:00,26,13,39
"1666",10102,"St Johns","NL",47.56038,-52.71147,2018-03-11 08:00:00,31,8,39
"1667",10102,"St Johns","NL",47.56038,-52.71147,2018-03-11 09:00:00,24,18,42
"1668",10102,"St Johns","NL",47.56038,-52.71147,2018-03-11 10:00:00,36,7,43
"1669",10102,"St Johns","NL",47.56038,-52.71147,2018-03-11 11:00:00,38,5,43
"1670",10102,"St Johns","NL",47.56038,-52.71147,2018-03-11 12:00:00,32,15,47
"1671",10102,"St Johns","NL",47.56038,-52.71147,2018-03-11 13:00:00,39,2,41
"1672",10102,"St Johns","NL",47.56038,-52.71147,2018-03-11 14:00:00,39,3,42
"1673",10102,"St Johns","NL",47.56038,-52.71147,2018-03-11 15:00:00,40,2,42
"1674",10102,"St Johns","NL",47.56038,-52.71147,2018-03-11 16:00:00,38,5,43
"1675",10102,"St Johns","NL",47.56038,-52.71147,2018-03-11 17:00:00,41,2,43
"1676",10102,"St Johns","NL",47.56038,-52.71147,2018-03-11 18:00:00,41,2,43
"1677",10102,"St Johns","NL",47.56038,-52.71147,2018-03-11 19:00:00,40,5,45
"1678",10102,"St Johns","NL",47.56038,-52.71147,2018-03-11 20:00:00,41,4,45
"1679",10102,"St Johns","NL",47.56038,-52.71147,2018-03-11 21:00:00,42,4,46
"1680",10102,"St Johns","NL",47.56038,-52.71147,2018-03-11 22:00:00,43,2,45
"1681",10102,"St Johns","NL",47.56038,-52.71147,2018-03-11 23:00:00,44,1,45
"1682",10102,"St Johns","NL",47.56038,-52.71147,2018-03-12 00:00:00,43,2,45
"1683",10102,"St Johns","NL",47.56038,-52.71147,2018-03-12 01:00:00,42,2,44
"1684",10102,"St Johns","NL",47.56038,-52.71147,2018-03-12 02:00:00,41,3,44
"1685",10102,"St Johns","NL",47.56038,-52.71147,2018-03-12 03:00:00,33,14,47
"1686",10102,"St Johns","NL",47.56038,-52.71147,2018-03-12 04:00:00,39,6,45
"1687",10102,"St Johns","NL",47.56038,-52.71147,2018-03-12 05:00:00,39,4,43
"1688",10102,"St Johns","NL",47.56038,-52.71147,2018-03-12 06:00:00,36,7,43
"1689",10102,"St Johns","NL",47.56038,-52.71147,2018-03-12 07:00:00,38,6,44
"1690",10102,"St Johns","NL",47.56038,-52.71147,2018-03-12 08:00:00,38,7,45
"1691",10102,"St Johns","NL",47.56038,-52.71147,2018-03-12 09:00:00,41,2,43
"1692",10102,"St Johns","NL",47.56038,-52.71147,2018-03-12 10:00:00,41,1,42
"1693",10102,"St Johns","NL",47.56038,-52.71147,2018-03-12 11:00:00,40,2,42
"1694",10102,"St Johns","NL",47.56038,-52.71147,2018-03-12 12:00:00,39,4,43
"1695",10102,"St Johns","NL",47.56038,-52.71147,2018-03-12 13:00:00,41,3,44
"1696",10102,"St Johns","NL",47.56038,-52.71147,2018-03-12 14:00:00,41,4,45
"1697",10102,"St Johns","NL",47.56038,-52.71147,2018-03-12 15:00:00,41,4,45
"1698",10102,"St Johns","NL",47.56038,-52.71147,2018-03-12 16:00:00,41,2,43
"1699",10102,"St Johns","NL",47.56038,-52.71147,2018-03-12 17:00:00,41,3,44
"1700",10102,"St Johns","NL",47.56038,-52.71147,2018-03-12 18:00:00,42,2,44
"1701",10102,"St Johns","NL",47.56038,-52.71147,2018-03-12 19:00:00,42,2,44
"1702",10102,"St Johns","NL",47.56038,-52.71147,2018-03-12 20:00:00,42,3,45
"1703",10102,"St Johns","NL",47.56038,-52.71147,2018-03-12 21:00:00,42,3,45
"1704",10102,"St Johns","NL",47.56038,-52.71147,2018-03-12 22:00:00,41,3,44
"1705",10102,"St Johns","NL",47.56038,-52.71147,2018-03-12 23:00:00,41,4,45
"1706",10102,"St Johns","NL",47.56038,-52.71147,2018-03-13 00:00:00,40,4,44
"1707",10102,"St Johns","NL",47.56038,-52.71147,2018-03-13 01:00:00,40,5,45
"1708",10102,"St Johns","NL",47.56038,-52.71147,2018-03-13 02:00:00,40,2,42
"1709",10102,"St Johns","NL",47.56038,-52.71147,2018-03-13 03:00:00,27,28,55
"1710",10102,"St Johns","NL",47.56038,-52.71147,2018-03-13 04:00:00,38,5,43
"1711",10102,"St Johns","NL",47.56038,-52.71147,2018-03-13 05:00:00,36,3,39
"1712",10102,"St Johns","NL",47.56038,-52.71147,2018-03-13 06:00:00,33,6,39
"1713",10102,"St Johns","NL",47.56038,-52.71147,2018-03-13 07:00:00,34,5,39
"1714",10102,"St Johns","NL",47.56038,-52.71147,2018-03-13 08:00:00,33,6,39
"1715",10102,"St Johns","NL",47.56038,-52.71147,2018-03-13 09:00:00,31,9,40
"1716",10102,"St Johns","NL",47.56038,-52.71147,2018-03-13 10:00:00,23,18,41
"1717",10102,"St Johns","NL",47.56038,-52.71147,2018-03-13 11:00:00,28,12,40
"1718",10102,"St Johns","NL",47.56038,-52.71147,2018-03-13 12:00:00,22,19,41
"1719",10102,"St Johns","NL",47.56038,-52.71147,2018-03-13 13:00:00,24,16,40
"1720",10102,"St Johns","NL",47.56038,-52.71147,2018-03-13 14:00:00,20,21,41
"1721",10102,"St Johns","NL",47.56038,-52.71147,2018-03-13 15:00:00,24,16,40
"1722",10102,"St Johns","NL",47.56038,-52.71147,2018-03-13 16:00:00,25,15,40
"1723",10102,"St Johns","NL",47.56038,-52.71147,2018-03-13 17:00:00,19,21,40
"1724",10102,"St Johns","NL",47.56038,-52.71147,2018-03-13 18:00:00,13,29,42
"1725",10102,"St Johns","NL",47.56038,-52.71147,2018-03-13 19:00:00,22,20,42
"1726",10102,"St Johns","NL",47.56038,-52.71147,2018-03-13 20:00:00,26,16,42
"1727",10102,"St Johns","NL",47.56038,-52.71147,2018-03-13 21:00:00,26,15,41
"1728",10102,"St Johns","NL",47.56038,-52.71147,2018-03-13 22:00:00,25,19,44
"1729",10102,"St Johns","NL",47.56038,-52.71147,2018-03-13 23:00:00,29,14,43
"1730",10102,"St Johns","NL",47.56038,-52.71147,2018-03-14 00:00:00,30,13,43
"1731",10102,"St Johns","NL",47.56038,-52.71147,2018-03-14 01:00:00,31,11,42
"1732",10102,"St Johns","NL",47.56038,-52.71147,2018-03-14 02:00:00,29,15,44
"1733",10102,"St Johns","NL",47.56038,-52.71147,2018-03-14 03:00:00,31,12,43
"1734",10102,"St Johns","NL",47.56038,-52.71147,2018-03-14 04:00:00,32,12,44
"1735",10102,"St Johns","NL",47.56038,-52.71147,2018-03-14 05:00:00,35,9,44
"1736",10102,"St Johns","NL",47.56038,-52.71147,2018-03-14 06:00:00,37,8,45
"1737",10102,"St Johns","NL",47.56038,-52.71147,2018-03-14 07:00:00,37,8,45
"1738",10102,"St Johns","NL",47.56038,-52.71147,2018-03-14 08:00:00,34,11,45
"1739",10102,"St Johns","NL",47.56038,-52.71147,2018-03-14 09:00:00,37,10,47
"1740",10102,"St Johns","NL",47.56038,-52.71147,2018-03-14 10:00:00,33,15,48
"1741",10102,"St Johns","NL",47.56038,-52.71147,2018-03-14 11:00:00,37,9,46
"1742",10102,"St Johns","NL",47.56038,-52.71147,2018-03-14 12:00:00,35,11,46
"1743",10102,"St Johns","NL",47.56038,-52.71147,2018-03-14 13:00:00,32,15,47
"1744",10102,"St Johns","NL",47.56038,-52.71147,2018-03-14 14:00:00,33,13,46
"1745",10102,"St Johns","NL",47.56038,-52.71147,2018-03-14 15:00:00,35,11,46
"1746",10102,"St Johns","NL",47.56038,-52.71147,2018-03-14 16:00:00,38,7,45
"1747",10102,"St Johns","NL",47.56038,-52.71147,2018-03-14 17:00:00,37,8,45
"1748",10102,"St Johns","NL",47.56038,-52.71147,2018-03-14 18:00:00,36,8,44
"1749",10102,"St Johns","NL",47.56038,-52.71147,2018-03-14 19:00:00,35,7,42
"1750",10102,"St Johns","NL",47.56038,-52.71147,2018-03-14 20:00:00,34,7,41
"1751",10102,"St Johns","NL",47.56038,-52.71147,2018-03-14 21:00:00,36,5,41
"1752",10102,"St Johns","NL",47.56038,-52.71147,2018-03-14 22:00:00,34,4,38
"1753",10102,"St Johns","NL",47.56038,-52.71147,2018-03-14 23:00:00,32,7,39
"1754",10102,"St Johns","NL",47.56038,-52.71147,2018-03-15 00:00:00,21,17,38
"1755",10102,"St Johns","NL",47.56038,-52.71147,2018-03-15 01:00:00,29,8,37
"1756",10102,"St Johns","NL",47.56038,-52.71147,2018-03-15 02:00:00,15,20,35
"1757",10102,"St Johns","NL",47.56038,-52.71147,2018-03-15 03:00:00,17,17,34
"1758",10102,"St Johns","NL",47.56038,-52.71147,2018-03-15 04:00:00,2,34,36
"1759",10102,"St Johns","NL",47.56038,-52.71147,2018-03-15 05:00:00,3,36,39
"1760",10102,"St Johns","NL",47.56038,-52.71147,2018-03-15 06:00:00,32,9,41
"1761",10102,"St Johns","NL",47.56038,-52.71147,2018-03-15 07:00:00,28,14,42
"1762",10102,"St Johns","NL",47.56038,-52.71147,2018-03-15 08:00:00,32,11,43
"1763",10102,"St Johns","NL",47.56038,-52.71147,2018-03-15 09:00:00,34,9,43
"1764",10102,"St Johns","NL",47.56038,-52.71147,2018-03-15 10:00:00,35,9,44
"1765",10102,"St Johns","NL",47.56038,-52.71147,2018-03-15 11:00:00,36,9,45
"1766",10102,"St Johns","NL",47.56038,-52.71147,2018-03-15 12:00:00,38,8,46
"1767",10102,"St Johns","NL",47.56038,-52.71147,2018-03-15 13:00:00,39,9,48
"1768",10102,"St Johns","NL",47.56038,-52.71147,2018-03-15 14:00:00,41,6,47
"1769",10102,"St Johns","NL",47.56038,-52.71147,2018-03-15 15:00:00,40,8,48
"1770",10102,"St Johns","NL",47.56038,-52.71147,2018-03-15 16:00:00,41,8,49
"1771",10102,"St Johns","NL",47.56038,-52.71147,2018-03-15 17:00:00,43,6,49
"1772",10102,"St Johns","NL",47.56038,-52.71147,2018-03-15 18:00:00,40,7,47
"1773",10102,"St Johns","NL",47.56038,-52.71147,2018-03-15 19:00:00,21,25,46
"1774",10102,"St Johns","NL",47.56038,-52.71147,2018-03-15 20:00:00,27,19,46
"1775",10102,"St Johns","NL",47.56038,-52.71147,2018-03-15 21:00:00,39,6,45
"1776",10102,"St Johns","NL",47.56038,-52.71147,2018-03-15 22:00:00,39,6,45
"1777",10102,"St Johns","NL",47.56038,-52.71147,2018-03-15 23:00:00,42,5,47
"1778",10102,"St Johns","NL",47.56038,-52.71147,2018-03-16 00:00:00,45,5,50
"1779",10102,"St Johns","NL",47.56038,-52.71147,2018-03-16 01:00:00,45,3,48
"1780",10102,"St Johns","NL",47.56038,-52.71147,2018-03-16 02:00:00,44,3,47
"1781",10102,"St Johns","NL",47.56038,-52.71147,2018-03-16 03:00:00,41,4,45
"1782",10102,"St Johns","NL",47.56038,-52.71147,2018-03-16 04:00:00,41,4,45
"1783",10102,"St Johns","NL",47.56038,-52.71147,2018-03-16 05:00:00,42,3,45
"1784",10102,"St Johns","NL",47.56038,-52.71147,2018-03-16 06:00:00,39,4,43
"1785",10102,"St Johns","NL",47.56038,-52.71147,2018-03-16 07:00:00,36,6,42
"1786",10102,"St Johns","NL",47.56038,-52.71147,2018-03-16 08:00:00,35,7,42
"1787",10102,"St Johns","NL",47.56038,-52.71147,2018-03-16 09:00:00,37,5,42
"1788",10102,"St Johns","NL",47.56038,-52.71147,2018-03-16 10:00:00,38,4,42
"1789",10102,"St Johns","NL",47.56038,-52.71147,2018-03-16 11:00:00,39,4,43
"1790",10102,"St Johns","NL",47.56038,-52.71147,2018-03-16 12:00:00,38,2,40
"1791",10102,"St Johns","NL",47.56038,-52.71147,2018-03-16 13:00:00,38,2,40
"1792",10102,"St Johns","NL",47.56038,-52.71147,2018-03-16 14:00:00,38,3,41
"1793",10102,"St Johns","NL",47.56038,-52.71147,2018-03-16 15:00:00,40,3,43
"1794",10102,"St Johns","NL",47.56038,-52.71147,2018-03-16 16:00:00,41,3,44
"1795",10102,"St Johns","NL",47.56038,-52.71147,2018-03-16 17:00:00,36,7,43
"1796",10102,"St Johns","NL",47.56038,-52.71147,2018-03-16 18:00:00,35,6,41
"1797",10102,"St Johns","NL",47.56038,-52.71147,2018-03-16 19:00:00,33,7,40
"1798",10102,"St Johns","NL",47.56038,-52.71147,2018-03-16 20:00:00,27,10,37
"1799",10102,"St Johns","NL",47.56038,-52.71147,2018-03-16 21:00:00,23,13,36
"1800",10102,"St Johns","NL",47.56038,-52.71147,2018-03-16 22:00:00,16,17,33
"1801",10102,"St Johns","NL",47.56038,-52.71147,2018-03-16 23:00:00,15,18,33
"1802",10102,"St Johns","NL",47.56038,-52.71147,2018-03-17 00:00:00,10,19,29
"1803",10102,"St Johns","NL",47.56038,-52.71147,2018-03-17 01:00:00,7,20,27
"1804",10102,"St Johns","NL",47.56038,-52.71147,2018-03-17 02:00:00,21,11,32
"1805",10102,"St Johns","NL",47.56038,-52.71147,2018-03-17 03:00:00,26,6,32
"1806",10102,"St Johns","NL",47.56038,-52.71147,2018-03-17 04:00:00,22,10,32
"1807",10102,"St Johns","NL",47.56038,-52.71147,2018-03-17 05:00:00,30,5,35
"1808",10102,"St Johns","NL",47.56038,-52.71147,2018-03-17 06:00:00,33,3,36
"1809",10102,"St Johns","NL",47.56038,-52.71147,2018-03-17 07:00:00,33,4,37
"1810",10102,"St Johns","NL",47.56038,-52.71147,2018-03-17 08:00:00,34,4,38
"1811",10102,"St Johns","NL",47.56038,-52.71147,2018-03-17 09:00:00,34,5,39
"1812",10102,"St Johns","NL",47.56038,-52.71147,2018-03-17 10:00:00,35,3,38
"1813",10102,"St Johns","NL",47.56038,-52.71147,2018-03-17 11:00:00,36,2,38
"1814",10102,"St Johns","NL",47.56038,-52.71147,2018-03-17 12:00:00,36,1,37
"1815",10102,"St Johns","NL",47.56038,-52.71147,2018-03-17 13:00:00,36,3,39
"1816",10102,"St Johns","NL",47.56038,-52.71147,2018-03-17 14:00:00,38,2,40
"1817",10102,"St Johns","NL",47.56038,-52.71147,2018-03-17 15:00:00,35,4,39
"1818",10102,"St Johns","NL",47.56038,-52.71147,2018-03-17 16:00:00,31,7,38
"1819",10102,"St Johns","NL",47.56038,-52.71147,2018-03-17 17:00:00,31,8,39
"1820",10102,"St Johns","NL",47.56038,-52.71147,2018-03-17 18:00:00,28,13,41
"1821",10102,"St Johns","NL",47.56038,-52.71147,2018-03-17 19:00:00,33,4,37
"1822",10102,"St Johns","NL",47.56038,-52.71147,2018-03-17 20:00:00,33,4,37
"1823",10102,"St Johns","NL",47.56038,-52.71147,2018-03-17 21:00:00,30,7,37
"1824",10102,"St Johns","NL",47.56038,-52.71147,2018-03-17 22:00:00,28,6,34
"1825",10102,"St Johns","NL",47.56038,-52.71147,2018-03-17 23:00:00,31,4,35
"1826",10102,"St Johns","NL",47.56038,-52.71147,2018-03-18 00:00:00,32,3,35
"1827",10102,"St Johns","NL",47.56038,-52.71147,2018-03-18 01:00:00,33,2,35
"1828",10102,"St Johns","NL",47.56038,-52.71147,2018-03-18 02:00:00,31,3,34
"1829",10102,"St Johns","NL",47.56038,-52.71147,2018-03-18 03:00:00,31,4,35
"1830",10102,"St Johns","NL",47.56038,-52.71147,2018-03-18 04:00:00,33,3,36
"1831",10102,"St Johns","NL",47.56038,-52.71147,2018-03-18 05:00:00,36,2,38
"1832",10102,"St Johns","NL",47.56038,-52.71147,2018-03-18 06:00:00,37,2,39
"1833",10102,"St Johns","NL",47.56038,-52.71147,2018-03-18 07:00:00,35,2,37
"1834",10102,"St Johns","NL",47.56038,-52.71147,2018-03-18 08:00:00,35,2,37
"1835",10102,"St Johns","NL",47.56038,-52.71147,2018-03-18 09:00:00,34,1,35
"1836",10102,"St Johns","NL",47.56038,-52.71147,2018-03-18 10:00:00,35,2,37
"1837",10102,"St Johns","NL",47.56038,-52.71147,2018-03-18 11:00:00,36,1,37
"1838",10102,"St Johns","NL",47.56038,-52.71147,2018-03-18 12:00:00,37,1,38
"1839",10102,"St Johns","NL",47.56038,-52.71147,2018-03-18 13:00:00,36,2,38
"1840",10102,"St Johns","NL",47.56038,-52.71147,2018-03-18 14:00:00,36,1,37
"1841",10102,"St Johns","NL",47.56038,-52.71147,2018-03-18 15:00:00,36,2,38
"1842",10102,"St Johns","NL",47.56038,-52.71147,2018-03-18 16:00:00,35,1,36
"1843",10102,"St Johns","NL",47.56038,-52.71147,2018-03-18 17:00:00,34,2,36
"1844",10102,"St Johns","NL",47.56038,-52.71147,2018-03-18 18:00:00,35,2,37
"1845",10102,"St Johns","NL",47.56038,-52.71147,2018-03-18 19:00:00,35,2,37
"1846",10102,"St Johns","NL",47.56038,-52.71147,2018-03-18 20:00:00,35,1,36
"1847",10102,"St Johns","NL",47.56038,-52.71147,2018-03-18 21:00:00,35,1,36
"1848",10102,"St Johns","NL",47.56038,-52.71147,2018-03-18 22:00:00,34,2,36
"1849",10102,"St Johns","NL",47.56038,-52.71147,2018-03-18 23:00:00,35,1,36
"1850",10102,"St Johns","NL",47.56038,-52.71147,2018-03-19 00:00:00,36,1,37
"1851",10102,"St Johns","NL",47.56038,-52.71147,2018-03-19 01:00:00,36,1,37
"1852",10102,"St Johns","NL",47.56038,-52.71147,2018-03-19 02:00:00,36,1,37
"1853",10102,"St Johns","NL",47.56038,-52.71147,2018-03-19 03:00:00,35,1,36
"1854",10102,"St Johns","NL",47.56038,-52.71147,2018-03-19 04:00:00,35,1,36
"1855",10102,"St Johns","NL",47.56038,-52.71147,2018-03-19 05:00:00,34,1,35
"1856",10102,"St Johns","NL",47.56038,-52.71147,2018-03-19 06:00:00,34,1,35
"1857",10102,"St Johns","NL",47.56038,-52.71147,2018-03-19 07:00:00,34,2,36
"1858",10102,"St Johns","NL",47.56038,-52.71147,2018-03-19 08:00:00,34,2,36
"1859",10102,"St Johns","NL",47.56038,-52.71147,2018-03-19 09:00:00,34,2,36
"1860",10102,"St Johns","NL",47.56038,-52.71147,2018-03-19 10:00:00,35,3,38
"1861",10102,"St Johns","NL",47.56038,-52.71147,2018-03-19 11:00:00,34,3,37
"1862",10102,"St Johns","NL",47.56038,-52.71147,2018-03-19 12:00:00,33,1,34
"1863",10102,"St Johns","NL",47.56038,-52.71147,2018-03-19 13:00:00,33,1,34
"1864",10102,"St Johns","NL",47.56038,-52.71147,2018-03-19 14:00:00,33,1,34
"1865",10102,"St Johns","NL",47.56038,-52.71147,2018-03-19 15:00:00,32,2,34
"1866",10102,"St Johns","NL",47.56038,-52.71147,2018-03-19 16:00:00,33,1,34
"1867",10102,"St Johns","NL",47.56038,-52.71147,2018-03-19 17:00:00,32,2,34
"1868",10102,"St Johns","NL",47.56038,-52.71147,2018-03-19 18:00:00,32,1,33
"1869",10102,"St Johns","NL",47.56038,-52.71147,2018-03-19 19:00:00,32,1,33
"1870",10102,"St Johns","NL",47.56038,-52.71147,2018-03-19 20:00:00,33,1,34
"1871",10102,"St Johns","NL",47.56038,-52.71147,2018-03-19 21:00:00,33,1,34
"1872",10102,"St Johns","NL",47.56038,-52.71147,2018-03-19 22:00:00,33,1,34
"1873",10102,"St Johns","NL",47.56038,-52.71147,2018-03-19 23:00:00,32,1,33
"1874",10102,"St Johns","NL",47.56038,-52.71147,2018-03-20 00:00:00,33,1,34
"1875",10102,"St Johns","NL",47.56038,-52.71147,2018-03-20 01:00:00,34,0,34
"1876",10102,"St Johns","NL",47.56038,-52.71147,2018-03-20 02:00:00,33,1,34
"1877",10102,"St Johns","NL",47.56038,-52.71147,2018-03-20 03:00:00,34,1,35
"1878",10102,"St Johns","NL",47.56038,-52.71147,2018-03-20 04:00:00,34,1,35
"1879",10102,"St Johns","NL",47.56038,-52.71147,2018-03-20 05:00:00,33,1,34
"1880",10102,"St Johns","NL",47.56038,-52.71147,2018-03-20 06:00:00,31,3,34
"1881",10102,"St Johns","NL",47.56038,-52.71147,2018-03-20 07:00:00,31,3,34
"1882",10102,"St Johns","NL",47.56038,-52.71147,2018-03-20 08:00:00,28,5,33
"1883",10102,"St Johns","NL",47.56038,-52.71147,2018-03-20 09:00:00,28,5,33
"1884",10102,"St Johns","NL",47.56038,-52.71147,2018-03-20 10:00:00,29,3,32
"1885",10102,"St Johns","NL",47.56038,-52.71147,2018-03-20 11:00:00,30,2,32
"1886",10102,"St Johns","NL",47.56038,-52.71147,2018-03-20 12:00:00,30,3,33
"1887",10102,"St Johns","NL",47.56038,-52.71147,2018-03-20 13:00:00,30,3,33
"1888",10102,"St Johns","NL",47.56038,-52.71147,2018-03-20 14:00:00,31,3,34
"1889",10102,"St Johns","NL",47.56038,-52.71147,2018-03-20 15:00:00,33,2,35
"1890",10102,"St Johns","NL",47.56038,-52.71147,2018-03-20 16:00:00,33,3,36
"1891",10102,"St Johns","NL",47.56038,-52.71147,2018-03-20 17:00:00,32,4,36
"1892",10102,"St Johns","NL",47.56038,-52.71147,2018-03-20 18:00:00,32,2,34
"1893",10102,"St Johns","NL",47.56038,-52.71147,2018-03-20 19:00:00,32,2,34
"1894",10102,"St Johns","NL",47.56038,-52.71147,2018-03-20 20:00:00,32,2,34
"1895",10102,"St Johns","NL",47.56038,-52.71147,2018-03-20 21:00:00,33,2,35
"1896",10102,"St Johns","NL",47.56038,-52.71147,2018-03-20 22:00:00,33,2,35
"1897",10102,"St Johns","NL",47.56038,-52.71147,2018-03-20 23:00:00,33,2,35
"1898",10102,"St Johns","NL",47.56038,-52.71147,2018-03-21 00:00:00,36,2,38
"1899",10102,"St Johns","NL",47.56038,-52.71147,2018-03-21 01:00:00,36,2,38
"1900",10102,"St Johns","NL",47.56038,-52.71147,2018-03-21 02:00:00,37,2,39
"1901",10102,"St Johns","NL",47.56038,-52.71147,2018-03-21 03:00:00,38,2,40
"1902",10102,"St Johns","NL",47.56038,-52.71147,2018-03-21 04:00:00,38,2,40
"1903",10102,"St Johns","NL",47.56038,-52.71147,2018-03-21 05:00:00,39,1,40
"1904",10102,"St Johns","NL",47.56038,-52.71147,2018-03-21 06:00:00,39,2,41
"1905",10102,"St Johns","NL",47.56038,-52.71147,2018-03-21 07:00:00,37,3,40
"1906",10102,"St Johns","NL",47.56038,-52.71147,2018-03-21 08:00:00,36,4,40
"1907",10102,"St Johns","NL",47.56038,-52.71147,2018-03-21 09:00:00,36,4,40
"1908",10102,"St Johns","NL",47.56038,-52.71147,2018-03-21 10:00:00,36,3,39
"1909",10102,"St Johns","NL",47.56038,-52.71147,2018-03-21 11:00:00,36,4,40
"1910",10102,"St Johns","NL",47.56038,-52.71147,2018-03-21 12:00:00,37,3,40
"1911",10102,"St Johns","NL",47.56038,-52.71147,2018-03-21 13:00:00,38,3,41
"1912",10102,"St Johns","NL",47.56038,-52.71147,2018-03-21 14:00:00,37,3,40
"1913",10102,"St Johns","NL",47.56038,-52.71147,2018-03-21 15:00:00,38,4,42
"1914",10102,"St Johns","NL",47.56038,-52.71147,2018-03-21 16:00:00,36,5,41
"1915",10102,"St Johns","NL",47.56038,-52.71147,2018-03-21 17:00:00,35,5,40
"1916",10102,"St Johns","NL",47.56038,-52.71147,2018-03-21 18:00:00,36,4,40
"1917",10102,"St Johns","NL",47.56038,-52.71147,2018-03-21 19:00:00,34,5,39
"1918",10102,"St Johns","NL",47.56038,-52.71147,2018-03-21 20:00:00,28,10,38
"1919",10102,"St Johns","NL",47.56038,-52.71147,2018-03-21 21:00:00,30,7,37
"1920",10102,"St Johns","NL",47.56038,-52.71147,2018-03-21 22:00:00,22,15,37
"1921",10102,"St Johns","NL",47.56038,-52.71147,2018-03-21 23:00:00,22,15,37
"1922",10102,"St Johns","NL",47.56038,-52.71147,2018-03-22 00:00:00,19,19,38
"1923",10102,"St Johns","NL",47.56038,-52.71147,2018-03-22 01:00:00,24,14,38
"1924",10102,"St Johns","NL",47.56038,-52.71147,2018-03-22 02:00:00,22,16,38
"1925",10102,"St Johns","NL",47.56038,-52.71147,2018-03-22 03:00:00,24,15,39
"1926",10102,"St Johns","NL",47.56038,-52.71147,2018-03-22 04:00:00,23,16,39
"1927",10102,"St Johns","NL",47.56038,-52.71147,2018-03-22 05:00:00,26,14,40
"1928",10102,"St Johns","NL",47.56038,-52.71147,2018-03-22 06:00:00,27,12,39
"1929",10102,"St Johns","NL",47.56038,-52.71147,2018-03-22 07:00:00,23,17,40
"1930",10102,"St Johns","NL",47.56038,-52.71147,2018-03-22 08:00:00,26,15,41
"1931",10102,"St Johns","NL",47.56038,-52.71147,2018-03-22 09:00:00,26,16,42
"1932",10102,"St Johns","NL",47.56038,-52.71147,2018-03-22 10:00:00,27,15,42
"1933",10102,"St Johns","NL",47.56038,-52.71147,2018-03-22 11:00:00,23,19,42
"1934",10102,"St Johns","NL",47.56038,-52.71147,2018-03-22 12:00:00,26,14,40
"1935",10102,"St Johns","NL",47.56038,-52.71147,2018-03-22 13:00:00,25,15,40
"1936",10102,"St Johns","NL",47.56038,-52.71147,2018-03-22 14:00:00,26,15,41
"1937",10102,"St Johns","NL",47.56038,-52.71147,2018-03-22 15:00:00,24,17,41
"1938",10102,"St Johns","NL",47.56038,-52.71147,2018-03-22 16:00:00,29,11,40
"1939",10102,"St Johns","NL",47.56038,-52.71147,2018-03-22 17:00:00,33,7,40
"1940",10102,"St Johns","NL",47.56038,-52.71147,2018-03-22 18:00:00,33,7,40
"1941",10102,"St Johns","NL",47.56038,-52.71147,2018-03-22 19:00:00,30,9,39
"1942",10102,"St Johns","NL",47.56038,-52.71147,2018-03-22 20:00:00,32,7,39
"1943",10102,"St Johns","NL",47.56038,-52.71147,2018-03-22 21:00:00,31,8,39
"1944",10102,"St Johns","NL",47.56038,-52.71147,2018-03-22 22:00:00,28,9,37
"1945",10102,"St Johns","NL",47.56038,-52.71147,2018-03-22 23:00:00,25,13,38
"1946",10102,"St Johns","NL",47.56038,-52.71147,2018-03-23 00:00:00,24,16,40
"1947",10102,"St Johns","NL",47.56038,-52.71147,2018-03-23 01:00:00,36,2,38
"1948",10102,"St Johns","NL",47.56038,-52.71147,2018-03-23 02:00:00,32,6,38
"1949",10102,"St Johns","NL",47.56038,-52.71147,2018-03-23 03:00:00,34,4,38
"1950",10102,"St Johns","NL",47.56038,-52.71147,2018-03-23 04:00:00,33,4,37
"1951",10102,"St Johns","NL",47.56038,-52.71147,2018-03-23 05:00:00,24,11,35
"1952",10102,"St Johns","NL",47.56038,-52.71147,2018-03-23 06:00:00,18,17,35
"1953",10102,"St Johns","NL",47.56038,-52.71147,2018-03-23 07:00:00,6,28,34
"1954",10102,"St Johns","NL",47.56038,-52.71147,2018-03-23 08:00:00,5,33,38
"1955",10102,"St Johns","NL",47.56038,-52.71147,2018-03-23 09:00:00,3,32,35
"1956",10102,"St Johns","NL",47.56038,-52.71147,2018-03-23 10:00:00,27,10,37
"1957",10102,"St Johns","NL",47.56038,-52.71147,2018-03-23 11:00:00,35,2,37
"1958",10102,"St Johns","NL",47.56038,-52.71147,2018-03-23 12:00:00,37,1,38
"1959",10102,"St Johns","NL",47.56038,-52.71147,2018-03-23 13:00:00,39,1,40
"1960",10102,"St Johns","NL",47.56038,-52.71147,2018-03-23 14:00:00,38,2,40
"1961",10102,"St Johns","NL",47.56038,-52.71147,2018-03-23 15:00:00,37,2,39
"1962",10102,"St Johns","NL",47.56038,-52.71147,2018-03-23 16:00:00,37,2,39
"1963",10102,"St Johns","NL",47.56038,-52.71147,2018-03-23 17:00:00,38,2,40
"1964",10102,"St Johns","NL",47.56038,-52.71147,2018-03-23 18:00:00,38,1,39
"1965",10102,"St Johns","NL",47.56038,-52.71147,2018-03-23 19:00:00,37,1,38
"1966",10102,"St Johns","NL",47.56038,-52.71147,2018-03-23 20:00:00,35,1,36
"1967",10102,"St Johns","NL",47.56038,-52.71147,2018-03-23 21:00:00,35,1,36
"1968",10102,"St Johns","NL",47.56038,-52.71147,2018-03-23 22:00:00,36,1,37
"1969",10102,"St Johns","NL",47.56038,-52.71147,2018-03-23 23:00:00,37,1,38
"1970",10102,"St Johns","NL",47.56038,-52.71147,2018-03-24 00:00:00,36,1,37
"1971",10102,"St Johns","NL",47.56038,-52.71147,2018-03-24 01:00:00,36,1,37
"1972",10102,"St Johns","NL",47.56038,-52.71147,2018-03-24 02:00:00,35,2,37
"1973",10102,"St Johns","NL",47.56038,-52.71147,2018-03-24 03:00:00,35,1,36
"1974",10102,"St Johns","NL",47.56038,-52.71147,2018-03-24 04:00:00,34,1,35
"1975",10102,"St Johns","NL",47.56038,-52.71147,2018-03-24 05:00:00,36,1,37
"1976",10102,"St Johns","NL",47.56038,-52.71147,2018-03-24 06:00:00,36,2,38
"1977",10102,"St Johns","NL",47.56038,-52.71147,2018-03-24 07:00:00,38,1,39
"1978",10102,"St Johns","NL",47.56038,-52.71147,2018-03-24 08:00:00,39,2,41
"1979",10102,"St Johns","NL",47.56038,-52.71147,2018-03-24 09:00:00,39,2,41
"1980",10102,"St Johns","NL",47.56038,-52.71147,2018-03-24 10:00:00,39,1,40
"1981",10102,"St Johns","NL",47.56038,-52.71147,2018-03-24 11:00:00,40,1,41
"1982",10102,"St Johns","NL",47.56038,-52.71147,2018-03-24 12:00:00,39,1,40
"1983",10102,"St Johns","NL",47.56038,-52.71147,2018-03-24 13:00:00,40,1,41
"1984",10102,"St Johns","NL",47.56038,-52.71147,2018-03-24 14:00:00,40,1,41
"1985",10102,"St Johns","NL",47.56038,-52.71147,2018-03-24 15:00:00,41,2,43
"1986",10102,"St Johns","NL",47.56038,-52.71147,2018-03-24 16:00:00,40,2,42
"1987",10102,"St Johns","NL",47.56038,-52.71147,2018-03-24 17:00:00,40,2,42
"1988",10102,"St Johns","NL",47.56038,-52.71147,2018-03-24 18:00:00,40,2,42
"1989",10102,"St Johns","NL",47.56038,-52.71147,2018-03-24 19:00:00,40,2,42
"1990",10102,"St Johns","NL",47.56038,-52.71147,2018-03-24 20:00:00,39,3,42
"1991",10102,"St Johns","NL",47.56038,-52.71147,2018-03-24 21:00:00,40,3,43
"1992",10102,"St Johns","NL",47.56038,-52.71147,2018-03-24 22:00:00,41,2,43
"1993",10102,"St Johns","NL",47.56038,-52.71147,2018-03-24 23:00:00,41,2,43
"1994",10102,"St Johns","NL",47.56038,-52.71147,2018-03-25 00:00:00,40,2,42
"1995",10102,"St Johns","NL",47.56038,-52.71147,2018-03-25 01:00:00,40,1,41
"1996",10102,"St Johns","NL",47.56038,-52.71147,2018-03-25 02:00:00,39,1,40
"1997",10102,"St Johns","NL",47.56038,-52.71147,2018-03-25 03:00:00,40,2,42
"1998",10102,"St Johns","NL",47.56038,-52.71147,2018-03-25 04:00:00,41,1,42
"1999",10102,"St Johns","NL",47.56038,-52.71147,2018-03-25 05:00:00,41,1,42
"2000",10102,"St Johns","NL",47.56038,-52.71147,2018-03-25 06:00:00,41,1,42
"2001",10102,"St Johns","NL",47.56038,-52.71147,2018-03-25 07:00:00,40,1,41
"2002",10102,"St Johns","NL",47.56038,-52.71147,2018-03-25 08:00:00,40,1,41
"2003",10102,"St Johns","NL",47.56038,-52.71147,2018-03-25 09:00:00,41,1,42
"2004",10102,"St Johns","NL",47.56038,-52.71147,2018-03-25 10:00:00,40,2,42
"2005",10102,"St Johns","NL",47.56038,-52.71147,2018-03-25 11:00:00,40,1,41
"2006",10102,"St Johns","NL",47.56038,-52.71147,2018-03-25 12:00:00,40,2,42
"2007",10102,"St Johns","NL",47.56038,-52.71147,2018-03-25 13:00:00,41,2,43
"2008",10102,"St Johns","NL",47.56038,-52.71147,2018-03-25 14:00:00,40,2,42
"2009",10102,"St Johns","NL",47.56038,-52.71147,2018-03-25 15:00:00,40,2,42
"2010",10102,"St Johns","NL",47.56038,-52.71147,2018-03-25 16:00:00,41,2,43
"2011",10102,"St Johns","NL",47.56038,-52.71147,2018-03-25 17:00:00,41,2,43
"2012",10102,"St Johns","NL",47.56038,-52.71147,2018-03-25 18:00:00,40,3,43
"2013",10102,"St Johns","NL",47.56038,-52.71147,2018-03-25 19:00:00,41,2,43
"2014",10102,"St Johns","NL",47.56038,-52.71147,2018-03-25 20:00:00,40,2,42
"2015",10102,"St Johns","NL",47.56038,-52.71147,2018-03-25 21:00:00,41,2,43
"2016",10102,"St Johns","NL",47.56038,-52.71147,2018-03-25 22:00:00,40,2,42
"2017",10102,"St Johns","NL",47.56038,-52.71147,2018-03-25 23:00:00,41,2,43
"2018",10102,"St Johns","NL",47.56038,-52.71147,2018-03-26 00:00:00,41,2,43
"2019",10102,"St Johns","NL",47.56038,-52.71147,2018-03-26 01:00:00,41,2,43
"2020",10102,"St Johns","NL",47.56038,-52.71147,2018-03-26 02:00:00,41,2,43
"2021",10102,"St Johns","NL",47.56038,-52.71147,2018-03-26 03:00:00,42,2,44
"2022",10102,"St Johns","NL",47.56038,-52.71147,2018-03-26 04:00:00,41,2,43
"2023",10102,"St Johns","NL",47.56038,-52.71147,2018-03-26 05:00:00,42,3,45
"2024",10102,"St Johns","NL",47.56038,-52.71147,2018-03-26 06:00:00,41,3,44
"2025",10102,"St Johns","NL",47.56038,-52.71147,2018-03-26 07:00:00,41,4,45
"2026",10102,"St Johns","NL",47.56038,-52.71147,2018-03-26 08:00:00,40,5,45
"2027",10102,"St Johns","NL",47.56038,-52.71147,2018-03-26 09:00:00,41,3,44
"2028",10102,"St Johns","NL",47.56038,-52.71147,2018-03-26 10:00:00,40,4,44
"2029",10102,"St Johns","NL",47.56038,-52.71147,2018-03-26 11:00:00,39,5,44
"2030",10102,"St Johns","NL",47.56038,-52.71147,2018-03-26 12:00:00,36,7,43
"2031",10102,"St Johns","NL",47.56038,-52.71147,2018-03-26 13:00:00,32,11,43
"2032",10102,"St Johns","NL",47.56038,-52.71147,2018-03-26 14:00:00,33,8,41
"2033",10102,"St Johns","NL",47.56038,-52.71147,2018-03-26 15:00:00,39,2,41
"2034",10102,"St Johns","NL",47.56038,-52.71147,2018-03-26 16:00:00,38,4,42
"2035",10102,"St Johns","NL",47.56038,-52.71147,2018-03-26 17:00:00,40,2,42
"2036",10102,"St Johns","NL",47.56038,-52.71147,2018-03-26 18:00:00,23,18,41
"2037",10102,"St Johns","NL",47.56038,-52.71147,2018-03-26 19:00:00,12,29,41
"2038",10102,"St Johns","NL",47.56038,-52.71147,2018-03-26 20:00:00,11,28,39
"2039",10102,"St Johns","NL",47.56038,-52.71147,2018-03-26 21:00:00,6,31,37
"2040",10102,"St Johns","NL",47.56038,-52.71147,2018-03-26 22:00:00,21,10,31
"2041",10102,"St Johns","NL",47.56038,-52.71147,2018-03-26 23:00:00,24,8,32
"2042",10102,"St Johns","NL",47.56038,-52.71147,2018-03-27 00:00:00,26,6,32
"2043",10102,"St Johns","NL",47.56038,-52.71147,2018-03-27 01:00:00,25,7,32
"2044",10102,"St Johns","NL",47.56038,-52.71147,2018-03-27 02:00:00,28,6,34
"2045",10102,"St Johns","NL",47.56038,-52.71147,2018-03-27 03:00:00,25,8,33
"2046",10102,"St Johns","NL",47.56038,-52.71147,2018-03-27 04:00:00,24,7,31
"2047",10102,"St Johns","NL",47.56038,-52.71147,2018-03-27 05:00:00,26,9,35
"2048",10102,"St Johns","NL",47.56038,-52.71147,2018-03-27 06:00:00,19,16,35
"2049",10102,"St Johns","NL",47.56038,-52.71147,2018-03-27 07:00:00,12,21,33
"2050",10102,"St Johns","NL",47.56038,-52.71147,2018-03-27 08:00:00,12,24,36
"2051",10102,"St Johns","NL",47.56038,-52.71147,2018-03-27 09:00:00,21,20,41
"2052",10102,"St Johns","NL",47.56038,-52.71147,2018-03-27 10:00:00,31,13,44
"2053",10102,"St Johns","NL",47.56038,-52.71147,2018-03-27 11:00:00,35,11,46
"2054",10102,"St Johns","NL",47.56038,-52.71147,2018-03-27 12:00:00,36,12,48
"2055",10102,"St Johns","NL",47.56038,-52.71147,2018-03-27 13:00:00,33,13,46
"2056",10102,"St Johns","NL",47.56038,-52.71147,2018-03-27 14:00:00,33,13,46
"2057",10102,"St Johns","NL",47.56038,-52.71147,2018-03-27 15:00:00,27,20,47
"2058",10102,"St Johns","NL",47.56038,-52.71147,2018-03-27 16:00:00,27,21,48
"2059",10102,"St Johns","NL",47.56038,-52.71147,2018-03-27 17:00:00,38,14,52
"2060",10102,"St Johns","NL",47.56038,-52.71147,2018-03-27 18:00:00,43,5,48
"2061",10102,"St Johns","NL",47.56038,-52.71147,2018-03-27 19:00:00,40,7,47
"2062",10102,"St Johns","NL",47.56038,-52.71147,2018-03-27 20:00:00,34,10,44
"2063",10102,"St Johns","NL",47.56038,-52.71147,2018-03-27 21:00:00,28,15,43
"2064",10102,"St Johns","NL",47.56038,-52.71147,2018-03-27 22:00:00,26,12,38
"2065",10102,"St Johns","NL",47.56038,-52.71147,2018-03-27 23:00:00,20,15,35
"2066",10102,"St Johns","NL",47.56038,-52.71147,2018-03-28 00:00:00,0,37,37
"2067",10102,"St Johns","NL",47.56038,-52.71147,2018-03-28 01:00:00,10,31,41
"2068",10102,"St Johns","NL",47.56038,-52.71147,2018-03-28 02:00:00,27,13,40
"2069",10102,"St Johns","NL",47.56038,-52.71147,2018-03-28 03:00:00,33,6,39
"2070",10102,"St Johns","NL",47.56038,-52.71147,2018-03-28 04:00:00,29,11,40
"2071",10102,"St Johns","NL",47.56038,-52.71147,2018-03-28 05:00:00,30,13,43
"2072",10102,"St Johns","NL",47.56038,-52.71147,2018-03-28 06:00:00,28,17,45
"2073",10102,"St Johns","NL",47.56038,-52.71147,2018-03-28 07:00:00,29,18,47
"2074",10102,"St Johns","NL",47.56038,-52.71147,2018-03-28 08:00:00,31,17,48
"2075",10102,"St Johns","NL",47.56038,-52.71147,2018-03-28 09:00:00,30,21,51
"2076",10102,"St Johns","NL",47.56038,-52.71147,2018-03-28 10:00:00,27,26,53
"2077",10102,"St Johns","NL",47.56038,-52.71147,2018-03-28 11:00:00,29,23,52
"2078",10102,"St Johns","NL",47.56038,-52.71147,2018-03-28 12:00:00,33,14,47
"2079",10102,"St Johns","NL",47.56038,-52.71147,2018-03-28 13:00:00,32,15,47
"2080",10102,"St Johns","NL",47.56038,-52.71147,2018-03-28 14:00:00,34,12,46
"2081",10102,"St Johns","NL",47.56038,-52.71147,2018-03-28 15:00:00,32,15,47
"2082",10102,"St Johns","NL",47.56038,-52.71147,2018-03-28 16:00:00,31,16,47
"2083",10102,"St Johns","NL",47.56038,-52.71147,2018-03-28 17:00:00,38,7,45
"2084",10102,"St Johns","NL",47.56038,-52.71147,2018-03-28 18:00:00,34,10,44
"2085",10102,"St Johns","NL",47.56038,-52.71147,2018-03-28 19:00:00,12,32,44
"2086",10102,"St Johns","NL",47.56038,-52.71147,2018-03-28 20:00:00,3,43,46
"2087",10102,"St Johns","NL",47.56038,-52.71147,2018-03-28 21:00:00,9,28,37
"2088",10102,"St Johns","NL",47.56038,-52.71147,2018-03-28 22:00:00,17,16,33
"2089",10102,"St Johns","NL",47.56038,-52.71147,2018-03-28 23:00:00,17,17,34
"2090",10102,"St Johns","NL",47.56038,-52.71147,2018-03-29 00:00:00,24,8,32
"2091",10102,"St Johns","NL",47.56038,-52.71147,2018-03-29 01:00:00,22,10,32
"2092",10102,"St Johns","NL",47.56038,-52.71147,2018-03-29 02:00:00,16,16,32
"2093",10102,"St Johns","NL",47.56038,-52.71147,2018-03-29 03:00:00,20,15,35
"2094",10102,"St Johns","NL",47.56038,-52.71147,2018-03-29 04:00:00,26,10,36
"2095",10102,"St Johns","NL",47.56038,-52.71147,2018-03-29 05:00:00,29,8,37
"2096",10102,"St Johns","NL",47.56038,-52.71147,2018-03-29 06:00:00,25,10,35
"2097",10102,"St Johns","NL",47.56038,-52.71147,2018-03-29 07:00:00,15,16,31
"2098",10102,"St Johns","NL",47.56038,-52.71147,2018-03-29 08:00:00,21,16,37
"2099",10102,"St Johns","NL",47.56038,-52.71147,2018-03-29 09:00:00,28,11,39
"2100",10102,"St Johns","NL",47.56038,-52.71147,2018-03-29 10:00:00,24,14,38
"2101",10102,"St Johns","NL",47.56038,-52.71147,2018-03-29 11:00:00,23,15,38
"2102",10102,"St Johns","NL",47.56038,-52.71147,2018-03-29 12:00:00,26,18,44
"2103",10102,"St Johns","NL",47.56038,-52.71147,2018-03-29 13:00:00,33,10,43
"2104",10102,"St Johns","NL",47.56038,-52.71147,2018-03-29 14:00:00,34,7,41
"2105",10102,"St Johns","NL",47.56038,-52.71147,2018-03-29 15:00:00,37,5,42
"2106",10102,"St Johns","NL",47.56038,-52.71147,2018-03-29 16:00:00,40,4,44
"2107",10102,"St Johns","NL",47.56038,-52.71147,2018-03-29 17:00:00,37,8,45
"2108",10102,"St Johns","NL",47.56038,-52.71147,2018-03-29 18:00:00,41,4,45
"2109",10102,"St Johns","NL",47.56038,-52.71147,2018-03-29 19:00:00,40,4,44
"2110",10102,"St Johns","NL",47.56038,-52.71147,2018-03-29 20:00:00,40,4,44
"2111",10102,"St Johns","NL",47.56038,-52.71147,2018-03-29 21:00:00,40,3,43
"2112",10102,"St Johns","NL",47.56038,-52.71147,2018-03-29 22:00:00,39,3,42
"2113",10102,"St Johns","NL",47.56038,-52.71147,2018-03-29 23:00:00,39,3,42
"2114",10102,"St Johns","NL",47.56038,-52.71147,2018-03-30 00:00:00,39,3,42
"2115",10102,"St Johns","NL",47.56038,-52.71147,2018-03-30 01:00:00,39,2,41
"2116",10102,"St Johns","NL",47.56038,-52.71147,2018-03-30 02:00:00,38,3,41
"2117",10102,"St Johns","NL",47.56038,-52.71147,2018-03-30 03:00:00,38,2,40
"2118",10102,"St Johns","NL",47.56038,-52.71147,2018-03-30 04:00:00,38,3,41
"2119",10102,"St Johns","NL",47.56038,-52.71147,2018-03-30 05:00:00,39,2,41
"2120",10102,"St Johns","NL",47.56038,-52.71147,2018-03-30 06:00:00,40,2,42
"2121",10102,"St Johns","NL",47.56038,-52.71147,2018-03-30 07:00:00,40,2,42
"2122",10102,"St Johns","NL",47.56038,-52.71147,2018-03-30 08:00:00,39,3,42
"2123",10102,"St Johns","NL",47.56038,-52.71147,2018-03-30 09:00:00,39,3,42
"2124",10102,"St Johns","NL",47.56038,-52.71147,2018-03-30 10:00:00,40,2,42
"2125",10102,"St Johns","NL",47.56038,-52.71147,2018-03-30 11:00:00,39,8,47
"2126",10102,"St Johns","NL",47.56038,-52.71147,2018-03-30 12:00:00,42,1,43
"2127",10102,"St Johns","NL",47.56038,-52.71147,2018-03-30 13:00:00,43,1,44
"2128",10102,"St Johns","NL",47.56038,-52.71147,2018-03-30 14:00:00,43,1,44
"2129",10102,"St Johns","NL",47.56038,-52.71147,2018-03-30 15:00:00,43,2,45
"2130",10102,"St Johns","NL",47.56038,-52.71147,2018-03-30 16:00:00,42,2,44
"2131",10102,"St Johns","NL",47.56038,-52.71147,2018-03-30 17:00:00,42,2,44
"2132",10102,"St Johns","NL",47.56038,-52.71147,2018-03-30 18:00:00,41,2,43
"2133",10102,"St Johns","NL",47.56038,-52.71147,2018-03-30 19:00:00,38,3,41
"2134",10102,"St Johns","NL",47.56038,-52.71147,2018-03-30 20:00:00,29,12,41
"2135",10102,"St Johns","NL",47.56038,-52.71147,2018-03-30 21:00:00,26,16,42
"2136",10102,"St Johns","NL",47.56038,-52.71147,2018-03-30 22:00:00,38,4,42
"2137",10102,"St Johns","NL",47.56038,-52.71147,2018-03-30 23:00:00,40,2,42
"2138",10102,"St Johns","NL",47.56038,-52.71147,2018-03-31 00:00:00,32,9,41
"2139",10102,"St Johns","NL",47.56038,-52.71147,2018-03-31 01:00:00,34,4,38
"2140",10102,"St Johns","NL",47.56038,-52.71147,2018-03-31 02:00:00,29,8,37
"2141",10102,"St Johns","NL",47.56038,-52.71147,2018-03-31 03:00:00,25,10,35
"2142",10102,"St Johns","NL",47.56038,-52.71147,2018-03-31 04:00:00,33,2,35
"2143",10102,"St Johns","NL",47.56038,-52.71147,2018-03-31 05:00:00,37,1,38
"2144",10102,"St Johns","NL",47.56038,-52.71147,2018-03-31 06:00:00,37,1,38
"2145",10102,"St Johns","NL",47.56038,-52.71147,2018-03-31 07:00:00,37,2,39
"2146",10102,"St Johns","NL",47.56038,-52.71147,2018-03-31 08:00:00,30,8,38
"2147",10102,"St Johns","NL",47.56038,-52.71147,2018-03-31 09:00:00,14,24,38
"2148",10102,"St Johns","NL",47.56038,-52.71147,2018-03-31 10:00:00,13,25,38
"2149",10102,"St Johns","NL",47.56038,-52.71147,2018-03-31 11:00:00,8,28,36
"2150",10102,"St Johns","NL",47.56038,-52.71147,2018-03-31 12:00:00,13,20,33
"2151",10102,"St Johns","NL",47.56038,-52.71147,2018-03-31 13:00:00,12,21,33
"2152",10102,"St Johns","NL",47.56038,-52.71147,2018-03-31 14:00:00,29,2,31
"2153",10102,"St Johns","NL",47.56038,-52.71147,2018-03-31 15:00:00,31,1,32
"2154",10102,"St Johns","NL",47.56038,-52.71147,2018-03-31 16:00:00,32,1,33
"2155",10102,"St Johns","NL",47.56038,-52.71147,2018-03-31 17:00:00,32,1,33
"2156",10102,"St Johns","NL",47.56038,-52.71147,2018-03-31 18:00:00,31,2,33
"2157",10102,"St Johns","NL",47.56038,-52.71147,2018-03-31 19:00:00,34,2,36
"2158",10102,"St Johns","NL",47.56038,-52.71147,2018-03-31 20:00:00,36,1,37
"2159",10102,"St Johns","NL",47.56038,-52.71147,2018-03-31 21:00:00,36,1,37
"2160",10102,"St Johns","NL",47.56038,-52.71147,2018-03-31 22:00:00,37,1,38
"2161",10102,"St Johns","NL",47.56038,-52.71147,2018-03-31 23:00:00,36,0,36
"2162",10102,"St Johns","NL",47.56038,-52.71147,2018-04-01 00:00:00,38,0,38
"2163",10102,"St Johns","NL",47.56038,-52.71147,2018-04-01 01:00:00,41,1,42
"2164",10102,"St Johns","NL",47.56038,-52.71147,2018-04-01 02:00:00,43,0,43
"2165",10102,"St Johns","NL",47.56038,-52.71147,2018-04-01 03:00:00,42,1,43
"2166",10102,"St Johns","NL",47.56038,-52.71147,2018-04-01 04:00:00,42,0,42
"2167",10102,"St Johns","NL",47.56038,-52.71147,2018-04-01 05:00:00,42,0,42
"2168",10102,"St Johns","NL",47.56038,-52.71147,2018-04-01 06:00:00,42,0,42
"2169",10102,"St Johns","NL",47.56038,-52.71147,2018-04-01 07:00:00,41,0,41
"2170",10102,"St Johns","NL",47.56038,-52.71147,2018-04-01 08:00:00,41,0,41
"2171",10102,"St Johns","NL",47.56038,-52.71147,2018-04-01 09:00:00,41,1,42
"2172",10102,"St Johns","NL",47.56038,-52.71147,2018-04-01 10:00:00,40,0,40
"2173",10102,"St Johns","NL",47.56038,-52.71147,2018-04-01 11:00:00,40,1,41
"2174",10102,"St Johns","NL",47.56038,-52.71147,2018-04-01 12:00:00,40,1,41
"2175",10102,"St Johns","NL",47.56038,-52.71147,2018-04-01 13:00:00,40,1,41
"2176",10102,"St Johns","NL",47.56038,-52.71147,2018-04-01 14:00:00,41,2,43
"2177",10102,"St Johns","NL",47.56038,-52.71147,2018-04-01 15:00:00,42,2,44
"2178",10102,"St Johns","NL",47.56038,-52.71147,2018-04-01 16:00:00,42,1,43
"2179",10102,"St Johns","NL",47.56038,-52.71147,2018-04-01 17:00:00,42,2,44
"2180",10102,"St Johns","NL",47.56038,-52.71147,2018-04-01 18:00:00,41,2,43
"2181",10102,"St Johns","NL",47.56038,-52.71147,2018-04-01 19:00:00,41,3,44
"2182",10102,"St Johns","NL",47.56038,-52.71147,2018-04-01 20:00:00,38,3,41
"2183",10102,"St Johns","NL",47.56038,-52.71147,2018-04-01 21:00:00,39,2,41
"2184",10102,"St Johns","NL",47.56038,-52.71147,2018-04-01 22:00:00,40,2,42
"2185",10102,"St Johns","NL",47.56038,-52.71147,2018-04-01 23:00:00,41,1,42
"2186",10102,"St Johns","NL",47.56038,-52.71147,2018-04-02 00:00:00,40,2,42
"2187",10102,"St Johns","NL",47.56038,-52.71147,2018-04-02 01:00:00,40,2,42
"2188",10102,"St Johns","NL",47.56038,-52.71147,2018-04-02 02:00:00,40,1,41
"2189",10102,"St Johns","NL",47.56038,-52.71147,2018-04-02 03:00:00,41,2,43
"2190",10102,"St Johns","NL",47.56038,-52.71147,2018-04-02 04:00:00,41,2,43
"2191",10102,"St Johns","NL",47.56038,-52.71147,2018-04-02 05:00:00,41,2,43
"2192",10102,"St Johns","NL",47.56038,-52.71147,2018-04-02 06:00:00,42,2,44
"2193",10102,"St Johns","NL",47.56038,-52.71147,2018-04-02 07:00:00,40,3,43
"2194",10102,"St Johns","NL",47.56038,-52.71147,2018-04-02 08:00:00,37,5,42
"2195",10102,"St Johns","NL",47.56038,-52.71147,2018-04-02 09:00:00,39,4,43
"2196",10102,"St Johns","NL",47.56038,-52.71147,2018-04-02 10:00:00,33,4,37
"2197",10102,"St Johns","NL",47.56038,-52.71147,2018-04-02 11:00:00,36,2,38
"2198",10102,"St Johns","NL",47.56038,-52.71147,2018-04-02 12:00:00,38,1,39
"2199",10102,"St Johns","NL",47.56038,-52.71147,2018-04-02 13:00:00,39,2,41
"2200",10102,"St Johns","NL",47.56038,-52.71147,2018-04-02 14:00:00,40,1,41
"2201",10102,"St Johns","NL",47.56038,-52.71147,2018-04-02 15:00:00,40,2,42
"2202",10102,"St Johns","NL",47.56038,-52.71147,2018-04-02 16:00:00,39,1,40
"2203",10102,"St Johns","NL",47.56038,-52.71147,2018-04-02 17:00:00,38,2,40
"2204",10102,"St Johns","NL",47.56038,-52.71147,2018-04-02 18:00:00,37,2,39
"2205",10102,"St Johns","NL",47.56038,-52.71147,2018-04-02 19:00:00,35,3,38
"2206",10102,"St Johns","NL",47.56038,-52.71147,2018-04-02 20:00:00,34,3,37
"2207",10102,"St Johns","NL",47.56038,-52.71147,2018-04-02 21:00:00,32,4,36
"2208",10102,"St Johns","NL",47.56038,-52.71147,2018-04-02 22:00:00,31,3,34
"2209",10102,"St Johns","NL",47.56038,-52.71147,2018-04-02 23:00:00,31,3,34
"2210",10102,"St Johns","NL",47.56038,-52.71147,2018-04-03 00:00:00,30,3,33
"2211",10102,"St Johns","NL",47.56038,-52.71147,2018-04-03 01:00:00,31,2,33
"2212",10102,"St Johns","NL",47.56038,-52.71147,2018-04-03 02:00:00,32,2,34
"2213",10102,"St Johns","NL",47.56038,-52.71147,2018-04-03 03:00:00,32,1,33
"2214",10102,"St Johns","NL",47.56038,-52.71147,2018-04-03 04:00:00,34,2,36
"2215",10102,"St Johns","NL",47.56038,-52.71147,2018-04-03 05:00:00,34,4,38
"2216",10102,"St Johns","NL",47.56038,-52.71147,2018-04-03 06:00:00,34,3,37
"2217",10102,"St Johns","NL",47.56038,-52.71147,2018-04-03 07:00:00,33,4,37
"2218",10102,"St Johns","NL",47.56038,-52.71147,2018-04-03 08:00:00,29,15,44
"2219",10102,"St Johns","NL",47.56038,-52.71147,2018-04-03 09:00:00,34,9,43
"2220",10102,"St Johns","NL",47.56038,-52.71147,2018-04-03 10:00:00,35,4,39
"2221",10102,"St Johns","NL",47.56038,-52.71147,2018-04-03 11:00:00,36,4,40
"2222",10102,"St Johns","NL",47.56038,-52.71147,2018-04-03 12:00:00,37,2,39
"2223",10102,"St Johns","NL",47.56038,-52.71147,2018-04-03 13:00:00,35,6,41
"2224",10102,"St Johns","NL",47.56038,-52.71147,2018-04-03 14:00:00,37,4,41
"2225",10102,"St Johns","NL",47.56038,-52.71147,2018-04-03 15:00:00,35,8,43
"2226",10102,"St Johns","NL",47.56038,-52.71147,2018-04-03 16:00:00,20,23,43
"2227",10102,"St Johns","NL",47.56038,-52.71147,2018-04-03 17:00:00,17,30,47
"2228",10102,"St Johns","NL",47.56038,-52.71147,2018-04-03 18:00:00,16,32,48
"2229",10102,"St Johns","NL",47.56038,-52.71147,2018-04-03 19:00:00,19,22,41
"2230",10102,"St Johns","NL",47.56038,-52.71147,2018-04-03 20:00:00,14,34,48
"2231",10102,"St Johns","NL",47.56038,-52.71147,2018-04-03 21:00:00,16,37,53
"2232",10102,"St Johns","NL",47.56038,-52.71147,2018-04-03 22:00:00,34,5,39
"2233",10102,"St Johns","NL",47.56038,-52.71147,2018-04-03 23:00:00,35,4,39
"2234",10102,"St Johns","NL",47.56038,-52.71147,2018-04-04 00:00:00,32,7,39
"2235",10102,"St Johns","NL",47.56038,-52.71147,2018-04-04 01:00:00,37,4,41
"2236",10102,"St Johns","NL",47.56038,-52.71147,2018-04-04 02:00:00,38,3,41
"2237",10102,"St Johns","NL",47.56038,-52.71147,2018-04-04 03:00:00,35,5,40
"2238",10102,"St Johns","NL",47.56038,-52.71147,2018-04-04 04:00:00,34,5,39
"2239",10102,"St Johns","NL",47.56038,-52.71147,2018-04-04 05:00:00,33,5,38
"2240",10102,"St Johns","NL",47.56038,-52.71147,2018-04-04 06:00:00,26,11,37
"2241",10102,"St Johns","NL",47.56038,-52.71147,2018-04-04 07:00:00,27,11,38
"2242",10102,"St Johns","NL",47.56038,-52.71147,2018-04-04 08:00:00,26,14,40
"2243",10102,"St Johns","NL",47.56038,-52.71147,2018-04-04 09:00:00,31,17,48
"2244",10102,"St Johns","NL",47.56038,-52.71147,2018-04-04 10:00:00,37,11,48
"2245",10102,"St Johns","NL",47.56038,-52.71147,2018-04-04 11:00:00,NA,13,NA
"2246",10102,"St Johns","NL",47.56038,-52.71147,2018-04-04 12:00:00,36,12,48
"2247",10102,"St Johns","NL",47.56038,-52.71147,2018-04-04 13:00:00,35,12,47
"2248",10102,"St Johns","NL",47.56038,-52.71147,2018-04-04 14:00:00,34,13,47
"2249",10102,"St Johns","NL",47.56038,-52.71147,2018-04-04 15:00:00,33,12,45
"2250",10102,"St Johns","NL",47.56038,-52.71147,2018-04-04 16:00:00,33,14,47
"2251",10102,"St Johns","NL",47.56038,-52.71147,2018-04-04 17:00:00,38,9,47
"2252",10102,"St Johns","NL",47.56038,-52.71147,2018-04-04 18:00:00,41,7,48
"2253",10102,"St Johns","NL",47.56038,-52.71147,2018-04-04 19:00:00,41,5,46
"2254",10102,"St Johns","NL",47.56038,-52.71147,2018-04-04 20:00:00,42,4,46
"2255",10102,"St Johns","NL",47.56038,-52.71147,2018-04-04 21:00:00,42,4,46
"2256",10102,"St Johns","NL",47.56038,-52.71147,2018-04-04 22:00:00,43,4,47
"2257",10102,"St Johns","NL",47.56038,-52.71147,2018-04-04 23:00:00,45,2,47
"2258",10102,"St Johns","NL",47.56038,-52.71147,2018-04-05 00:00:00,45,2,47
"2259",10102,"St Johns","NL",47.56038,-52.71147,2018-04-05 01:00:00,45,2,47
"2260",10102,"St Johns","NL",47.56038,-52.71147,2018-04-05 02:00:00,45,2,47
"2261",10102,"St Johns","NL",47.56038,-52.71147,2018-04-05 03:00:00,45,2,47
"2262",10102,"St Johns","NL",47.56038,-52.71147,2018-04-05 04:00:00,44,2,46
"2263",10102,"St Johns","NL",47.56038,-52.71147,2018-04-05 05:00:00,42,3,45
"2264",10102,"St Johns","NL",47.56038,-52.71147,2018-04-05 06:00:00,39,6,45
"2265",10102,"St Johns","NL",47.56038,-52.71147,2018-04-05 07:00:00,34,14,48
"2266",10102,"St Johns","NL",47.56038,-52.71147,2018-04-05 08:00:00,38,5,43
"2267",10102,"St Johns","NL",47.56038,-52.71147,2018-04-05 09:00:00,28,14,42
"2268",10102,"St Johns","NL",47.56038,-52.71147,2018-04-05 10:00:00,32,9,41
"2269",10102,"St Johns","NL",47.56038,-52.71147,2018-04-05 11:00:00,37,4,41
"2270",10102,"St Johns","NL",47.56038,-52.71147,2018-04-05 12:00:00,36,1,37
"2271",10102,"St Johns","NL",47.56038,-52.71147,2018-04-05 13:00:00,35,3,38
"2272",10102,"St Johns","NL",47.56038,-52.71147,2018-04-05 14:00:00,37,2,39
"2273",10102,"St Johns","NL",47.56038,-52.71147,2018-04-05 15:00:00,36,2,38
"2274",10102,"St Johns","NL",47.56038,-52.71147,2018-04-05 16:00:00,35,4,39
"2275",10102,"St Johns","NL",47.56038,-52.71147,2018-04-05 17:00:00,33,4,37
"2276",10102,"St Johns","NL",47.56038,-52.71147,2018-04-05 18:00:00,36,3,39
"2277",10102,"St Johns","NL",47.56038,-52.71147,2018-04-05 19:00:00,36,3,39
"2278",10102,"St Johns","NL",47.56038,-52.71147,2018-04-05 20:00:00,36,2,38
"2279",10102,"St Johns","NL",47.56038,-52.71147,2018-04-05 21:00:00,36,2,38
"2280",10102,"St Johns","NL",47.56038,-52.71147,2018-04-05 22:00:00,37,2,39
"2281",10102,"St Johns","NL",47.56038,-52.71147,2018-04-05 23:00:00,37,1,38
"2282",10102,"St Johns","NL",47.56038,-52.71147,2018-04-06 00:00:00,37,1,38
"2283",10102,"St Johns","NL",47.56038,-52.71147,2018-04-06 01:00:00,37,0,37
"2284",10102,"St Johns","NL",47.56038,-52.71147,2018-04-06 02:00:00,37,1,38
"2285",10102,"St Johns","NL",47.56038,-52.71147,2018-04-06 03:00:00,37,1,38
"2286",10102,"St Johns","NL",47.56038,-52.71147,2018-04-06 04:00:00,35,2,37
"2287",10102,"St Johns","NL",47.56038,-52.71147,2018-04-06 05:00:00,33,1,34
"2288",10102,"St Johns","NL",47.56038,-52.71147,2018-04-06 06:00:00,32,3,35
"2289",10102,"St Johns","NL",47.56038,-52.71147,2018-04-06 07:00:00,33,3,36
"2290",10102,"St Johns","NL",47.56038,-52.71147,2018-04-06 08:00:00,33,5,38
"2291",10102,"St Johns","NL",47.56038,-52.71147,2018-04-06 09:00:00,34,4,38
"2292",10102,"St Johns","NL",47.56038,-52.71147,2018-04-06 10:00:00,35,5,40
"2293",10102,"St Johns","NL",47.56038,-52.71147,2018-04-06 11:00:00,35,7,42
"2294",10102,"St Johns","NL",47.56038,-52.71147,2018-04-06 12:00:00,38,2,40
"2295",10102,"St Johns","NL",47.56038,-52.71147,2018-04-06 13:00:00,36,6,42
"2296",10102,"St Johns","NL",47.56038,-52.71147,2018-04-06 14:00:00,37,4,41
"2297",10102,"St Johns","NL",47.56038,-52.71147,2018-04-06 15:00:00,37,3,40
"2298",10102,"St Johns","NL",47.56038,-52.71147,2018-04-06 16:00:00,37,6,43
"2299",10102,"St Johns","NL",47.56038,-52.71147,2018-04-06 17:00:00,37,5,42
"2300",10102,"St Johns","NL",47.56038,-52.71147,2018-04-06 18:00:00,39,3,42
"2301",10102,"St Johns","NL",47.56038,-52.71147,2018-04-06 19:00:00,38,3,41
"2302",10102,"St Johns","NL",47.56038,-52.71147,2018-04-06 20:00:00,38,2,40
"2303",10102,"St Johns","NL",47.56038,-52.71147,2018-04-06 21:00:00,39,1,40
"2304",10102,"St Johns","NL",47.56038,-52.71147,2018-04-06 22:00:00,39,1,40
"2305",10102,"St Johns","NL",47.56038,-52.71147,2018-04-06 23:00:00,39,1,40
"2306",10102,"St Johns","NL",47.56038,-52.71147,2018-04-07 00:00:00,39,1,40
"2307",10102,"St Johns","NL",47.56038,-52.71147,2018-04-07 01:00:00,39,1,40
"2308",10102,"St Johns","NL",47.56038,-52.71147,2018-04-07 02:00:00,38,1,39
"2309",10102,"St Johns","NL",47.56038,-52.71147,2018-04-07 03:00:00,36,3,39
"2310",10102,"St Johns","NL",47.56038,-52.71147,2018-04-07 04:00:00,36,2,38
"2311",10102,"St Johns","NL",47.56038,-52.71147,2018-04-07 05:00:00,34,3,37
"2312",10102,"St Johns","NL",47.56038,-52.71147,2018-04-07 06:00:00,35,1,36
"2313",10102,"St Johns","NL",47.56038,-52.71147,2018-04-07 07:00:00,34,5,39
"2314",10102,"St Johns","NL",47.56038,-52.71147,2018-04-07 08:00:00,35,6,41
"2315",10102,"St Johns","NL",47.56038,-52.71147,2018-04-07 09:00:00,37,6,43
"2316",10102,"St Johns","NL",47.56038,-52.71147,2018-04-07 10:00:00,35,9,44
"2317",10102,"St Johns","NL",47.56038,-52.71147,2018-04-07 11:00:00,23,22,45
"2318",10102,"St Johns","NL",47.56038,-52.71147,2018-04-07 12:00:00,33,12,45
"2319",10102,"St Johns","NL",47.56038,-52.71147,2018-04-07 13:00:00,34,13,47
"2320",10102,"St Johns","NL",47.56038,-52.71147,2018-04-07 14:00:00,39,4,43
"2321",10102,"St Johns","NL",47.56038,-52.71147,2018-04-07 15:00:00,41,5,46
"2322",10102,"St Johns","NL",47.56038,-52.71147,2018-04-07 16:00:00,45,3,48
"2323",10102,"St Johns","NL",47.56038,-52.71147,2018-04-07 17:00:00,46,1,47
"2324",10102,"St Johns","NL",47.56038,-52.71147,2018-04-07 18:00:00,48,1,49
"2325",10102,"St Johns","NL",47.56038,-52.71147,2018-04-07 19:00:00,47,1,48
"2326",10102,"St Johns","NL",47.56038,-52.71147,2018-04-07 20:00:00,47,1,48
"2327",10102,"St Johns","NL",47.56038,-52.71147,2018-04-07 21:00:00,45,1,46
"2328",10102,"St Johns","NL",47.56038,-52.71147,2018-04-07 22:00:00,45,1,46
"2329",10102,"St Johns","NL",47.56038,-52.71147,2018-04-07 23:00:00,47,2,49
"2330",10102,"St Johns","NL",47.56038,-52.71147,2018-04-08 00:00:00,47,3,50
"2331",10102,"St Johns","NL",47.56038,-52.71147,2018-04-08 01:00:00,45,2,47
"2332",10102,"St Johns","NL",47.56038,-52.71147,2018-04-08 02:00:00,42,2,44
"2333",10102,"St Johns","NL",47.56038,-52.71147,2018-04-08 03:00:00,40,3,43
"2334",10102,"St Johns","NL",47.56038,-52.71147,2018-04-08 04:00:00,36,5,41
"2335",10102,"St Johns","NL",47.56038,-52.71147,2018-04-08 05:00:00,38,3,41
"2336",10102,"St Johns","NL",47.56038,-52.71147,2018-04-08 06:00:00,35,9,44
"2337",10102,"St Johns","NL",47.56038,-52.71147,2018-04-08 07:00:00,42,2,44
"2338",10102,"St Johns","NL",47.56038,-52.71147,2018-04-08 08:00:00,26,20,46
"2339",10102,"St Johns","NL",47.56038,-52.71147,2018-04-08 09:00:00,21,27,48
"2340",10102,"St Johns","NL",47.56038,-52.71147,2018-04-08 10:00:00,33,11,44
"2341",10102,"St Johns","NL",47.56038,-52.71147,2018-04-08 11:00:00,29,17,46
"2342",10102,"St Johns","NL",47.56038,-52.71147,2018-04-08 12:00:00,21,26,47
"2343",10102,"St Johns","NL",47.56038,-52.71147,2018-04-08 13:00:00,32,14,46
"2344",10102,"St Johns","NL",47.56038,-52.71147,2018-04-08 14:00:00,31,14,45
"2345",10102,"St Johns","NL",47.56038,-52.71147,2018-04-08 15:00:00,27,19,46
"2346",10102,"St Johns","NL",47.56038,-52.71147,2018-04-08 16:00:00,25,21,46
"2347",10102,"St Johns","NL",47.56038,-52.71147,2018-04-08 17:00:00,16,32,48
"2348",10102,"St Johns","NL",47.56038,-52.71147,2018-04-08 18:00:00,29,17,46
"2349",10102,"St Johns","NL",47.56038,-52.71147,2018-04-08 19:00:00,31,15,46
"2350",10102,"St Johns","NL",47.56038,-52.71147,2018-04-08 20:00:00,30,16,46
"2351",10102,"St Johns","NL",47.56038,-52.71147,2018-04-08 21:00:00,32,14,46
"2352",10102,"St Johns","NL",47.56038,-52.71147,2018-04-08 22:00:00,33,12,45
"2353",10102,"St Johns","NL",47.56038,-52.71147,2018-04-08 23:00:00,29,16,45
"2354",10102,"St Johns","NL",47.56038,-52.71147,2018-04-09 00:00:00,23,24,47
"2355",10102,"St Johns","NL",47.56038,-52.71147,2018-04-09 01:00:00,30,18,48
"2356",10102,"St Johns","NL",47.56038,-52.71147,2018-04-09 02:00:00,23,17,40
"2357",10102,"St Johns","NL",47.56038,-52.71147,2018-04-09 03:00:00,21,2,23
"2358",10102,"St Johns","NL",47.56038,-52.71147,2018-04-09 04:00:00,19,1,20
"2359",10102,"St Johns","NL",47.56038,-52.71147,2018-04-09 05:00:00,19,1,20
"2360",10102,"St Johns","NL",47.56038,-52.71147,2018-04-09 06:00:00,21,2,23
"2361",10102,"St Johns","NL",47.56038,-52.71147,2018-04-09 07:00:00,26,2,28
"2362",10102,"St Johns","NL",47.56038,-52.71147,2018-04-09 08:00:00,35,3,38
"2363",10102,"St Johns","NL",47.56038,-52.71147,2018-04-09 09:00:00,37,3,40
"2364",10102,"St Johns","NL",47.56038,-52.71147,2018-04-09 10:00:00,39,2,41
"2365",10102,"St Johns","NL",47.56038,-52.71147,2018-04-09 11:00:00,40,3,43
"2366",10102,"St Johns","NL",47.56038,-52.71147,2018-04-09 12:00:00,42,2,44
"2367",10102,"St Johns","NL",47.56038,-52.71147,2018-04-09 13:00:00,41,2,43
"2368",10102,"St Johns","NL",47.56038,-52.71147,2018-04-09 14:00:00,39,2,41
"2369",10102,"St Johns","NL",47.56038,-52.71147,2018-04-09 15:00:00,39,3,42
"2370",10102,"St Johns","NL",47.56038,-52.71147,2018-04-09 16:00:00,38,3,41
"2371",10102,"St Johns","NL",47.56038,-52.71147,2018-04-09 17:00:00,37,2,39
"2372",10102,"St Johns","NL",47.56038,-52.71147,2018-04-09 18:00:00,38,2,40
"2373",10102,"St Johns","NL",47.56038,-52.71147,2018-04-09 19:00:00,38,2,40
"2374",10102,"St Johns","NL",47.56038,-52.71147,2018-04-09 20:00:00,37,2,39
"2375",10102,"St Johns","NL",47.56038,-52.71147,2018-04-09 21:00:00,37,2,39
"2376",10102,"St Johns","NL",47.56038,-52.71147,2018-04-09 22:00:00,37,2,39
"2377",10102,"St Johns","NL",47.56038,-52.71147,2018-04-09 23:00:00,37,2,39
"2378",10102,"St Johns","NL",47.56038,-52.71147,2018-04-10 00:00:00,36,2,38
"2379",10102,"St Johns","NL",47.56038,-52.71147,2018-04-10 01:00:00,37,1,38
"2380",10102,"St Johns","NL",47.56038,-52.71147,2018-04-10 02:00:00,37,2,39
"2381",10102,"St Johns","NL",47.56038,-52.71147,2018-04-10 03:00:00,38,2,40
"2382",10102,"St Johns","NL",47.56038,-52.71147,2018-04-10 04:00:00,38,2,40
"2383",10102,"St Johns","NL",47.56038,-52.71147,2018-04-10 05:00:00,38,3,41
"2384",10102,"St Johns","NL",47.56038,-52.71147,2018-04-10 06:00:00,37,3,40
"2385",10102,"St Johns","NL",47.56038,-52.71147,2018-04-10 07:00:00,35,5,40
"2386",10102,"St Johns","NL",47.56038,-52.71147,2018-04-10 08:00:00,34,9,43
"2387",10102,"St Johns","NL",47.56038,-52.71147,2018-04-10 09:00:00,34,5,39
"2388",10102,"St Johns","NL",47.56038,-52.71147,2018-04-10 10:00:00,34,7,41
"2389",10102,"St Johns","NL",47.56038,-52.71147,2018-04-10 11:00:00,34,6,40
"2390",10102,"St Johns","NL",47.56038,-52.71147,2018-04-10 12:00:00,35,3,38
"2391",10102,"St Johns","NL",47.56038,-52.71147,2018-04-10 13:00:00,35,2,37
"2392",10102,"St Johns","NL",47.56038,-52.71147,2018-04-10 14:00:00,34,3,37
"2393",10102,"St Johns","NL",47.56038,-52.71147,2018-04-10 15:00:00,34,4,38
"2394",10102,"St Johns","NL",47.56038,-52.71147,2018-04-10 16:00:00,33,4,37
"2395",10102,"St Johns","NL",47.56038,-52.71147,2018-04-10 17:00:00,33,4,37
"2396",10102,"St Johns","NL",47.56038,-52.71147,2018-04-10 18:00:00,33,3,36
"2397",10102,"St Johns","NL",47.56038,-52.71147,2018-04-10 19:00:00,32,3,35
"2398",10102,"St Johns","NL",47.56038,-52.71147,2018-04-10 20:00:00,31,3,34
"2399",10102,"St Johns","NL",47.56038,-52.71147,2018-04-10 21:00:00,31,3,34
"2400",10102,"St Johns","NL",47.56038,-52.71147,2018-04-10 22:00:00,31,3,34
"2401",10102,"St Johns","NL",47.56038,-52.71147,2018-04-10 23:00:00,32,2,34
"2402",10102,"St Johns","NL",47.56038,-52.71147,2018-04-11 00:00:00,32,2,34
"2403",10102,"St Johns","NL",47.56038,-52.71147,2018-04-11 01:00:00,31,3,34
"2404",10102,"St Johns","NL",47.56038,-52.71147,2018-04-11 02:00:00,29,4,33
"2405",10102,"St Johns","NL",47.56038,-52.71147,2018-04-11 03:00:00,27,4,31
"2406",10102,"St Johns","NL",47.56038,-52.71147,2018-04-11 04:00:00,26,7,33
"2407",10102,"St Johns","NL",47.56038,-52.71147,2018-04-11 05:00:00,26,6,32
"2408",10102,"St Johns","NL",47.56038,-52.71147,2018-04-11 06:00:00,25,6,31
"2409",10102,"St Johns","NL",47.56038,-52.71147,2018-04-11 07:00:00,25,7,32
"2410",10102,"St Johns","NL",47.56038,-52.71147,2018-04-11 08:00:00,28,8,36
"2411",10102,"St Johns","NL",47.56038,-52.71147,2018-04-11 09:00:00,29,8,37
"2412",10102,"St Johns","NL",47.56038,-52.71147,2018-04-11 10:00:00,31,3,34
"2413",10102,"St Johns","NL",47.56038,-52.71147,2018-04-11 11:00:00,30,12,42
"2414",10102,"St Johns","NL",47.56038,-52.71147,2018-04-11 12:00:00,22,44,66
"2415",10102,"St Johns","NL",47.56038,-52.71147,2018-04-11 13:00:00,27,8,35
"2416",10102,"St Johns","NL",47.56038,-52.71147,2018-04-11 14:00:00,28,8,36
"2417",10102,"St Johns","NL",47.56038,-52.71147,2018-04-11 15:00:00,30,6,36
"2418",10102,"St Johns","NL",47.56038,-52.71147,2018-04-11 16:00:00,34,6,40
"2419",10102,"St Johns","NL",47.56038,-52.71147,2018-04-11 17:00:00,38,5,43
"2420",10102,"St Johns","NL",47.56038,-52.71147,2018-04-11 18:00:00,37,6,43
"2421",10102,"St Johns","NL",47.56038,-52.71147,2018-04-11 19:00:00,39,2,41
"2422",10102,"St Johns","NL",47.56038,-52.71147,2018-04-11 20:00:00,33,9,42
"2423",10102,"St Johns","NL",47.56038,-52.71147,2018-04-11 21:00:00,33,6,39
"2424",10102,"St Johns","NL",47.56038,-52.71147,2018-04-11 22:00:00,25,11,36
"2425",10102,"St Johns","NL",47.56038,-52.71147,2018-04-11 23:00:00,25,7,32
"2426",10102,"St Johns","NL",47.56038,-52.71147,2018-04-12 00:00:00,31,3,34
"2427",10102,"St Johns","NL",47.56038,-52.71147,2018-04-12 01:00:00,29,4,33
"2428",10102,"St Johns","NL",47.56038,-52.71147,2018-04-12 02:00:00,26,5,31
"2429",10102,"St Johns","NL",47.56038,-52.71147,2018-04-12 03:00:00,21,7,28
"2430",10102,"St Johns","NL",47.56038,-52.71147,2018-04-12 04:00:00,16,13,29
"2431",10102,"St Johns","NL",47.56038,-52.71147,2018-04-12 05:00:00,24,12,36
"2432",10102,"St Johns","NL",47.56038,-52.71147,2018-04-12 06:00:00,24,19,43
"2433",10102,"St Johns","NL",47.56038,-52.71147,2018-04-12 07:00:00,16,26,42
"2434",10102,"St Johns","NL",47.56038,-52.71147,2018-04-12 08:00:00,17,27,44
"2435",10102,"St Johns","NL",47.56038,-52.71147,2018-04-12 09:00:00,22,21,43
"2436",10102,"St Johns","NL",47.56038,-52.71147,2018-04-12 10:00:00,23,21,44
"2437",10102,"St Johns","NL",47.56038,-52.71147,2018-04-12 11:00:00,28,17,45
"2438",10102,"St Johns","NL",47.56038,-52.71147,2018-04-12 12:00:00,21,19,40
"2439",10102,"St Johns","NL",47.56038,-52.71147,2018-04-12 13:00:00,22,19,41
"2440",10102,"St Johns","NL",47.56038,-52.71147,2018-04-12 14:00:00,28,11,39
"2441",10102,"St Johns","NL",47.56038,-52.71147,2018-04-12 15:00:00,30,9,39
"2442",10102,"St Johns","NL",47.56038,-52.71147,2018-04-12 16:00:00,24,15,39
"2443",10102,"St Johns","NL",47.56038,-52.71147,2018-04-12 17:00:00,28,9,37
"2444",10102,"St Johns","NL",47.56038,-52.71147,2018-04-12 18:00:00,30,6,36
"2445",10102,"St Johns","NL",47.56038,-52.71147,2018-04-12 19:00:00,30,5,35
"2446",10102,"St Johns","NL",47.56038,-52.71147,2018-04-12 20:00:00,30,5,35
"2447",10102,"St Johns","NL",47.56038,-52.71147,2018-04-12 21:00:00,29,5,34
"2448",10102,"St Johns","NL",47.56038,-52.71147,2018-04-12 22:00:00,27,6,33
"2449",10102,"St Johns","NL",47.56038,-52.71147,2018-04-12 23:00:00,22,10,32
"2450",10102,"St Johns","NL",47.56038,-52.71147,2018-04-13 00:00:00,23,6,29
"2451",10102,"St Johns","NL",47.56038,-52.71147,2018-04-13 01:00:00,20,7,27
"2452",10102,"St Johns","NL",47.56038,-52.71147,2018-04-13 02:00:00,18,8,26
"2453",10102,"St Johns","NL",47.56038,-52.71147,2018-04-13 03:00:00,15,11,26
"2454",10102,"St Johns","NL",47.56038,-52.71147,2018-04-13 04:00:00,13,12,25
"2455",10102,"St Johns","NL",47.56038,-52.71147,2018-04-13 05:00:00,18,9,27
"2456",10102,"St Johns","NL",47.56038,-52.71147,2018-04-13 06:00:00,19,10,29
"2457",10102,"St Johns","NL",47.56038,-52.71147,2018-04-13 07:00:00,17,11,28
"2458",10102,"St Johns","NL",47.56038,-52.71147,2018-04-13 08:00:00,21,13,34
"2459",10102,"St Johns","NL",47.56038,-52.71147,2018-04-13 09:00:00,23,16,39
"2460",10102,"St Johns","NL",47.56038,-52.71147,2018-04-13 10:00:00,23,18,41
"2461",10102,"St Johns","NL",47.56038,-52.71147,2018-04-13 11:00:00,32,11,43
"2462",10102,"St Johns","NL",47.56038,-52.71147,2018-04-13 12:00:00,35,6,41
"2463",10102,"St Johns","NL",47.56038,-52.71147,2018-04-13 13:00:00,34,9,43
"2464",10102,"St Johns","NL",47.56038,-52.71147,2018-04-13 14:00:00,37,4,41
"2465",10102,"St Johns","NL",47.56038,-52.71147,2018-04-13 15:00:00,38,3,41
"2466",10102,"St Johns","NL",47.56038,-52.71147,2018-04-13 16:00:00,37,6,43
"2467",10102,"St Johns","NL",47.56038,-52.71147,2018-04-13 17:00:00,37,5,42
"2468",10102,"St Johns","NL",47.56038,-52.71147,2018-04-13 18:00:00,37,3,40
"2469",10102,"St Johns","NL",47.56038,-52.71147,2018-04-13 19:00:00,37,2,39
"2470",10102,"St Johns","NL",47.56038,-52.71147,2018-04-13 20:00:00,36,1,37
"2471",10102,"St Johns","NL",47.56038,-52.71147,2018-04-13 21:00:00,37,1,38
"2472",10102,"St Johns","NL",47.56038,-52.71147,2018-04-13 22:00:00,38,1,39
"2473",10102,"St Johns","NL",47.56038,-52.71147,2018-04-13 23:00:00,38,0,38
"2474",10102,"St Johns","NL",47.56038,-52.71147,2018-04-14 00:00:00,38,0,38
"2475",10102,"St Johns","NL",47.56038,-52.71147,2018-04-14 01:00:00,38,0,38
"2476",10102,"St Johns","NL",47.56038,-52.71147,2018-04-14 02:00:00,39,0,39
"2477",10102,"St Johns","NL",47.56038,-52.71147,2018-04-14 03:00:00,38,0,38
"2478",10102,"St Johns","NL",47.56038,-52.71147,2018-04-14 04:00:00,36,1,37
"2479",10102,"St Johns","NL",47.56038,-52.71147,2018-04-14 05:00:00,38,0,38
"2480",10102,"St Johns","NL",47.56038,-52.71147,2018-04-14 06:00:00,41,0,41
"2481",10102,"St Johns","NL",47.56038,-52.71147,2018-04-14 07:00:00,40,0,40
"2482",10102,"St Johns","NL",47.56038,-52.71147,2018-04-14 08:00:00,39,1,40
"2483",10102,"St Johns","NL",47.56038,-52.71147,2018-04-14 09:00:00,40,1,41
"2484",10102,"St Johns","NL",47.56038,-52.71147,2018-04-14 10:00:00,43,1,44
"2485",10102,"St Johns","NL",47.56038,-52.71147,2018-04-14 11:00:00,44,0,44
"2486",10102,"St Johns","NL",47.56038,-52.71147,2018-04-14 12:00:00,42,1,43
"2487",10102,"St Johns","NL",47.56038,-52.71147,2018-04-14 13:00:00,42,3,45
"2488",10102,"St Johns","NL",47.56038,-52.71147,2018-04-14 14:00:00,43,2,45
"2489",10102,"St Johns","NL",47.56038,-52.71147,2018-04-14 15:00:00,44,1,45
"2490",10102,"St Johns","NL",47.56038,-52.71147,2018-04-14 16:00:00,44,1,45
"2491",10102,"St Johns","NL",47.56038,-52.71147,2018-04-14 17:00:00,44,1,45
"2492",10102,"St Johns","NL",47.56038,-52.71147,2018-04-14 18:00:00,42,1,43
"2493",10102,"St Johns","NL",47.56038,-52.71147,2018-04-14 19:00:00,40,1,41
"2494",10102,"St Johns","NL",47.56038,-52.71147,2018-04-14 20:00:00,45,0,45
"2495",10102,"St Johns","NL",47.56038,-52.71147,2018-04-14 21:00:00,42,1,43
"2496",10102,"St Johns","NL",47.56038,-52.71147,2018-04-14 22:00:00,39,0,39
"2497",10102,"St Johns","NL",47.56038,-52.71147,2018-04-14 23:00:00,36,0,36
"2498",10102,"St Johns","NL",47.56038,-52.71147,2018-04-15 00:00:00,35,1,36
"2499",10102,"St Johns","NL",47.56038,-52.71147,2018-04-15 01:00:00,35,0,35
"2500",10102,"St Johns","NL",47.56038,-52.71147,2018-04-15 02:00:00,35,1,36
"2501",10102,"St Johns","NL",47.56038,-52.71147,2018-04-15 03:00:00,36,0,36
"2502",10102,"St Johns","NL",47.56038,-52.71147,2018-04-15 04:00:00,37,0,37
"2503",10102,"St Johns","NL",47.56038,-52.71147,2018-04-15 05:00:00,37,1,38
"2504",10102,"St Johns","NL",47.56038,-52.71147,2018-04-15 06:00:00,37,1,38
"2505",10102,"St Johns","NL",47.56038,-52.71147,2018-04-15 07:00:00,36,1,37
"2506",10102,"St Johns","NL",47.56038,-52.71147,2018-04-15 08:00:00,36,1,37
"2507",10102,"St Johns","NL",47.56038,-52.71147,2018-04-15 09:00:00,36,1,37
"2508",10102,"St Johns","NL",47.56038,-52.71147,2018-04-15 10:00:00,35,1,36
"2509",10102,"St Johns","NL",47.56038,-52.71147,2018-04-15 11:00:00,36,1,37
"2510",10102,"St Johns","NL",47.56038,-52.71147,2018-04-15 12:00:00,37,0,37
"2511",10102,"St Johns","NL",47.56038,-52.71147,2018-04-15 13:00:00,36,1,37
"2512",10102,"St Johns","NL",47.56038,-52.71147,2018-04-15 14:00:00,35,1,36
"2513",10102,"St Johns","NL",47.56038,-52.71147,2018-04-15 15:00:00,35,2,37
"2514",10102,"St Johns","NL",47.56038,-52.71147,2018-04-15 16:00:00,37,1,38
"2515",10102,"St Johns","NL",47.56038,-52.71147,2018-04-15 17:00:00,38,1,39
"2516",10102,"St Johns","NL",47.56038,-52.71147,2018-04-15 18:00:00,38,1,39
"2517",10102,"St Johns","NL",47.56038,-52.71147,2018-04-15 19:00:00,39,1,40
"2518",10102,"St Johns","NL",47.56038,-52.71147,2018-04-15 20:00:00,40,1,41
"2519",10102,"St Johns","NL",47.56038,-52.71147,2018-04-15 21:00:00,41,1,42
"2520",10102,"St Johns","NL",47.56038,-52.71147,2018-04-15 22:00:00,41,0,41
"2521",10102,"St Johns","NL",47.56038,-52.71147,2018-04-15 23:00:00,41,1,42
"2522",10102,"St Johns","NL",47.56038,-52.71147,2018-04-16 00:00:00,41,1,42
"2523",10102,"St Johns","NL",47.56038,-52.71147,2018-04-16 01:00:00,41,0,41
"2524",10102,"St Johns","NL",47.56038,-52.71147,2018-04-16 02:00:00,40,1,41
"2525",10102,"St Johns","NL",47.56038,-52.71147,2018-04-16 03:00:00,38,0,38
"2526",10102,"St Johns","NL",47.56038,-52.71147,2018-04-16 04:00:00,38,0,38
"2527",10102,"St Johns","NL",47.56038,-52.71147,2018-04-16 05:00:00,36,1,37
"2528",10102,"St Johns","NL",47.56038,-52.71147,2018-04-16 06:00:00,34,1,35
"2529",10102,"St Johns","NL",47.56038,-52.71147,2018-04-16 07:00:00,30,8,38
"2530",10102,"St Johns","NL",47.56038,-52.71147,2018-04-16 08:00:00,28,11,39
"2531",10102,"St Johns","NL",47.56038,-52.71147,2018-04-16 09:00:00,32,2,34
"2532",10102,"St Johns","NL",47.56038,-52.71147,2018-04-16 10:00:00,32,1,33
"2533",10102,"St Johns","NL",47.56038,-52.71147,2018-04-16 11:00:00,33,0,33
"2534",10102,"St Johns","NL",47.56038,-52.71147,2018-04-16 12:00:00,38,3,41
"2535",10102,"St Johns","NL",47.56038,-52.71147,2018-04-16 13:00:00,42,3,45
"2536",10102,"St Johns","NL",47.56038,-52.71147,2018-04-16 14:00:00,43,3,46
"2537",10102,"St Johns","NL",47.56038,-52.71147,2018-04-16 15:00:00,41,5,46
"2538",10102,"St Johns","NL",47.56038,-52.71147,2018-04-16 16:00:00,40,5,45
"2539",10102,"St Johns","NL",47.56038,-52.71147,2018-04-16 17:00:00,41,4,45
"2540",10102,"St Johns","NL",47.56038,-52.71147,2018-04-16 18:00:00,40,4,44
"2541",10102,"St Johns","NL",47.56038,-52.71147,2018-04-16 19:00:00,27,15,42
"2542",10102,"St Johns","NL",47.56038,-52.71147,2018-04-16 20:00:00,25,18,43
"2543",10102,"St Johns","NL",47.56038,-52.71147,2018-04-16 21:00:00,34,6,40
"2544",10102,"St Johns","NL",47.56038,-52.71147,2018-04-16 22:00:00,27,12,39
"2545",10102,"St Johns","NL",47.56038,-52.71147,2018-04-16 23:00:00,22,13,35
"2546",10102,"St Johns","NL",47.56038,-52.71147,2018-04-17 00:00:00,21,13,34
"2547",10102,"St Johns","NL",47.56038,-52.71147,2018-04-17 01:00:00,22,12,34
"2548",10102,"St Johns","NL",47.56038,-52.71147,2018-04-17 02:00:00,25,10,35
"2549",10102,"St Johns","NL",47.56038,-52.71147,2018-04-17 03:00:00,27,7,34
"2550",10102,"St Johns","NL",47.56038,-52.71147,2018-04-17 04:00:00,28,7,35
"2551",10102,"St Johns","NL",47.56038,-52.71147,2018-04-17 05:00:00,30,6,36
"2552",10102,"St Johns","NL",47.56038,-52.71147,2018-04-17 06:00:00,29,9,38
"2553",10102,"St Johns","NL",47.56038,-52.71147,2018-04-17 07:00:00,30,8,38
"2554",10102,"St Johns","NL",47.56038,-52.71147,2018-04-17 08:00:00,36,5,41
"2555",10102,"St Johns","NL",47.56038,-52.71147,2018-04-17 09:00:00,38,4,42
"2556",10102,"St Johns","NL",47.56038,-52.71147,2018-04-17 10:00:00,39,4,43
"2557",10102,"St Johns","NL",47.56038,-52.71147,2018-04-17 11:00:00,40,3,43
"2558",10102,"St Johns","NL",47.56038,-52.71147,2018-04-17 12:00:00,38,4,42
"2559",10102,"St Johns","NL",47.56038,-52.71147,2018-04-17 13:00:00,31,12,43
"2560",10102,"St Johns","NL",47.56038,-52.71147,2018-04-17 14:00:00,33,9,42
"2561",10102,"St Johns","NL",47.56038,-52.71147,2018-04-17 15:00:00,31,13,44
"2562",10102,"St Johns","NL",47.56038,-52.71147,2018-04-17 16:00:00,31,12,43
"2563",10102,"St Johns","NL",47.56038,-52.71147,2018-04-17 17:00:00,31,14,45
"2564",10102,"St Johns","NL",47.56038,-52.71147,2018-04-17 18:00:00,31,12,43
"2565",10102,"St Johns","NL",47.56038,-52.71147,2018-04-17 19:00:00,31,12,43
"2566",10102,"St Johns","NL",47.56038,-52.71147,2018-04-17 20:00:00,22,24,46
"2567",10102,"St Johns","NL",47.56038,-52.71147,2018-04-17 21:00:00,30,12,42
"2568",10102,"St Johns","NL",47.56038,-52.71147,2018-04-17 22:00:00,35,8,43
"2569",10102,"St Johns","NL",47.56038,-52.71147,2018-04-17 23:00:00,39,3,42
"2570",10102,"St Johns","NL",47.56038,-52.71147,2018-04-18 00:00:00,38,4,42
"2571",10102,"St Johns","NL",47.56038,-52.71147,2018-04-18 01:00:00,37,5,42
"2572",10102,"St Johns","NL",47.56038,-52.71147,2018-04-18 02:00:00,37,6,43
"2573",10102,"St Johns","NL",47.56038,-52.71147,2018-04-18 03:00:00,38,4,42
"2574",10102,"St Johns","NL",47.56038,-52.71147,2018-04-18 04:00:00,37,6,43
"2575",10102,"St Johns","NL",47.56038,-52.71147,2018-04-18 05:00:00,34,8,42
"2576",10102,"St Johns","NL",47.56038,-52.71147,2018-04-18 06:00:00,36,8,44
"2577",10102,"St Johns","NL",47.56038,-52.71147,2018-04-18 07:00:00,32,15,47
"2578",10102,"St Johns","NL",47.56038,-52.71147,2018-04-18 08:00:00,32,16,48
"2579",10102,"St Johns","NL",47.56038,-52.71147,2018-04-18 09:00:00,34,14,48
"2580",10102,"St Johns","NL",47.56038,-52.71147,2018-04-18 10:00:00,34,14,48
"2581",10102,"St Johns","NL",47.56038,-52.71147,2018-04-18 11:00:00,34,14,48
"2582",10102,"St Johns","NL",47.56038,-52.71147,2018-04-18 12:00:00,37,11,48
"2583",10102,"St Johns","NL",47.56038,-52.71147,2018-04-18 13:00:00,34,12,46
"2584",10102,"St Johns","NL",47.56038,-52.71147,2018-04-18 14:00:00,32,11,43
"2585",10102,"St Johns","NL",47.56038,-52.71147,2018-04-18 15:00:00,31,12,43
"2586",10102,"St Johns","NL",47.56038,-52.71147,2018-04-18 16:00:00,25,21,46
"2587",10102,"St Johns","NL",47.56038,-52.71147,2018-04-18 17:00:00,14,30,44
"2588",10102,"St Johns","NL",47.56038,-52.71147,2018-04-18 18:00:00,11,39,50
"2589",10102,"St Johns","NL",47.56038,-52.71147,2018-04-18 19:00:00,4,43,47
"2590",10102,"St Johns","NL",47.56038,-52.71147,2018-04-18 20:00:00,29,6,35
"2591",10102,"St Johns","NL",47.56038,-52.71147,2018-04-18 21:00:00,35,2,37
"2592",10102,"St Johns","NL",47.56038,-52.71147,2018-04-18 22:00:00,35,2,37
"2593",10102,"St Johns","NL",47.56038,-52.71147,2018-04-18 23:00:00,39,2,41
"2594",10102,"St Johns","NL",47.56038,-52.71147,2018-04-19 00:00:00,39,1,40
"2595",10102,"St Johns","NL",47.56038,-52.71147,2018-04-19 01:00:00,38,1,39
"2596",10102,"St Johns","NL",47.56038,-52.71147,2018-04-19 02:00:00,36,1,37
"2597",10102,"St Johns","NL",47.56038,-52.71147,2018-04-19 03:00:00,37,1,38
"2598",10102,"St Johns","NL",47.56038,-52.71147,2018-04-19 04:00:00,36,1,37
"2599",10102,"St Johns","NL",47.56038,-52.71147,2018-04-19 05:00:00,35,1,36
"2600",10102,"St Johns","NL",47.56038,-52.71147,2018-04-19 06:00:00,35,2,37
"2601",10102,"St Johns","NL",47.56038,-52.71147,2018-04-19 07:00:00,34,3,37
"2602",10102,"St Johns","NL",47.56038,-52.71147,2018-04-19 08:00:00,32,5,37
"2603",10102,"St Johns","NL",47.56038,-52.71147,2018-04-19 09:00:00,34,3,37
"2604",10102,"St Johns","NL",47.56038,-52.71147,2018-04-19 10:00:00,34,2,36
"2605",10102,"St Johns","NL",47.56038,-52.71147,2018-04-19 11:00:00,34,2,36
"2606",10102,"St Johns","NL",47.56038,-52.71147,2018-04-19 12:00:00,31,2,33
"2607",10102,"St Johns","NL",47.56038,-52.71147,2018-04-19 13:00:00,31,3,34
"2608",10102,"St Johns","NL",47.56038,-52.71147,2018-04-19 14:00:00,32,2,34
"2609",10102,"St Johns","NL",47.56038,-52.71147,2018-04-19 15:00:00,31,2,33
"2610",10102,"St Johns","NL",47.56038,-52.71147,2018-04-19 16:00:00,30,2,32
"2611",10102,"St Johns","NL",47.56038,-52.71147,2018-04-19 17:00:00,29,3,32
"2612",10102,"St Johns","NL",47.56038,-52.71147,2018-04-19 18:00:00,29,4,33
"2613",10102,"St Johns","NL",47.56038,-52.71147,2018-04-19 19:00:00,30,3,33
"2614",10102,"St Johns","NL",47.56038,-52.71147,2018-04-19 20:00:00,31,1,32
"2615",10102,"St Johns","NL",47.56038,-52.71147,2018-04-19 21:00:00,32,1,33
"2616",10102,"St Johns","NL",47.56038,-52.71147,2018-04-19 22:00:00,31,1,32
"2617",10102,"St Johns","NL",47.56038,-52.71147,2018-04-19 23:00:00,28,3,31
"2618",10102,"St Johns","NL",47.56038,-52.71147,2018-04-20 00:00:00,27,4,31
"2619",10102,"St Johns","NL",47.56038,-52.71147,2018-04-20 01:00:00,24,4,28
"2620",10102,"St Johns","NL",47.56038,-52.71147,2018-04-20 02:00:00,24,3,27
"2621",10102,"St Johns","NL",47.56038,-52.71147,2018-04-20 03:00:00,23,2,25
"2622",10102,"St Johns","NL",47.56038,-52.71147,2018-04-20 04:00:00,22,2,24
"2623",10102,"St Johns","NL",47.56038,-52.71147,2018-04-20 05:00:00,17,6,23
"2624",10102,"St Johns","NL",47.56038,-52.71147,2018-04-20 06:00:00,2,23,25
"2625",10102,"St Johns","NL",47.56038,-52.71147,2018-04-20 07:00:00,5,24,29
"2626",10102,"St Johns","NL",47.56038,-52.71147,2018-04-20 08:00:00,10,20,30
"2627",10102,"St Johns","NL",47.56038,-52.71147,2018-04-20 09:00:00,12,22,34
"2628",10102,"St Johns","NL",47.56038,-52.71147,2018-04-20 10:00:00,15,22,37
"2629",10102,"St Johns","NL",47.56038,-52.71147,2018-04-20 11:00:00,21,19,40
"2630",10102,"St Johns","NL",47.56038,-52.71147,2018-04-20 12:00:00,11,33,44
"2631",10102,"St Johns","NL",47.56038,-52.71147,2018-04-20 13:00:00,16,27,43
"2632",10102,"St Johns","NL",47.56038,-52.71147,2018-04-20 14:00:00,18,19,37
"2633",10102,"St Johns","NL",47.56038,-52.71147,2018-04-20 15:00:00,20,17,37
"2634",10102,"St Johns","NL",47.56038,-52.71147,2018-04-20 16:00:00,12,28,40
"2635",10102,"St Johns","NL",47.56038,-52.71147,2018-04-20 17:00:00,14,24,38
"2636",10102,"St Johns","NL",47.56038,-52.71147,2018-04-20 18:00:00,17,23,40
"2637",10102,"St Johns","NL",47.56038,-52.71147,2018-04-20 19:00:00,36,2,38
"2638",10102,"St Johns","NL",47.56038,-52.71147,2018-04-20 20:00:00,35,2,37
"2639",10102,"St Johns","NL",47.56038,-52.71147,2018-04-20 21:00:00,34,2,36
"2640",10102,"St Johns","NL",47.56038,-52.71147,2018-04-20 22:00:00,34,1,35
"2641",10102,"St Johns","NL",47.56038,-52.71147,2018-04-20 23:00:00,33,1,34
"2642",10102,"St Johns","NL",47.56038,-52.71147,2018-04-21 00:00:00,32,2,34
"2643",10102,"St Johns","NL",47.56038,-52.71147,2018-04-21 01:00:00,32,1,33
"2644",10102,"St Johns","NL",47.56038,-52.71147,2018-04-21 02:00:00,31,1,32
"2645",10102,"St Johns","NL",47.56038,-52.71147,2018-04-21 03:00:00,32,2,34
"2646",10102,"St Johns","NL",47.56038,-52.71147,2018-04-21 04:00:00,31,1,32
"2647",10102,"St Johns","NL",47.56038,-52.71147,2018-04-21 05:00:00,30,1,31
"2648",10102,"St Johns","NL",47.56038,-52.71147,2018-04-21 06:00:00,30,1,31
"2649",10102,"St Johns","NL",47.56038,-52.71147,2018-04-21 07:00:00,30,2,32
"2650",10102,"St Johns","NL",47.56038,-52.71147,2018-04-21 08:00:00,30,2,32
"2651",10102,"St Johns","NL",47.56038,-52.71147,2018-04-21 09:00:00,31,2,33
"2652",10102,"St Johns","NL",47.56038,-52.71147,2018-04-21 10:00:00,30,3,33
"2653",10102,"St Johns","NL",47.56038,-52.71147,2018-04-21 11:00:00,31,3,34
"2654",10102,"St Johns","NL",47.56038,-52.71147,2018-04-21 12:00:00,32,1,33
"2655",10102,"St Johns","NL",47.56038,-52.71147,2018-04-21 13:00:00,33,2,35
"2656",10102,"St Johns","NL",47.56038,-52.71147,2018-04-21 14:00:00,34,2,36
"2657",10102,"St Johns","NL",47.56038,-52.71147,2018-04-21 15:00:00,35,2,37
"2658",10102,"St Johns","NL",47.56038,-52.71147,2018-04-21 16:00:00,35,1,36
"2659",10102,"St Johns","NL",47.56038,-52.71147,2018-04-21 17:00:00,35,2,37
"2660",10102,"St Johns","NL",47.56038,-52.71147,2018-04-21 18:00:00,35,2,37
"2661",10102,"St Johns","NL",47.56038,-52.71147,2018-04-21 19:00:00,36,2,38
"2662",10102,"St Johns","NL",47.56038,-52.71147,2018-04-21 20:00:00,35,3,38
"2663",10102,"St Johns","NL",47.56038,-52.71147,2018-04-21 21:00:00,34,3,37
"2664",10102,"St Johns","NL",47.56038,-52.71147,2018-04-21 22:00:00,34,3,37
"2665",10102,"St Johns","NL",47.56038,-52.71147,2018-04-21 23:00:00,33,4,37
"2666",10102,"St Johns","NL",47.56038,-52.71147,2018-04-22 00:00:00,33,3,36
"2667",10102,"St Johns","NL",47.56038,-52.71147,2018-04-22 01:00:00,33,2,35
"2668",10102,"St Johns","NL",47.56038,-52.71147,2018-04-22 02:00:00,33,1,34
"2669",10102,"St Johns","NL",47.56038,-52.71147,2018-04-22 03:00:00,32,2,34
"2670",10102,"St Johns","NL",47.56038,-52.71147,2018-04-22 04:00:00,32,2,34
"2671",10102,"St Johns","NL",47.56038,-52.71147,2018-04-22 05:00:00,33,1,34
"2672",10102,"St Johns","NL",47.56038,-52.71147,2018-04-22 06:00:00,33,2,35
"2673",10102,"St Johns","NL",47.56038,-52.71147,2018-04-22 07:00:00,33,2,35
"2674",10102,"St Johns","NL",47.56038,-52.71147,2018-04-22 08:00:00,36,1,37
"2675",10102,"St Johns","NL",47.56038,-52.71147,2018-04-22 09:00:00,37,0,37
"2676",10102,"St Johns","NL",47.56038,-52.71147,2018-04-22 10:00:00,36,1,37
"2677",10102,"St Johns","NL",47.56038,-52.71147,2018-04-22 11:00:00,36,2,38
"2678",10102,"St Johns","NL",47.56038,-52.71147,2018-04-22 12:00:00,36,0,36
"2679",10102,"St Johns","NL",47.56038,-52.71147,2018-04-22 13:00:00,37,0,37
"2680",10102,"St Johns","NL",47.56038,-52.71147,2018-04-22 14:00:00,38,0,38
"2681",10102,"St Johns","NL",47.56038,-52.71147,2018-04-22 15:00:00,38,0,38
"2682",10102,"St Johns","NL",47.56038,-52.71147,2018-04-22 16:00:00,38,0,38
"2683",10102,"St Johns","NL",47.56038,-52.71147,2018-04-22 17:00:00,38,1,39
"2684",10102,"St Johns","NL",47.56038,-52.71147,2018-04-22 18:00:00,35,3,38
"2685",10102,"St Johns","NL",47.56038,-52.71147,2018-04-22 19:00:00,8,36,44
"2686",10102,"St Johns","NL",47.56038,-52.71147,2018-04-22 20:00:00,16,24,40
"2687",10102,"St Johns","NL",47.56038,-52.71147,2018-04-22 21:00:00,25,10,35
"2688",10102,"St Johns","NL",47.56038,-52.71147,2018-04-22 22:00:00,33,3,36
"2689",10102,"St Johns","NL",47.56038,-52.71147,2018-04-22 23:00:00,38,1,39
"2690",10102,"St Johns","NL",47.56038,-52.71147,2018-04-23 00:00:00,40,1,41
"2691",10102,"St Johns","NL",47.56038,-52.71147,2018-04-23 01:00:00,41,1,42
"2692",10102,"St Johns","NL",47.56038,-52.71147,2018-04-23 02:00:00,40,2,42
"2693",10102,"St Johns","NL",47.56038,-52.71147,2018-04-23 03:00:00,40,2,42
"2694",10102,"St Johns","NL",47.56038,-52.71147,2018-04-23 04:00:00,41,1,42
"2695",10102,"St Johns","NL",47.56038,-52.71147,2018-04-23 05:00:00,40,1,41
"2696",10102,"St Johns","NL",47.56038,-52.71147,2018-04-23 06:00:00,35,5,40
"2697",10102,"St Johns","NL",47.56038,-52.71147,2018-04-23 07:00:00,38,2,40
"2698",10102,"St Johns","NL",47.56038,-52.71147,2018-04-23 08:00:00,40,1,41
"2699",10102,"St Johns","NL",47.56038,-52.71147,2018-04-23 09:00:00,40,1,41
"2700",10102,"St Johns","NL",47.56038,-52.71147,2018-04-23 10:00:00,41,1,42
"2701",10102,"St Johns","NL",47.56038,-52.71147,2018-04-23 11:00:00,41,0,41
"2702",10102,"St Johns","NL",47.56038,-52.71147,2018-04-23 12:00:00,42,2,44
"2703",10102,"St Johns","NL",47.56038,-52.71147,2018-04-23 13:00:00,42,2,44
"2704",10102,"St Johns","NL",47.56038,-52.71147,2018-04-23 14:00:00,41,2,43
"2705",10102,"St Johns","NL",47.56038,-52.71147,2018-04-23 15:00:00,42,2,44
"2706",10102,"St Johns","NL",47.56038,-52.71147,2018-04-23 16:00:00,39,4,43
"2707",10102,"St Johns","NL",47.56038,-52.71147,2018-04-23 17:00:00,43,3,46
"2708",10102,"St Johns","NL",47.56038,-52.71147,2018-04-23 18:00:00,42,3,45
"2709",10102,"St Johns","NL",47.56038,-52.71147,2018-04-23 19:00:00,42,3,45
"2710",10102,"St Johns","NL",47.56038,-52.71147,2018-04-23 20:00:00,40,4,44
"2711",10102,"St Johns","NL",47.56038,-52.71147,2018-04-23 21:00:00,37,6,43
"2712",10102,"St Johns","NL",47.56038,-52.71147,2018-04-23 22:00:00,39,3,42
"2713",10102,"St Johns","NL",47.56038,-52.71147,2018-04-23 23:00:00,37,3,40
"2714",10102,"St Johns","NL",47.56038,-52.71147,2018-04-24 00:00:00,35,5,40
"2715",10102,"St Johns","NL",47.56038,-52.71147,2018-04-24 01:00:00,35,5,40
"2716",10102,"St Johns","NL",47.56038,-52.71147,2018-04-24 02:00:00,34,5,39
"2717",10102,"St Johns","NL",47.56038,-52.71147,2018-04-24 03:00:00,33,5,38
"2718",10102,"St Johns","NL",47.56038,-52.71147,2018-04-24 04:00:00,36,5,41
"2719",10102,"St Johns","NL",47.56038,-52.71147,2018-04-24 05:00:00,35,5,40
"2720",10102,"St Johns","NL",47.56038,-52.71147,2018-04-24 06:00:00,32,7,39
"2721",10102,"St Johns","NL",47.56038,-52.71147,2018-04-24 07:00:00,31,13,44
"2722",10102,"St Johns","NL",47.56038,-52.71147,2018-04-24 08:00:00,40,4,44
"2723",10102,"St Johns","NL",47.56038,-52.71147,2018-04-24 09:00:00,42,3,45
"2724",10102,"St Johns","NL",47.56038,-52.71147,2018-04-24 10:00:00,43,3,46
"2725",10102,"St Johns","NL",47.56038,-52.71147,2018-04-24 11:00:00,43,3,46
"2726",10102,"St Johns","NL",47.56038,-52.71147,2018-04-24 12:00:00,45,3,48
"2727",10102,"St Johns","NL",47.56038,-52.71147,2018-04-24 13:00:00,45,3,48
"2728",10102,"St Johns","NL",47.56038,-52.71147,2018-04-24 14:00:00,45,3,48
"2729",10102,"St Johns","NL",47.56038,-52.71147,2018-04-24 15:00:00,46,2,48
"2730",10102,"St Johns","NL",47.56038,-52.71147,2018-04-24 16:00:00,46,4,50
"2731",10102,"St Johns","NL",47.56038,-52.71147,2018-04-24 17:00:00,45,4,49
"2732",10102,"St Johns","NL",47.56038,-52.71147,2018-04-24 18:00:00,46,4,50
"2733",10102,"St Johns","NL",47.56038,-52.71147,2018-04-24 19:00:00,46,3,49
"2734",10102,"St Johns","NL",47.56038,-52.71147,2018-04-24 20:00:00,42,4,46
"2735",10102,"St Johns","NL",47.56038,-52.71147,2018-04-24 21:00:00,40,6,46
"2736",10102,"St Johns","NL",47.56038,-52.71147,2018-04-24 22:00:00,40,4,44
"2737",10102,"St Johns","NL",47.56038,-52.71147,2018-04-24 23:00:00,40,4,44
"2738",10102,"St Johns","NL",47.56038,-52.71147,2018-04-25 00:00:00,42,3,45
"2739",10102,"St Johns","NL",47.56038,-52.71147,2018-04-25 01:00:00,42,3,45
"2740",10102,"St Johns","NL",47.56038,-52.71147,2018-04-25 02:00:00,42,2,44
"2741",10102,"St Johns","NL",47.56038,-52.71147,2018-04-25 03:00:00,42,2,44
"2742",10102,"St Johns","NL",47.56038,-52.71147,2018-04-25 04:00:00,41,2,43
"2743",10102,"St Johns","NL",47.56038,-52.71147,2018-04-25 05:00:00,43,3,46
"2744",10102,"St Johns","NL",47.56038,-52.71147,2018-04-25 06:00:00,42,5,47
"2745",10102,"St Johns","NL",47.56038,-52.71147,2018-04-25 07:00:00,40,7,47
"2746",10102,"St Johns","NL",47.56038,-52.71147,2018-04-25 08:00:00,38,11,49
"2747",10102,"St Johns","NL",47.56038,-52.71147,2018-04-25 09:00:00,45,6,51
"2748",10102,"St Johns","NL",47.56038,-52.71147,2018-04-25 10:00:00,48,5,53
"2749",10102,"St Johns","NL",47.56038,-52.71147,2018-04-25 11:00:00,48,6,54
"2750",10102,"St Johns","NL",47.56038,-52.71147,2018-04-25 12:00:00,47,5,52
"2751",10102,"St Johns","NL",47.56038,-52.71147,2018-04-25 13:00:00,49,3,52
"2752",10102,"St Johns","NL",47.56038,-52.71147,2018-04-25 14:00:00,50,4,54
"2753",10102,"St Johns","NL",47.56038,-52.71147,2018-04-25 15:00:00,50,4,54
"2754",10102,"St Johns","NL",47.56038,-52.71147,2018-04-25 16:00:00,50,4,54
"2755",10102,"St Johns","NL",47.56038,-52.71147,2018-04-25 17:00:00,51,4,55
"2756",10102,"St Johns","NL",47.56038,-52.71147,2018-04-25 18:00:00,51,4,55
"2757",10102,"St Johns","NL",47.56038,-52.71147,2018-04-25 19:00:00,50,4,54
"2758",10102,"St Johns","NL",47.56038,-52.71147,2018-04-25 20:00:00,49,3,52
"2759",10102,"St Johns","NL",47.56038,-52.71147,2018-04-25 21:00:00,49,3,52
"2760",10102,"St Johns","NL",47.56038,-52.71147,2018-04-25 22:00:00,51,2,53
"2761",10102,"St Johns","NL",47.56038,-52.71147,2018-04-25 23:00:00,51,2,53
"2762",10102,"St Johns","NL",47.56038,-52.71147,2018-04-26 00:00:00,51,2,53
"2763",10102,"St Johns","NL",47.56038,-52.71147,2018-04-26 01:00:00,49,2,51
"2764",10102,"St Johns","NL",47.56038,-52.71147,2018-04-26 02:00:00,46,1,47
"2765",10102,"St Johns","NL",47.56038,-52.71147,2018-04-26 03:00:00,45,2,47
"2766",10102,"St Johns","NL",47.56038,-52.71147,2018-04-26 04:00:00,44,2,46
"2767",10102,"St Johns","NL",47.56038,-52.71147,2018-04-26 05:00:00,40,3,43
"2768",10102,"St Johns","NL",47.56038,-52.71147,2018-04-26 06:00:00,38,3,41
"2769",10102,"St Johns","NL",47.56038,-52.71147,2018-04-26 07:00:00,31,9,40
"2770",10102,"St Johns","NL",47.56038,-52.71147,2018-04-26 08:00:00,39,4,43
"2771",10102,"St Johns","NL",47.56038,-52.71147,2018-04-26 09:00:00,41,4,45
"2772",10102,"St Johns","NL",47.56038,-52.71147,2018-04-26 10:00:00,42,3,45
"2773",10102,"St Johns","NL",47.56038,-52.71147,2018-04-26 11:00:00,41,3,44
"2774",10102,"St Johns","NL",47.56038,-52.71147,2018-04-26 12:00:00,41,4,45
"2775",10102,"St Johns","NL",47.56038,-52.71147,2018-04-26 13:00:00,41,4,45
"2776",10102,"St Johns","NL",47.56038,-52.71147,2018-04-26 14:00:00,42,3,45
"2777",10102,"St Johns","NL",47.56038,-52.71147,2018-04-26 15:00:00,43,5,48
"2778",10102,"St Johns","NL",47.56038,-52.71147,2018-04-26 16:00:00,44,5,49
"2779",10102,"St Johns","NL",47.56038,-52.71147,2018-04-26 17:00:00,44,4,48
"2780",10102,"St Johns","NL",47.56038,-52.71147,2018-04-26 18:00:00,42,3,45
"2781",10102,"St Johns","NL",47.56038,-52.71147,2018-04-26 19:00:00,40,3,43
"2782",10102,"St Johns","NL",47.56038,-52.71147,2018-04-26 20:00:00,40,2,42
"2783",10102,"St Johns","NL",47.56038,-52.71147,2018-04-26 21:00:00,39,3,42
"2784",10102,"St Johns","NL",47.56038,-52.71147,2018-04-26 22:00:00,40,2,42
"2785",10102,"St Johns","NL",47.56038,-52.71147,2018-04-26 23:00:00,37,5,42
"2786",10102,"St Johns","NL",47.56038,-52.71147,2018-04-27 00:00:00,40,0,40
"2787",10102,"St Johns","NL",47.56038,-52.71147,2018-04-27 01:00:00,41,1,42
"2788",10102,"St Johns","NL",47.56038,-52.71147,2018-04-27 02:00:00,42,1,43
"2789",10102,"St Johns","NL",47.56038,-52.71147,2018-04-27 03:00:00,42,1,43
"2790",10102,"St Johns","NL",47.56038,-52.71147,2018-04-27 04:00:00,41,1,42
"2791",10102,"St Johns","NL",47.56038,-52.71147,2018-04-27 05:00:00,41,1,42
"2792",10102,"St Johns","NL",47.56038,-52.71147,2018-04-27 06:00:00,41,2,43
"2793",10102,"St Johns","NL",47.56038,-52.71147,2018-04-27 07:00:00,41,2,43
"2794",10102,"St Johns","NL",47.56038,-52.71147,2018-04-27 08:00:00,38,5,43
"2795",10102,"St Johns","NL",47.56038,-52.71147,2018-04-27 09:00:00,36,5,41
"2796",10102,"St Johns","NL",47.56038,-52.71147,2018-04-27 10:00:00,37,6,43
"2797",10102,"St Johns","NL",47.56038,-52.71147,2018-04-27 11:00:00,38,5,43
"2798",10102,"St Johns","NL",47.56038,-52.71147,2018-04-27 12:00:00,40,1,41
"2799",10102,"St Johns","NL",47.56038,-52.71147,2018-04-27 13:00:00,39,2,41
"2800",10102,"St Johns","NL",47.56038,-52.71147,2018-04-27 14:00:00,40,1,41
"2801",10102,"St Johns","NL",47.56038,-52.71147,2018-04-27 15:00:00,40,1,41
"2802",10102,"St Johns","NL",47.56038,-52.71147,2018-04-27 16:00:00,45,2,47
"2803",10102,"St Johns","NL",47.56038,-52.71147,2018-04-27 17:00:00,44,2,46
"2804",10102,"St Johns","NL",47.56038,-52.71147,2018-04-27 18:00:00,42,1,43
"2805",10102,"St Johns","NL",47.56038,-52.71147,2018-04-27 19:00:00,38,1,39
"2806",10102,"St Johns","NL",47.56038,-52.71147,2018-04-27 20:00:00,35,2,37
"2807",10102,"St Johns","NL",47.56038,-52.71147,2018-04-27 21:00:00,34,2,36
"2808",10102,"St Johns","NL",47.56038,-52.71147,2018-04-27 22:00:00,33,1,34
"2809",10102,"St Johns","NL",47.56038,-52.71147,2018-04-27 23:00:00,33,1,34
"2810",10102,"St Johns","NL",47.56038,-52.71147,2018-04-28 00:00:00,30,3,33
"2811",10102,"St Johns","NL",47.56038,-52.71147,2018-04-28 01:00:00,27,3,30
"2812",10102,"St Johns","NL",47.56038,-52.71147,2018-04-28 02:00:00,24,2,26
"2813",10102,"St Johns","NL",47.56038,-52.71147,2018-04-28 03:00:00,7,23,30
"2814",10102,"St Johns","NL",47.56038,-52.71147,2018-04-28 04:00:00,11,15,26
"2815",10102,"St Johns","NL",47.56038,-52.71147,2018-04-28 05:00:00,17,3,20
"2816",10102,"St Johns","NL",47.56038,-52.71147,2018-04-28 06:00:00,16,3,19
"2817",10102,"St Johns","NL",47.56038,-52.71147,2018-04-28 07:00:00,19,7,26
"2818",10102,"St Johns","NL",47.56038,-52.71147,2018-04-28 08:00:00,8,25,33
"2819",10102,"St Johns","NL",47.56038,-52.71147,2018-04-28 09:00:00,8,38,46
"2820",10102,"St Johns","NL",47.56038,-52.71147,2018-04-28 10:00:00,25,19,44
"2821",10102,"St Johns","NL",47.56038,-52.71147,2018-04-28 11:00:00,30,9,39
"2822",10102,"St Johns","NL",47.56038,-52.71147,2018-04-28 12:00:00,35,1,36
"2823",10102,"St Johns","NL",47.56038,-52.71147,2018-04-28 13:00:00,34,1,35
"2824",10102,"St Johns","NL",47.56038,-52.71147,2018-04-28 14:00:00,31,2,33
"2825",10102,"St Johns","NL",47.56038,-52.71147,2018-04-28 15:00:00,28,1,29
"2826",10102,"St Johns","NL",47.56038,-52.71147,2018-04-28 16:00:00,25,1,26
"2827",10102,"St Johns","NL",47.56038,-52.71147,2018-04-28 17:00:00,26,1,27
"2828",10102,"St Johns","NL",47.56038,-52.71147,2018-04-28 18:00:00,28,1,29
"2829",10102,"St Johns","NL",47.56038,-52.71147,2018-04-28 19:00:00,28,1,29
"2830",10102,"St Johns","NL",47.56038,-52.71147,2018-04-28 20:00:00,29,0,29
"2831",10102,"St Johns","NL",47.56038,-52.71147,2018-04-28 21:00:00,28,0,28
"2832",10102,"St Johns","NL",47.56038,-52.71147,2018-04-28 22:00:00,27,1,28
"2833",10102,"St Johns","NL",47.56038,-52.71147,2018-04-28 23:00:00,26,0,26
"2834",10102,"St Johns","NL",47.56038,-52.71147,2018-04-29 00:00:00,27,0,27
"2835",10102,"St Johns","NL",47.56038,-52.71147,2018-04-29 01:00:00,27,0,27
"2836",10102,"St Johns","NL",47.56038,-52.71147,2018-04-29 02:00:00,27,1,28
"2837",10102,"St Johns","NL",47.56038,-52.71147,2018-04-29 03:00:00,27,1,28
"2838",10102,"St Johns","NL",47.56038,-52.71147,2018-04-29 04:00:00,27,1,28
"2839",10102,"St Johns","NL",47.56038,-52.71147,2018-04-29 05:00:00,27,1,28
"2840",10102,"St Johns","NL",47.56038,-52.71147,2018-04-29 06:00:00,27,1,28
"2841",10102,"St Johns","NL",47.56038,-52.71147,2018-04-29 07:00:00,27,1,28
"2842",10102,"St Johns","NL",47.56038,-52.71147,2018-04-29 08:00:00,26,2,28
"2843",10102,"St Johns","NL",47.56038,-52.71147,2018-04-29 09:00:00,27,1,28
"2844",10102,"St Johns","NL",47.56038,-52.71147,2018-04-29 10:00:00,27,1,28
"2845",10102,"St Johns","NL",47.56038,-52.71147,2018-04-29 11:00:00,27,1,28
"2846",10102,"St Johns","NL",47.56038,-52.71147,2018-04-29 12:00:00,27,0,27
"2847",10102,"St Johns","NL",47.56038,-52.71147,2018-04-29 13:00:00,28,1,29
"2848",10102,"St Johns","NL",47.56038,-52.71147,2018-04-29 14:00:00,25,1,26
"2849",10102,"St Johns","NL",47.56038,-52.71147,2018-04-29 15:00:00,23,1,24
"2850",10102,"St Johns","NL",47.56038,-52.71147,2018-04-29 16:00:00,22,1,23
"2851",10102,"St Johns","NL",47.56038,-52.71147,2018-04-29 17:00:00,23,0,23
"2852",10102,"St Johns","NL",47.56038,-52.71147,2018-04-29 18:00:00,23,0,23
"2853",10102,"St Johns","NL",47.56038,-52.71147,2018-04-29 19:00:00,23,1,24
"2854",10102,"St Johns","NL",47.56038,-52.71147,2018-04-29 20:00:00,23,1,24
"2855",10102,"St Johns","NL",47.56038,-52.71147,2018-04-29 21:00:00,25,1,26
"2856",10102,"St Johns","NL",47.56038,-52.71147,2018-04-29 22:00:00,26,1,27
"2857",10102,"St Johns","NL",47.56038,-52.71147,2018-04-29 23:00:00,27,0,27
"2858",10102,"St Johns","NL",47.56038,-52.71147,2018-04-30 00:00:00,29,0,29
"2859",10102,"St Johns","NL",47.56038,-52.71147,2018-04-30 01:00:00,31,0,31
"2860",10102,"St Johns","NL",47.56038,-52.71147,2018-04-30 02:00:00,31,0,31
"2861",10102,"St Johns","NL",47.56038,-52.71147,2018-04-30 03:00:00,29,1,30
"2862",10102,"St Johns","NL",47.56038,-52.71147,2018-04-30 04:00:00,27,1,28
"2863",10102,"St Johns","NL",47.56038,-52.71147,2018-04-30 05:00:00,27,1,28
"2864",10102,"St Johns","NL",47.56038,-52.71147,2018-04-30 06:00:00,27,1,28
"2865",10102,"St Johns","NL",47.56038,-52.71147,2018-04-30 07:00:00,29,1,30
"2866",10102,"St Johns","NL",47.56038,-52.71147,2018-04-30 08:00:00,28,3,31
"2867",10102,"St Johns","NL",47.56038,-52.71147,2018-04-30 09:00:00,29,3,32
"2868",10102,"St Johns","NL",47.56038,-52.71147,2018-04-30 10:00:00,29,1,30
"2869",10102,"St Johns","NL",47.56038,-52.71147,2018-04-30 11:00:00,29,2,31
"2870",10102,"St Johns","NL",47.56038,-52.71147,2018-04-30 12:00:00,28,3,31
"2871",10102,"St Johns","NL",47.56038,-52.71147,2018-04-30 13:00:00,28,6,34
"2872",10102,"St Johns","NL",47.56038,-52.71147,2018-04-30 14:00:00,25,12,37
"2873",10102,"St Johns","NL",47.56038,-52.71147,2018-04-30 15:00:00,29,7,36
"2874",10102,"St Johns","NL",47.56038,-52.71147,2018-04-30 16:00:00,26,12,38
"2875",10102,"St Johns","NL",47.56038,-52.71147,2018-04-30 17:00:00,16,20,36
"2876",10102,"St Johns","NL",47.56038,-52.71147,2018-04-30 18:00:00,17,21,38
"2877",10102,"St Johns","NL",47.56038,-52.71147,2018-04-30 19:00:00,27,8,35
"2878",10102,"St Johns","NL",47.56038,-52.71147,2018-04-30 20:00:00,24,12,36
"2879",10102,"St Johns","NL",47.56038,-52.71147,2018-04-30 21:00:00,20,16,36
"2880",10102,"St Johns","NL",47.56038,-52.71147,2018-04-30 22:00:00,14,22,36
"2881",10102,"St Johns","NL",47.56038,-52.71147,2018-04-30 23:00:00,20,14,34
"2882",10102,"St Johns","NL",47.56038,-52.71147,2018-05-01 00:00:00,17,19,36
"2883",10102,"St Johns","NL",47.56038,-52.71147,2018-05-01 01:00:00,17,18,35
"2884",10102,"St Johns","NL",47.56038,-52.71147,2018-05-01 02:00:00,14,21,35
"2885",10102,"St Johns","NL",47.56038,-52.71147,2018-05-01 03:00:00,13,22,35
"2886",10102,"St Johns","NL",47.56038,-52.71147,2018-05-01 04:00:00,13,23,36
"2887",10102,"St Johns","NL",47.56038,-52.71147,2018-05-01 05:00:00,15,21,36
"2888",10102,"St Johns","NL",47.56038,-52.71147,2018-05-01 06:00:00,13,21,34
"2889",10102,"St Johns","NL",47.56038,-52.71147,2018-05-01 07:00:00,15,20,35
"2890",10102,"St Johns","NL",47.56038,-52.71147,2018-05-01 08:00:00,11,21,32
"2891",10102,"St Johns","NL",47.56038,-52.71147,2018-05-01 09:00:00,9,26,35
"2892",10102,"St Johns","NL",47.56038,-52.71147,2018-05-01 10:00:00,3,32,35
"2893",10102,"St Johns","NL",47.56038,-52.71147,2018-05-01 11:00:00,4,31,35
"2894",10102,"St Johns","NL",47.56038,-52.71147,2018-05-01 12:00:00,6,33,39
"2895",10102,"St Johns","NL",47.56038,-52.71147,2018-05-01 13:00:00,5,31,36
"2896",10102,"St Johns","NL",47.56038,-52.71147,2018-05-01 14:00:00,4,35,39
"2897",10102,"St Johns","NL",47.56038,-52.71147,2018-05-01 15:00:00,6,29,35
"2898",10102,"St Johns","NL",47.56038,-52.71147,2018-05-01 16:00:00,2,37,39
"2899",10102,"St Johns","NL",47.56038,-52.71147,2018-05-01 17:00:00,3,38,41
"2900",10102,"St Johns","NL",47.56038,-52.71147,2018-05-01 18:00:00,0,38,38
"2901",10102,"St Johns","NL",47.56038,-52.71147,2018-05-01 19:00:00,6,28,34
"2902",10102,"St Johns","NL",47.56038,-52.71147,2018-05-01 20:00:00,8,26,34
"2903",10102,"St Johns","NL",47.56038,-52.71147,2018-05-01 21:00:00,0,36,36
"2904",10102,"St Johns","NL",47.56038,-52.71147,2018-05-01 22:00:00,18,18,36
"2905",10102,"St Johns","NL",47.56038,-52.71147,2018-05-01 23:00:00,33,3,36
"2906",10102,"St Johns","NL",47.56038,-52.71147,2018-05-02 00:00:00,33,3,36
"2907",10102,"St Johns","NL",47.56038,-52.71147,2018-05-02 01:00:00,34,3,37
"2908",10102,"St Johns","NL",47.56038,-52.71147,2018-05-02 02:00:00,36,2,38
"2909",10102,"St Johns","NL",47.56038,-52.71147,2018-05-02 03:00:00,34,2,36
"2910",10102,"St Johns","NL",47.56038,-52.71147,2018-05-02 04:00:00,37,2,39
"2911",10102,"St Johns","NL",47.56038,-52.71147,2018-05-02 05:00:00,38,2,40
"2912",10102,"St Johns","NL",47.56038,-52.71147,2018-05-02 06:00:00,40,3,43
"2913",10102,"St Johns","NL",47.56038,-52.71147,2018-05-02 07:00:00,35,5,40
"2914",10102,"St Johns","NL",47.56038,-52.71147,2018-05-02 08:00:00,36,5,41
"2915",10102,"St Johns","NL",47.56038,-52.71147,2018-05-02 09:00:00,37,4,41
"2916",10102,"St Johns","NL",47.56038,-52.71147,2018-05-02 10:00:00,38,4,42
"2917",10102,"St Johns","NL",47.56038,-52.71147,2018-05-02 11:00:00,39,3,42
"2918",10102,"St Johns","NL",47.56038,-52.71147,2018-05-02 12:00:00,37,2,39
"2919",10102,"St Johns","NL",47.56038,-52.71147,2018-05-02 13:00:00,39,2,41
"2920",10102,"St Johns","NL",47.56038,-52.71147,2018-05-02 14:00:00,41,2,43
"2921",10102,"St Johns","NL",47.56038,-52.71147,2018-05-02 15:00:00,41,2,43
"2922",10102,"St Johns","NL",47.56038,-52.71147,2018-05-02 16:00:00,36,3,39
"2923",10102,"St Johns","NL",47.56038,-52.71147,2018-05-02 17:00:00,30,2,32
"2924",10102,"St Johns","NL",47.56038,-52.71147,2018-05-02 18:00:00,28,2,30
"2925",10102,"St Johns","NL",47.56038,-52.71147,2018-05-02 19:00:00,27,2,29
"2926",10102,"St Johns","NL",47.56038,-52.71147,2018-05-02 20:00:00,29,2,31
"2927",10102,"St Johns","NL",47.56038,-52.71147,2018-05-02 21:00:00,30,2,32
"2928",10102,"St Johns","NL",47.56038,-52.71147,2018-05-02 22:00:00,32,1,33
"2929",10102,"St Johns","NL",47.56038,-52.71147,2018-05-02 23:00:00,32,1,33
"2930",10102,"St Johns","NL",47.56038,-52.71147,2018-05-03 00:00:00,31,1,32
"2931",10102,"St Johns","NL",47.56038,-52.71147,2018-05-03 01:00:00,30,1,31
"2932",10102,"St Johns","NL",47.56038,-52.71147,2018-05-03 02:00:00,27,1,28
"2933",10102,"St Johns","NL",47.56038,-52.71147,2018-05-03 03:00:00,25,1,26
"2934",10102,"St Johns","NL",47.56038,-52.71147,2018-05-03 04:00:00,25,1,26
"2935",10102,"St Johns","NL",47.56038,-52.71147,2018-05-03 05:00:00,9,19,28
"2936",10102,"St Johns","NL",47.56038,-52.71147,2018-05-03 06:00:00,0,32,32
"2937",10102,"St Johns","NL",47.56038,-52.71147,2018-05-03 07:00:00,2,31,33
"2938",10102,"St Johns","NL",47.56038,-52.71147,2018-05-03 08:00:00,21,7,28
"2939",10102,"St Johns","NL",47.56038,-52.71147,2018-05-03 09:00:00,23,6,29
"2940",10102,"St Johns","NL",47.56038,-52.71147,2018-05-03 10:00:00,20,7,27
"2941",10102,"St Johns","NL",47.56038,-52.71147,2018-05-03 11:00:00,29,6,35
"2942",10102,"St Johns","NL",47.56038,-52.71147,2018-05-03 12:00:00,34,5,39
"2943",10102,"St Johns","NL",47.56038,-52.71147,2018-05-03 13:00:00,34,6,40
"2944",10102,"St Johns","NL",47.56038,-52.71147,2018-05-03 14:00:00,36,5,41
"2945",10102,"St Johns","NL",47.56038,-52.71147,2018-05-03 15:00:00,35,5,40
"2946",10102,"St Johns","NL",47.56038,-52.71147,2018-05-03 16:00:00,35,4,39
"2947",10102,"St Johns","NL",47.56038,-52.71147,2018-05-03 17:00:00,34,5,39
"2948",10102,"St Johns","NL",47.56038,-52.71147,2018-05-03 18:00:00,34,4,38
"2949",10102,"St Johns","NL",47.56038,-52.71147,2018-05-03 19:00:00,34,2,36
"2950",10102,"St Johns","NL",47.56038,-52.71147,2018-05-03 20:00:00,34,2,36
"2951",10102,"St Johns","NL",47.56038,-52.71147,2018-05-03 21:00:00,33,3,36
"2952",10102,"St Johns","NL",47.56038,-52.71147,2018-05-03 22:00:00,32,2,34
"2953",10102,"St Johns","NL",47.56038,-52.71147,2018-05-03 23:00:00,31,2,33
"2954",10102,"St Johns","NL",47.56038,-52.71147,2018-05-04 00:00:00,32,2,34
"2955",10102,"St Johns","NL",47.56038,-52.71147,2018-05-04 01:00:00,32,3,35
"2956",10102,"St Johns","NL",47.56038,-52.71147,2018-05-04 02:00:00,33,2,35
"2957",10102,"St Johns","NL",47.56038,-52.71147,2018-05-04 03:00:00,31,3,34
"2958",10102,"St Johns","NL",47.56038,-52.71147,2018-05-04 04:00:00,32,2,34
"2959",10102,"St Johns","NL",47.56038,-52.71147,2018-05-04 05:00:00,28,6,34
"2960",10102,"St Johns","NL",47.56038,-52.71147,2018-05-04 06:00:00,16,21,37
"2961",10102,"St Johns","NL",47.56038,-52.71147,2018-05-04 07:00:00,20,18,38
"2962",10102,"St Johns","NL",47.56038,-52.71147,2018-05-04 08:00:00,17,22,39
"2963",10102,"St Johns","NL",47.56038,-52.71147,2018-05-04 09:00:00,19,18,37
"2964",10102,"St Johns","NL",47.56038,-52.71147,2018-05-04 10:00:00,12,27,39
"2965",10102,"St Johns","NL",47.56038,-52.71147,2018-05-04 11:00:00,13,27,40
"2966",10102,"St Johns","NL",47.56038,-52.71147,2018-05-04 12:00:00,12,27,39
"2967",10102,"St Johns","NL",47.56038,-52.71147,2018-05-04 13:00:00,18,18,36
"2968",10102,"St Johns","NL",47.56038,-52.71147,2018-05-04 14:00:00,12,24,36
"2969",10102,"St Johns","NL",47.56038,-52.71147,2018-05-04 15:00:00,12,29,41
"2970",10102,"St Johns","NL",47.56038,-52.71147,2018-05-04 16:00:00,6,38,44
"2971",10102,"St Johns","NL",47.56038,-52.71147,2018-05-04 17:00:00,14,24,38
"2972",10102,"St Johns","NL",47.56038,-52.71147,2018-05-04 18:00:00,18,16,34
"2973",10102,"St Johns","NL",47.56038,-52.71147,2018-05-04 19:00:00,18,15,33
"2974",10102,"St Johns","NL",47.56038,-52.71147,2018-05-04 20:00:00,21,11,32
"2975",10102,"St Johns","NL",47.56038,-52.71147,2018-05-04 21:00:00,19,14,33
"2976",10102,"St Johns","NL",47.56038,-52.71147,2018-05-04 22:00:00,22,11,33
"2977",10102,"St Johns","NL",47.56038,-52.71147,2018-05-04 23:00:00,25,7,32
"2978",10102,"St Johns","NL",47.56038,-52.71147,2018-05-05 00:00:00,28,6,34
"2979",10102,"St Johns","NL",47.56038,-52.71147,2018-05-05 01:00:00,28,6,34
"2980",10102,"St Johns","NL",47.56038,-52.71147,2018-05-05 02:00:00,26,7,33
"2981",10102,"St Johns","NL",47.56038,-52.71147,2018-05-05 03:00:00,17,15,32
"2982",10102,"St Johns","NL",47.56038,-52.71147,2018-05-05 04:00:00,23,11,34
"2983",10102,"St Johns","NL",47.56038,-52.71147,2018-05-05 05:00:00,31,4,35
"2984",10102,"St Johns","NL",47.56038,-52.71147,2018-05-05 06:00:00,31,5,36
"2985",10102,"St Johns","NL",47.56038,-52.71147,2018-05-05 07:00:00,28,8,36
"2986",10102,"St Johns","NL",47.56038,-52.71147,2018-05-05 08:00:00,22,16,38
"2987",10102,"St Johns","NL",47.56038,-52.71147,2018-05-05 09:00:00,29,8,37
"2988",10102,"St Johns","NL",47.56038,-52.71147,2018-05-05 10:00:00,30,10,40
"2989",10102,"St Johns","NL",47.56038,-52.71147,2018-05-05 11:00:00,32,5,37
"2990",10102,"St Johns","NL",47.56038,-52.71147,2018-05-05 12:00:00,32,3,35
"2991",10102,"St Johns","NL",47.56038,-52.71147,2018-05-05 13:00:00,31,4,35
"2992",10102,"St Johns","NL",47.56038,-52.71147,2018-05-05 14:00:00,33,3,36
"2993",10102,"St Johns","NL",47.56038,-52.71147,2018-05-05 15:00:00,37,2,39
"2994",10102,"St Johns","NL",47.56038,-52.71147,2018-05-05 16:00:00,38,1,39
"2995",10102,"St Johns","NL",47.56038,-52.71147,2018-05-05 17:00:00,37,1,38
"2996",10102,"St Johns","NL",47.56038,-52.71147,2018-05-05 18:00:00,38,0,38
"2997",10102,"St Johns","NL",47.56038,-52.71147,2018-05-05 19:00:00,34,0,34
"2998",10102,"St Johns","NL",47.56038,-52.71147,2018-05-05 20:00:00,29,0,29
"2999",10102,"St Johns","NL",47.56038,-52.71147,2018-05-05 21:00:00,28,0,28
"3000",10102,"St Johns","NL",47.56038,-52.71147,2018-05-05 22:00:00,28,1,29
"3001",10102,"St Johns","NL",47.56038,-52.71147,2018-05-05 23:00:00,28,0,28
"3002",10102,"St Johns","NL",47.56038,-52.71147,2018-05-06 00:00:00,28,1,29
"3003",10102,"St Johns","NL",47.56038,-52.71147,2018-05-06 01:00:00,28,0,28
"3004",10102,"St Johns","NL",47.56038,-52.71147,2018-05-06 02:00:00,28,0,28
"3005",10102,"St Johns","NL",47.56038,-52.71147,2018-05-06 03:00:00,30,1,31
"3006",10102,"St Johns","NL",47.56038,-52.71147,2018-05-06 04:00:00,30,0,30
"3007",10102,"St Johns","NL",47.56038,-52.71147,2018-05-06 05:00:00,32,1,33
"3008",10102,"St Johns","NL",47.56038,-52.71147,2018-05-06 06:00:00,32,0,32
"3009",10102,"St Johns","NL",47.56038,-52.71147,2018-05-06 07:00:00,32,1,33
"3010",10102,"St Johns","NL",47.56038,-52.71147,2018-05-06 08:00:00,33,1,34
"3011",10102,"St Johns","NL",47.56038,-52.71147,2018-05-06 09:00:00,33,0,33
"3012",10102,"St Johns","NL",47.56038,-52.71147,2018-05-06 10:00:00,33,0,33
"3013",10102,"St Johns","NL",47.56038,-52.71147,2018-05-06 11:00:00,34,0,34
"3014",10102,"St Johns","NL",47.56038,-52.71147,2018-05-06 12:00:00,33,1,34
"3015",10102,"St Johns","NL",47.56038,-52.71147,2018-05-06 13:00:00,32,1,33
"3016",10102,"St Johns","NL",47.56038,-52.71147,2018-05-06 14:00:00,30,1,31
"3017",10102,"St Johns","NL",47.56038,-52.71147,2018-05-06 15:00:00,31,1,32
"3018",10102,"St Johns","NL",47.56038,-52.71147,2018-05-06 16:00:00,32,1,33
"3019",10102,"St Johns","NL",47.56038,-52.71147,2018-05-06 17:00:00,33,1,34
"3020",10102,"St Johns","NL",47.56038,-52.71147,2018-05-06 18:00:00,33,1,34
"3021",10102,"St Johns","NL",47.56038,-52.71147,2018-05-06 19:00:00,32,2,34
"3022",10102,"St Johns","NL",47.56038,-52.71147,2018-05-06 20:00:00,32,2,34
"3023",10102,"St Johns","NL",47.56038,-52.71147,2018-05-06 21:00:00,31,1,32
"3024",10102,"St Johns","NL",47.56038,-52.71147,2018-05-06 22:00:00,31,2,33
"3025",10102,"St Johns","NL",47.56038,-52.71147,2018-05-06 23:00:00,32,2,34
"3026",10102,"St Johns","NL",47.56038,-52.71147,2018-05-07 00:00:00,31,4,35
"3027",10102,"St Johns","NL",47.56038,-52.71147,2018-05-07 01:00:00,31,1,32
"3028",10102,"St Johns","NL",47.56038,-52.71147,2018-05-07 02:00:00,31,1,32
"3029",10102,"St Johns","NL",47.56038,-52.71147,2018-05-07 03:00:00,32,2,34
"3030",10102,"St Johns","NL",47.56038,-52.71147,2018-05-07 04:00:00,35,2,37
"3031",10102,"St Johns","NL",47.56038,-52.71147,2018-05-07 05:00:00,36,2,38
"3032",10102,"St Johns","NL",47.56038,-52.71147,2018-05-07 06:00:00,35,2,37
"3033",10102,"St Johns","NL",47.56038,-52.71147,2018-05-07 07:00:00,31,6,37
"3034",10102,"St Johns","NL",47.56038,-52.71147,2018-05-07 08:00:00,25,18,43
"3035",10102,"St Johns","NL",47.56038,-52.71147,2018-05-07 09:00:00,23,16,39
"3036",10102,"St Johns","NL",47.56038,-52.71147,2018-05-07 10:00:00,32,9,41
"3037",10102,"St Johns","NL",47.56038,-52.71147,2018-05-07 11:00:00,NA,NA,NA
"3038",10102,"St Johns","NL",47.56038,-52.71147,2018-05-07 12:00:00,NA,NA,NA
"3039",10102,"St Johns","NL",47.56038,-52.71147,2018-05-07 13:00:00,NA,NA,NA
"3040",10102,"St Johns","NL",47.56038,-52.71147,2018-05-07 14:00:00,31,NA,NA
"3041",10102,"St Johns","NL",47.56038,-52.71147,2018-05-07 15:00:00,25,3,28
"3042",10102,"St Johns","NL",47.56038,-52.71147,2018-05-07 16:00:00,35,2,37
"3043",10102,"St Johns","NL",47.56038,-52.71147,2018-05-07 17:00:00,36,1,37
"3044",10102,"St Johns","NL",47.56038,-52.71147,2018-05-07 18:00:00,34,3,37
"3045",10102,"St Johns","NL",47.56038,-52.71147,2018-05-07 19:00:00,31,2,33
"3046",10102,"St Johns","NL",47.56038,-52.71147,2018-05-07 20:00:00,30,1,31
"3047",10102,"St Johns","NL",47.56038,-52.71147,2018-05-07 21:00:00,34,2,36
"3048",10102,"St Johns","NL",47.56038,-52.71147,2018-05-07 22:00:00,32,2,34
"3049",10102,"St Johns","NL",47.56038,-52.71147,2018-05-07 23:00:00,29,3,32
"3050",10102,"St Johns","NL",47.56038,-52.71147,2018-05-08 00:00:00,31,2,33
"3051",10102,"St Johns","NL",47.56038,-52.71147,2018-05-08 01:00:00,30,2,32
"3052",10102,"St Johns","NL",47.56038,-52.71147,2018-05-08 02:00:00,27,3,30
"3053",10102,"St Johns","NL",47.56038,-52.71147,2018-05-08 03:00:00,24,2,26
"3054",10102,"St Johns","NL",47.56038,-52.71147,2018-05-08 04:00:00,24,4,28
"3055",10102,"St Johns","NL",47.56038,-52.71147,2018-05-08 05:00:00,23,4,27
"3056",10102,"St Johns","NL",47.56038,-52.71147,2018-05-08 06:00:00,19,7,26
"3057",10102,"St Johns","NL",47.56038,-52.71147,2018-05-08 07:00:00,24,5,29
"3058",10102,"St Johns","NL",47.56038,-52.71147,2018-05-08 08:00:00,28,3,31
"3059",10102,"St Johns","NL",47.56038,-52.71147,2018-05-08 09:00:00,30,2,32
"3060",10102,"St Johns","NL",47.56038,-52.71147,2018-05-08 10:00:00,32,2,34
"3061",10102,"St Johns","NL",47.56038,-52.71147,2018-05-08 11:00:00,NA,6,NA
"3062",10102,"St Johns","NL",47.56038,-52.71147,2018-05-08 12:00:00,35,2,37
"3063",10102,"St Johns","NL",47.56038,-52.71147,2018-05-08 13:00:00,32,6,38
"3064",10102,"St Johns","NL",47.56038,-52.71147,2018-05-08 14:00:00,30,7,37
"3065",10102,"St Johns","NL",47.56038,-52.71147,2018-05-08 15:00:00,34,5,39
"3066",10102,"St Johns","NL",47.56038,-52.71147,2018-05-08 16:00:00,31,9,40
"3067",10102,"St Johns","NL",47.56038,-52.71147,2018-05-08 17:00:00,36,6,42
"3068",10102,"St Johns","NL",47.56038,-52.71147,2018-05-08 18:00:00,39,2,41
"3069",10102,"St Johns","NL",47.56038,-52.71147,2018-05-08 19:00:00,38,2,40
"3070",10102,"St Johns","NL",47.56038,-52.71147,2018-05-08 20:00:00,35,3,38
"3071",10102,"St Johns","NL",47.56038,-52.71147,2018-05-08 21:00:00,34,2,36
"3072",10102,"St Johns","NL",47.56038,-52.71147,2018-05-08 22:00:00,34,1,35
"3073",10102,"St Johns","NL",47.56038,-52.71147,2018-05-08 23:00:00,36,1,37
"3074",10102,"St Johns","NL",47.56038,-52.71147,2018-05-09 00:00:00,35,1,36
"3075",10102,"St Johns","NL",47.56038,-52.71147,2018-05-09 01:00:00,35,1,36
"3076",10102,"St Johns","NL",47.56038,-52.71147,2018-05-09 02:00:00,39,1,40
"3077",10102,"St Johns","NL",47.56038,-52.71147,2018-05-09 03:00:00,40,0,40
"3078",10102,"St Johns","NL",47.56038,-52.71147,2018-05-09 04:00:00,39,1,40
"3079",10102,"St Johns","NL",47.56038,-52.71147,2018-05-09 05:00:00,43,1,44
"3080",10102,"St Johns","NL",47.56038,-52.71147,2018-05-09 06:00:00,39,2,41
"3081",10102,"St Johns","NL",47.56038,-52.71147,2018-05-09 07:00:00,40,3,43
"3082",10102,"St Johns","NL",47.56038,-52.71147,2018-05-09 08:00:00,37,4,41
"3083",10102,"St Johns","NL",47.56038,-52.71147,2018-05-09 09:00:00,36,3,39
"3084",10102,"St Johns","NL",47.56038,-52.71147,2018-05-09 10:00:00,35,3,38
"3085",10102,"St Johns","NL",47.56038,-52.71147,2018-05-09 11:00:00,36,2,38
"3086",10102,"St Johns","NL",47.56038,-52.71147,2018-05-09 12:00:00,36,6,42
"3087",10102,"St Johns","NL",47.56038,-52.71147,2018-05-09 13:00:00,40,5,45
"3088",10102,"St Johns","NL",47.56038,-52.71147,2018-05-09 14:00:00,43,3,46
"3089",10102,"St Johns","NL",47.56038,-52.71147,2018-05-09 15:00:00,43,1,44
"3090",10102,"St Johns","NL",47.56038,-52.71147,2018-05-09 16:00:00,42,1,43
"3091",10102,"St Johns","NL",47.56038,-52.71147,2018-05-09 17:00:00,34,3,37
"3092",10102,"St Johns","NL",47.56038,-52.71147,2018-05-09 18:00:00,32,3,35
"3093",10102,"St Johns","NL",47.56038,-52.71147,2018-05-09 19:00:00,23,14,37
"3094",10102,"St Johns","NL",47.56038,-52.71147,2018-05-09 20:00:00,22,12,34
"3095",10102,"St Johns","NL",47.56038,-52.71147,2018-05-09 21:00:00,23,11,34
"3096",10102,"St Johns","NL",47.56038,-52.71147,2018-05-09 22:00:00,17,15,32
"3097",10102,"St Johns","NL",47.56038,-52.71147,2018-05-09 23:00:00,22,10,32
"3098",10102,"St Johns","NL",47.56038,-52.71147,2018-05-10 00:00:00,16,12,28
"3099",10102,"St Johns","NL",47.56038,-52.71147,2018-05-10 01:00:00,15,11,26
"3100",10102,"St Johns","NL",47.56038,-52.71147,2018-05-10 02:00:00,10,18,28
"3101",10102,"St Johns","NL",47.56038,-52.71147,2018-05-10 03:00:00,15,12,27
"3102",10102,"St Johns","NL",47.56038,-52.71147,2018-05-10 04:00:00,17,10,27
"3103",10102,"St Johns","NL",47.56038,-52.71147,2018-05-10 05:00:00,9,15,24
"3104",10102,"St Johns","NL",47.56038,-52.71147,2018-05-10 06:00:00,7,17,24
"3105",10102,"St Johns","NL",47.56038,-52.71147,2018-05-10 07:00:00,5,31,36
"3106",10102,"St Johns","NL",47.56038,-52.71147,2018-05-10 08:00:00,9,29,38
"3107",10102,"St Johns","NL",47.56038,-52.71147,2018-05-10 09:00:00,19,18,37
"3108",10102,"St Johns","NL",47.56038,-52.71147,2018-05-10 10:00:00,22,17,39
"3109",10102,"St Johns","NL",47.56038,-52.71147,2018-05-10 11:00:00,28,6,34
"3110",10102,"St Johns","NL",47.56038,-52.71147,2018-05-10 12:00:00,30,4,34
"3111",10102,"St Johns","NL",47.56038,-52.71147,2018-05-10 13:00:00,28,6,34
"3112",10102,"St Johns","NL",47.56038,-52.71147,2018-05-10 14:00:00,30,7,37
"3113",10102,"St Johns","NL",47.56038,-52.71147,2018-05-10 15:00:00,32,6,38
"3114",10102,"St Johns","NL",47.56038,-52.71147,2018-05-10 16:00:00,32,5,37
"3115",10102,"St Johns","NL",47.56038,-52.71147,2018-05-10 17:00:00,32,4,36
"3116",10102,"St Johns","NL",47.56038,-52.71147,2018-05-10 18:00:00,32,4,36
"3117",10102,"St Johns","NL",47.56038,-52.71147,2018-05-10 19:00:00,32,3,35
"3118",10102,"St Johns","NL",47.56038,-52.71147,2018-05-10 20:00:00,31,4,35
"3119",10102,"St Johns","NL",47.56038,-52.71147,2018-05-10 21:00:00,31,4,35
"3120",10102,"St Johns","NL",47.56038,-52.71147,2018-05-10 22:00:00,33,3,36
"3121",10102,"St Johns","NL",47.56038,-52.71147,2018-05-10 23:00:00,34,3,37
"3122",10102,"St Johns","NL",47.56038,-52.71147,2018-05-11 00:00:00,35,2,37
"3123",10102,"St Johns","NL",47.56038,-52.71147,2018-05-11 01:00:00,36,2,38
"3124",10102,"St Johns","NL",47.56038,-52.71147,2018-05-11 02:00:00,36,2,38
"3125",10102,"St Johns","NL",47.56038,-52.71147,2018-05-11 03:00:00,36,1,37
"3126",10102,"St Johns","NL",47.56038,-52.71147,2018-05-11 04:00:00,36,2,38
"3127",10102,"St Johns","NL",47.56038,-52.71147,2018-05-11 05:00:00,35,2,37
"3128",10102,"St Johns","NL",47.56038,-52.71147,2018-05-11 06:00:00,33,2,35
"3129",10102,"St Johns","NL",47.56038,-52.71147,2018-05-11 07:00:00,29,3,32
"3130",10102,"St Johns","NL",47.56038,-52.71147,2018-05-11 08:00:00,28,3,31
"3131",10102,"St Johns","NL",47.56038,-52.71147,2018-05-11 09:00:00,31,3,34
"3132",10102,"St Johns","NL",47.56038,-52.71147,2018-05-11 10:00:00,33,4,37
"3133",10102,"St Johns","NL",47.56038,-52.71147,2018-05-11 11:00:00,32,3,35
"3134",10102,"St Johns","NL",47.56038,-52.71147,2018-05-11 12:00:00,36,1,37
"3135",10102,"St Johns","NL",47.56038,-52.71147,2018-05-11 13:00:00,43,2,45
"3136",10102,"St Johns","NL",47.56038,-52.71147,2018-05-11 14:00:00,45,2,47
"3137",10102,"St Johns","NL",47.56038,-52.71147,2018-05-11 15:00:00,39,1,40
"3138",10102,"St Johns","NL",47.56038,-52.71147,2018-05-11 16:00:00,36,2,38
"3139",10102,"St Johns","NL",47.56038,-52.71147,2018-05-11 17:00:00,36,1,37
"3140",10102,"St Johns","NL",47.56038,-52.71147,2018-05-11 18:00:00,33,1,34
"3141",10102,"St Johns","NL",47.56038,-52.71147,2018-05-11 19:00:00,31,2,33
"3142",10102,"St Johns","NL",47.56038,-52.71147,2018-05-11 20:00:00,29,2,31
"3143",10102,"St Johns","NL",47.56038,-52.71147,2018-05-11 21:00:00,28,3,31
"3144",10102,"St Johns","NL",47.56038,-52.71147,2018-05-11 22:00:00,32,1,33
"3145",10102,"St Johns","NL",47.56038,-52.71147,2018-05-11 23:00:00,26,2,28
"3146",10102,"St Johns","NL",47.56038,-52.71147,2018-05-12 00:00:00,26,1,27
"3147",10102,"St Johns","NL",47.56038,-52.71147,2018-05-12 01:00:00,25,1,26
"3148",10102,"St Johns","NL",47.56038,-52.71147,2018-05-12 02:00:00,23,1,24
"3149",10102,"St Johns","NL",47.56038,-52.71147,2018-05-12 03:00:00,23,1,24
"3150",10102,"St Johns","NL",47.56038,-52.71147,2018-05-12 04:00:00,22,1,23
"3151",10102,"St Johns","NL",47.56038,-52.71147,2018-05-12 05:00:00,23,1,24
"3152",10102,"St Johns","NL",47.56038,-52.71147,2018-05-12 06:00:00,23,1,24
"3153",10102,"St Johns","NL",47.56038,-52.71147,2018-05-12 07:00:00,23,2,25
"3154",10102,"St Johns","NL",47.56038,-52.71147,2018-05-12 08:00:00,23,0,23
"3155",10102,"St Johns","NL",47.56038,-52.71147,2018-05-12 09:00:00,24,1,25
"3156",10102,"St Johns","NL",47.56038,-52.71147,2018-05-12 10:00:00,25,1,26
"3157",10102,"St Johns","NL",47.56038,-52.71147,2018-05-12 11:00:00,26,1,27
"3158",10102,"St Johns","NL",47.56038,-52.71147,2018-05-12 12:00:00,26,1,27
"3159",10102,"St Johns","NL",47.56038,-52.71147,2018-05-12 13:00:00,27,1,28
"3160",10102,"St Johns","NL",47.56038,-52.71147,2018-05-12 14:00:00,29,0,29
"3161",10102,"St Johns","NL",47.56038,-52.71147,2018-05-12 15:00:00,29,1,30
"3162",10102,"St Johns","NL",47.56038,-52.71147,2018-05-12 16:00:00,31,1,32
"3163",10102,"St Johns","NL",47.56038,-52.71147,2018-05-12 17:00:00,32,1,33
"3164",10102,"St Johns","NL",47.56038,-52.71147,2018-05-12 18:00:00,31,1,32
"3165",10102,"St Johns","NL",47.56038,-52.71147,2018-05-12 19:00:00,31,1,32
"3166",10102,"St Johns","NL",47.56038,-52.71147,2018-05-12 20:00:00,32,1,33
"3167",10102,"St Johns","NL",47.56038,-52.71147,2018-05-12 21:00:00,32,1,33
"3168",10102,"St Johns","NL",47.56038,-52.71147,2018-05-12 22:00:00,31,2,33
"3169",10102,"St Johns","NL",47.56038,-52.71147,2018-05-12 23:00:00,31,2,33
"3170",10102,"St Johns","NL",47.56038,-52.71147,2018-05-13 00:00:00,30,1,31
"3171",10102,"St Johns","NL",47.56038,-52.71147,2018-05-13 01:00:00,30,1,31
"3172",10102,"St Johns","NL",47.56038,-52.71147,2018-05-13 02:00:00,30,1,31
"3173",10102,"St Johns","NL",47.56038,-52.71147,2018-05-13 03:00:00,28,2,30
"3174",10102,"St Johns","NL",47.56038,-52.71147,2018-05-13 04:00:00,28,2,30
"3175",10102,"St Johns","NL",47.56038,-52.71147,2018-05-13 05:00:00,28,2,30
"3176",10102,"St Johns","NL",47.56038,-52.71147,2018-05-13 06:00:00,29,1,30
"3177",10102,"St Johns","NL",47.56038,-52.71147,2018-05-13 07:00:00,31,1,32
"3178",10102,"St Johns","NL",47.56038,-52.71147,2018-05-13 08:00:00,35,1,36
"3179",10102,"St Johns","NL",47.56038,-52.71147,2018-05-13 09:00:00,38,0,38
"3180",10102,"St Johns","NL",47.56038,-52.71147,2018-05-13 10:00:00,37,0,37
"3181",10102,"St Johns","NL",47.56038,-52.71147,2018-05-13 11:00:00,39,0,39
"3182",10102,"St Johns","NL",47.56038,-52.71147,2018-05-13 12:00:00,39,1,40
"3183",10102,"St Johns","NL",47.56038,-52.71147,2018-05-13 13:00:00,39,1,40
"3184",10102,"St Johns","NL",47.56038,-52.71147,2018-05-13 14:00:00,39,1,40
"3185",10102,"St Johns","NL",47.56038,-52.71147,2018-05-13 15:00:00,38,1,39
"3186",10102,"St Johns","NL",47.56038,-52.71147,2018-05-13 16:00:00,38,1,39
"3187",10102,"St Johns","NL",47.56038,-52.71147,2018-05-13 17:00:00,39,2,41
"3188",10102,"St Johns","NL",47.56038,-52.71147,2018-05-13 18:00:00,38,1,39
"3189",10102,"St Johns","NL",47.56038,-52.71147,2018-05-13 19:00:00,37,3,40
"3190",10102,"St Johns","NL",47.56038,-52.71147,2018-05-13 20:00:00,35,1,36
"3191",10102,"St Johns","NL",47.56038,-52.71147,2018-05-13 21:00:00,35,2,37
"3192",10102,"St Johns","NL",47.56038,-52.71147,2018-05-13 22:00:00,33,3,36
"3193",10102,"St Johns","NL",47.56038,-52.71147,2018-05-13 23:00:00,33,3,36
"3194",10102,"St Johns","NL",47.56038,-52.71147,2018-05-14 00:00:00,33,2,35
"3195",10102,"St Johns","NL",47.56038,-52.71147,2018-05-14 01:00:00,33,2,35
"3196",10102,"St Johns","NL",47.56038,-52.71147,2018-05-14 02:00:00,32,2,34
"3197",10102,"St Johns","NL",47.56038,-52.71147,2018-05-14 03:00:00,31,3,34
"3198",10102,"St Johns","NL",47.56038,-52.71147,2018-05-14 04:00:00,31,3,34
"3199",10102,"St Johns","NL",47.56038,-52.71147,2018-05-14 05:00:00,34,3,37
"3200",10102,"St Johns","NL",47.56038,-52.71147,2018-05-14 06:00:00,31,6,37
"3201",10102,"St Johns","NL",47.56038,-52.71147,2018-05-14 07:00:00,31,9,40
"3202",10102,"St Johns","NL",47.56038,-52.71147,2018-05-14 08:00:00,34,5,39
"3203",10102,"St Johns","NL",47.56038,-52.71147,2018-05-14 09:00:00,38,5,43
"3204",10102,"St Johns","NL",47.56038,-52.71147,2018-05-14 10:00:00,39,4,43
"3205",10102,"St Johns","NL",47.56038,-52.71147,2018-05-14 11:00:00,37,5,42
"3206",10102,"St Johns","NL",47.56038,-52.71147,2018-05-14 12:00:00,40,2,42
"3207",10102,"St Johns","NL",47.56038,-52.71147,2018-05-14 13:00:00,40,2,42
"3208",10102,"St Johns","NL",47.56038,-52.71147,2018-05-14 14:00:00,40,1,41
"3209",10102,"St Johns","NL",47.56038,-52.71147,2018-05-14 15:00:00,39,1,40
"3210",10102,"St Johns","NL",47.56038,-52.71147,2018-05-14 16:00:00,36,3,39
"3211",10102,"St Johns","NL",47.56038,-52.71147,2018-05-14 17:00:00,38,3,41
"3212",10102,"St Johns","NL",47.56038,-52.71147,2018-05-14 18:00:00,40,4,44
"3213",10102,"St Johns","NL",47.56038,-52.71147,2018-05-14 19:00:00,40,2,42
"3214",10102,"St Johns","NL",47.56038,-52.71147,2018-05-14 20:00:00,38,1,39
"3215",10102,"St Johns","NL",47.56038,-52.71147,2018-05-14 21:00:00,39,1,40
"3216",10102,"St Johns","NL",47.56038,-52.71147,2018-05-14 22:00:00,38,0,38
"3217",10102,"St Johns","NL",47.56038,-52.71147,2018-05-14 23:00:00,38,0,38
"3218",10102,"St Johns","NL",47.56038,-52.71147,2018-05-15 00:00:00,35,1,36
"3219",10102,"St Johns","NL",47.56038,-52.71147,2018-05-15 01:00:00,24,11,35
"3220",10102,"St Johns","NL",47.56038,-52.71147,2018-05-15 02:00:00,26,10,36
"3221",10102,"St Johns","NL",47.56038,-52.71147,2018-05-15 03:00:00,31,3,34
"3222",10102,"St Johns","NL",47.56038,-52.71147,2018-05-15 04:00:00,18,16,34
"3223",10102,"St Johns","NL",47.56038,-52.71147,2018-05-15 05:00:00,10,24,34
"3224",10102,"St Johns","NL",47.56038,-52.71147,2018-05-15 06:00:00,14,15,29
"3225",10102,"St Johns","NL",47.56038,-52.71147,2018-05-15 07:00:00,20,7,27
"3226",10102,"St Johns","NL",47.56038,-52.71147,2018-05-15 08:00:00,31,4,35
"3227",10102,"St Johns","NL",47.56038,-52.71147,2018-05-15 09:00:00,31,3,34
"3228",10102,"St Johns","NL",47.56038,-52.71147,2018-05-15 10:00:00,32,2,34
"3229",10102,"St Johns","NL",47.56038,-52.71147,2018-05-15 11:00:00,34,3,37
"3230",10102,"St Johns","NL",47.56038,-52.71147,2018-05-15 12:00:00,36,1,37
"3231",10102,"St Johns","NL",47.56038,-52.71147,2018-05-15 13:00:00,38,2,40
"3232",10102,"St Johns","NL",47.56038,-52.71147,2018-05-15 14:00:00,35,7,42
"3233",10102,"St Johns","NL",47.56038,-52.71147,2018-05-15 15:00:00,39,3,42
"3234",10102,"St Johns","NL",47.56038,-52.71147,2018-05-15 16:00:00,38,2,40
"3235",10102,"St Johns","NL",47.56038,-52.71147,2018-05-15 17:00:00,39,1,40
"3236",10102,"St Johns","NL",47.56038,-52.71147,2018-05-15 18:00:00,41,2,43
"3237",10102,"St Johns","NL",47.56038,-52.71147,2018-05-15 19:00:00,41,0,41
"3238",10102,"St Johns","NL",47.56038,-52.71147,2018-05-15 20:00:00,39,1,40
"3239",10102,"St Johns","NL",47.56038,-52.71147,2018-05-15 21:00:00,35,1,36
"3240",10102,"St Johns","NL",47.56038,-52.71147,2018-05-15 22:00:00,36,0,36
"3241",10102,"St Johns","NL",47.56038,-52.71147,2018-05-15 23:00:00,37,0,37
"3242",10102,"St Johns","NL",47.56038,-52.71147,2018-05-16 00:00:00,35,0,35
"3243",10102,"St Johns","NL",47.56038,-52.71147,2018-05-16 01:00:00,34,1,35
"3244",10102,"St Johns","NL",47.56038,-52.71147,2018-05-16 02:00:00,35,0,35
"3245",10102,"St Johns","NL",47.56038,-52.71147,2018-05-16 03:00:00,36,1,37
"3246",10102,"St Johns","NL",47.56038,-52.71147,2018-05-16 04:00:00,34,0,34
"3247",10102,"St Johns","NL",47.56038,-52.71147,2018-05-16 05:00:00,33,0,33
"3248",10102,"St Johns","NL",47.56038,-52.71147,2018-05-16 06:00:00,35,0,35
"3249",10102,"St Johns","NL",47.56038,-52.71147,2018-05-16 07:00:00,31,4,35
"3250",10102,"St Johns","NL",47.56038,-52.71147,2018-05-16 08:00:00,31,3,34
"3251",10102,"St Johns","NL",47.56038,-52.71147,2018-05-16 09:00:00,32,2,34
"3252",10102,"St Johns","NL",47.56038,-52.71147,2018-05-16 10:00:00,33,1,34
"3253",10102,"St Johns","NL",47.56038,-52.71147,2018-05-16 11:00:00,30,5,35
"3254",10102,"St Johns","NL",47.56038,-52.71147,2018-05-16 12:00:00,26,3,29
"3255",10102,"St Johns","NL",47.56038,-52.71147,2018-05-16 13:00:00,21,13,34
"3256",10102,"St Johns","NL",47.56038,-52.71147,2018-05-16 14:00:00,15,18,33
"3257",10102,"St Johns","NL",47.56038,-52.71147,2018-05-16 15:00:00,16,19,35
"3258",10102,"St Johns","NL",47.56038,-52.71147,2018-05-16 16:00:00,22,7,29
"3259",10102,"St Johns","NL",47.56038,-52.71147,2018-05-16 17:00:00,25,3,28
"3260",10102,"St Johns","NL",47.56038,-52.71147,2018-05-16 18:00:00,23,5,28
"3261",10102,"St Johns","NL",47.56038,-52.71147,2018-05-16 19:00:00,24,4,28
"3262",10102,"St Johns","NL",47.56038,-52.71147,2018-05-16 20:00:00,25,2,27
"3263",10102,"St Johns","NL",47.56038,-52.71147,2018-05-16 21:00:00,26,1,27
"3264",10102,"St Johns","NL",47.56038,-52.71147,2018-05-16 22:00:00,28,1,29
"3265",10102,"St Johns","NL",47.56038,-52.71147,2018-05-16 23:00:00,28,1,29
"3266",10102,"St Johns","NL",47.56038,-52.71147,2018-05-17 00:00:00,29,1,30
"3267",10102,"St Johns","NL",47.56038,-52.71147,2018-05-17 01:00:00,28,2,30
"3268",10102,"St Johns","NL",47.56038,-52.71147,2018-05-17 02:00:00,28,2,30
"3269",10102,"St Johns","NL",47.56038,-52.71147,2018-05-17 03:00:00,26,3,29
"3270",10102,"St Johns","NL",47.56038,-52.71147,2018-05-17 04:00:00,28,3,31
"3271",10102,"St Johns","NL",47.56038,-52.71147,2018-05-17 05:00:00,31,0,31
"3272",10102,"St Johns","NL",47.56038,-52.71147,2018-05-17 06:00:00,26,1,27
"3273",10102,"St Johns","NL",47.56038,-52.71147,2018-05-17 07:00:00,23,5,28
"3274",10102,"St Johns","NL",47.56038,-52.71147,2018-05-17 08:00:00,29,1,30
"3275",10102,"St Johns","NL",47.56038,-52.71147,2018-05-17 09:00:00,29,3,32
"3276",10102,"St Johns","NL",47.56038,-52.71147,2018-05-17 10:00:00,35,1,36
"3277",10102,"St Johns","NL",47.56038,-52.71147,2018-05-17 11:00:00,30,3,33
"3278",10102,"St Johns","NL",47.56038,-52.71147,2018-05-17 12:00:00,42,2,44
"3279",10102,"St Johns","NL",47.56038,-52.71147,2018-05-17 13:00:00,43,2,45
"3280",10102,"St Johns","NL",47.56038,-52.71147,2018-05-17 14:00:00,42,3,45
"3281",10102,"St Johns","NL",47.56038,-52.71147,2018-05-17 15:00:00,45,2,47
"3282",10102,"St Johns","NL",47.56038,-52.71147,2018-05-17 16:00:00,47,2,49
"3283",10102,"St Johns","NL",47.56038,-52.71147,2018-05-17 17:00:00,43,2,45
"3284",10102,"St Johns","NL",47.56038,-52.71147,2018-05-17 18:00:00,38,2,40
"3285",10102,"St Johns","NL",47.56038,-52.71147,2018-05-17 19:00:00,35,1,36
"3286",10102,"St Johns","NL",47.56038,-52.71147,2018-05-17 20:00:00,34,2,36
"3287",10102,"St Johns","NL",47.56038,-52.71147,2018-05-17 21:00:00,33,2,35
"3288",10102,"St Johns","NL",47.56038,-52.71147,2018-05-17 22:00:00,31,2,33
"3289",10102,"St Johns","NL",47.56038,-52.71147,2018-05-17 23:00:00,31,1,32
"3290",10102,"St Johns","NL",47.56038,-52.71147,2018-05-18 00:00:00,29,1,30
"3291",10102,"St Johns","NL",47.56038,-52.71147,2018-05-18 01:00:00,28,2,30
"3292",10102,"St Johns","NL",47.56038,-52.71147,2018-05-18 02:00:00,29,1,30
"3293",10102,"St Johns","NL",47.56038,-52.71147,2018-05-18 03:00:00,28,2,30
"3294",10102,"St Johns","NL",47.56038,-52.71147,2018-05-18 04:00:00,27,2,29
"3295",10102,"St Johns","NL",47.56038,-52.71147,2018-05-18 05:00:00,23,3,26
"3296",10102,"St Johns","NL",47.56038,-52.71147,2018-05-18 06:00:00,23,2,25
"3297",10102,"St Johns","NL",47.56038,-52.71147,2018-05-18 07:00:00,25,2,27
"3298",10102,"St Johns","NL",47.56038,-52.71147,2018-05-18 08:00:00,27,2,29
"3299",10102,"St Johns","NL",47.56038,-52.71147,2018-05-18 09:00:00,27,2,29
"3300",10102,"St Johns","NL",47.56038,-52.71147,2018-05-18 10:00:00,27,2,29
"3301",10102,"St Johns","NL",47.56038,-52.71147,2018-05-18 11:00:00,27,2,29
"3302",10102,"St Johns","NL",47.56038,-52.71147,2018-05-18 12:00:00,27,1,28
"3303",10102,"St Johns","NL",47.56038,-52.71147,2018-05-18 13:00:00,28,0,28
"3304",10102,"St Johns","NL",47.56038,-52.71147,2018-05-18 14:00:00,27,1,28
"3305",10102,"St Johns","NL",47.56038,-52.71147,2018-05-18 15:00:00,25,4,29
"3306",10102,"St Johns","NL",47.56038,-52.71147,2018-05-18 16:00:00,25,4,29
"3307",10102,"St Johns","NL",47.56038,-52.71147,2018-05-18 17:00:00,24,3,27
"3308",10102,"St Johns","NL",47.56038,-52.71147,2018-05-18 18:00:00,27,0,27
"3309",10102,"St Johns","NL",47.56038,-52.71147,2018-05-18 19:00:00,28,0,28
"3310",10102,"St Johns","NL",47.56038,-52.71147,2018-05-18 20:00:00,28,0,28
"3311",10102,"St Johns","NL",47.56038,-52.71147,2018-05-18 21:00:00,27,1,28
"3312",10102,"St Johns","NL",47.56038,-52.71147,2018-05-18 22:00:00,26,1,27
"3313",10102,"St Johns","NL",47.56038,-52.71147,2018-05-18 23:00:00,25,1,26
"3314",10102,"St Johns","NL",47.56038,-52.71147,2018-05-19 00:00:00,23,3,26
"3315",10102,"St Johns","NL",47.56038,-52.71147,2018-05-19 01:00:00,23,2,25
"3316",10102,"St Johns","NL",47.56038,-52.71147,2018-05-19 02:00:00,16,3,19
"3317",10102,"St Johns","NL",47.56038,-52.71147,2018-05-19 03:00:00,25,1,26
"3318",10102,"St Johns","NL",47.56038,-52.71147,2018-05-19 04:00:00,27,0,27
"3319",10102,"St Johns","NL",47.56038,-52.71147,2018-05-19 05:00:00,26,2,28
"3320",10102,"St Johns","NL",47.56038,-52.71147,2018-05-19 06:00:00,26,1,27
"3321",10102,"St Johns","NL",47.56038,-52.71147,2018-05-19 07:00:00,25,1,26
"3322",10102,"St Johns","NL",47.56038,-52.71147,2018-05-19 08:00:00,26,0,26
"3323",10102,"St Johns","NL",47.56038,-52.71147,2018-05-19 09:00:00,27,1,28
"3324",10102,"St Johns","NL",47.56038,-52.71147,2018-05-19 10:00:00,27,0,27
"3325",10102,"St Johns","NL",47.56038,-52.71147,2018-05-19 11:00:00,27,0,27
"3326",10102,"St Johns","NL",47.56038,-52.71147,2018-05-19 12:00:00,30,1,31
"3327",10102,"St Johns","NL",47.56038,-52.71147,2018-05-19 13:00:00,30,1,31
"3328",10102,"St Johns","NL",47.56038,-52.71147,2018-05-19 14:00:00,29,1,30
"3329",10102,"St Johns","NL",47.56038,-52.71147,2018-05-19 15:00:00,30,1,31
"3330",10102,"St Johns","NL",47.56038,-52.71147,2018-05-19 16:00:00,31,1,32
"3331",10102,"St Johns","NL",47.56038,-52.71147,2018-05-19 17:00:00,31,1,32
"3332",10102,"St Johns","NL",47.56038,-52.71147,2018-05-19 18:00:00,31,0,31
"3333",10102,"St Johns","NL",47.56038,-52.71147,2018-05-19 19:00:00,31,1,32
"3334",10102,"St Johns","NL",47.56038,-52.71147,2018-05-19 20:00:00,30,1,31
"3335",10102,"St Johns","NL",47.56038,-52.71147,2018-05-19 21:00:00,30,1,31
"3336",10102,"St Johns","NL",47.56038,-52.71147,2018-05-19 22:00:00,30,1,31
"3337",10102,"St Johns","NL",47.56038,-52.71147,2018-05-19 23:00:00,29,1,30
"3338",10102,"St Johns","NL",47.56038,-52.71147,2018-05-20 00:00:00,27,1,28
"3339",10102,"St Johns","NL",47.56038,-52.71147,2018-05-20 01:00:00,27,1,28
"3340",10102,"St Johns","NL",47.56038,-52.71147,2018-05-20 02:00:00,28,1,29
"3341",10102,"St Johns","NL",47.56038,-52.71147,2018-05-20 03:00:00,27,1,28
"3342",10102,"St Johns","NL",47.56038,-52.71147,2018-05-20 04:00:00,27,1,28
"3343",10102,"St Johns","NL",47.56038,-52.71147,2018-05-20 05:00:00,27,1,28
"3344",10102,"St Johns","NL",47.56038,-52.71147,2018-05-20 06:00:00,26,1,27
"3345",10102,"St Johns","NL",47.56038,-52.71147,2018-05-20 07:00:00,26,1,27
"3346",10102,"St Johns","NL",47.56038,-52.71147,2018-05-20 08:00:00,30,1,31
"3347",10102,"St Johns","NL",47.56038,-52.71147,2018-05-20 09:00:00,33,0,33
"3348",10102,"St Johns","NL",47.56038,-52.71147,2018-05-20 10:00:00,33,1,34
"3349",10102,"St Johns","NL",47.56038,-52.71147,2018-05-20 11:00:00,34,0,34
"3350",10102,"St Johns","NL",47.56038,-52.71147,2018-05-20 12:00:00,33,1,34
"3351",10102,"St Johns","NL",47.56038,-52.71147,2018-05-20 13:00:00,32,3,35
"3352",10102,"St Johns","NL",47.56038,-52.71147,2018-05-20 14:00:00,33,2,35
"3353",10102,"St Johns","NL",47.56038,-52.71147,2018-05-20 15:00:00,33,1,34
"3354",10102,"St Johns","NL",47.56038,-52.71147,2018-05-20 16:00:00,34,1,35
"3355",10102,"St Johns","NL",47.56038,-52.71147,2018-05-20 17:00:00,34,0,34
"3356",10102,"St Johns","NL",47.56038,-52.71147,2018-05-20 18:00:00,33,0,33
"3357",10102,"St Johns","NL",47.56038,-52.71147,2018-05-20 19:00:00,31,0,31
"3358",10102,"St Johns","NL",47.56038,-52.71147,2018-05-20 20:00:00,28,0,28
"3359",10102,"St Johns","NL",47.56038,-52.71147,2018-05-20 21:00:00,26,0,26
"3360",10102,"St Johns","NL",47.56038,-52.71147,2018-05-20 22:00:00,26,1,27
"3361",10102,"St Johns","NL",47.56038,-52.71147,2018-05-20 23:00:00,25,1,26
"3362",10102,"St Johns","NL",47.56038,-52.71147,2018-05-21 00:00:00,25,1,26
"3363",10102,"St Johns","NL",47.56038,-52.71147,2018-05-21 01:00:00,27,1,28
"3364",10102,"St Johns","NL",47.56038,-52.71147,2018-05-21 02:00:00,28,0,28
"3365",10102,"St Johns","NL",47.56038,-52.71147,2018-05-21 03:00:00,27,1,28
"3366",10102,"St Johns","NL",47.56038,-52.71147,2018-05-21 04:00:00,26,0,26
"3367",10102,"St Johns","NL",47.56038,-52.71147,2018-05-21 05:00:00,26,1,27
"3368",10102,"St Johns","NL",47.56038,-52.71147,2018-05-21 06:00:00,24,0,24
"3369",10102,"St Johns","NL",47.56038,-52.71147,2018-05-21 07:00:00,24,1,25
"3370",10102,"St Johns","NL",47.56038,-52.71147,2018-05-21 08:00:00,25,1,26
"3371",10102,"St Johns","NL",47.56038,-52.71147,2018-05-21 09:00:00,26,1,27
"3372",10102,"St Johns","NL",47.56038,-52.71147,2018-05-21 10:00:00,26,1,27
"3373",10102,"St Johns","NL",47.56038,-52.71147,2018-05-21 11:00:00,26,1,27
"3374",10102,"St Johns","NL",47.56038,-52.71147,2018-05-21 12:00:00,27,0,27
"3375",10102,"St Johns","NL",47.56038,-52.71147,2018-05-21 13:00:00,24,4,28
"3376",10102,"St Johns","NL",47.56038,-52.71147,2018-05-21 14:00:00,21,8,29
"3377",10102,"St Johns","NL",47.56038,-52.71147,2018-05-21 15:00:00,20,8,28
"3378",10102,"St Johns","NL",47.56038,-52.71147,2018-05-21 16:00:00,22,7,29
"3379",10102,"St Johns","NL",47.56038,-52.71147,2018-05-21 17:00:00,21,8,29
"3380",10102,"St Johns","NL",47.56038,-52.71147,2018-05-21 18:00:00,26,3,29
"3381",10102,"St Johns","NL",47.56038,-52.71147,2018-05-21 19:00:00,27,2,29
"3382",10102,"St Johns","NL",47.56038,-52.71147,2018-05-21 20:00:00,25,3,28
"3383",10102,"St Johns","NL",47.56038,-52.71147,2018-05-21 21:00:00,17,13,30
"3384",10102,"St Johns","NL",47.56038,-52.71147,2018-05-21 22:00:00,2,24,26
"3385",10102,"St Johns","NL",47.56038,-52.71147,2018-05-21 23:00:00,25,5,30
"3386",10102,"St Johns","NL",47.56038,-52.71147,2018-05-22 00:00:00,33,1,34
"3387",10102,"St Johns","NL",47.56038,-52.71147,2018-05-22 01:00:00,34,1,35
"3388",10102,"St Johns","NL",47.56038,-52.71147,2018-05-22 02:00:00,30,1,31
"3389",10102,"St Johns","NL",47.56038,-52.71147,2018-05-22 03:00:00,31,1,32
"3390",10102,"St Johns","NL",47.56038,-52.71147,2018-05-22 04:00:00,29,1,30
"3391",10102,"St Johns","NL",47.56038,-52.71147,2018-05-22 05:00:00,27,2,29
"3392",10102,"St Johns","NL",47.56038,-52.71147,2018-05-22 06:00:00,26,3,29
"3393",10102,"St Johns","NL",47.56038,-52.71147,2018-05-22 07:00:00,25,1,26
"3394",10102,"St Johns","NL",47.56038,-52.71147,2018-05-22 08:00:00,25,1,26
"3395",10102,"St Johns","NL",47.56038,-52.71147,2018-05-22 09:00:00,24,3,27
"3396",10102,"St Johns","NL",47.56038,-52.71147,2018-05-22 10:00:00,23,7,30
"3397",10102,"St Johns","NL",47.56038,-52.71147,2018-05-22 11:00:00,27,12,39
"3398",10102,"St Johns","NL",47.56038,-52.71147,2018-05-22 12:00:00,31,2,33
"3399",10102,"St Johns","NL",47.56038,-52.71147,2018-05-22 13:00:00,23,11,34
"3400",10102,"St Johns","NL",47.56038,-52.71147,2018-05-22 14:00:00,19,16,35
"3401",10102,"St Johns","NL",47.56038,-52.71147,2018-05-22 15:00:00,15,19,34
"3402",10102,"St Johns","NL",47.56038,-52.71147,2018-05-22 16:00:00,13,21,34
"3403",10102,"St Johns","NL",47.56038,-52.71147,2018-05-22 17:00:00,20,11,31
"3404",10102,"St Johns","NL",47.56038,-52.71147,2018-05-22 18:00:00,24,9,33
"3405",10102,"St Johns","NL",47.56038,-52.71147,2018-05-22 19:00:00,32,1,33
"3406",10102,"St Johns","NL",47.56038,-52.71147,2018-05-22 20:00:00,32,0,32
"3407",10102,"St Johns","NL",47.56038,-52.71147,2018-05-22 21:00:00,29,2,31
"3408",10102,"St Johns","NL",47.56038,-52.71147,2018-05-22 22:00:00,27,1,28
"3409",10102,"St Johns","NL",47.56038,-52.71147,2018-05-22 23:00:00,22,1,23
"3410",10102,"St Johns","NL",47.56038,-52.71147,2018-05-23 00:00:00,21,1,22
"3411",10102,"St Johns","NL",47.56038,-52.71147,2018-05-23 01:00:00,24,1,25
"3412",10102,"St Johns","NL",47.56038,-52.71147,2018-05-23 02:00:00,29,1,30
"3413",10102,"St Johns","NL",47.56038,-52.71147,2018-05-23 03:00:00,31,1,32
"3414",10102,"St Johns","NL",47.56038,-52.71147,2018-05-23 04:00:00,33,1,34
"3415",10102,"St Johns","NL",47.56038,-52.71147,2018-05-23 05:00:00,33,0,33
"3416",10102,"St Johns","NL",47.56038,-52.71147,2018-05-23 06:00:00,34,1,35
"3417",10102,"St Johns","NL",47.56038,-52.71147,2018-05-23 07:00:00,33,2,35
"3418",10102,"St Johns","NL",47.56038,-52.71147,2018-05-23 08:00:00,34,2,36
"3419",10102,"St Johns","NL",47.56038,-52.71147,2018-05-23 09:00:00,34,2,36
"3420",10102,"St Johns","NL",47.56038,-52.71147,2018-05-23 10:00:00,35,1,36
"3421",10102,"St Johns","NL",47.56038,-52.71147,2018-05-23 11:00:00,36,1,37
"3422",10102,"St Johns","NL",47.56038,-52.71147,2018-05-23 12:00:00,37,1,38
"3423",10102,"St Johns","NL",47.56038,-52.71147,2018-05-23 13:00:00,38,1,39
"3424",10102,"St Johns","NL",47.56038,-52.71147,2018-05-23 14:00:00,38,2,40
"3425",10102,"St Johns","NL",47.56038,-52.71147,2018-05-23 15:00:00,37,3,40
"3426",10102,"St Johns","NL",47.56038,-52.71147,2018-05-23 16:00:00,37,2,39
"3427",10102,"St Johns","NL",47.56038,-52.71147,2018-05-23 17:00:00,34,5,39
"3428",10102,"St Johns","NL",47.56038,-52.71147,2018-05-23 18:00:00,34,3,37
"3429",10102,"St Johns","NL",47.56038,-52.71147,2018-05-23 19:00:00,28,5,33
"3430",10102,"St Johns","NL",47.56038,-52.71147,2018-05-23 20:00:00,4,30,34
"3431",10102,"St Johns","NL",47.56038,-52.71147,2018-05-23 21:00:00,6,28,34
"3432",10102,"St Johns","NL",47.56038,-52.71147,2018-05-23 22:00:00,21,17,38
"3433",10102,"St Johns","NL",47.56038,-52.71147,2018-05-23 23:00:00,21,16,37
"3434",10102,"St Johns","NL",47.56038,-52.71147,2018-05-24 00:00:00,23,14,37
"3435",10102,"St Johns","NL",47.56038,-52.71147,2018-05-24 01:00:00,20,17,37
"3436",10102,"St Johns","NL",47.56038,-52.71147,2018-05-24 02:00:00,16,18,34
"3437",10102,"St Johns","NL",47.56038,-52.71147,2018-05-24 03:00:00,8,29,37
"3438",10102,"St Johns","NL",47.56038,-52.71147,2018-05-24 04:00:00,21,16,37
"3439",10102,"St Johns","NL",47.56038,-52.71147,2018-05-24 05:00:00,12,25,37
"3440",10102,"St Johns","NL",47.56038,-52.71147,2018-05-24 06:00:00,29,6,35
"3441",10102,"St Johns","NL",47.56038,-52.71147,2018-05-24 07:00:00,26,10,36
"3442",10102,"St Johns","NL",47.56038,-52.71147,2018-05-24 08:00:00,29,5,34
"3443",10102,"St Johns","NL",47.56038,-52.71147,2018-05-24 09:00:00,29,5,34
"3444",10102,"St Johns","NL",47.56038,-52.71147,2018-05-24 10:00:00,29,2,31
"3445",10102,"St Johns","NL",47.56038,-52.71147,2018-05-24 11:00:00,28,8,36
"3446",10102,"St Johns","NL",47.56038,-52.71147,2018-05-24 12:00:00,28,1,29
"3447",10102,"St Johns","NL",47.56038,-52.71147,2018-05-24 13:00:00,26,3,29
"3448",10102,"St Johns","NL",47.56038,-52.71147,2018-05-24 14:00:00,28,3,31
"3449",10102,"St Johns","NL",47.56038,-52.71147,2018-05-24 15:00:00,30,1,31
"3450",10102,"St Johns","NL",47.56038,-52.71147,2018-05-24 16:00:00,30,1,31
"3451",10102,"St Johns","NL",47.56038,-52.71147,2018-05-24 17:00:00,30,1,31
"3452",10102,"St Johns","NL",47.56038,-52.71147,2018-05-24 18:00:00,30,0,30
"3453",10102,"St Johns","NL",47.56038,-52.71147,2018-05-24 19:00:00,27,1,28
"3454",10102,"St Johns","NL",47.56038,-52.71147,2018-05-24 20:00:00,24,10,34
"3455",10102,"St Johns","NL",47.56038,-52.71147,2018-05-24 21:00:00,25,1,26
"3456",10102,"St Johns","NL",47.56038,-52.71147,2018-05-24 22:00:00,24,1,25
"3457",10102,"St Johns","NL",47.56038,-52.71147,2018-05-24 23:00:00,24,1,25
"3458",10102,"St Johns","NL",47.56038,-52.71147,2018-05-25 00:00:00,24,1,25
"3459",10102,"St Johns","NL",47.56038,-52.71147,2018-05-25 01:00:00,23,1,24
"3460",10102,"St Johns","NL",47.56038,-52.71147,2018-05-25 02:00:00,22,1,23
"3461",10102,"St Johns","NL",47.56038,-52.71147,2018-05-25 03:00:00,22,1,23
"3462",10102,"St Johns","NL",47.56038,-52.71147,2018-05-25 04:00:00,22,1,23
"3463",10102,"St Johns","NL",47.56038,-52.71147,2018-05-25 05:00:00,21,1,22
"3464",10102,"St Johns","NL",47.56038,-52.71147,2018-05-25 06:00:00,21,2,23
"3465",10102,"St Johns","NL",47.56038,-52.71147,2018-05-25 07:00:00,23,2,25
"3466",10102,"St Johns","NL",47.56038,-52.71147,2018-05-25 08:00:00,25,2,27
"3467",10102,"St Johns","NL",47.56038,-52.71147,2018-05-25 09:00:00,24,5,29
"3468",10102,"St Johns","NL",47.56038,-52.71147,2018-05-25 10:00:00,24,8,32
"3469",10102,"St Johns","NL",47.56038,-52.71147,2018-05-25 11:00:00,25,7,32
"3470",10102,"St Johns","NL",47.56038,-52.71147,2018-05-25 12:00:00,24,7,31
"3471",10102,"St Johns","NL",47.56038,-52.71147,2018-05-25 13:00:00,24,7,31
"3472",10102,"St Johns","NL",47.56038,-52.71147,2018-05-25 14:00:00,25,7,32
"3473",10102,"St Johns","NL",47.56038,-52.71147,2018-05-25 15:00:00,27,3,30
"3474",10102,"St Johns","NL",47.56038,-52.71147,2018-05-25 16:00:00,25,6,31
"3475",10102,"St Johns","NL",47.56038,-52.71147,2018-05-25 17:00:00,26,5,31
"3476",10102,"St Johns","NL",47.56038,-52.71147,2018-05-25 18:00:00,28,4,32
"3477",10102,"St Johns","NL",47.56038,-52.71147,2018-05-25 19:00:00,29,3,32
"3478",10102,"St Johns","NL",47.56038,-52.71147,2018-05-25 20:00:00,29,3,32
"3479",10102,"St Johns","NL",47.56038,-52.71147,2018-05-25 21:00:00,29,3,32
"3480",10102,"St Johns","NL",47.56038,-52.71147,2018-05-25 22:00:00,29,3,32
"3481",10102,"St Johns","NL",47.56038,-52.71147,2018-05-25 23:00:00,30,2,32
"3482",10102,"St Johns","NL",47.56038,-52.71147,2018-05-26 00:00:00,31,2,33
"3483",10102,"St Johns","NL",47.56038,-52.71147,2018-05-26 01:00:00,33,1,34
"3484",10102,"St Johns","NL",47.56038,-52.71147,2018-05-26 02:00:00,33,3,36
"3485",10102,"St Johns","NL",47.56038,-52.71147,2018-05-26 03:00:00,34,3,37
"3486",10102,"St Johns","NL",47.56038,-52.71147,2018-05-26 04:00:00,36,1,37
"3487",10102,"St Johns","NL",47.56038,-52.71147,2018-05-26 05:00:00,36,1,37
"3488",10102,"St Johns","NL",47.56038,-52.71147,2018-05-26 06:00:00,32,3,35
"3489",10102,"St Johns","NL",47.56038,-52.71147,2018-05-26 07:00:00,26,7,33
"3490",10102,"St Johns","NL",47.56038,-52.71147,2018-05-26 08:00:00,25,9,34
"3491",10102,"St Johns","NL",47.56038,-52.71147,2018-05-26 09:00:00,28,4,32
"3492",10102,"St Johns","NL",47.56038,-52.71147,2018-05-26 10:00:00,27,6,33
"3493",10102,"St Johns","NL",47.56038,-52.71147,2018-05-26 11:00:00,29,2,31
"3494",10102,"St Johns","NL",47.56038,-52.71147,2018-05-26 12:00:00,29,2,31
"3495",10102,"St Johns","NL",47.56038,-52.71147,2018-05-26 13:00:00,30,1,31
"3496",10102,"St Johns","NL",47.56038,-52.71147,2018-05-26 14:00:00,29,2,31
"3497",10102,"St Johns","NL",47.56038,-52.71147,2018-05-26 15:00:00,30,2,32
"3498",10102,"St Johns","NL",47.56038,-52.71147,2018-05-26 16:00:00,28,2,30
"3499",10102,"St Johns","NL",47.56038,-52.71147,2018-05-26 17:00:00,23,6,29
"3500",10102,"St Johns","NL",47.56038,-52.71147,2018-05-26 18:00:00,25,6,31
"3501",10102,"St Johns","NL",47.56038,-52.71147,2018-05-26 19:00:00,24,7,31
"3502",10102,"St Johns","NL",47.56038,-52.71147,2018-05-26 20:00:00,21,9,30
"3503",10102,"St Johns","NL",47.56038,-52.71147,2018-05-26 21:00:00,21,10,31
"3504",10102,"St Johns","NL",47.56038,-52.71147,2018-05-26 22:00:00,26,6,32
"3505",10102,"St Johns","NL",47.56038,-52.71147,2018-05-26 23:00:00,28,3,31
"3506",10102,"St Johns","NL",47.56038,-52.71147,2018-05-27 00:00:00,24,6,30
"3507",10102,"St Johns","NL",47.56038,-52.71147,2018-05-27 01:00:00,26,3,29
"3508",10102,"St Johns","NL",47.56038,-52.71147,2018-05-27 02:00:00,24,3,27
"3509",10102,"St Johns","NL",47.56038,-52.71147,2018-05-27 03:00:00,25,2,27
"3510",10102,"St Johns","NL",47.56038,-52.71147,2018-05-27 04:00:00,27,2,29
"3511",10102,"St Johns","NL",47.56038,-52.71147,2018-05-27 05:00:00,29,1,30
"3512",10102,"St Johns","NL",47.56038,-52.71147,2018-05-27 06:00:00,28,1,29
"3513",10102,"St Johns","NL",47.56038,-52.71147,2018-05-27 07:00:00,28,0,28
"3514",10102,"St Johns","NL",47.56038,-52.71147,2018-05-27 08:00:00,27,1,28
"3515",10102,"St Johns","NL",47.56038,-52.71147,2018-05-27 09:00:00,27,1,28
"3516",10102,"St Johns","NL",47.56038,-52.71147,2018-05-27 10:00:00,28,1,29
"3517",10102,"St Johns","NL",47.56038,-52.71147,2018-05-27 11:00:00,29,1,30
"3518",10102,"St Johns","NL",47.56038,-52.71147,2018-05-27 12:00:00,28,1,29
"3519",10102,"St Johns","NL",47.56038,-52.71147,2018-05-27 13:00:00,28,1,29
"3520",10102,"St Johns","NL",47.56038,-52.71147,2018-05-27 14:00:00,30,2,32
"3521",10102,"St Johns","NL",47.56038,-52.71147,2018-05-27 15:00:00,30,2,32
"3522",10102,"St Johns","NL",47.56038,-52.71147,2018-05-27 16:00:00,29,2,31
"3523",10102,"St Johns","NL",47.56038,-52.71147,2018-05-27 17:00:00,29,2,31
"3524",10102,"St Johns","NL",47.56038,-52.71147,2018-05-27 18:00:00,16,15,31
"3525",10102,"St Johns","NL",47.56038,-52.71147,2018-05-27 19:00:00,12,18,30
"3526",10102,"St Johns","NL",47.56038,-52.71147,2018-05-27 20:00:00,7,22,29
"3527",10102,"St Johns","NL",47.56038,-52.71147,2018-05-27 21:00:00,3,27,30
"3528",10102,"St Johns","NL",47.56038,-52.71147,2018-05-27 22:00:00,5,22,27
"3529",10102,"St Johns","NL",47.56038,-52.71147,2018-05-27 23:00:00,14,14,28
"3530",10102,"St Johns","NL",47.56038,-52.71147,2018-05-28 00:00:00,16,13,29
"3531",10102,"St Johns","NL",47.56038,-52.71147,2018-05-28 01:00:00,20,5,25
"3532",10102,"St Johns","NL",47.56038,-52.71147,2018-05-28 02:00:00,13,11,24
"3533",10102,"St Johns","NL",47.56038,-52.71147,2018-05-28 03:00:00,2,19,21
"3534",10102,"St Johns","NL",47.56038,-52.71147,2018-05-28 04:00:00,2,17,19
"3535",10102,"St Johns","NL",47.56038,-52.71147,2018-05-28 05:00:00,2,17,19
"3536",10102,"St Johns","NL",47.56038,-52.71147,2018-05-28 06:00:00,5,12,17
"3537",10102,"St Johns","NL",47.56038,-52.71147,2018-05-28 07:00:00,11,15,26
"3538",10102,"St Johns","NL",47.56038,-52.71147,2018-05-28 08:00:00,8,42,50
"3539",10102,"St Johns","NL",47.56038,-52.71147,2018-05-28 09:00:00,10,38,48
"3540",10102,"St Johns","NL",47.56038,-52.71147,2018-05-28 10:00:00,11,38,49
"3541",10102,"St Johns","NL",47.56038,-52.71147,2018-05-28 11:00:00,22,13,35
"3542",10102,"St Johns","NL",47.56038,-52.71147,2018-05-28 12:00:00,17,13,30
"3543",10102,"St Johns","NL",47.56038,-52.71147,2018-05-28 13:00:00,17,15,32
"3544",10102,"St Johns","NL",47.56038,-52.71147,2018-05-28 14:00:00,21,14,35
"3545",10102,"St Johns","NL",47.56038,-52.71147,2018-05-28 15:00:00,24,8,32
"3546",10102,"St Johns","NL",47.56038,-52.71147,2018-05-28 16:00:00,19,13,32
"3547",10102,"St Johns","NL",47.56038,-52.71147,2018-05-28 17:00:00,24,9,33
"3548",10102,"St Johns","NL",47.56038,-52.71147,2018-05-28 18:00:00,31,4,35
"3549",10102,"St Johns","NL",47.56038,-52.71147,2018-05-28 19:00:00,29,4,33
"3550",10102,"St Johns","NL",47.56038,-52.71147,2018-05-28 20:00:00,26,6,32
"3551",10102,"St Johns","NL",47.56038,-52.71147,2018-05-28 21:00:00,26,4,30
"3552",10102,"St Johns","NL",47.56038,-52.71147,2018-05-28 22:00:00,27,2,29
"3553",10102,"St Johns","NL",47.56038,-52.71147,2018-05-28 23:00:00,27,3,30
"3554",10102,"St Johns","NL",47.56038,-52.71147,2018-05-29 00:00:00,26,2,28
"3555",10102,"St Johns","NL",47.56038,-52.71147,2018-05-29 01:00:00,25,2,27
"3556",10102,"St Johns","NL",47.56038,-52.71147,2018-05-29 02:00:00,24,2,26
"3557",10102,"St Johns","NL",47.56038,-52.71147,2018-05-29 03:00:00,26,2,28
"3558",10102,"St Johns","NL",47.56038,-52.71147,2018-05-29 04:00:00,27,2,29
"3559",10102,"St Johns","NL",47.56038,-52.71147,2018-05-29 05:00:00,27,3,30
"3560",10102,"St Johns","NL",47.56038,-52.71147,2018-05-29 06:00:00,26,4,30
"3561",10102,"St Johns","NL",47.56038,-52.71147,2018-05-29 07:00:00,29,5,34
"3562",10102,"St Johns","NL",47.56038,-52.71147,2018-05-29 08:00:00,28,7,35
"3563",10102,"St Johns","NL",47.56038,-52.71147,2018-05-29 09:00:00,31,3,34
"3564",10102,"St Johns","NL",47.56038,-52.71147,2018-05-29 10:00:00,29,6,35
"3565",10102,"St Johns","NL",47.56038,-52.71147,2018-05-29 11:00:00,25,8,33
"3566",10102,"St Johns","NL",47.56038,-52.71147,2018-05-29 12:00:00,NA,7,NA
"3567",10102,"St Johns","NL",47.56038,-52.71147,2018-05-29 13:00:00,29,7,36
"3568",10102,"St Johns","NL",47.56038,-52.71147,2018-05-29 14:00:00,31,3,34
"3569",10102,"St Johns","NL",47.56038,-52.71147,2018-05-29 15:00:00,32,4,36
"3570",10102,"St Johns","NL",47.56038,-52.71147,2018-05-29 16:00:00,31,5,36
"3571",10102,"St Johns","NL",47.56038,-52.71147,2018-05-29 17:00:00,23,11,34
"3572",10102,"St Johns","NL",47.56038,-52.71147,2018-05-29 18:00:00,19,18,37
"3573",10102,"St Johns","NL",47.56038,-52.71147,2018-05-29 19:00:00,17,19,36
"3574",10102,"St Johns","NL",47.56038,-52.71147,2018-05-29 20:00:00,18,18,36
"3575",10102,"St Johns","NL",47.56038,-52.71147,2018-05-29 21:00:00,18,21,39
"3576",10102,"St Johns","NL",47.56038,-52.71147,2018-05-29 22:00:00,20,26,46
"3577",10102,"St Johns","NL",47.56038,-52.71147,2018-05-29 23:00:00,10,37,47
"3578",10102,"St Johns","NL",47.56038,-52.71147,2018-05-30 00:00:00,11,42,53
"3579",10102,"St Johns","NL",47.56038,-52.71147,2018-05-30 01:00:00,16,31,47
"3580",10102,"St Johns","NL",47.56038,-52.71147,2018-05-30 02:00:00,15,32,47
"3581",10102,"St Johns","NL",47.56038,-52.71147,2018-05-30 03:00:00,10,40,50
"3582",10102,"St Johns","NL",47.56038,-52.71147,2018-05-30 04:00:00,20,27,47
"3583",10102,"St Johns","NL",47.56038,-52.71147,2018-05-30 05:00:00,29,19,48
"3584",10102,"St Johns","NL",47.56038,-52.71147,2018-05-30 06:00:00,29,16,45
"3585",10102,"St Johns","NL",47.56038,-52.71147,2018-05-30 07:00:00,34,16,50
"3586",10102,"St Johns","NL",47.56038,-52.71147,2018-05-30 08:00:00,34,16,50
"3587",10102,"St Johns","NL",47.56038,-52.71147,2018-05-30 09:00:00,28,22,50
"3588",10102,"St Johns","NL",47.56038,-52.71147,2018-05-30 10:00:00,24,38,62
"3589",10102,"St Johns","NL",47.56038,-52.71147,2018-05-30 11:00:00,22,35,57
"3590",10102,"St Johns","NL",47.56038,-52.71147,2018-05-30 12:00:00,24,32,56
"3591",10102,"St Johns","NL",47.56038,-52.71147,2018-05-30 13:00:00,29,22,51
"3592",10102,"St Johns","NL",47.56038,-52.71147,2018-05-30 14:00:00,35,9,44
"3593",10102,"St Johns","NL",47.56038,-52.71147,2018-05-30 15:00:00,33,11,44
"3594",10102,"St Johns","NL",47.56038,-52.71147,2018-05-30 16:00:00,37,4,41
"3595",10102,"St Johns","NL",47.56038,-52.71147,2018-05-30 17:00:00,37,1,38
"3596",10102,"St Johns","NL",47.56038,-52.71147,2018-05-30 18:00:00,37,4,41
"3597",10102,"St Johns","NL",47.56038,-52.71147,2018-05-30 19:00:00,38,3,41
"3598",10102,"St Johns","NL",47.56038,-52.71147,2018-05-30 20:00:00,39,1,40
"3599",10102,"St Johns","NL",47.56038,-52.71147,2018-05-30 21:00:00,38,1,39
"3600",10102,"St Johns","NL",47.56038,-52.71147,2018-05-30 22:00:00,36,1,37
"3601",10102,"St Johns","NL",47.56038,-52.71147,2018-05-30 23:00:00,36,0,36
"3602",10102,"St Johns","NL",47.56038,-52.71147,2018-05-31 00:00:00,37,1,38
"3603",10102,"St Johns","NL",47.56038,-52.71147,2018-05-31 01:00:00,37,1,38
"3604",10102,"St Johns","NL",47.56038,-52.71147,2018-05-31 02:00:00,36,1,37
"3605",10102,"St Johns","NL",47.56038,-52.71147,2018-05-31 03:00:00,35,1,36
"3606",10102,"St Johns","NL",47.56038,-52.71147,2018-05-31 04:00:00,34,1,35
"3607",10102,"St Johns","NL",47.56038,-52.71147,2018-05-31 05:00:00,34,0,34
"3608",10102,"St Johns","NL",47.56038,-52.71147,2018-05-31 06:00:00,33,1,34
"3609",10102,"St Johns","NL",47.56038,-52.71147,2018-05-31 07:00:00,30,5,35
"3610",10102,"St Johns","NL",47.56038,-52.71147,2018-05-31 08:00:00,30,4,34
"3611",10102,"St Johns","NL",47.56038,-52.71147,2018-05-31 09:00:00,26,13,39
"3612",10102,"St Johns","NL",47.56038,-52.71147,2018-05-31 10:00:00,25,11,36
"3613",10102,"St Johns","NL",47.56038,-52.71147,2018-05-31 11:00:00,30,4,34
"3614",10102,"St Johns","NL",47.56038,-52.71147,2018-05-31 12:00:00,30,6,36
"3615",10102,"St Johns","NL",47.56038,-52.71147,2018-05-31 13:00:00,31,3,34
"3616",10102,"St Johns","NL",47.56038,-52.71147,2018-05-31 14:00:00,31,3,34
"3617",10102,"St Johns","NL",47.56038,-52.71147,2018-05-31 15:00:00,29,6,35
"3618",10102,"St Johns","NL",47.56038,-52.71147,2018-05-31 16:00:00,29,6,35
"3619",10102,"St Johns","NL",47.56038,-52.71147,2018-05-31 17:00:00,27,8,35
"3620",10102,"St Johns","NL",47.56038,-52.71147,2018-05-31 18:00:00,25,10,35
"3621",10102,"St Johns","NL",47.56038,-52.71147,2018-05-31 19:00:00,30,2,32
"3622",10102,"St Johns","NL",47.56038,-52.71147,2018-05-31 20:00:00,29,3,32
"3623",10102,"St Johns","NL",47.56038,-52.71147,2018-05-31 21:00:00,29,3,32
"3624",10102,"St Johns","NL",47.56038,-52.71147,2018-05-31 22:00:00,29,2,31
"3625",10102,"St Johns","NL",47.56038,-52.71147,2018-05-31 23:00:00,28,4,32
"3626",10102,"St Johns","NL",47.56038,-52.71147,2018-06-01 00:00:00,29,1,30
"3627",10102,"St Johns","NL",47.56038,-52.71147,2018-06-01 01:00:00,28,2,30
"3628",10102,"St Johns","NL",47.56038,-52.71147,2018-06-01 02:00:00,26,4,30
"3629",10102,"St Johns","NL",47.56038,-52.71147,2018-06-01 03:00:00,24,6,30
"3630",10102,"St Johns","NL",47.56038,-52.71147,2018-06-01 04:00:00,26,4,30
"3631",10102,"St Johns","NL",47.56038,-52.71147,2018-06-01 05:00:00,24,6,30
"3632",10102,"St Johns","NL",47.56038,-52.71147,2018-06-01 06:00:00,25,4,29
"3633",10102,"St Johns","NL",47.56038,-52.71147,2018-06-01 07:00:00,21,8,29
"3634",10102,"St Johns","NL",47.56038,-52.71147,2018-06-01 08:00:00,21,11,32
"3635",10102,"St Johns","NL",47.56038,-52.71147,2018-06-01 09:00:00,20,9,29
"3636",10102,"St Johns","NL",47.56038,-52.71147,2018-06-01 10:00:00,16,16,32
"3637",10102,"St Johns","NL",47.56038,-52.71147,2018-06-01 11:00:00,18,11,29
"3638",10102,"St Johns","NL",47.56038,-52.71147,2018-06-01 12:00:00,18,10,28
"3639",10102,"St Johns","NL",47.56038,-52.71147,2018-06-01 13:00:00,19,8,27
"3640",10102,"St Johns","NL",47.56038,-52.71147,2018-06-01 14:00:00,21,9,30
"3641",10102,"St Johns","NL",47.56038,-52.71147,2018-06-01 15:00:00,14,31,45
"3642",10102,"St Johns","NL",47.56038,-52.71147,2018-06-01 16:00:00,21,9,30
"3643",10102,"St Johns","NL",47.56038,-52.71147,2018-06-01 17:00:00,19,9,28
"3644",10102,"St Johns","NL",47.56038,-52.71147,2018-06-01 18:00:00,20,13,33
"3645",10102,"St Johns","NL",47.56038,-52.71147,2018-06-01 19:00:00,15,14,29
"3646",10102,"St Johns","NL",47.56038,-52.71147,2018-06-01 20:00:00,7,18,25
"3647",10102,"St Johns","NL",47.56038,-52.71147,2018-06-01 21:00:00,23,3,26
"3648",10102,"St Johns","NL",47.56038,-52.71147,2018-06-01 22:00:00,13,12,25
"3649",10102,"St Johns","NL",47.56038,-52.71147,2018-06-01 23:00:00,11,15,26
"3650",10102,"St Johns","NL",47.56038,-52.71147,2018-06-02 00:00:00,19,10,29
"3651",10102,"St Johns","NL",47.56038,-52.71147,2018-06-02 01:00:00,22,6,28
"3652",10102,"St Johns","NL",47.56038,-52.71147,2018-06-02 02:00:00,16,11,27
"3653",10102,"St Johns","NL",47.56038,-52.71147,2018-06-02 03:00:00,20,10,30
"3654",10102,"St Johns","NL",47.56038,-52.71147,2018-06-02 04:00:00,27,5,32
"3655",10102,"St Johns","NL",47.56038,-52.71147,2018-06-02 05:00:00,19,13,32
"3656",10102,"St Johns","NL",47.56038,-52.71147,2018-06-02 06:00:00,19,15,34
"3657",10102,"St Johns","NL",47.56038,-52.71147,2018-06-02 07:00:00,14,23,37
"3658",10102,"St Johns","NL",47.56038,-52.71147,2018-06-02 08:00:00,14,21,35
"3659",10102,"St Johns","NL",47.56038,-52.71147,2018-06-02 09:00:00,20,14,34
"3660",10102,"St Johns","NL",47.56038,-52.71147,2018-06-02 10:00:00,22,25,47
"3661",10102,"St Johns","NL",47.56038,-52.71147,2018-06-02 11:00:00,23,25,48
"3662",10102,"St Johns","NL",47.56038,-52.71147,2018-06-02 12:00:00,39,22,61
"3663",10102,"St Johns","NL",47.56038,-52.71147,2018-06-02 13:00:00,NA,23,NA
"3664",10102,"St Johns","NL",47.56038,-52.71147,2018-06-02 14:00:00,NA,18,NA
"3665",10102,"St Johns","NL",47.56038,-52.71147,2018-06-02 15:00:00,26,49,75
"3666",10102,"St Johns","NL",47.56038,-52.71147,2018-06-02 16:00:00,10,49,59
"3667",10102,"St Johns","NL",47.56038,-52.71147,2018-06-02 17:00:00,13,36,49
"3668",10102,"St Johns","NL",47.56038,-52.71147,2018-06-02 18:00:00,13,43,56
"3669",10102,"St Johns","NL",47.56038,-52.71147,2018-06-02 19:00:00,15,34,49
"3670",10102,"St Johns","NL",47.56038,-52.71147,2018-06-02 20:00:00,16,31,47
"3671",10102,"St Johns","NL",47.56038,-52.71147,2018-06-02 21:00:00,16,27,43
"3672",10102,"St Johns","NL",47.56038,-52.71147,2018-06-02 22:00:00,17,26,43
"3673",10102,"St Johns","NL",47.56038,-52.71147,2018-06-02 23:00:00,17,27,44
"3674",10102,"St Johns","NL",47.56038,-52.71147,2018-06-03 00:00:00,19,28,47
"3675",10102,"St Johns","NL",47.56038,-52.71147,2018-06-03 01:00:00,15,23,38
"3676",10102,"St Johns","NL",47.56038,-52.71147,2018-06-03 02:00:00,23,6,29
"3677",10102,"St Johns","NL",47.56038,-52.71147,2018-06-03 03:00:00,26,2,28
"3678",10102,"St Johns","NL",47.56038,-52.71147,2018-06-03 04:00:00,26,2,28
"3679",10102,"St Johns","NL",47.56038,-52.71147,2018-06-03 05:00:00,25,2,27
"3680",10102,"St Johns","NL",47.56038,-52.71147,2018-06-03 06:00:00,25,1,26
"3681",10102,"St Johns","NL",47.56038,-52.71147,2018-06-03 07:00:00,25,1,26
"3682",10102,"St Johns","NL",47.56038,-52.71147,2018-06-03 08:00:00,24,2,26
"3683",10102,"St Johns","NL",47.56038,-52.71147,2018-06-03 09:00:00,25,1,26
"3684",10102,"St Johns","NL",47.56038,-52.71147,2018-06-03 10:00:00,26,1,27
"3685",10102,"St Johns","NL",47.56038,-52.71147,2018-06-03 11:00:00,26,1,27
"3686",10102,"St Johns","NL",47.56038,-52.71147,2018-06-03 12:00:00,25,1,26
"3687",10102,"St Johns","NL",47.56038,-52.71147,2018-06-03 13:00:00,25,1,26
"3688",10102,"St Johns","NL",47.56038,-52.71147,2018-06-03 14:00:00,24,4,28
"3689",10102,"St Johns","NL",47.56038,-52.71147,2018-06-03 15:00:00,22,8,30
"3690",10102,"St Johns","NL",47.56038,-52.71147,2018-06-03 16:00:00,23,0,23
"3691",10102,"St Johns","NL",47.56038,-52.71147,2018-06-03 17:00:00,23,0,23
"3692",10102,"St Johns","NL",47.56038,-52.71147,2018-06-03 18:00:00,23,1,24
"3693",10102,"St Johns","NL",47.56038,-52.71147,2018-06-03 19:00:00,23,1,24
"3694",10102,"St Johns","NL",47.56038,-52.71147,2018-06-03 20:00:00,23,1,24
"3695",10102,"St Johns","NL",47.56038,-52.71147,2018-06-03 21:00:00,24,0,24
"3696",10102,"St Johns","NL",47.56038,-52.71147,2018-06-03 22:00:00,23,1,24
"3697",10102,"St Johns","NL",47.56038,-52.71147,2018-06-03 23:00:00,23,0,23
"3698",10102,"St Johns","NL",47.56038,-52.71147,2018-06-04 00:00:00,23,0,23
"3699",10102,"St Johns","NL",47.56038,-52.71147,2018-06-04 01:00:00,22,0,22
"3700",10102,"St Johns","NL",47.56038,-52.71147,2018-06-04 02:00:00,21,0,21
"3701",10102,"St Johns","NL",47.56038,-52.71147,2018-06-04 03:00:00,20,0,20
"3702",10102,"St Johns","NL",47.56038,-52.71147,2018-06-04 04:00:00,20,0,20
"3703",10102,"St Johns","NL",47.56038,-52.71147,2018-06-04 05:00:00,19,0,19
"3704",10102,"St Johns","NL",47.56038,-52.71147,2018-06-04 06:00:00,18,0,18
"3705",10102,"St Johns","NL",47.56038,-52.71147,2018-06-04 07:00:00,19,2,21
"3706",10102,"St Johns","NL",47.56038,-52.71147,2018-06-04 08:00:00,20,3,23
"3707",10102,"St Johns","NL",47.56038,-52.71147,2018-06-04 09:00:00,22,2,24
"3708",10102,"St Johns","NL",47.56038,-52.71147,2018-06-04 10:00:00,22,1,23
"3709",10102,"St Johns","NL",47.56038,-52.71147,2018-06-04 11:00:00,22,1,23
"3710",10102,"St Johns","NL",47.56038,-52.71147,2018-06-04 12:00:00,22,2,24
"3711",10102,"St Johns","NL",47.56038,-52.71147,2018-06-04 13:00:00,22,3,25
"3712",10102,"St Johns","NL",47.56038,-52.71147,2018-06-04 14:00:00,23,3,26
"3713",10102,"St Johns","NL",47.56038,-52.71147,2018-06-04 15:00:00,21,6,27
"3714",10102,"St Johns","NL",47.56038,-52.71147,2018-06-04 16:00:00,23,3,26
"3715",10102,"St Johns","NL",47.56038,-52.71147,2018-06-04 17:00:00,23,3,26
"3716",10102,"St Johns","NL",47.56038,-52.71147,2018-06-04 18:00:00,21,9,30
"3717",10102,"St Johns","NL",47.56038,-52.71147,2018-06-04 19:00:00,22,8,30
"3718",10102,"St Johns","NL",47.56038,-52.71147,2018-06-04 20:00:00,23,5,28
"3719",10102,"St Johns","NL",47.56038,-52.71147,2018-06-04 21:00:00,20,6,26
"3720",10102,"St Johns","NL",47.56038,-52.71147,2018-06-04 22:00:00,19,5,24
"3721",10102,"St Johns","NL",47.56038,-52.71147,2018-06-04 23:00:00,19,4,23
"3722",10102,"St Johns","NL",47.56038,-52.71147,2018-06-05 00:00:00,21,4,25
"3723",10102,"St Johns","NL",47.56038,-52.71147,2018-06-05 01:00:00,20,3,23
"3724",10102,"St Johns","NL",47.56038,-52.71147,2018-06-05 02:00:00,20,3,23
"3725",10102,"St Johns","NL",47.56038,-52.71147,2018-06-05 03:00:00,20,2,22
"3726",10102,"St Johns","NL",47.56038,-52.71147,2018-06-05 04:00:00,20,2,22
"3727",10102,"St Johns","NL",47.56038,-52.71147,2018-06-05 05:00:00,20,3,23
"3728",10102,"St Johns","NL",47.56038,-52.71147,2018-06-05 06:00:00,19,4,23
"3729",10102,"St Johns","NL",47.56038,-52.71147,2018-06-05 07:00:00,20,7,27
"3730",10102,"St Johns","NL",47.56038,-52.71147,2018-06-05 08:00:00,23,4,27
"3731",10102,"St Johns","NL",47.56038,-52.71147,2018-06-05 09:00:00,25,7,32
"3732",10102,"St Johns","NL",47.56038,-52.71147,2018-06-05 10:00:00,26,3,29
"3733",10102,"St Johns","NL",47.56038,-52.71147,2018-06-05 11:00:00,29,1,30
"3734",10102,"St Johns","NL",47.56038,-52.71147,2018-06-05 12:00:00,25,10,35
"3735",10102,"St Johns","NL",47.56038,-52.71147,2018-06-05 13:00:00,12,20,32
"3736",10102,"St Johns","NL",47.56038,-52.71147,2018-06-05 14:00:00,13,22,35
"3737",10102,"St Johns","NL",47.56038,-52.71147,2018-06-05 15:00:00,24,6,30
"3738",10102,"St Johns","NL",47.56038,-52.71147,2018-06-05 16:00:00,24,5,29
"3739",10102,"St Johns","NL",47.56038,-52.71147,2018-06-05 17:00:00,24,4,28
"3740",10102,"St Johns","NL",47.56038,-52.71147,2018-06-05 18:00:00,19,8,27
"3741",10102,"St Johns","NL",47.56038,-52.71147,2018-06-05 19:00:00,23,1,24
"3742",10102,"St Johns","NL",47.56038,-52.71147,2018-06-05 20:00:00,21,5,26
"3743",10102,"St Johns","NL",47.56038,-52.71147,2018-06-05 21:00:00,21,3,24
"3744",10102,"St Johns","NL",47.56038,-52.71147,2018-06-05 22:00:00,27,1,28
"3745",10102,"St Johns","NL",47.56038,-52.71147,2018-06-05 23:00:00,29,3,32
"3746",10102,"St Johns","NL",47.56038,-52.71147,2018-06-06 00:00:00,13,19,32
"3747",10102,"St Johns","NL",47.56038,-52.71147,2018-06-06 01:00:00,20,8,28
"3748",10102,"St Johns","NL",47.56038,-52.71147,2018-06-06 02:00:00,25,6,31
"3749",10102,"St Johns","NL",47.56038,-52.71147,2018-06-06 03:00:00,25,5,30
"3750",10102,"St Johns","NL",47.56038,-52.71147,2018-06-06 04:00:00,23,6,29
"3751",10102,"St Johns","NL",47.56038,-52.71147,2018-06-06 05:00:00,24,6,30
"3752",10102,"St Johns","NL",47.56038,-52.71147,2018-06-06 06:00:00,26,7,33
"3753",10102,"St Johns","NL",47.56038,-52.71147,2018-06-06 07:00:00,16,21,37
"3754",10102,"St Johns","NL",47.56038,-52.71147,2018-06-06 08:00:00,23,22,45
"3755",10102,"St Johns","NL",47.56038,-52.71147,2018-06-06 09:00:00,17,25,42
"3756",10102,"St Johns","NL",47.56038,-52.71147,2018-06-06 10:00:00,16,24,40
"3757",10102,"St Johns","NL",47.56038,-52.71147,2018-06-06 11:00:00,13,27,40
"3758",10102,"St Johns","NL",47.56038,-52.71147,2018-06-06 12:00:00,26,10,36
"3759",10102,"St Johns","NL",47.56038,-52.71147,2018-06-06 13:00:00,31,4,35
"3760",10102,"St Johns","NL",47.56038,-52.71147,2018-06-06 14:00:00,33,5,38
"3761",10102,"St Johns","NL",47.56038,-52.71147,2018-06-06 15:00:00,30,3,33
"3762",10102,"St Johns","NL",47.56038,-52.71147,2018-06-06 16:00:00,29,4,33
"3763",10102,"St Johns","NL",47.56038,-52.71147,2018-06-06 17:00:00,29,2,31
"3764",10102,"St Johns","NL",47.56038,-52.71147,2018-06-06 18:00:00,28,7,35
"3765",10102,"St Johns","NL",47.56038,-52.71147,2018-06-06 19:00:00,29,2,31
"3766",10102,"St Johns","NL",47.56038,-52.71147,2018-06-06 20:00:00,28,2,30
"3767",10102,"St Johns","NL",47.56038,-52.71147,2018-06-06 21:00:00,27,2,29
"3768",10102,"St Johns","NL",47.56038,-52.71147,2018-06-06 22:00:00,28,2,30
"3769",10102,"St Johns","NL",47.56038,-52.71147,2018-06-06 23:00:00,28,1,29
"3770",10102,"St Johns","NL",47.56038,-52.71147,2018-06-07 00:00:00,29,2,31
"3771",10102,"St Johns","NL",47.56038,-52.71147,2018-06-07 01:00:00,30,3,33
"3772",10102,"St Johns","NL",47.56038,-52.71147,2018-06-07 02:00:00,31,2,33
"3773",10102,"St Johns","NL",47.56038,-52.71147,2018-06-07 03:00:00,31,2,33
"3774",10102,"St Johns","NL",47.56038,-52.71147,2018-06-07 04:00:00,29,4,33
"3775",10102,"St Johns","NL",47.56038,-52.71147,2018-06-07 05:00:00,31,3,34
"3776",10102,"St Johns","NL",47.56038,-52.71147,2018-06-07 06:00:00,32,2,34
"3777",10102,"St Johns","NL",47.56038,-52.71147,2018-06-07 07:00:00,30,5,35
"3778",10102,"St Johns","NL",47.56038,-52.71147,2018-06-07 08:00:00,23,13,36
"3779",10102,"St Johns","NL",47.56038,-52.71147,2018-06-07 09:00:00,23,14,37
"3780",10102,"St Johns","NL",47.56038,-52.71147,2018-06-07 10:00:00,25,11,36
"3781",10102,"St Johns","NL",47.56038,-52.71147,2018-06-07 11:00:00,29,9,38
"3782",10102,"St Johns","NL",47.56038,-52.71147,2018-06-07 12:00:00,27,8,35
"3783",10102,"St Johns","NL",47.56038,-52.71147,2018-06-07 13:00:00,32,6,38
"3784",10102,"St Johns","NL",47.56038,-52.71147,2018-06-07 14:00:00,33,7,40
"3785",10102,"St Johns","NL",47.56038,-52.71147,2018-06-07 15:00:00,32,7,39
"3786",10102,"St Johns","NL",47.56038,-52.71147,2018-06-07 16:00:00,31,8,39
"3787",10102,"St Johns","NL",47.56038,-52.71147,2018-06-07 17:00:00,30,7,37
"3788",10102,"St Johns","NL",47.56038,-52.71147,2018-06-07 18:00:00,26,12,38
"3789",10102,"St Johns","NL",47.56038,-52.71147,2018-06-07 19:00:00,18,19,37
"3790",10102,"St Johns","NL",47.56038,-52.71147,2018-06-07 20:00:00,16,18,34
"3791",10102,"St Johns","NL",47.56038,-52.71147,2018-06-07 21:00:00,21,13,34
"3792",10102,"St Johns","NL",47.56038,-52.71147,2018-06-07 22:00:00,22,6,28
"3793",10102,"St Johns","NL",47.56038,-52.71147,2018-06-07 23:00:00,20,5,25
"3794",10102,"St Johns","NL",47.56038,-52.71147,2018-06-08 00:00:00,21,5,26
"3795",10102,"St Johns","NL",47.56038,-52.71147,2018-06-08 01:00:00,19,4,23
"3796",10102,"St Johns","NL",47.56038,-52.71147,2018-06-08 02:00:00,20,4,24
"3797",10102,"St Johns","NL",47.56038,-52.71147,2018-06-08 03:00:00,21,3,24
"3798",10102,"St Johns","NL",47.56038,-52.71147,2018-06-08 04:00:00,15,5,20
"3799",10102,"St Johns","NL",47.56038,-52.71147,2018-06-08 05:00:00,19,5,24
"3800",10102,"St Johns","NL",47.56038,-52.71147,2018-06-08 06:00:00,23,4,27
"3801",10102,"St Johns","NL",47.56038,-52.71147,2018-06-08 07:00:00,25,7,32
"3802",10102,"St Johns","NL",47.56038,-52.71147,2018-06-08 08:00:00,30,6,36
"3803",10102,"St Johns","NL",47.56038,-52.71147,2018-06-08 09:00:00,32,4,36
"3804",10102,"St Johns","NL",47.56038,-52.71147,2018-06-08 10:00:00,30,3,33
"3805",10102,"St Johns","NL",47.56038,-52.71147,2018-06-08 11:00:00,30,3,33
"3806",10102,"St Johns","NL",47.56038,-52.71147,2018-06-08 12:00:00,29,1,30
"3807",10102,"St Johns","NL",47.56038,-52.71147,2018-06-08 13:00:00,29,2,31
"3808",10102,"St Johns","NL",47.56038,-52.71147,2018-06-08 14:00:00,30,1,31
"3809",10102,"St Johns","NL",47.56038,-52.71147,2018-06-08 15:00:00,31,1,32
"3810",10102,"St Johns","NL",47.56038,-52.71147,2018-06-08 16:00:00,31,1,32
"3811",10102,"St Johns","NL",47.56038,-52.71147,2018-06-08 17:00:00,31,2,33
"3812",10102,"St Johns","NL",47.56038,-52.71147,2018-06-08 18:00:00,31,0,31
"3813",10102,"St Johns","NL",47.56038,-52.71147,2018-06-08 19:00:00,30,1,31
"3814",10102,"St Johns","NL",47.56038,-52.71147,2018-06-08 20:00:00,33,0,33
"3815",10102,"St Johns","NL",47.56038,-52.71147,2018-06-08 21:00:00,33,0,33
"3816",10102,"St Johns","NL",47.56038,-52.71147,2018-06-08 22:00:00,28,1,29
"3817",10102,"St Johns","NL",47.56038,-52.71147,2018-06-08 23:00:00,27,1,28
"3818",10102,"St Johns","NL",47.56038,-52.71147,2018-06-09 00:00:00,27,1,28
"3819",10102,"St Johns","NL",47.56038,-52.71147,2018-06-09 01:00:00,26,1,27
"3820",10102,"St Johns","NL",47.56038,-52.71147,2018-06-09 02:00:00,24,2,26
"3821",10102,"St Johns","NL",47.56038,-52.71147,2018-06-09 03:00:00,24,2,26
"3822",10102,"St Johns","NL",47.56038,-52.71147,2018-06-09 04:00:00,24,1,25
"3823",10102,"St Johns","NL",47.56038,-52.71147,2018-06-09 05:00:00,26,2,28
"3824",10102,"St Johns","NL",47.56038,-52.71147,2018-06-09 06:00:00,32,0,32
"3825",10102,"St Johns","NL",47.56038,-52.71147,2018-06-09 07:00:00,34,1,35
"3826",10102,"St Johns","NL",47.56038,-52.71147,2018-06-09 08:00:00,35,1,36
"3827",10102,"St Johns","NL",47.56038,-52.71147,2018-06-09 09:00:00,34,0,34
"3828",10102,"St Johns","NL",47.56038,-52.71147,2018-06-09 10:00:00,32,1,33
"3829",10102,"St Johns","NL",47.56038,-52.71147,2018-06-09 11:00:00,31,1,32
"3830",10102,"St Johns","NL",47.56038,-52.71147,2018-06-09 12:00:00,30,1,31
"3831",10102,"St Johns","NL",47.56038,-52.71147,2018-06-09 13:00:00,28,3,31
"3832",10102,"St Johns","NL",47.56038,-52.71147,2018-06-09 14:00:00,29,2,31
"3833",10102,"St Johns","NL",47.56038,-52.71147,2018-06-09 15:00:00,31,1,32
"3834",10102,"St Johns","NL",47.56038,-52.71147,2018-06-09 16:00:00,29,2,31
"3835",10102,"St Johns","NL",47.56038,-52.71147,2018-06-09 17:00:00,29,1,30
"3836",10102,"St Johns","NL",47.56038,-52.71147,2018-06-09 18:00:00,27,3,30
"3837",10102,"St Johns","NL",47.56038,-52.71147,2018-06-09 19:00:00,27,2,29
"3838",10102,"St Johns","NL",47.56038,-52.71147,2018-06-09 20:00:00,26,1,27
"3839",10102,"St Johns","NL",47.56038,-52.71147,2018-06-09 21:00:00,22,2,24
"3840",10102,"St Johns","NL",47.56038,-52.71147,2018-06-09 22:00:00,18,2,20
"3841",10102,"St Johns","NL",47.56038,-52.71147,2018-06-09 23:00:00,21,2,23
"3842",10102,"St Johns","NL",47.56038,-52.71147,2018-06-10 00:00:00,24,2,26
"3843",10102,"St Johns","NL",47.56038,-52.71147,2018-06-10 01:00:00,25,1,26
"3844",10102,"St Johns","NL",47.56038,-52.71147,2018-06-10 02:00:00,25,1,26
"3845",10102,"St Johns","NL",47.56038,-52.71147,2018-06-10 03:00:00,23,1,24
"3846",10102,"St Johns","NL",47.56038,-52.71147,2018-06-10 04:00:00,22,1,23
"3847",10102,"St Johns","NL",47.56038,-52.71147,2018-06-10 05:00:00,24,1,25
"3848",10102,"St Johns","NL",47.56038,-52.71147,2018-06-10 06:00:00,25,1,26
"3849",10102,"St Johns","NL",47.56038,-52.71147,2018-06-10 07:00:00,24,1,25
"3850",10102,"St Johns","NL",47.56038,-52.71147,2018-06-10 08:00:00,24,0,24
"3851",10102,"St Johns","NL",47.56038,-52.71147,2018-06-10 09:00:00,23,0,23
"3852",10102,"St Johns","NL",47.56038,-52.71147,2018-06-10 10:00:00,22,0,22
"3853",10102,"St Johns","NL",47.56038,-52.71147,2018-06-10 11:00:00,23,0,23
"3854",10102,"St Johns","NL",47.56038,-52.71147,2018-06-10 12:00:00,22,1,23
"3855",10102,"St Johns","NL",47.56038,-52.71147,2018-06-10 13:00:00,24,0,24
"3856",10102,"St Johns","NL",47.56038,-52.71147,2018-06-10 14:00:00,24,0,24
"3857",10102,"St Johns","NL",47.56038,-52.71147,2018-06-10 15:00:00,26,1,27
"3858",10102,"St Johns","NL",47.56038,-52.71147,2018-06-10 16:00:00,27,1,28
"3859",10102,"St Johns","NL",47.56038,-52.71147,2018-06-10 17:00:00,28,1,29
"3860",10102,"St Johns","NL",47.56038,-52.71147,2018-06-10 18:00:00,29,1,30
"3861",10102,"St Johns","NL",47.56038,-52.71147,2018-06-10 19:00:00,15,6,21
"3862",10102,"St Johns","NL",47.56038,-52.71147,2018-06-10 20:00:00,7,13,20
"3863",10102,"St Johns","NL",47.56038,-52.71147,2018-06-10 21:00:00,3,18,21
"3864",10102,"St Johns","NL",47.56038,-52.71147,2018-06-10 22:00:00,0,22,22
"3865",10102,"St Johns","NL",47.56038,-52.71147,2018-06-10 23:00:00,1,20,21
"3866",10102,"St Johns","NL",47.56038,-52.71147,2018-06-11 00:00:00,1,21,22
"3867",10102,"St Johns","NL",47.56038,-52.71147,2018-06-11 01:00:00,15,10,25
"3868",10102,"St Johns","NL",47.56038,-52.71147,2018-06-11 02:00:00,1,22,23
"3869",10102,"St Johns","NL",47.56038,-52.71147,2018-06-11 03:00:00,3,22,25
"3870",10102,"St Johns","NL",47.56038,-52.71147,2018-06-11 04:00:00,4,17,21
"3871",10102,"St Johns","NL",47.56038,-52.71147,2018-06-11 05:00:00,2,18,20
"3872",10102,"St Johns","NL",47.56038,-52.71147,2018-06-11 06:00:00,3,21,24
"3873",10102,"St Johns","NL",47.56038,-52.71147,2018-06-11 07:00:00,4,21,25
"3874",10102,"St Johns","NL",47.56038,-52.71147,2018-06-11 08:00:00,3,19,22
"3875",10102,"St Johns","NL",47.56038,-52.71147,2018-06-11 09:00:00,6,16,22
"3876",10102,"St Johns","NL",47.56038,-52.71147,2018-06-11 10:00:00,10,19,29
"3877",10102,"St Johns","NL",47.56038,-52.71147,2018-06-11 11:00:00,14,11,25
"3878",10102,"St Johns","NL",47.56038,-52.71147,2018-06-11 12:00:00,17,7,24
"3879",10102,"St Johns","NL",47.56038,-52.71147,2018-06-11 13:00:00,19,7,26
"3880",10102,"St Johns","NL",47.56038,-52.71147,2018-06-11 14:00:00,15,10,25
"3881",10102,"St Johns","NL",47.56038,-52.71147,2018-06-11 15:00:00,16,9,25
"3882",10102,"St Johns","NL",47.56038,-52.71147,2018-06-11 16:00:00,14,10,24
"3883",10102,"St Johns","NL",47.56038,-52.71147,2018-06-11 17:00:00,12,10,22
"3884",10102,"St Johns","NL",47.56038,-52.71147,2018-06-11 18:00:00,14,8,22
"3885",10102,"St Johns","NL",47.56038,-52.71147,2018-06-11 19:00:00,12,11,23
"3886",10102,"St Johns","NL",47.56038,-52.71147,2018-06-11 20:00:00,10,13,23
"3887",10102,"St Johns","NL",47.56038,-52.71147,2018-06-11 21:00:00,13,10,23
"3888",10102,"St Johns","NL",47.56038,-52.71147,2018-06-11 22:00:00,18,4,22
"3889",10102,"St Johns","NL",47.56038,-52.71147,2018-06-11 23:00:00,15,8,23
"3890",10102,"St Johns","NL",47.56038,-52.71147,2018-06-12 00:00:00,17,6,23
"3891",10102,"St Johns","NL",47.56038,-52.71147,2018-06-12 01:00:00,18,4,22
"3892",10102,"St Johns","NL",47.56038,-52.71147,2018-06-12 02:00:00,22,2,24
"3893",10102,"St Johns","NL",47.56038,-52.71147,2018-06-12 03:00:00,23,1,24
"3894",10102,"St Johns","NL",47.56038,-52.71147,2018-06-12 04:00:00,21,4,25
"3895",10102,"St Johns","NL",47.56038,-52.71147,2018-06-12 05:00:00,24,2,26
"3896",10102,"St Johns","NL",47.56038,-52.71147,2018-06-12 06:00:00,22,2,24
"3897",10102,"St Johns","NL",47.56038,-52.71147,2018-06-12 07:00:00,23,4,27
"3898",10102,"St Johns","NL",47.56038,-52.71147,2018-06-12 08:00:00,23,4,27
"3899",10102,"St Johns","NL",47.56038,-52.71147,2018-06-12 09:00:00,24,5,29
"3900",10102,"St Johns","NL",47.56038,-52.71147,2018-06-12 10:00:00,23,3,26
"3901",10102,"St Johns","NL",47.56038,-52.71147,2018-06-12 11:00:00,21,5,26
"3902",10102,"St Johns","NL",47.56038,-52.71147,2018-06-12 12:00:00,18,6,24
"3903",10102,"St Johns","NL",47.56038,-52.71147,2018-06-12 13:00:00,15,11,26
"3904",10102,"St Johns","NL",47.56038,-52.71147,2018-06-12 14:00:00,17,8,25
"3905",10102,"St Johns","NL",47.56038,-52.71147,2018-06-12 15:00:00,18,6,24
"3906",10102,"St Johns","NL",47.56038,-52.71147,2018-06-12 16:00:00,16,10,26
"3907",10102,"St Johns","NL",47.56038,-52.71147,2018-06-12 17:00:00,14,11,25
"3908",10102,"St Johns","NL",47.56038,-52.71147,2018-06-12 18:00:00,21,2,23
"3909",10102,"St Johns","NL",47.56038,-52.71147,2018-06-12 19:00:00,22,2,24
"3910",10102,"St Johns","NL",47.56038,-52.71147,2018-06-12 20:00:00,20,2,22
"3911",10102,"St Johns","NL",47.56038,-52.71147,2018-06-12 21:00:00,16,3,19
"3912",10102,"St Johns","NL",47.56038,-52.71147,2018-06-12 22:00:00,15,2,17
"3913",10102,"St Johns","NL",47.56038,-52.71147,2018-06-12 23:00:00,17,2,19
"3914",10102,"St Johns","NL",47.56038,-52.71147,2018-06-13 00:00:00,17,1,18
"3915",10102,"St Johns","NL",47.56038,-52.71147,2018-06-13 01:00:00,16,1,17
"3916",10102,"St Johns","NL",47.56038,-52.71147,2018-06-13 02:00:00,17,1,18
"3917",10102,"St Johns","NL",47.56038,-52.71147,2018-06-13 03:00:00,19,0,19
"3918",10102,"St Johns","NL",47.56038,-52.71147,2018-06-13 04:00:00,20,0,20
"3919",10102,"St Johns","NL",47.56038,-52.71147,2018-06-13 05:00:00,20,1,21
"3920",10102,"St Johns","NL",47.56038,-52.71147,2018-06-13 06:00:00,23,0,23
"3921",10102,"St Johns","NL",47.56038,-52.71147,2018-06-13 07:00:00,23,1,24
"3922",10102,"St Johns","NL",47.56038,-52.71147,2018-06-13 08:00:00,22,3,25
"3923",10102,"St Johns","NL",47.56038,-52.71147,2018-06-13 09:00:00,23,3,26
"3924",10102,"St Johns","NL",47.56038,-52.71147,2018-06-13 10:00:00,31,0,31
"3925",10102,"St Johns","NL",47.56038,-52.71147,2018-06-13 11:00:00,34,0,34
"3926",10102,"St Johns","NL",47.56038,-52.71147,2018-06-13 12:00:00,32,2,34
"3927",10102,"St Johns","NL",47.56038,-52.71147,2018-06-13 13:00:00,31,2,33
"3928",10102,"St Johns","NL",47.56038,-52.71147,2018-06-13 14:00:00,32,1,33
"3929",10102,"St Johns","NL",47.56038,-52.71147,2018-06-13 15:00:00,32,1,33
"3930",10102,"St Johns","NL",47.56038,-52.71147,2018-06-13 16:00:00,31,2,33
"3931",10102,"St Johns","NL",47.56038,-52.71147,2018-06-13 17:00:00,31,1,32
"3932",10102,"St Johns","NL",47.56038,-52.71147,2018-06-13 18:00:00,31,1,32
"3933",10102,"St Johns","NL",47.56038,-52.71147,2018-06-13 19:00:00,30,1,31
"3934",10102,"St Johns","NL",47.56038,-52.71147,2018-06-13 20:00:00,28,1,29
"3935",10102,"St Johns","NL",47.56038,-52.71147,2018-06-13 21:00:00,25,2,27
"3936",10102,"St Johns","NL",47.56038,-52.71147,2018-06-13 22:00:00,24,2,26
"3937",10102,"St Johns","NL",47.56038,-52.71147,2018-06-13 23:00:00,23,1,24
"3938",10102,"St Johns","NL",47.56038,-52.71147,2018-06-14 00:00:00,21,2,23
"3939",10102,"St Johns","NL",47.56038,-52.71147,2018-06-14 01:00:00,20,2,22
"3940",10102,"St Johns","NL",47.56038,-52.71147,2018-06-14 02:00:00,21,1,22
"3941",10102,"St Johns","NL",47.56038,-52.71147,2018-06-14 03:00:00,21,1,22
"3942",10102,"St Johns","NL",47.56038,-52.71147,2018-06-14 04:00:00,22,1,23
"3943",10102,"St Johns","NL",47.56038,-52.71147,2018-06-14 05:00:00,22,1,23
"3944",10102,"St Johns","NL",47.56038,-52.71147,2018-06-14 06:00:00,23,1,24
"3945",10102,"St Johns","NL",47.56038,-52.71147,2018-06-14 07:00:00,22,3,25
"3946",10102,"St Johns","NL",47.56038,-52.71147,2018-06-14 08:00:00,24,1,25
"3947",10102,"St Johns","NL",47.56038,-52.71147,2018-06-14 09:00:00,25,1,26
"3948",10102,"St Johns","NL",47.56038,-52.71147,2018-06-14 10:00:00,24,3,27
"3949",10102,"St Johns","NL",47.56038,-52.71147,2018-06-14 11:00:00,24,3,27
"3950",10102,"St Johns","NL",47.56038,-52.71147,2018-06-14 12:00:00,14,14,28
"3951",10102,"St Johns","NL",47.56038,-52.71147,2018-06-14 13:00:00,18,9,27
"3952",10102,"St Johns","NL",47.56038,-52.71147,2018-06-14 14:00:00,17,11,28
"3953",10102,"St Johns","NL",47.56038,-52.71147,2018-06-14 15:00:00,18,10,28
"3954",10102,"St Johns","NL",47.56038,-52.71147,2018-06-14 16:00:00,16,11,27
"3955",10102,"St Johns","NL",47.56038,-52.71147,2018-06-14 17:00:00,15,13,28
"3956",10102,"St Johns","NL",47.56038,-52.71147,2018-06-14 18:00:00,16,12,28
"3957",10102,"St Johns","NL",47.56038,-52.71147,2018-06-14 19:00:00,20,7,27
"3958",10102,"St Johns","NL",47.56038,-52.71147,2018-06-14 20:00:00,17,11,28
"3959",10102,"St Johns","NL",47.56038,-52.71147,2018-06-14 21:00:00,20,5,25
"3960",10102,"St Johns","NL",47.56038,-52.71147,2018-06-14 22:00:00,21,5,26
"3961",10102,"St Johns","NL",47.56038,-52.71147,2018-06-14 23:00:00,21,5,26
"3962",10102,"St Johns","NL",47.56038,-52.71147,2018-06-15 00:00:00,19,7,26
"3963",10102,"St Johns","NL",47.56038,-52.71147,2018-06-15 01:00:00,18,8,26
"3964",10102,"St Johns","NL",47.56038,-52.71147,2018-06-15 02:00:00,18,7,25
"3965",10102,"St Johns","NL",47.56038,-52.71147,2018-06-15 03:00:00,16,10,26
"3966",10102,"St Johns","NL",47.56038,-52.71147,2018-06-15 04:00:00,12,14,26
"3967",10102,"St Johns","NL",47.56038,-52.71147,2018-06-15 05:00:00,10,15,25
"3968",10102,"St Johns","NL",47.56038,-52.71147,2018-06-15 06:00:00,8,20,28
"3969",10102,"St Johns","NL",47.56038,-52.71147,2018-06-15 07:00:00,2,28,30
"3970",10102,"St Johns","NL",47.56038,-52.71147,2018-06-15 08:00:00,1,28,29
"3971",10102,"St Johns","NL",47.56038,-52.71147,2018-06-15 09:00:00,3,25,28
"3972",10102,"St Johns","NL",47.56038,-52.71147,2018-06-15 10:00:00,2,26,28
"3973",10102,"St Johns","NL",47.56038,-52.71147,2018-06-15 11:00:00,7,22,29
"3974",10102,"St Johns","NL",47.56038,-52.71147,2018-06-15 12:00:00,9,19,28
"3975",10102,"St Johns","NL",47.56038,-52.71147,2018-06-15 13:00:00,10,19,29
"3976",10102,"St Johns","NL",47.56038,-52.71147,2018-06-15 14:00:00,14,13,27
"3977",10102,"St Johns","NL",47.56038,-52.71147,2018-06-15 15:00:00,18,9,27
"3978",10102,"St Johns","NL",47.56038,-52.71147,2018-06-15 16:00:00,16,12,28
"3979",10102,"St Johns","NL",47.56038,-52.71147,2018-06-15 17:00:00,10,20,30
"3980",10102,"St Johns","NL",47.56038,-52.71147,2018-06-15 18:00:00,10,19,29
"3981",10102,"St Johns","NL",47.56038,-52.71147,2018-06-15 19:00:00,10,16,26
"3982",10102,"St Johns","NL",47.56038,-52.71147,2018-06-15 20:00:00,4,24,28
"3983",10102,"St Johns","NL",47.56038,-52.71147,2018-06-15 21:00:00,4,23,27
"3984",10102,"St Johns","NL",47.56038,-52.71147,2018-06-15 22:00:00,5,18,23
"3985",10102,"St Johns","NL",47.56038,-52.71147,2018-06-15 23:00:00,3,17,20
"3986",10102,"St Johns","NL",47.56038,-52.71147,2018-06-16 00:00:00,17,5,22
"3987",10102,"St Johns","NL",47.56038,-52.71147,2018-06-16 01:00:00,18,4,22
"3988",10102,"St Johns","NL",47.56038,-52.71147,2018-06-16 02:00:00,19,4,23
"3989",10102,"St Johns","NL",47.56038,-52.71147,2018-06-16 03:00:00,13,6,19
"3990",10102,"St Johns","NL",47.56038,-52.71147,2018-06-16 04:00:00,5,17,22
"3991",10102,"St Johns","NL",47.56038,-52.71147,2018-06-16 05:00:00,0,24,24
"3992",10102,"St Johns","NL",47.56038,-52.71147,2018-06-16 06:00:00,3,21,24
"3993",10102,"St Johns","NL",47.56038,-52.71147,2018-06-16 07:00:00,4,13,17
"3994",10102,"St Johns","NL",47.56038,-52.71147,2018-06-16 08:00:00,22,3,25
"3995",10102,"St Johns","NL",47.56038,-52.71147,2018-06-16 09:00:00,12,15,27
"3996",10102,"St Johns","NL",47.56038,-52.71147,2018-06-16 10:00:00,11,18,29
"3997",10102,"St Johns","NL",47.56038,-52.71147,2018-06-16 11:00:00,16,11,27
"3998",10102,"St Johns","NL",47.56038,-52.71147,2018-06-16 12:00:00,20,8,28
"3999",10102,"St Johns","NL",47.56038,-52.71147,2018-06-16 13:00:00,19,10,29
"4000",10102,"St Johns","NL",47.56038,-52.71147,2018-06-16 14:00:00,22,6,28
"4001",10102,"St Johns","NL",47.56038,-52.71147,2018-06-16 15:00:00,23,7,30
"4002",10102,"St Johns","NL",47.56038,-52.71147,2018-06-16 16:00:00,23,6,29
"4003",10102,"St Johns","NL",47.56038,-52.71147,2018-06-16 17:00:00,20,9,29
"4004",10102,"St Johns","NL",47.56038,-52.71147,2018-06-16 18:00:00,16,10,26
"4005",10102,"St Johns","NL",47.56038,-52.71147,2018-06-16 19:00:00,13,14,27
"4006",10102,"St Johns","NL",47.56038,-52.71147,2018-06-16 20:00:00,18,8,26
"4007",10102,"St Johns","NL",47.56038,-52.71147,2018-06-16 21:00:00,12,13,25
"4008",10102,"St Johns","NL",47.56038,-52.71147,2018-06-16 22:00:00,17,8,25
"4009",10102,"St Johns","NL",47.56038,-52.71147,2018-06-16 23:00:00,13,13,26
"4010",10102,"St Johns","NL",47.56038,-52.71147,2018-06-17 00:00:00,15,10,25
"4011",10102,"St Johns","NL",47.56038,-52.71147,2018-06-17 01:00:00,15,11,26
"4012",10102,"St Johns","NL",47.56038,-52.71147,2018-06-17 02:00:00,12,14,26
"4013",10102,"St Johns","NL",47.56038,-52.71147,2018-06-17 03:00:00,14,11,25
"4014",10102,"St Johns","NL",47.56038,-52.71147,2018-06-17 04:00:00,9,16,25
"4015",10102,"St Johns","NL",47.56038,-52.71147,2018-06-17 05:00:00,10,17,27
"4016",10102,"St Johns","NL",47.56038,-52.71147,2018-06-17 06:00:00,11,17,28
"4017",10102,"St Johns","NL",47.56038,-52.71147,2018-06-17 07:00:00,15,14,29
"4018",10102,"St Johns","NL",47.56038,-52.71147,2018-06-17 08:00:00,15,13,28
"4019",10102,"St Johns","NL",47.56038,-52.71147,2018-06-17 09:00:00,14,14,28
"4020",10102,"St Johns","NL",47.56038,-52.71147,2018-06-17 10:00:00,14,15,29
"4021",10102,"St Johns","NL",47.56038,-52.71147,2018-06-17 11:00:00,16,12,28
"4022",10102,"St Johns","NL",47.56038,-52.71147,2018-06-17 12:00:00,23,5,28
"4023",10102,"St Johns","NL",47.56038,-52.71147,2018-06-17 13:00:00,23,5,28
"4024",10102,"St Johns","NL",47.56038,-52.71147,2018-06-17 14:00:00,21,5,26
"4025",10102,"St Johns","NL",47.56038,-52.71147,2018-06-17 15:00:00,16,11,27
"4026",10102,"St Johns","NL",47.56038,-52.71147,2018-06-17 16:00:00,19,9,28
"4027",10102,"St Johns","NL",47.56038,-52.71147,2018-06-17 17:00:00,19,6,25
"4028",10102,"St Johns","NL",47.56038,-52.71147,2018-06-17 18:00:00,18,8,26
"4029",10102,"St Johns","NL",47.56038,-52.71147,2018-06-17 19:00:00,18,8,26
"4030",10102,"St Johns","NL",47.56038,-52.71147,2018-06-17 20:00:00,17,9,26
"4031",10102,"St Johns","NL",47.56038,-52.71147,2018-06-17 21:00:00,18,8,26
"4032",10102,"St Johns","NL",47.56038,-52.71147,2018-06-17 22:00:00,22,2,24
"4033",10102,"St Johns","NL",47.56038,-52.71147,2018-06-17 23:00:00,22,2,24
"4034",10102,"St Johns","NL",47.56038,-52.71147,2018-06-18 00:00:00,21,2,23
"4035",10102,"St Johns","NL",47.56038,-52.71147,2018-06-18 01:00:00,18,2,20
"4036",10102,"St Johns","NL",47.56038,-52.71147,2018-06-18 02:00:00,18,1,19
"4037",10102,"St Johns","NL",47.56038,-52.71147,2018-06-18 03:00:00,16,3,19
"4038",10102,"St Johns","NL",47.56038,-52.71147,2018-06-18 04:00:00,15,3,18
"4039",10102,"St Johns","NL",47.56038,-52.71147,2018-06-18 05:00:00,14,2,16
"4040",10102,"St Johns","NL",47.56038,-52.71147,2018-06-18 06:00:00,11,3,14
"4041",10102,"St Johns","NL",47.56038,-52.71147,2018-06-18 07:00:00,5,13,18
"4042",10102,"St Johns","NL",47.56038,-52.71147,2018-06-18 08:00:00,6,12,18
"4043",10102,"St Johns","NL",47.56038,-52.71147,2018-06-18 09:00:00,9,10,19
"4044",10102,"St Johns","NL",47.56038,-52.71147,2018-06-18 10:00:00,13,11,24
"4045",10102,"St Johns","NL",47.56038,-52.71147,2018-06-18 11:00:00,17,11,28
"4046",10102,"St Johns","NL",47.56038,-52.71147,2018-06-18 12:00:00,18,11,29
"4047",10102,"St Johns","NL",47.56038,-52.71147,2018-06-18 13:00:00,20,8,28
"4048",10102,"St Johns","NL",47.56038,-52.71147,2018-06-18 14:00:00,22,6,28
"4049",10102,"St Johns","NL",47.56038,-52.71147,2018-06-18 15:00:00,25,5,30
"4050",10102,"St Johns","NL",47.56038,-52.71147,2018-06-18 16:00:00,23,6,29
"4051",10102,"St Johns","NL",47.56038,-52.71147,2018-06-18 17:00:00,23,5,28
"4052",10102,"St Johns","NL",47.56038,-52.71147,2018-06-18 18:00:00,21,8,29
"4053",10102,"St Johns","NL",47.56038,-52.71147,2018-06-18 19:00:00,23,3,26
"4054",10102,"St Johns","NL",47.56038,-52.71147,2018-06-18 20:00:00,24,2,26
"4055",10102,"St Johns","NL",47.56038,-52.71147,2018-06-18 21:00:00,23,1,24
"4056",10102,"St Johns","NL",47.56038,-52.71147,2018-06-18 22:00:00,21,2,23
"4057",10102,"St Johns","NL",47.56038,-52.71147,2018-06-18 23:00:00,20,2,22
"4058",10102,"St Johns","NL",47.56038,-52.71147,2018-06-19 00:00:00,23,1,24
"4059",10102,"St Johns","NL",47.56038,-52.71147,2018-06-19 01:00:00,22,1,23
"4060",10102,"St Johns","NL",47.56038,-52.71147,2018-06-19 02:00:00,22,1,23
"4061",10102,"St Johns","NL",47.56038,-52.71147,2018-06-19 03:00:00,23,1,24
"4062",10102,"St Johns","NL",47.56038,-52.71147,2018-06-19 04:00:00,25,1,26
"4063",10102,"St Johns","NL",47.56038,-52.71147,2018-06-19 05:00:00,24,3,27
"4064",10102,"St Johns","NL",47.56038,-52.71147,2018-06-19 06:00:00,25,4,29
"4065",10102,"St Johns","NL",47.56038,-52.71147,2018-06-19 07:00:00,24,7,31
"4066",10102,"St Johns","NL",47.56038,-52.71147,2018-06-19 08:00:00,27,3,30
"4067",10102,"St Johns","NL",47.56038,-52.71147,2018-06-19 09:00:00,28,3,31
"4068",10102,"St Johns","NL",47.56038,-52.71147,2018-06-19 10:00:00,29,3,32
"4069",10102,"St Johns","NL",47.56038,-52.71147,2018-06-19 11:00:00,29,3,32
"4070",10102,"St Johns","NL",47.56038,-52.71147,2018-06-19 12:00:00,30,2,32
"4071",10102,"St Johns","NL",47.56038,-52.71147,2018-06-19 13:00:00,31,2,33
"4072",10102,"St Johns","NL",47.56038,-52.71147,2018-06-19 14:00:00,30,2,32
"4073",10102,"St Johns","NL",47.56038,-52.71147,2018-06-19 15:00:00,30,3,33
"4074",10102,"St Johns","NL",47.56038,-52.71147,2018-06-19 16:00:00,29,3,32
"4075",10102,"St Johns","NL",47.56038,-52.71147,2018-06-19 17:00:00,32,2,34
"4076",10102,"St Johns","NL",47.56038,-52.71147,2018-06-19 18:00:00,34,1,35
"4077",10102,"St Johns","NL",47.56038,-52.71147,2018-06-19 19:00:00,31,1,32
"4078",10102,"St Johns","NL",47.56038,-52.71147,2018-06-19 20:00:00,31,1,32
"4079",10102,"St Johns","NL",47.56038,-52.71147,2018-06-19 21:00:00,31,1,32
"4080",10102,"St Johns","NL",47.56038,-52.71147,2018-06-19 22:00:00,31,1,32
"4081",10102,"St Johns","NL",47.56038,-52.71147,2018-06-19 23:00:00,29,2,31
"4082",10102,"St Johns","NL",47.56038,-52.71147,2018-06-20 00:00:00,28,1,29
"4083",10102,"St Johns","NL",47.56038,-52.71147,2018-06-20 01:00:00,26,2,28
"4084",10102,"St Johns","NL",47.56038,-52.71147,2018-06-20 02:00:00,25,2,27
"4085",10102,"St Johns","NL",47.56038,-52.71147,2018-06-20 03:00:00,25,2,27
"4086",10102,"St Johns","NL",47.56038,-52.71147,2018-06-20 04:00:00,24,2,26
"4087",10102,"St Johns","NL",47.56038,-52.71147,2018-06-20 05:00:00,20,6,26
"4088",10102,"St Johns","NL",47.56038,-52.71147,2018-06-20 06:00:00,19,6,25
"4089",10102,"St Johns","NL",47.56038,-52.71147,2018-06-20 07:00:00,14,9,23
"4090",10102,"St Johns","NL",47.56038,-52.71147,2018-06-20 08:00:00,13,12,25
"4091",10102,"St Johns","NL",47.56038,-52.71147,2018-06-20 09:00:00,13,10,23
"4092",10102,"St Johns","NL",47.56038,-52.71147,2018-06-20 10:00:00,17,5,22
"4093",10102,"St Johns","NL",47.56038,-52.71147,2018-06-20 11:00:00,16,7,23
"4094",10102,"St Johns","NL",47.56038,-52.71147,2018-06-20 12:00:00,6,21,27
"4095",10102,"St Johns","NL",47.56038,-52.71147,2018-06-20 13:00:00,5,25,30
"4096",10102,"St Johns","NL",47.56038,-52.71147,2018-06-20 14:00:00,12,15,27
"4097",10102,"St Johns","NL",47.56038,-52.71147,2018-06-20 15:00:00,11,21,32
"4098",10102,"St Johns","NL",47.56038,-52.71147,2018-06-20 16:00:00,13,16,29
"4099",10102,"St Johns","NL",47.56038,-52.71147,2018-06-20 17:00:00,10,19,29
"4100",10102,"St Johns","NL",47.56038,-52.71147,2018-06-20 18:00:00,8,17,25
"4101",10102,"St Johns","NL",47.56038,-52.71147,2018-06-20 19:00:00,14,14,28
"4102",10102,"St Johns","NL",47.56038,-52.71147,2018-06-20 20:00:00,19,5,24
"4103",10102,"St Johns","NL",47.56038,-52.71147,2018-06-20 21:00:00,16,4,20
"4104",10102,"St Johns","NL",47.56038,-52.71147,2018-06-20 22:00:00,16,3,19
"4105",10102,"St Johns","NL",47.56038,-52.71147,2018-06-20 23:00:00,16,2,18
"4106",10102,"St Johns","NL",47.56038,-52.71147,2018-06-21 00:00:00,22,2,24
"4107",10102,"St Johns","NL",47.56038,-52.71147,2018-06-21 01:00:00,21,2,23
"4108",10102,"St Johns","NL",47.56038,-52.71147,2018-06-21 02:00:00,20,1,21
"4109",10102,"St Johns","NL",47.56038,-52.71147,2018-06-21 03:00:00,19,1,20
"4110",10102,"St Johns","NL",47.56038,-52.71147,2018-06-21 04:00:00,19,1,20
"4111",10102,"St Johns","NL",47.56038,-52.71147,2018-06-21 05:00:00,18,1,19
"4112",10102,"St Johns","NL",47.56038,-52.71147,2018-06-21 06:00:00,18,2,20
"4113",10102,"St Johns","NL",47.56038,-52.71147,2018-06-21 07:00:00,19,2,21
"4114",10102,"St Johns","NL",47.56038,-52.71147,2018-06-21 08:00:00,21,3,24
"4115",10102,"St Johns","NL",47.56038,-52.71147,2018-06-21 09:00:00,25,2,27
"4116",10102,"St Johns","NL",47.56038,-52.71147,2018-06-21 10:00:00,27,2,29
"4117",10102,"St Johns","NL",47.56038,-52.71147,2018-06-21 11:00:00,31,2,33
"4118",10102,"St Johns","NL",47.56038,-52.71147,2018-06-21 12:00:00,35,1,36
"4119",10102,"St Johns","NL",47.56038,-52.71147,2018-06-21 13:00:00,35,1,36
"4120",10102,"St Johns","NL",47.56038,-52.71147,2018-06-21 14:00:00,35,1,36
"4121",10102,"St Johns","NL",47.56038,-52.71147,2018-06-21 15:00:00,34,1,35
"4122",10102,"St Johns","NL",47.56038,-52.71147,2018-06-21 16:00:00,34,1,35
"4123",10102,"St Johns","NL",47.56038,-52.71147,2018-06-21 17:00:00,32,3,35
"4124",10102,"St Johns","NL",47.56038,-52.71147,2018-06-21 18:00:00,32,2,34
"4125",10102,"St Johns","NL",47.56038,-52.71147,2018-06-21 19:00:00,32,1,33
"4126",10102,"St Johns","NL",47.56038,-52.71147,2018-06-21 20:00:00,29,1,30
"4127",10102,"St Johns","NL",47.56038,-52.71147,2018-06-21 21:00:00,28,2,30
"4128",10102,"St Johns","NL",47.56038,-52.71147,2018-06-21 22:00:00,25,2,27
"4129",10102,"St Johns","NL",47.56038,-52.71147,2018-06-21 23:00:00,24,1,25
"4130",10102,"St Johns","NL",47.56038,-52.71147,2018-06-22 00:00:00,23,1,24
"4131",10102,"St Johns","NL",47.56038,-52.71147,2018-06-22 01:00:00,23,0,23
"4132",10102,"St Johns","NL",47.56038,-52.71147,2018-06-22 02:00:00,22,1,23
"4133",10102,"St Johns","NL",47.56038,-52.71147,2018-06-22 03:00:00,22,1,23
"4134",10102,"St Johns","NL",47.56038,-52.71147,2018-06-22 04:00:00,23,0,23
"4135",10102,"St Johns","NL",47.56038,-52.71147,2018-06-22 05:00:00,25,1,26
"4136",10102,"St Johns","NL",47.56038,-52.71147,2018-06-22 06:00:00,20,2,22
"4137",10102,"St Johns","NL",47.56038,-52.71147,2018-06-22 07:00:00,19,4,23
"4138",10102,"St Johns","NL",47.56038,-52.71147,2018-06-22 08:00:00,20,2,22
"4139",10102,"St Johns","NL",47.56038,-52.71147,2018-06-22 09:00:00,19,1,20
"4140",10102,"St Johns","NL",47.56038,-52.71147,2018-06-22 10:00:00,19,4,23
"4141",10102,"St Johns","NL",47.56038,-52.71147,2018-06-22 11:00:00,20,2,22
"4142",10102,"St Johns","NL",47.56038,-52.71147,2018-06-22 12:00:00,13,10,23
"4143",10102,"St Johns","NL",47.56038,-52.71147,2018-06-22 13:00:00,11,14,25
"4144",10102,"St Johns","NL",47.56038,-52.71147,2018-06-22 14:00:00,14,7,21
"4145",10102,"St Johns","NL",47.56038,-52.71147,2018-06-22 15:00:00,13,8,21
"4146",10102,"St Johns","NL",47.56038,-52.71147,2018-06-22 16:00:00,15,7,22
"4147",10102,"St Johns","NL",47.56038,-52.71147,2018-06-22 17:00:00,12,13,25
"4148",10102,"St Johns","NL",47.56038,-52.71147,2018-06-22 18:00:00,9,16,25
"4149",10102,"St Johns","NL",47.56038,-52.71147,2018-06-22 19:00:00,6,19,25
"4150",10102,"St Johns","NL",47.56038,-52.71147,2018-06-22 20:00:00,5,18,23
"4151",10102,"St Johns","NL",47.56038,-52.71147,2018-06-22 21:00:00,0,24,24
"4152",10102,"St Johns","NL",47.56038,-52.71147,2018-06-22 22:00:00,1,22,23
"4153",10102,"St Johns","NL",47.56038,-52.71147,2018-06-22 23:00:00,0,21,21
"4154",10102,"St Johns","NL",47.56038,-52.71147,2018-06-23 00:00:00,11,4,15
"4155",10102,"St Johns","NL",47.56038,-52.71147,2018-06-23 01:00:00,15,2,17
"4156",10102,"St Johns","NL",47.56038,-52.71147,2018-06-23 02:00:00,14,1,15
"4157",10102,"St Johns","NL",47.56038,-52.71147,2018-06-23 03:00:00,12,1,13
"4158",10102,"St Johns","NL",47.56038,-52.71147,2018-06-23 04:00:00,14,2,16
"4159",10102,"St Johns","NL",47.56038,-52.71147,2018-06-23 05:00:00,16,2,18
"4160",10102,"St Johns","NL",47.56038,-52.71147,2018-06-23 06:00:00,17,2,19
"4161",10102,"St Johns","NL",47.56038,-52.71147,2018-06-23 07:00:00,21,4,25
"4162",10102,"St Johns","NL",47.56038,-52.71147,2018-06-23 08:00:00,25,4,29
"4163",10102,"St Johns","NL",47.56038,-52.71147,2018-06-23 09:00:00,27,2,29
"4164",10102,"St Johns","NL",47.56038,-52.71147,2018-06-23 10:00:00,28,2,30
"4165",10102,"St Johns","NL",47.56038,-52.71147,2018-06-23 11:00:00,29,1,30
"4166",10102,"St Johns","NL",47.56038,-52.71147,2018-06-23 12:00:00,30,2,32
"4167",10102,"St Johns","NL",47.56038,-52.71147,2018-06-23 13:00:00,31,3,34
"4168",10102,"St Johns","NL",47.56038,-52.71147,2018-06-23 14:00:00,31,3,34
"4169",10102,"St Johns","NL",47.56038,-52.71147,2018-06-23 15:00:00,30,1,31
"4170",10102,"St Johns","NL",47.56038,-52.71147,2018-06-23 16:00:00,31,2,33
"4171",10102,"St Johns","NL",47.56038,-52.71147,2018-06-23 17:00:00,31,2,33
"4172",10102,"St Johns","NL",47.56038,-52.71147,2018-06-23 18:00:00,31,1,32
"4173",10102,"St Johns","NL",47.56038,-52.71147,2018-06-23 19:00:00,31,2,33
"4174",10102,"St Johns","NL",47.56038,-52.71147,2018-06-23 20:00:00,30,1,31
"4175",10102,"St Johns","NL",47.56038,-52.71147,2018-06-23 21:00:00,30,2,32
"4176",10102,"St Johns","NL",47.56038,-52.71147,2018-06-23 22:00:00,29,1,30
"4177",10102,"St Johns","NL",47.56038,-52.71147,2018-06-23 23:00:00,30,1,31
"4178",10102,"St Johns","NL",47.56038,-52.71147,2018-06-24 00:00:00,28,1,29
"4179",10102,"St Johns","NL",47.56038,-52.71147,2018-06-24 01:00:00,26,1,27
"4180",10102,"St Johns","NL",47.56038,-52.71147,2018-06-24 02:00:00,25,0,25
"4181",10102,"St Johns","NL",47.56038,-52.71147,2018-06-24 03:00:00,23,2,25
"4182",10102,"St Johns","NL",47.56038,-52.71147,2018-06-24 04:00:00,21,1,22
"4183",10102,"St Johns","NL",47.56038,-52.71147,2018-06-24 05:00:00,17,5,22
"4184",10102,"St Johns","NL",47.56038,-52.71147,2018-06-24 06:00:00,21,1,22
"4185",10102,"St Johns","NL",47.56038,-52.71147,2018-06-24 07:00:00,22,1,23
"4186",10102,"St Johns","NL",47.56038,-52.71147,2018-06-24 08:00:00,24,1,25
"4187",10102,"St Johns","NL",47.56038,-52.71147,2018-06-24 09:00:00,25,1,26
"4188",10102,"St Johns","NL",47.56038,-52.71147,2018-06-24 10:00:00,21,10,31
"4189",10102,"St Johns","NL",47.56038,-52.71147,2018-06-24 11:00:00,13,15,28
"4190",10102,"St Johns","NL",47.56038,-52.71147,2018-06-24 12:00:00,14,11,25
"4191",10102,"St Johns","NL",47.56038,-52.71147,2018-06-24 13:00:00,3,20,23
"4192",10102,"St Johns","NL",47.56038,-52.71147,2018-06-24 14:00:00,2,20,22
"4193",10102,"St Johns","NL",47.56038,-52.71147,2018-06-24 15:00:00,4,20,24
"4194",10102,"St Johns","NL",47.56038,-52.71147,2018-06-24 16:00:00,2,23,25
"4195",10102,"St Johns","NL",47.56038,-52.71147,2018-06-24 17:00:00,2,23,25
"4196",10102,"St Johns","NL",47.56038,-52.71147,2018-06-24 18:00:00,4,25,29
"4197",10102,"St Johns","NL",47.56038,-52.71147,2018-06-24 19:00:00,3,33,36
"4198",10102,"St Johns","NL",47.56038,-52.71147,2018-06-24 20:00:00,18,16,34
"4199",10102,"St Johns","NL",47.56038,-52.71147,2018-06-24 21:00:00,16,20,36
"4200",10102,"St Johns","NL",47.56038,-52.71147,2018-06-24 22:00:00,18,11,29
"4201",10102,"St Johns","NL",47.56038,-52.71147,2018-06-24 23:00:00,23,4,27
"4202",10102,"St Johns","NL",47.56038,-52.71147,2018-06-25 00:00:00,17,3,20
"4203",10102,"St Johns","NL",47.56038,-52.71147,2018-06-25 01:00:00,11,12,23
"4204",10102,"St Johns","NL",47.56038,-52.71147,2018-06-25 02:00:00,12,7,19
"4205",10102,"St Johns","NL",47.56038,-52.71147,2018-06-25 03:00:00,15,5,20
"4206",10102,"St Johns","NL",47.56038,-52.71147,2018-06-25 04:00:00,20,1,21
"4207",10102,"St Johns","NL",47.56038,-52.71147,2018-06-25 05:00:00,19,2,21
"4208",10102,"St Johns","NL",47.56038,-52.71147,2018-06-25 06:00:00,16,6,22
"4209",10102,"St Johns","NL",47.56038,-52.71147,2018-06-25 07:00:00,16,6,22
"4210",10102,"St Johns","NL",47.56038,-52.71147,2018-06-25 08:00:00,17,6,23
"4211",10102,"St Johns","NL",47.56038,-52.71147,2018-06-25 09:00:00,17,8,25
"4212",10102,"St Johns","NL",47.56038,-52.71147,2018-06-25 10:00:00,16,9,25
"4213",10102,"St Johns","NL",47.56038,-52.71147,2018-06-25 11:00:00,14,14,28
"4214",10102,"St Johns","NL",47.56038,-52.71147,2018-06-25 12:00:00,13,14,27
"4215",10102,"St Johns","NL",47.56038,-52.71147,2018-06-25 13:00:00,11,17,28
"4216",10102,"St Johns","NL",47.56038,-52.71147,2018-06-25 14:00:00,13,12,25
"4217",10102,"St Johns","NL",47.56038,-52.71147,2018-06-25 15:00:00,7,18,25
"4218",10102,"St Johns","NL",47.56038,-52.71147,2018-06-25 16:00:00,5,21,26
"4219",10102,"St Johns","NL",47.56038,-52.71147,2018-06-25 17:00:00,6,18,24
"4220",10102,"St Johns","NL",47.56038,-52.71147,2018-06-25 18:00:00,7,17,24
"4221",10102,"St Johns","NL",47.56038,-52.71147,2018-06-25 19:00:00,8,15,23
"4222",10102,"St Johns","NL",47.56038,-52.71147,2018-06-25 20:00:00,10,12,22
"4223",10102,"St Johns","NL",47.56038,-52.71147,2018-06-25 21:00:00,11,9,20
"4224",10102,"St Johns","NL",47.56038,-52.71147,2018-06-25 22:00:00,11,11,22
"4225",10102,"St Johns","NL",47.56038,-52.71147,2018-06-25 23:00:00,11,9,20
"4226",10102,"St Johns","NL",47.56038,-52.71147,2018-06-26 00:00:00,9,12,21
"4227",10102,"St Johns","NL",47.56038,-52.71147,2018-06-26 01:00:00,12,10,22
"4228",10102,"St Johns","NL",47.56038,-52.71147,2018-06-26 02:00:00,14,7,21
"4229",10102,"St Johns","NL",47.56038,-52.71147,2018-06-26 03:00:00,15,7,22
"4230",10102,"St Johns","NL",47.56038,-52.71147,2018-06-26 04:00:00,15,7,22
"4231",10102,"St Johns","NL",47.56038,-52.71147,2018-06-26 05:00:00,13,11,24
"4232",10102,"St Johns","NL",47.56038,-52.71147,2018-06-26 06:00:00,13,10,23
"4233",10102,"St Johns","NL",47.56038,-52.71147,2018-06-26 07:00:00,12,13,25
"4234",10102,"St Johns","NL",47.56038,-52.71147,2018-06-26 08:00:00,14,11,25
"4235",10102,"St Johns","NL",47.56038,-52.71147,2018-06-26 09:00:00,15,11,26
"4236",10102,"St Johns","NL",47.56038,-52.71147,2018-06-26 10:00:00,15,12,27
"4237",10102,"St Johns","NL",47.56038,-52.71147,2018-06-26 11:00:00,15,13,28
"4238",10102,"St Johns","NL",47.56038,-52.71147,2018-06-26 12:00:00,16,11,27
"4239",10102,"St Johns","NL",47.56038,-52.71147,2018-06-26 13:00:00,18,10,28
"4240",10102,"St Johns","NL",47.56038,-52.71147,2018-06-26 14:00:00,19,9,28
"4241",10102,"St Johns","NL",47.56038,-52.71147,2018-06-26 15:00:00,18,14,32
"4242",10102,"St Johns","NL",47.56038,-52.71147,2018-06-26 16:00:00,24,5,29
"4243",10102,"St Johns","NL",47.56038,-52.71147,2018-06-26 17:00:00,21,7,28
"4244",10102,"St Johns","NL",47.56038,-52.71147,2018-06-26 18:00:00,18,12,30
"4245",10102,"St Johns","NL",47.56038,-52.71147,2018-06-26 19:00:00,13,12,25
"4246",10102,"St Johns","NL",47.56038,-52.71147,2018-06-26 20:00:00,10,16,26
"4247",10102,"St Johns","NL",47.56038,-52.71147,2018-06-26 21:00:00,23,1,24
"4248",10102,"St Johns","NL",47.56038,-52.71147,2018-06-26 22:00:00,25,1,26
"4249",10102,"St Johns","NL",47.56038,-52.71147,2018-06-26 23:00:00,27,1,28
"4250",10102,"St Johns","NL",47.56038,-52.71147,2018-06-27 00:00:00,26,0,26
"4251",10102,"St Johns","NL",47.56038,-52.71147,2018-06-27 01:00:00,26,0,26
"4252",10102,"St Johns","NL",47.56038,-52.71147,2018-06-27 02:00:00,27,0,27
"4253",10102,"St Johns","NL",47.56038,-52.71147,2018-06-27 03:00:00,26,0,26
"4254",10102,"St Johns","NL",47.56038,-52.71147,2018-06-27 04:00:00,22,0,22
"4255",10102,"St Johns","NL",47.56038,-52.71147,2018-06-27 05:00:00,20,0,20
"4256",10102,"St Johns","NL",47.56038,-52.71147,2018-06-27 06:00:00,18,1,19
"4257",10102,"St Johns","NL",47.56038,-52.71147,2018-06-27 07:00:00,17,3,20
"4258",10102,"St Johns","NL",47.56038,-52.71147,2018-06-27 08:00:00,15,5,20
"4259",10102,"St Johns","NL",47.56038,-52.71147,2018-06-27 09:00:00,16,4,20
"4260",10102,"St Johns","NL",47.56038,-52.71147,2018-06-27 10:00:00,15,4,19
"4261",10102,"St Johns","NL",47.56038,-52.71147,2018-06-27 11:00:00,15,4,19
"4262",10102,"St Johns","NL",47.56038,-52.71147,2018-06-27 12:00:00,17,5,22
"4263",10102,"St Johns","NL",47.56038,-52.71147,2018-06-27 13:00:00,16,5,21
"4264",10102,"St Johns","NL",47.56038,-52.71147,2018-06-27 14:00:00,18,3,21
"4265",10102,"St Johns","NL",47.56038,-52.71147,2018-06-27 15:00:00,22,3,25
"4266",10102,"St Johns","NL",47.56038,-52.71147,2018-06-27 16:00:00,23,4,27
"4267",10102,"St Johns","NL",47.56038,-52.71147,2018-06-27 17:00:00,26,3,29
"4268",10102,"St Johns","NL",47.56038,-52.71147,2018-06-27 18:00:00,24,3,27
"4269",10102,"St Johns","NL",47.56038,-52.71147,2018-06-27 19:00:00,24,2,26
"4270",10102,"St Johns","NL",47.56038,-52.71147,2018-06-27 20:00:00,22,3,25
"4271",10102,"St Johns","NL",47.56038,-52.71147,2018-06-27 21:00:00,23,4,27
"4272",10102,"St Johns","NL",47.56038,-52.71147,2018-06-27 22:00:00,24,3,27
"4273",10102,"St Johns","NL",47.56038,-52.71147,2018-06-27 23:00:00,26,2,28
"4274",10102,"St Johns","NL",47.56038,-52.71147,2018-06-28 00:00:00,27,3,30
"4275",10102,"St Johns","NL",47.56038,-52.71147,2018-06-28 01:00:00,29,2,31
"4276",10102,"St Johns","NL",47.56038,-52.71147,2018-06-28 02:00:00,29,2,31
"4277",10102,"St Johns","NL",47.56038,-52.71147,2018-06-28 03:00:00,27,2,29
"4278",10102,"St Johns","NL",47.56038,-52.71147,2018-06-28 04:00:00,25,2,27
"4279",10102,"St Johns","NL",47.56038,-52.71147,2018-06-28 05:00:00,22,4,26
"4280",10102,"St Johns","NL",47.56038,-52.71147,2018-06-28 06:00:00,19,7,26
"4281",10102,"St Johns","NL",47.56038,-52.71147,2018-06-28 07:00:00,5,23,28
"4282",10102,"St Johns","NL",47.56038,-52.71147,2018-06-28 08:00:00,1,27,28
"4283",10102,"St Johns","NL",47.56038,-52.71147,2018-06-28 09:00:00,9,20,29
"4284",10102,"St Johns","NL",47.56038,-52.71147,2018-06-28 10:00:00,9,24,33
"4285",10102,"St Johns","NL",47.56038,-52.71147,2018-06-28 11:00:00,19,16,35
"4286",10102,"St Johns","NL",47.56038,-52.71147,2018-06-28 12:00:00,19,10,29
"4287",10102,"St Johns","NL",47.56038,-52.71147,2018-06-28 13:00:00,27,4,31
"4288",10102,"St Johns","NL",47.56038,-52.71147,2018-06-28 14:00:00,31,4,35
"4289",10102,"St Johns","NL",47.56038,-52.71147,2018-06-28 15:00:00,41,4,45
"4290",10102,"St Johns","NL",47.56038,-52.71147,2018-06-28 16:00:00,42,5,47
"4291",10102,"St Johns","NL",47.56038,-52.71147,2018-06-28 17:00:00,41,4,45
"4292",10102,"St Johns","NL",47.56038,-52.71147,2018-06-28 18:00:00,33,3,36
"4293",10102,"St Johns","NL",47.56038,-52.71147,2018-06-28 19:00:00,32,3,35
"4294",10102,"St Johns","NL",47.56038,-52.71147,2018-06-28 20:00:00,27,3,30
"4295",10102,"St Johns","NL",47.56038,-52.71147,2018-06-28 21:00:00,24,5,29
"4296",10102,"St Johns","NL",47.56038,-52.71147,2018-06-28 22:00:00,24,4,28
"4297",10102,"St Johns","NL",47.56038,-52.71147,2018-06-28 23:00:00,27,3,30
"4298",10102,"St Johns","NL",47.56038,-52.71147,2018-06-29 00:00:00,27,2,29
"4299",10102,"St Johns","NL",47.56038,-52.71147,2018-06-29 01:00:00,27,2,29
"4300",10102,"St Johns","NL",47.56038,-52.71147,2018-06-29 02:00:00,25,2,27
"4301",10102,"St Johns","NL",47.56038,-52.71147,2018-06-29 03:00:00,23,2,25
"4302",10102,"St Johns","NL",47.56038,-52.71147,2018-06-29 04:00:00,23,2,25
"4303",10102,"St Johns","NL",47.56038,-52.71147,2018-06-29 05:00:00,23,2,25
"4304",10102,"St Johns","NL",47.56038,-52.71147,2018-06-29 06:00:00,23,3,26
"4305",10102,"St Johns","NL",47.56038,-52.71147,2018-06-29 07:00:00,23,3,26
"4306",10102,"St Johns","NL",47.56038,-52.71147,2018-06-29 08:00:00,23,5,28
"4307",10102,"St Johns","NL",47.56038,-52.71147,2018-06-29 09:00:00,26,4,30
"4308",10102,"St Johns","NL",47.56038,-52.71147,2018-06-29 10:00:00,26,3,29
"4309",10102,"St Johns","NL",47.56038,-52.71147,2018-06-29 11:00:00,27,3,30
"4310",10102,"St Johns","NL",47.56038,-52.71147,2018-06-29 12:00:00,28,1,29
"4311",10102,"St Johns","NL",47.56038,-52.71147,2018-06-29 13:00:00,27,1,28
"4312",10102,"St Johns","NL",47.56038,-52.71147,2018-06-29 14:00:00,27,2,29
"4313",10102,"St Johns","NL",47.56038,-52.71147,2018-06-29 15:00:00,27,4,31
"4314",10102,"St Johns","NL",47.56038,-52.71147,2018-06-29 16:00:00,29,3,32
"4315",10102,"St Johns","NL",47.56038,-52.71147,2018-06-29 17:00:00,29,1,30
"4316",10102,"St Johns","NL",47.56038,-52.71147,2018-06-29 18:00:00,30,1,31
"4317",10102,"St Johns","NL",47.56038,-52.71147,2018-06-29 19:00:00,30,1,31
"4318",10102,"St Johns","NL",47.56038,-52.71147,2018-06-29 20:00:00,29,1,30
"4319",10102,"St Johns","NL",47.56038,-52.71147,2018-06-29 21:00:00,28,0,28
"4320",10102,"St Johns","NL",47.56038,-52.71147,2018-06-29 22:00:00,27,0,27
"4321",10102,"St Johns","NL",47.56038,-52.71147,2018-06-29 23:00:00,25,0,25
"4322",10102,"St Johns","NL",47.56038,-52.71147,2018-06-30 00:00:00,24,0,24
"4323",10102,"St Johns","NL",47.56038,-52.71147,2018-06-30 01:00:00,23,1,24
"4324",10102,"St Johns","NL",47.56038,-52.71147,2018-06-30 02:00:00,23,0,23
"4325",10102,"St Johns","NL",47.56038,-52.71147,2018-06-30 03:00:00,23,0,23
"4326",10102,"St Johns","NL",47.56038,-52.71147,2018-06-30 04:00:00,24,0,24
"4327",10102,"St Johns","NL",47.56038,-52.71147,2018-06-30 05:00:00,24,0,24
"4328",10102,"St Johns","NL",47.56038,-52.71147,2018-06-30 06:00:00,22,0,22
"4329",10102,"St Johns","NL",47.56038,-52.71147,2018-06-30 07:00:00,20,0,20
"4330",10102,"St Johns","NL",47.56038,-52.71147,2018-06-30 08:00:00,17,0,17
"4331",10102,"St Johns","NL",47.56038,-52.71147,2018-06-30 09:00:00,18,1,19
"4332",10102,"St Johns","NL",47.56038,-52.71147,2018-06-30 10:00:00,16,0,16
"4333",10102,"St Johns","NL",47.56038,-52.71147,2018-06-30 11:00:00,13,0,13
"4334",10102,"St Johns","NL",47.56038,-52.71147,2018-06-30 12:00:00,12,1,13
"4335",10102,"St Johns","NL",47.56038,-52.71147,2018-06-30 13:00:00,13,1,14
"4336",10102,"St Johns","NL",47.56038,-52.71147,2018-06-30 14:00:00,13,1,14
"4337",10102,"St Johns","NL",47.56038,-52.71147,2018-06-30 15:00:00,15,1,16
"4338",10102,"St Johns","NL",47.56038,-52.71147,2018-06-30 16:00:00,17,1,18
"4339",10102,"St Johns","NL",47.56038,-52.71147,2018-06-30 17:00:00,21,1,22
"4340",10102,"St Johns","NL",47.56038,-52.71147,2018-06-30 18:00:00,18,1,19
"4341",10102,"St Johns","NL",47.56038,-52.71147,2018-06-30 19:00:00,19,2,21
"4342",10102,"St Johns","NL",47.56038,-52.71147,2018-06-30 20:00:00,21,2,23
"4343",10102,"St Johns","NL",47.56038,-52.71147,2018-06-30 21:00:00,22,2,24
"4344",10102,"St Johns","NL",47.56038,-52.71147,2018-06-30 22:00:00,22,1,23
"4345",10102,"St Johns","NL",47.56038,-52.71147,2018-06-30 23:00:00,22,2,24
"4346",10102,"St Johns","NL",47.56038,-52.71147,2018-07-01 00:00:00,21,1,22
"4347",10102,"St Johns","NL",47.56038,-52.71147,2018-07-01 01:00:00,19,2,21
"4348",10102,"St Johns","NL",47.56038,-52.71147,2018-07-01 02:00:00,16,2,18
"4349",10102,"St Johns","NL",47.56038,-52.71147,2018-07-01 03:00:00,15,2,17
"4350",10102,"St Johns","NL",47.56038,-52.71147,2018-07-01 04:00:00,15,2,17
"4351",10102,"St Johns","NL",47.56038,-52.71147,2018-07-01 05:00:00,12,4,16
"4352",10102,"St Johns","NL",47.56038,-52.71147,2018-07-01 06:00:00,13,4,17
"4353",10102,"St Johns","NL",47.56038,-52.71147,2018-07-01 07:00:00,6,12,18
"4354",10102,"St Johns","NL",47.56038,-52.71147,2018-07-01 08:00:00,3,17,20
"4355",10102,"St Johns","NL",47.56038,-52.71147,2018-07-01 09:00:00,5,16,21
"4356",10102,"St Johns","NL",47.56038,-52.71147,2018-07-01 10:00:00,12,10,22
"4357",10102,"St Johns","NL",47.56038,-52.71147,2018-07-01 11:00:00,18,2,20
"4358",10102,"St Johns","NL",47.56038,-52.71147,2018-07-01 12:00:00,9,11,20
"4359",10102,"St Johns","NL",47.56038,-52.71147,2018-07-01 13:00:00,15,6,21
"4360",10102,"St Johns","NL",47.56038,-52.71147,2018-07-01 14:00:00,8,13,21
"4361",10102,"St Johns","NL",47.56038,-52.71147,2018-07-01 15:00:00,8,16,24
"4362",10102,"St Johns","NL",47.56038,-52.71147,2018-07-01 16:00:00,5,14,19
"4363",10102,"St Johns","NL",47.56038,-52.71147,2018-07-01 17:00:00,15,2,17
"4364",10102,"St Johns","NL",47.56038,-52.71147,2018-07-01 18:00:00,2,20,22
"4365",10102,"St Johns","NL",47.56038,-52.71147,2018-07-01 19:00:00,1,23,24
"4366",10102,"St Johns","NL",47.56038,-52.71147,2018-07-01 20:00:00,0,21,21
"4367",10102,"St Johns","NL",47.56038,-52.71147,2018-07-01 21:00:00,0,23,23
"4368",10102,"St Johns","NL",47.56038,-52.71147,2018-07-01 22:00:00,1,20,21
"4369",10102,"St Johns","NL",47.56038,-52.71147,2018-07-01 23:00:00,0,20,20
"4370",10102,"St Johns","NL",47.56038,-52.71147,2018-07-02 00:00:00,0,19,19
"4371",10102,"St Johns","NL",47.56038,-52.71147,2018-07-02 01:00:00,5,12,17
"4372",10102,"St Johns","NL",47.56038,-52.71147,2018-07-02 02:00:00,1,20,21
"4373",10102,"St Johns","NL",47.56038,-52.71147,2018-07-02 03:00:00,0,19,19
"4374",10102,"St Johns","NL",47.56038,-52.71147,2018-07-02 04:00:00,0,20,20
"4375",10102,"St Johns","NL",47.56038,-52.71147,2018-07-02 05:00:00,0,16,16
"4376",10102,"St Johns","NL",47.56038,-52.71147,2018-07-02 06:00:00,1,15,16
"4377",10102,"St Johns","NL",47.56038,-52.71147,2018-07-02 07:00:00,10,7,17
"4378",10102,"St Johns","NL",47.56038,-52.71147,2018-07-02 08:00:00,9,8,17
"4379",10102,"St Johns","NL",47.56038,-52.71147,2018-07-02 09:00:00,7,12,19
"4380",10102,"St Johns","NL",47.56038,-52.71147,2018-07-02 10:00:00,6,16,22
"4381",10102,"St Johns","NL",47.56038,-52.71147,2018-07-02 11:00:00,8,14,22
"4382",10102,"St Johns","NL",47.56038,-52.71147,2018-07-02 12:00:00,7,11,18
"4383",10102,"St Johns","NL",47.56038,-52.71147,2018-07-02 13:00:00,9,10,19
"4384",10102,"St Johns","NL",47.56038,-52.71147,2018-07-02 14:00:00,9,10,19
"4385",10102,"St Johns","NL",47.56038,-52.71147,2018-07-02 15:00:00,14,4,18
"4386",10102,"St Johns","NL",47.56038,-52.71147,2018-07-02 16:00:00,12,5,17
"4387",10102,"St Johns","NL",47.56038,-52.71147,2018-07-02 17:00:00,15,3,18
"4388",10102,"St Johns","NL",47.56038,-52.71147,2018-07-02 18:00:00,18,7,25
"4389",10102,"St Johns","NL",47.56038,-52.71147,2018-07-02 19:00:00,23,3,26
"4390",10102,"St Johns","NL",47.56038,-52.71147,2018-07-02 20:00:00,18,4,22
"4391",10102,"St Johns","NL",47.56038,-52.71147,2018-07-02 21:00:00,12,12,24
"4392",10102,"St Johns","NL",47.56038,-52.71147,2018-07-02 22:00:00,18,8,26
"4393",10102,"St Johns","NL",47.56038,-52.71147,2018-07-02 23:00:00,11,17,28
"4394",10102,"St Johns","NL",47.56038,-52.71147,2018-07-03 00:00:00,11,14,25
"4395",10102,"St Johns","NL",47.56038,-52.71147,2018-07-03 01:00:00,0,28,28
"4396",10102,"St Johns","NL",47.56038,-52.71147,2018-07-03 02:00:00,11,19,30
"4397",10102,"St Johns","NL",47.56038,-52.71147,2018-07-03 03:00:00,26,1,27
"4398",10102,"St Johns","NL",47.56038,-52.71147,2018-07-03 04:00:00,21,0,21
"4399",10102,"St Johns","NL",47.56038,-52.71147,2018-07-03 05:00:00,10,9,19
"4400",10102,"St Johns","NL",47.56038,-52.71147,2018-07-03 06:00:00,13,4,17
"4401",10102,"St Johns","NL",47.56038,-52.71147,2018-07-03 07:00:00,2,18,20
"4402",10102,"St Johns","NL",47.56038,-52.71147,2018-07-03 08:00:00,3,17,20
"4403",10102,"St Johns","NL",47.56038,-52.71147,2018-07-03 09:00:00,6,12,18
"4404",10102,"St Johns","NL",47.56038,-52.71147,2018-07-03 10:00:00,6,16,22
"4405",10102,"St Johns","NL",47.56038,-52.71147,2018-07-03 11:00:00,14,9,23
"4406",10102,"St Johns","NL",47.56038,-52.71147,2018-07-03 12:00:00,15,6,21
"4407",10102,"St Johns","NL",47.56038,-52.71147,2018-07-03 13:00:00,13,7,20
"4408",10102,"St Johns","NL",47.56038,-52.71147,2018-07-03 14:00:00,22,5,27
"4409",10102,"St Johns","NL",47.56038,-52.71147,2018-07-03 15:00:00,26,5,31
"4410",10102,"St Johns","NL",47.56038,-52.71147,2018-07-03 16:00:00,26,5,31
"4411",10102,"St Johns","NL",47.56038,-52.71147,2018-07-03 17:00:00,27,3,30
"4412",10102,"St Johns","NL",47.56038,-52.71147,2018-07-03 18:00:00,26,2,28
"4413",10102,"St Johns","NL",47.56038,-52.71147,2018-07-03 19:00:00,24,3,27
"4414",10102,"St Johns","NL",47.56038,-52.71147,2018-07-03 20:00:00,24,2,26
"4415",10102,"St Johns","NL",47.56038,-52.71147,2018-07-03 21:00:00,24,2,26
"4416",10102,"St Johns","NL",47.56038,-52.71147,2018-07-03 22:00:00,23,2,25
"4417",10102,"St Johns","NL",47.56038,-52.71147,2018-07-03 23:00:00,22,2,24
"4418",10102,"St Johns","NL",47.56038,-52.71147,2018-07-04 00:00:00,23,1,24
"4419",10102,"St Johns","NL",47.56038,-52.71147,2018-07-04 01:00:00,27,1,28
"4420",10102,"St Johns","NL",47.56038,-52.71147,2018-07-04 02:00:00,28,1,29
"4421",10102,"St Johns","NL",47.56038,-52.71147,2018-07-04 03:00:00,27,1,28
"4422",10102,"St Johns","NL",47.56038,-52.71147,2018-07-04 04:00:00,24,1,25
"4423",10102,"St Johns","NL",47.56038,-52.71147,2018-07-04 05:00:00,23,2,25
"4424",10102,"St Johns","NL",47.56038,-52.71147,2018-07-04 06:00:00,22,2,24
"4425",10102,"St Johns","NL",47.56038,-52.71147,2018-07-04 07:00:00,22,4,26
"4426",10102,"St Johns","NL",47.56038,-52.71147,2018-07-04 08:00:00,23,3,26
"4427",10102,"St Johns","NL",47.56038,-52.71147,2018-07-04 09:00:00,23,4,27
"4428",10102,"St Johns","NL",47.56038,-52.71147,2018-07-04 10:00:00,23,3,26
"4429",10102,"St Johns","NL",47.56038,-52.71147,2018-07-04 11:00:00,25,3,28
"4430",10102,"St Johns","NL",47.56038,-52.71147,2018-07-04 12:00:00,27,2,29
"4431",10102,"St Johns","NL",47.56038,-52.71147,2018-07-04 13:00:00,28,2,30
"4432",10102,"St Johns","NL",47.56038,-52.71147,2018-07-04 14:00:00,27,3,30
"4433",10102,"St Johns","NL",47.56038,-52.71147,2018-07-04 15:00:00,28,2,30
"4434",10102,"St Johns","NL",47.56038,-52.71147,2018-07-04 16:00:00,22,7,29
"4435",10102,"St Johns","NL",47.56038,-52.71147,2018-07-04 17:00:00,16,15,31
"4436",10102,"St Johns","NL",47.56038,-52.71147,2018-07-04 18:00:00,13,27,40
"4437",10102,"St Johns","NL",47.56038,-52.71147,2018-07-04 19:00:00,9,25,34
"4438",10102,"St Johns","NL",47.56038,-52.71147,2018-07-04 20:00:00,11,23,34
"4439",10102,"St Johns","NL",47.56038,-52.71147,2018-07-04 21:00:00,12,22,34
"4440",10102,"St Johns","NL",47.56038,-52.71147,2018-07-04 22:00:00,13,19,32
"4441",10102,"St Johns","NL",47.56038,-52.71147,2018-07-04 23:00:00,9,22,31
"4442",10102,"St Johns","NL",47.56038,-52.71147,2018-07-05 00:00:00,9,21,30
"4443",10102,"St Johns","NL",47.56038,-52.71147,2018-07-05 01:00:00,9,20,29
"4444",10102,"St Johns","NL",47.56038,-52.71147,2018-07-05 02:00:00,10,20,30
"4445",10102,"St Johns","NL",47.56038,-52.71147,2018-07-05 03:00:00,11,18,29
"4446",10102,"St Johns","NL",47.56038,-52.71147,2018-07-05 04:00:00,12,14,26
"4447",10102,"St Johns","NL",47.56038,-52.71147,2018-07-05 05:00:00,9,17,26
"4448",10102,"St Johns","NL",47.56038,-52.71147,2018-07-05 06:00:00,12,15,27
"4449",10102,"St Johns","NL",47.56038,-52.71147,2018-07-05 07:00:00,6,31,37
"4450",10102,"St Johns","NL",47.56038,-52.71147,2018-07-05 08:00:00,7,27,34
"4451",10102,"St Johns","NL",47.56038,-52.71147,2018-07-05 09:00:00,9,21,30
"4452",10102,"St Johns","NL",47.56038,-52.71147,2018-07-05 10:00:00,8,20,28
"4453",10102,"St Johns","NL",47.56038,-52.71147,2018-07-05 11:00:00,18,10,28
"4454",10102,"St Johns","NL",47.56038,-52.71147,2018-07-05 12:00:00,21,6,27
"4455",10102,"St Johns","NL",47.56038,-52.71147,2018-07-05 13:00:00,22,5,27
"4456",10102,"St Johns","NL",47.56038,-52.71147,2018-07-05 14:00:00,21,6,27
"4457",10102,"St Johns","NL",47.56038,-52.71147,2018-07-05 15:00:00,23,3,26
"4458",10102,"St Johns","NL",47.56038,-52.71147,2018-07-05 16:00:00,23,3,26
"4459",10102,"St Johns","NL",47.56038,-52.71147,2018-07-05 17:00:00,23,3,26
"4460",10102,"St Johns","NL",47.56038,-52.71147,2018-07-05 18:00:00,24,2,26
"4461",10102,"St Johns","NL",47.56038,-52.71147,2018-07-05 19:00:00,23,2,25
"4462",10102,"St Johns","NL",47.56038,-52.71147,2018-07-05 20:00:00,22,3,25
"4463",10102,"St Johns","NL",47.56038,-52.71147,2018-07-05 21:00:00,19,6,25
"4464",10102,"St Johns","NL",47.56038,-52.71147,2018-07-05 22:00:00,14,7,21
"4465",10102,"St Johns","NL",47.56038,-52.71147,2018-07-05 23:00:00,17,5,22
"4466",10102,"St Johns","NL",47.56038,-52.71147,2018-07-06 00:00:00,23,2,25
"4467",10102,"St Johns","NL",47.56038,-52.71147,2018-07-06 01:00:00,23,1,24
"4468",10102,"St Johns","NL",47.56038,-52.71147,2018-07-06 02:00:00,18,1,19
"4469",10102,"St Johns","NL",47.56038,-52.71147,2018-07-06 03:00:00,17,1,18
"4470",10102,"St Johns","NL",47.56038,-52.71147,2018-07-06 04:00:00,15,2,17
"4471",10102,"St Johns","NL",47.56038,-52.71147,2018-07-06 05:00:00,12,1,13
"4472",10102,"St Johns","NL",47.56038,-52.71147,2018-07-06 06:00:00,11,5,16
"4473",10102,"St Johns","NL",47.56038,-52.71147,2018-07-06 07:00:00,17,4,21
"4474",10102,"St Johns","NL",47.56038,-52.71147,2018-07-06 08:00:00,19,5,24
"4475",10102,"St Johns","NL",47.56038,-52.71147,2018-07-06 09:00:00,28,2,30
"4476",10102,"St Johns","NL",47.56038,-52.71147,2018-07-06 10:00:00,29,1,30
"4477",10102,"St Johns","NL",47.56038,-52.71147,2018-07-06 11:00:00,28,2,30
"4478",10102,"St Johns","NL",47.56038,-52.71147,2018-07-06 12:00:00,30,1,31
"4479",10102,"St Johns","NL",47.56038,-52.71147,2018-07-06 13:00:00,30,1,31
"4480",10102,"St Johns","NL",47.56038,-52.71147,2018-07-06 14:00:00,32,0,32
"4481",10102,"St Johns","NL",47.56038,-52.71147,2018-07-06 15:00:00,29,1,30
"4482",10102,"St Johns","NL",47.56038,-52.71147,2018-07-06 16:00:00,27,1,28
"4483",10102,"St Johns","NL",47.56038,-52.71147,2018-07-06 17:00:00,19,0,19
"4484",10102,"St Johns","NL",47.56038,-52.71147,2018-07-06 18:00:00,14,0,14
"4485",10102,"St Johns","NL",47.56038,-52.71147,2018-07-06 19:00:00,12,0,12
"4486",10102,"St Johns","NL",47.56038,-52.71147,2018-07-06 20:00:00,12,0,12
"4487",10102,"St Johns","NL",47.56038,-52.71147,2018-07-06 21:00:00,13,1,14
"4488",10102,"St Johns","NL",47.56038,-52.71147,2018-07-06 22:00:00,12,1,13
"4489",10102,"St Johns","NL",47.56038,-52.71147,2018-07-06 23:00:00,12,0,12
"4490",10102,"St Johns","NL",47.56038,-52.71147,2018-07-07 00:00:00,11,1,12
"4491",10102,"St Johns","NL",47.56038,-52.71147,2018-07-07 01:00:00,10,1,11
"4492",10102,"St Johns","NL",47.56038,-52.71147,2018-07-07 02:00:00,10,1,11
"4493",10102,"St Johns","NL",47.56038,-52.71147,2018-07-07 03:00:00,11,1,12
"4494",10102,"St Johns","NL",47.56038,-52.71147,2018-07-07 04:00:00,10,1,11
"4495",10102,"St Johns","NL",47.56038,-52.71147,2018-07-07 05:00:00,10,1,11
"4496",10102,"St Johns","NL",47.56038,-52.71147,2018-07-07 06:00:00,10,1,11
"4497",10102,"St Johns","NL",47.56038,-52.71147,2018-07-07 07:00:00,10,1,11
"4498",10102,"St Johns","NL",47.56038,-52.71147,2018-07-07 08:00:00,11,3,14
"4499",10102,"St Johns","NL",47.56038,-52.71147,2018-07-07 09:00:00,17,2,19
"4500",10102,"St Johns","NL",47.56038,-52.71147,2018-07-07 10:00:00,19,2,21
"4501",10102,"St Johns","NL",47.56038,-52.71147,2018-07-07 11:00:00,17,1,18
"4502",10102,"St Johns","NL",47.56038,-52.71147,2018-07-07 12:00:00,17,1,18
"4503",10102,"St Johns","NL",47.56038,-52.71147,2018-07-07 13:00:00,18,1,19
"4504",10102,"St Johns","NL",47.56038,-52.71147,2018-07-07 14:00:00,20,1,21
"4505",10102,"St Johns","NL",47.56038,-52.71147,2018-07-07 15:00:00,19,1,20
"4506",10102,"St Johns","NL",47.56038,-52.71147,2018-07-07 16:00:00,17,1,18
"4507",10102,"St Johns","NL",47.56038,-52.71147,2018-07-07 17:00:00,17,1,18
"4508",10102,"St Johns","NL",47.56038,-52.71147,2018-07-07 18:00:00,18,1,19
"4509",10102,"St Johns","NL",47.56038,-52.71147,2018-07-07 19:00:00,21,1,22
"4510",10102,"St Johns","NL",47.56038,-52.71147,2018-07-07 20:00:00,23,2,25
"4511",10102,"St Johns","NL",47.56038,-52.71147,2018-07-07 21:00:00,24,2,26
"4512",10102,"St Johns","NL",47.56038,-52.71147,2018-07-07 22:00:00,25,1,26
"4513",10102,"St Johns","NL",47.56038,-52.71147,2018-07-07 23:00:00,25,2,27
"4514",10102,"St Johns","NL",47.56038,-52.71147,2018-07-08 00:00:00,25,1,26
"4515",10102,"St Johns","NL",47.56038,-52.71147,2018-07-08 01:00:00,25,1,26
"4516",10102,"St Johns","NL",47.56038,-52.71147,2018-07-08 02:00:00,23,2,25
"4517",10102,"St Johns","NL",47.56038,-52.71147,2018-07-08 03:00:00,23,2,25
"4518",10102,"St Johns","NL",47.56038,-52.71147,2018-07-08 04:00:00,22,1,23
"4519",10102,"St Johns","NL",47.56038,-52.71147,2018-07-08 05:00:00,22,1,23
"4520",10102,"St Johns","NL",47.56038,-52.71147,2018-07-08 06:00:00,21,1,22
"4521",10102,"St Johns","NL",47.56038,-52.71147,2018-07-08 07:00:00,21,0,21
"4522",10102,"St Johns","NL",47.56038,-52.71147,2018-07-08 08:00:00,21,1,22
"4523",10102,"St Johns","NL",47.56038,-52.71147,2018-07-08 09:00:00,22,1,23
"4524",10102,"St Johns","NL",47.56038,-52.71147,2018-07-08 10:00:00,24,0,24
"4525",10102,"St Johns","NL",47.56038,-52.71147,2018-07-08 11:00:00,27,1,28
"4526",10102,"St Johns","NL",47.56038,-52.71147,2018-07-08 12:00:00,27,1,28
"4527",10102,"St Johns","NL",47.56038,-52.71147,2018-07-08 13:00:00,27,2,29
"4528",10102,"St Johns","NL",47.56038,-52.71147,2018-07-08 14:00:00,28,1,29
"4529",10102,"St Johns","NL",47.56038,-52.71147,2018-07-08 15:00:00,26,1,27
"4530",10102,"St Johns","NL",47.56038,-52.71147,2018-07-08 16:00:00,24,1,25
"4531",10102,"St Johns","NL",47.56038,-52.71147,2018-07-08 17:00:00,24,2,26
"4532",10102,"St Johns","NL",47.56038,-52.71147,2018-07-08 18:00:00,24,2,26
"4533",10102,"St Johns","NL",47.56038,-52.71147,2018-07-08 19:00:00,25,2,27
"4534",10102,"St Johns","NL",47.56038,-52.71147,2018-07-08 20:00:00,24,2,26
"4535",10102,"St Johns","NL",47.56038,-52.71147,2018-07-08 21:00:00,24,2,26
"4536",10102,"St Johns","NL",47.56038,-52.71147,2018-07-08 22:00:00,24,2,26
"4537",10102,"St Johns","NL",47.56038,-52.71147,2018-07-08 23:00:00,23,2,25
"4538",10102,"St Johns","NL",47.56038,-52.71147,2018-07-09 00:00:00,23,2,25
"4539",10102,"St Johns","NL",47.56038,-52.71147,2018-07-09 01:00:00,24,1,25
"4540",10102,"St Johns","NL",47.56038,-52.71147,2018-07-09 02:00:00,23,2,25
"4541",10102,"St Johns","NL",47.56038,-52.71147,2018-07-09 03:00:00,23,2,25
"4542",10102,"St Johns","NL",47.56038,-52.71147,2018-07-09 04:00:00,23,1,24
"4543",10102,"St Johns","NL",47.56038,-52.71147,2018-07-09 05:00:00,22,1,23
"4544",10102,"St Johns","NL",47.56038,-52.71147,2018-07-09 06:00:00,21,2,23
"4545",10102,"St Johns","NL",47.56038,-52.71147,2018-07-09 07:00:00,21,3,24
"4546",10102,"St Johns","NL",47.56038,-52.71147,2018-07-09 08:00:00,23,3,26
"4547",10102,"St Johns","NL",47.56038,-52.71147,2018-07-09 09:00:00,25,2,27
"4548",10102,"St Johns","NL",47.56038,-52.71147,2018-07-09 10:00:00,26,2,28
"4549",10102,"St Johns","NL",47.56038,-52.71147,2018-07-09 11:00:00,26,2,28
"4550",10102,"St Johns","NL",47.56038,-52.71147,2018-07-09 12:00:00,26,2,28
"4551",10102,"St Johns","NL",47.56038,-52.71147,2018-07-09 13:00:00,28,2,30
"4552",10102,"St Johns","NL",47.56038,-52.71147,2018-07-09 14:00:00,27,2,29
"4553",10102,"St Johns","NL",47.56038,-52.71147,2018-07-09 15:00:00,28,2,30
"4554",10102,"St Johns","NL",47.56038,-52.71147,2018-07-09 16:00:00,28,2,30
"4555",10102,"St Johns","NL",47.56038,-52.71147,2018-07-09 17:00:00,29,3,32
"4556",10102,"St Johns","NL",47.56038,-52.71147,2018-07-09 18:00:00,27,2,29
"4557",10102,"St Johns","NL",47.56038,-52.71147,2018-07-09 19:00:00,25,2,27
"4558",10102,"St Johns","NL",47.56038,-52.71147,2018-07-09 20:00:00,26,2,28
"4559",10102,"St Johns","NL",47.56038,-52.71147,2018-07-09 21:00:00,30,2,32
"4560",10102,"St Johns","NL",47.56038,-52.71147,2018-07-09 22:00:00,28,1,29
"4561",10102,"St Johns","NL",47.56038,-52.71147,2018-07-09 23:00:00,27,1,28
"4562",10102,"St Johns","NL",47.56038,-52.71147,2018-07-10 00:00:00,27,2,29
"4563",10102,"St Johns","NL",47.56038,-52.71147,2018-07-10 01:00:00,30,2,32
"4564",10102,"St Johns","NL",47.56038,-52.71147,2018-07-10 02:00:00,32,2,34
"4565",10102,"St Johns","NL",47.56038,-52.71147,2018-07-10 03:00:00,33,2,35
"4566",10102,"St Johns","NL",47.56038,-52.71147,2018-07-10 04:00:00,31,2,33
"4567",10102,"St Johns","NL",47.56038,-52.71147,2018-07-10 05:00:00,30,1,31
"4568",10102,"St Johns","NL",47.56038,-52.71147,2018-07-10 06:00:00,27,2,29
"4569",10102,"St Johns","NL",47.56038,-52.71147,2018-07-10 07:00:00,28,3,31
"4570",10102,"St Johns","NL",47.56038,-52.71147,2018-07-10 08:00:00,30,3,33
"4571",10102,"St Johns","NL",47.56038,-52.71147,2018-07-10 09:00:00,31,2,33
"4572",10102,"St Johns","NL",47.56038,-52.71147,2018-07-10 10:00:00,33,2,35
"4573",10102,"St Johns","NL",47.56038,-52.71147,2018-07-10 11:00:00,33,2,35
"4574",10102,"St Johns","NL",47.56038,-52.71147,2018-07-10 12:00:00,36,1,37
"4575",10102,"St Johns","NL",47.56038,-52.71147,2018-07-10 13:00:00,40,1,41
"4576",10102,"St Johns","NL",47.56038,-52.71147,2018-07-10 14:00:00,40,1,41
"4577",10102,"St Johns","NL",47.56038,-52.71147,2018-07-10 15:00:00,28,1,29
"4578",10102,"St Johns","NL",47.56038,-52.71147,2018-07-10 16:00:00,20,0,20
"4579",10102,"St Johns","NL",47.56038,-52.71147,2018-07-10 17:00:00,16,0,16
"4580",10102,"St Johns","NL",47.56038,-52.71147,2018-07-10 18:00:00,14,0,14
"4581",10102,"St Johns","NL",47.56038,-52.71147,2018-07-10 19:00:00,13,0,13
"4582",10102,"St Johns","NL",47.56038,-52.71147,2018-07-10 20:00:00,12,0,12
"4583",10102,"St Johns","NL",47.56038,-52.71147,2018-07-10 21:00:00,12,1,13
"4584",10102,"St Johns","NL",47.56038,-52.71147,2018-07-10 22:00:00,10,1,11
"4585",10102,"St Johns","NL",47.56038,-52.71147,2018-07-10 23:00:00,2,9,11
"4586",10102,"St Johns","NL",47.56038,-52.71147,2018-07-11 00:00:00,13,0,13
"4587",10102,"St Johns","NL",47.56038,-52.71147,2018-07-11 01:00:00,14,0,14
"4588",10102,"St Johns","NL",47.56038,-52.71147,2018-07-11 02:00:00,15,1,16
"4589",10102,"St Johns","NL",47.56038,-52.71147,2018-07-11 03:00:00,16,0,16
"4590",10102,"St Johns","NL",47.56038,-52.71147,2018-07-11 04:00:00,16,1,17
"4591",10102,"St Johns","NL",47.56038,-52.71147,2018-07-11 05:00:00,19,0,19
"4592",10102,"St Johns","NL",47.56038,-52.71147,2018-07-11 06:00:00,20,1,21
"4593",10102,"St Johns","NL",47.56038,-52.71147,2018-07-11 07:00:00,18,1,19
"4594",10102,"St Johns","NL",47.56038,-52.71147,2018-07-11 08:00:00,19,1,20
"4595",10102,"St Johns","NL",47.56038,-52.71147,2018-07-11 09:00:00,19,2,21
"4596",10102,"St Johns","NL",47.56038,-52.71147,2018-07-11 10:00:00,20,1,21
"4597",10102,"St Johns","NL",47.56038,-52.71147,2018-07-11 11:00:00,19,1,20
"4598",10102,"St Johns","NL",47.56038,-52.71147,2018-07-11 12:00:00,22,0,22
"4599",10102,"St Johns","NL",47.56038,-52.71147,2018-07-11 13:00:00,24,1,25
"4600",10102,"St Johns","NL",47.56038,-52.71147,2018-07-11 14:00:00,23,1,24
"4601",10102,"St Johns","NL",47.56038,-52.71147,2018-07-11 15:00:00,24,1,25
"4602",10102,"St Johns","NL",47.56038,-52.71147,2018-07-11 16:00:00,23,1,24
"4603",10102,"St Johns","NL",47.56038,-52.71147,2018-07-11 17:00:00,24,0,24
"4604",10102,"St Johns","NL",47.56038,-52.71147,2018-07-11 18:00:00,23,1,24
"4605",10102,"St Johns","NL",47.56038,-52.71147,2018-07-11 19:00:00,19,3,22
"4606",10102,"St Johns","NL",47.56038,-52.71147,2018-07-11 20:00:00,19,1,20
"4607",10102,"St Johns","NL",47.56038,-52.71147,2018-07-11 21:00:00,8,10,18
"4608",10102,"St Johns","NL",47.56038,-52.71147,2018-07-11 22:00:00,1,18,19
"4609",10102,"St Johns","NL",47.56038,-52.71147,2018-07-11 23:00:00,5,10,15
"4610",10102,"St Johns","NL",47.56038,-52.71147,2018-07-12 00:00:00,11,2,13
"4611",10102,"St Johns","NL",47.56038,-52.71147,2018-07-12 01:00:00,9,5,14
"4612",10102,"St Johns","NL",47.56038,-52.71147,2018-07-12 02:00:00,4,9,13
"4613",10102,"St Johns","NL",47.56038,-52.71147,2018-07-12 03:00:00,1,12,13
"4614",10102,"St Johns","NL",47.56038,-52.71147,2018-07-12 04:00:00,0,14,14
"4615",10102,"St Johns","NL",47.56038,-52.71147,2018-07-12 05:00:00,0,14,14
"4616",10102,"St Johns","NL",47.56038,-52.71147,2018-07-12 06:00:00,0,15,15
"4617",10102,"St Johns","NL",47.56038,-52.71147,2018-07-12 07:00:00,0,16,16
"4618",10102,"St Johns","NL",47.56038,-52.71147,2018-07-12 08:00:00,14,5,19
"4619",10102,"St Johns","NL",47.56038,-52.71147,2018-07-12 09:00:00,17,1,18
"4620",10102,"St Johns","NL",47.56038,-52.71147,2018-07-12 10:00:00,18,0,18
"4621",10102,"St Johns","NL",47.56038,-52.71147,2018-07-12 11:00:00,17,3,20
"4622",10102,"St Johns","NL",47.56038,-52.71147,2018-07-12 12:00:00,11,7,18
"4623",10102,"St Johns","NL",47.56038,-52.71147,2018-07-12 13:00:00,9,9,18
"4624",10102,"St Johns","NL",47.56038,-52.71147,2018-07-12 14:00:00,9,3,12
"4625",10102,"St Johns","NL",47.56038,-52.71147,2018-07-12 15:00:00,11,2,13
"4626",10102,"St Johns","NL",47.56038,-52.71147,2018-07-12 16:00:00,12,2,14
"4627",10102,"St Johns","NL",47.56038,-52.71147,2018-07-12 17:00:00,13,1,14
"4628",10102,"St Johns","NL",47.56038,-52.71147,2018-07-12 18:00:00,17,2,19
"4629",10102,"St Johns","NL",47.56038,-52.71147,2018-07-12 19:00:00,31,1,32
"4630",10102,"St Johns","NL",47.56038,-52.71147,2018-07-12 20:00:00,32,2,34
"4631",10102,"St Johns","NL",47.56038,-52.71147,2018-07-12 21:00:00,25,1,26
"4632",10102,"St Johns","NL",47.56038,-52.71147,2018-07-12 22:00:00,28,0,28
"4633",10102,"St Johns","NL",47.56038,-52.71147,2018-07-12 23:00:00,22,0,22
"4634",10102,"St Johns","NL",47.56038,-52.71147,2018-07-13 00:00:00,21,1,22
"4635",10102,"St Johns","NL",47.56038,-52.71147,2018-07-13 01:00:00,22,1,23
"4636",10102,"St Johns","NL",47.56038,-52.71147,2018-07-13 02:00:00,24,1,25
"4637",10102,"St Johns","NL",47.56038,-52.71147,2018-07-13 03:00:00,22,1,23
"4638",10102,"St Johns","NL",47.56038,-52.71147,2018-07-13 04:00:00,20,0,20
"4639",10102,"St Johns","NL",47.56038,-52.71147,2018-07-13 05:00:00,19,0,19
"4640",10102,"St Johns","NL",47.56038,-52.71147,2018-07-13 06:00:00,17,2,19
"4641",10102,"St Johns","NL",47.56038,-52.71147,2018-07-13 07:00:00,18,2,20
"4642",10102,"St Johns","NL",47.56038,-52.71147,2018-07-13 08:00:00,21,0,21
"4643",10102,"St Johns","NL",47.56038,-52.71147,2018-07-13 09:00:00,20,1,21
"4644",10102,"St Johns","NL",47.56038,-52.71147,2018-07-13 10:00:00,17,0,17
"4645",10102,"St Johns","NL",47.56038,-52.71147,2018-07-13 11:00:00,15,2,17
"4646",10102,"St Johns","NL",47.56038,-52.71147,2018-07-13 12:00:00,11,5,16
"4647",10102,"St Johns","NL",47.56038,-52.71147,2018-07-13 13:00:00,9,8,17
"4648",10102,"St Johns","NL",47.56038,-52.71147,2018-07-13 14:00:00,9,9,18
"4649",10102,"St Johns","NL",47.56038,-52.71147,2018-07-13 15:00:00,15,5,20
"4650",10102,"St Johns","NL",47.56038,-52.71147,2018-07-13 16:00:00,15,3,18
"4651",10102,"St Johns","NL",47.56038,-52.71147,2018-07-13 17:00:00,11,8,19
"4652",10102,"St Johns","NL",47.56038,-52.71147,2018-07-13 18:00:00,10,10,20
"4653",10102,"St Johns","NL",47.56038,-52.71147,2018-07-13 19:00:00,9,9,18
"4654",10102,"St Johns","NL",47.56038,-52.71147,2018-07-13 20:00:00,11,5,16
"4655",10102,"St Johns","NL",47.56038,-52.71147,2018-07-13 21:00:00,11,4,15
"4656",10102,"St Johns","NL",47.56038,-52.71147,2018-07-13 22:00:00,11,3,14
"4657",10102,"St Johns","NL",47.56038,-52.71147,2018-07-13 23:00:00,13,1,14
"4658",10102,"St Johns","NL",47.56038,-52.71147,2018-07-14 00:00:00,12,1,13
"4659",10102,"St Johns","NL",47.56038,-52.71147,2018-07-14 01:00:00,13,2,15
"4660",10102,"St Johns","NL",47.56038,-52.71147,2018-07-14 02:00:00,12,2,14
"4661",10102,"St Johns","NL",47.56038,-52.71147,2018-07-14 03:00:00,10,2,12
"4662",10102,"St Johns","NL",47.56038,-52.71147,2018-07-14 04:00:00,10,3,13
"4663",10102,"St Johns","NL",47.56038,-52.71147,2018-07-14 05:00:00,10,3,13
"4664",10102,"St Johns","NL",47.56038,-52.71147,2018-07-14 06:00:00,10,3,13
"4665",10102,"St Johns","NL",47.56038,-52.71147,2018-07-14 07:00:00,8,6,14
"4666",10102,"St Johns","NL",47.56038,-52.71147,2018-07-14 08:00:00,4,12,16
"4667",10102,"St Johns","NL",47.56038,-52.71147,2018-07-14 09:00:00,2,19,21
"4668",10102,"St Johns","NL",47.56038,-52.71147,2018-07-14 10:00:00,15,4,19
"4669",10102,"St Johns","NL",47.56038,-52.71147,2018-07-14 11:00:00,17,4,21
"4670",10102,"St Johns","NL",47.56038,-52.71147,2018-07-14 12:00:00,19,1,20
"4671",10102,"St Johns","NL",47.56038,-52.71147,2018-07-14 13:00:00,12,10,22
"4672",10102,"St Johns","NL",47.56038,-52.71147,2018-07-14 14:00:00,3,17,20
"4673",10102,"St Johns","NL",47.56038,-52.71147,2018-07-14 15:00:00,3,19,22
"4674",10102,"St Johns","NL",47.56038,-52.71147,2018-07-14 16:00:00,4,16,20
"4675",10102,"St Johns","NL",47.56038,-52.71147,2018-07-14 17:00:00,12,9,21
"4676",10102,"St Johns","NL",47.56038,-52.71147,2018-07-14 18:00:00,16,3,19
"4677",10102,"St Johns","NL",47.56038,-52.71147,2018-07-14 19:00:00,9,11,20
"4678",10102,"St Johns","NL",47.56038,-52.71147,2018-07-14 20:00:00,4,17,21
"4679",10102,"St Johns","NL",47.56038,-52.71147,2018-07-14 21:00:00,11,9,20
"4680",10102,"St Johns","NL",47.56038,-52.71147,2018-07-14 22:00:00,5,15,20
"4681",10102,"St Johns","NL",47.56038,-52.71147,2018-07-14 23:00:00,6,12,18
"4682",10102,"St Johns","NL",47.56038,-52.71147,2018-07-15 00:00:00,2,16,18
"4683",10102,"St Johns","NL",47.56038,-52.71147,2018-07-15 01:00:00,1,17,18
"4684",10102,"St Johns","NL",47.56038,-52.71147,2018-07-15 02:00:00,2,14,16
"4685",10102,"St Johns","NL",47.56038,-52.71147,2018-07-15 03:00:00,1,14,15
"4686",10102,"St Johns","NL",47.56038,-52.71147,2018-07-15 04:00:00,0,16,16
"4687",10102,"St Johns","NL",47.56038,-52.71147,2018-07-15 05:00:00,0,18,18
"4688",10102,"St Johns","NL",47.56038,-52.71147,2018-07-15 06:00:00,0,17,17
"4689",10102,"St Johns","NL",47.56038,-52.71147,2018-07-15 07:00:00,1,14,15
"4690",10102,"St Johns","NL",47.56038,-52.71147,2018-07-15 08:00:00,0,21,21
"4691",10102,"St Johns","NL",47.56038,-52.71147,2018-07-15 09:00:00,0,18,18
"4692",10102,"St Johns","NL",47.56038,-52.71147,2018-07-15 10:00:00,1,18,19
"4693",10102,"St Johns","NL",47.56038,-52.71147,2018-07-15 11:00:00,9,9,18
"4694",10102,"St Johns","NL",47.56038,-52.71147,2018-07-15 12:00:00,2,15,17
"4695",10102,"St Johns","NL",47.56038,-52.71147,2018-07-15 13:00:00,15,2,17
"4696",10102,"St Johns","NL",47.56038,-52.71147,2018-07-15 14:00:00,16,1,17
"4697",10102,"St Johns","NL",47.56038,-52.71147,2018-07-15 15:00:00,17,1,18
"4698",10102,"St Johns","NL",47.56038,-52.71147,2018-07-15 16:00:00,15,1,16
"4699",10102,"St Johns","NL",47.56038,-52.71147,2018-07-15 17:00:00,12,0,12
"4700",10102,"St Johns","NL",47.56038,-52.71147,2018-07-15 18:00:00,13,0,13
"4701",10102,"St Johns","NL",47.56038,-52.71147,2018-07-15 19:00:00,15,0,15
"4702",10102,"St Johns","NL",47.56038,-52.71147,2018-07-15 20:00:00,16,1,17
"4703",10102,"St Johns","NL",47.56038,-52.71147,2018-07-15 21:00:00,16,1,17
"4704",10102,"St Johns","NL",47.56038,-52.71147,2018-07-15 22:00:00,17,1,18
"4705",10102,"St Johns","NL",47.56038,-52.71147,2018-07-15 23:00:00,17,0,17
"4706",10102,"St Johns","NL",47.56038,-52.71147,2018-07-16 00:00:00,18,0,18
"4707",10102,"St Johns","NL",47.56038,-52.71147,2018-07-16 01:00:00,20,0,20
"4708",10102,"St Johns","NL",47.56038,-52.71147,2018-07-16 02:00:00,19,0,19
"4709",10102,"St Johns","NL",47.56038,-52.71147,2018-07-16 03:00:00,19,0,19
"4710",10102,"St Johns","NL",47.56038,-52.71147,2018-07-16 04:00:00,18,0,18
"4711",10102,"St Johns","NL",47.56038,-52.71147,2018-07-16 05:00:00,18,0,18
"4712",10102,"St Johns","NL",47.56038,-52.71147,2018-07-16 06:00:00,18,0,18
"4713",10102,"St Johns","NL",47.56038,-52.71147,2018-07-16 07:00:00,17,2,19
"4714",10102,"St Johns","NL",47.56038,-52.71147,2018-07-16 08:00:00,18,3,21
"4715",10102,"St Johns","NL",47.56038,-52.71147,2018-07-16 09:00:00,16,3,19
"4716",10102,"St Johns","NL",47.56038,-52.71147,2018-07-16 10:00:00,15,1,16
"4717",10102,"St Johns","NL",47.56038,-52.71147,2018-07-16 11:00:00,12,1,13
"4718",10102,"St Johns","NL",47.56038,-52.71147,2018-07-16 12:00:00,15,1,16
"4719",10102,"St Johns","NL",47.56038,-52.71147,2018-07-16 13:00:00,14,1,15
"4720",10102,"St Johns","NL",47.56038,-52.71147,2018-07-16 14:00:00,13,2,15
"4721",10102,"St Johns","NL",47.56038,-52.71147,2018-07-16 15:00:00,15,1,16
"4722",10102,"St Johns","NL",47.56038,-52.71147,2018-07-16 16:00:00,14,2,16
"4723",10102,"St Johns","NL",47.56038,-52.71147,2018-07-16 17:00:00,12,1,13
"4724",10102,"St Johns","NL",47.56038,-52.71147,2018-07-16 18:00:00,12,1,13
"4725",10102,"St Johns","NL",47.56038,-52.71147,2018-07-16 19:00:00,12,0,12
"4726",10102,"St Johns","NL",47.56038,-52.71147,2018-07-16 20:00:00,13,1,14
"4727",10102,"St Johns","NL",47.56038,-52.71147,2018-07-16 21:00:00,12,2,14
"4728",10102,"St Johns","NL",47.56038,-52.71147,2018-07-16 22:00:00,16,2,18
"4729",10102,"St Johns","NL",47.56038,-52.71147,2018-07-16 23:00:00,3,15,18
"4730",10102,"St Johns","NL",47.56038,-52.71147,2018-07-17 00:00:00,0,17,17
"4731",10102,"St Johns","NL",47.56038,-52.71147,2018-07-17 01:00:00,11,4,15
"4732",10102,"St Johns","NL",47.56038,-52.71147,2018-07-17 02:00:00,15,0,15
"4733",10102,"St Johns","NL",47.56038,-52.71147,2018-07-17 03:00:00,14,1,15
"4734",10102,"St Johns","NL",47.56038,-52.71147,2018-07-17 04:00:00,17,1,18
"4735",10102,"St Johns","NL",47.56038,-52.71147,2018-07-17 05:00:00,18,1,19
"4736",10102,"St Johns","NL",47.56038,-52.71147,2018-07-17 06:00:00,19,1,20
"4737",10102,"St Johns","NL",47.56038,-52.71147,2018-07-17 07:00:00,19,1,20
"4738",10102,"St Johns","NL",47.56038,-52.71147,2018-07-17 08:00:00,20,2,22
"4739",10102,"St Johns","NL",47.56038,-52.71147,2018-07-17 09:00:00,20,2,22
"4740",10102,"St Johns","NL",47.56038,-52.71147,2018-07-17 10:00:00,22,1,23
"4741",10102,"St Johns","NL",47.56038,-52.71147,2018-07-17 11:00:00,19,0,19
"4742",10102,"St Johns","NL",47.56038,-52.71147,2018-07-17 12:00:00,19,2,21
"4743",10102,"St Johns","NL",47.56038,-52.71147,2018-07-17 13:00:00,21,2,23
"4744",10102,"St Johns","NL",47.56038,-52.71147,2018-07-17 14:00:00,21,2,23
"4745",10102,"St Johns","NL",47.56038,-52.71147,2018-07-17 15:00:00,20,2,22
"4746",10102,"St Johns","NL",47.56038,-52.71147,2018-07-17 16:00:00,22,1,23
"4747",10102,"St Johns","NL",47.56038,-52.71147,2018-07-17 17:00:00,22,2,24
"4748",10102,"St Johns","NL",47.56038,-52.71147,2018-07-17 18:00:00,21,2,23
"4749",10102,"St Johns","NL",47.56038,-52.71147,2018-07-17 19:00:00,22,2,24
"4750",10102,"St Johns","NL",47.56038,-52.71147,2018-07-17 20:00:00,21,2,23
"4751",10102,"St Johns","NL",47.56038,-52.71147,2018-07-17 21:00:00,20,2,22
"4752",10102,"St Johns","NL",47.56038,-52.71147,2018-07-17 22:00:00,20,2,22
"4753",10102,"St Johns","NL",47.56038,-52.71147,2018-07-17 23:00:00,20,2,22
"4754",10102,"St Johns","NL",47.56038,-52.71147,2018-07-18 00:00:00,22,1,23
"4755",10102,"St Johns","NL",47.56038,-52.71147,2018-07-18 01:00:00,22,2,24
"4756",10102,"St Johns","NL",47.56038,-52.71147,2018-07-18 02:00:00,24,1,25
"4757",10102,"St Johns","NL",47.56038,-52.71147,2018-07-18 03:00:00,24,2,26
"4758",10102,"St Johns","NL",47.56038,-52.71147,2018-07-18 04:00:00,33,1,34
"4759",10102,"St Johns","NL",47.56038,-52.71147,2018-07-18 05:00:00,36,2,38
"4760",10102,"St Johns","NL",47.56038,-52.71147,2018-07-18 06:00:00,30,2,32
"4761",10102,"St Johns","NL",47.56038,-52.71147,2018-07-18 07:00:00,20,12,32
"4762",10102,"St Johns","NL",47.56038,-52.71147,2018-07-18 08:00:00,26,3,29
"4763",10102,"St Johns","NL",47.56038,-52.71147,2018-07-18 09:00:00,25,3,28
"4764",10102,"St Johns","NL",47.56038,-52.71147,2018-07-18 10:00:00,27,2,29
"4765",10102,"St Johns","NL",47.56038,-52.71147,2018-07-18 11:00:00,26,2,28
"4766",10102,"St Johns","NL",47.56038,-52.71147,2018-07-18 12:00:00,23,2,25
"4767",10102,"St Johns","NL",47.56038,-52.71147,2018-07-18 13:00:00,18,2,20
"4768",10102,"St Johns","NL",47.56038,-52.71147,2018-07-18 14:00:00,16,2,18
"4769",10102,"St Johns","NL",47.56038,-52.71147,2018-07-18 15:00:00,16,2,18
"4770",10102,"St Johns","NL",47.56038,-52.71147,2018-07-18 16:00:00,16,1,17
"4771",10102,"St Johns","NL",47.56038,-52.71147,2018-07-18 17:00:00,17,2,19
"4772",10102,"St Johns","NL",47.56038,-52.71147,2018-07-18 18:00:00,19,1,20
"4773",10102,"St Johns","NL",47.56038,-52.71147,2018-07-18 19:00:00,21,2,23
"4774",10102,"St Johns","NL",47.56038,-52.71147,2018-07-18 20:00:00,21,2,23
"4775",10102,"St Johns","NL",47.56038,-52.71147,2018-07-18 21:00:00,21,2,23
"4776",10102,"St Johns","NL",47.56038,-52.71147,2018-07-18 22:00:00,20,2,22
"4777",10102,"St Johns","NL",47.56038,-52.71147,2018-07-18 23:00:00,22,1,23
"4778",10102,"St Johns","NL",47.56038,-52.71147,2018-07-19 00:00:00,23,1,24
"4779",10102,"St Johns","NL",47.56038,-52.71147,2018-07-19 01:00:00,24,1,25
"4780",10102,"St Johns","NL",47.56038,-52.71147,2018-07-19 02:00:00,23,1,24
"4781",10102,"St Johns","NL",47.56038,-52.71147,2018-07-19 03:00:00,22,1,23
"4782",10102,"St Johns","NL",47.56038,-52.71147,2018-07-19 04:00:00,22,1,23
"4783",10102,"St Johns","NL",47.56038,-52.71147,2018-07-19 05:00:00,22,2,24
"4784",10102,"St Johns","NL",47.56038,-52.71147,2018-07-19 06:00:00,22,1,23
"4785",10102,"St Johns","NL",47.56038,-52.71147,2018-07-19 07:00:00,19,1,20
"4786",10102,"St Johns","NL",47.56038,-52.71147,2018-07-19 08:00:00,17,2,19
"4787",10102,"St Johns","NL",47.56038,-52.71147,2018-07-19 09:00:00,16,2,18
"4788",10102,"St Johns","NL",47.56038,-52.71147,2018-07-19 10:00:00,15,1,16
"4789",10102,"St Johns","NL",47.56038,-52.71147,2018-07-19 11:00:00,14,1,15
"4790",10102,"St Johns","NL",47.56038,-52.71147,2018-07-19 12:00:00,12,0,12
"4791",10102,"St Johns","NL",47.56038,-52.71147,2018-07-19 13:00:00,14,1,15
"4792",10102,"St Johns","NL",47.56038,-52.71147,2018-07-19 14:00:00,12,1,13
"4793",10102,"St Johns","NL",47.56038,-52.71147,2018-07-19 15:00:00,12,0,12
"4794",10102,"St Johns","NL",47.56038,-52.71147,2018-07-19 16:00:00,14,1,15
"4795",10102,"St Johns","NL",47.56038,-52.71147,2018-07-19 17:00:00,11,2,13
"4796",10102,"St Johns","NL",47.56038,-52.71147,2018-07-19 18:00:00,11,1,12
"4797",10102,"St Johns","NL",47.56038,-52.71147,2018-07-19 19:00:00,13,1,14
"4798",10102,"St Johns","NL",47.56038,-52.71147,2018-07-19 20:00:00,16,1,17
"4799",10102,"St Johns","NL",47.56038,-52.71147,2018-07-19 21:00:00,20,1,21
"4800",10102,"St Johns","NL",47.56038,-52.71147,2018-07-19 22:00:00,21,0,21
"4801",10102,"St Johns","NL",47.56038,-52.71147,2018-07-19 23:00:00,19,1,20
"4802",10102,"St Johns","NL",47.56038,-52.71147,2018-07-20 00:00:00,19,1,20
"4803",10102,"St Johns","NL",47.56038,-52.71147,2018-07-20 01:00:00,15,1,16
"4804",10102,"St Johns","NL",47.56038,-52.71147,2018-07-20 02:00:00,14,0,14
"4805",10102,"St Johns","NL",47.56038,-52.71147,2018-07-20 03:00:00,17,1,18
"4806",10102,"St Johns","NL",47.56038,-52.71147,2018-07-20 04:00:00,17,1,18
"4807",10102,"St Johns","NL",47.56038,-52.71147,2018-07-20 05:00:00,17,2,19
"4808",10102,"St Johns","NL",47.56038,-52.71147,2018-07-20 06:00:00,15,3,18
"4809",10102,"St Johns","NL",47.56038,-52.71147,2018-07-20 07:00:00,15,2,17
"4810",10102,"St Johns","NL",47.56038,-52.71147,2018-07-20 08:00:00,14,3,17
"4811",10102,"St Johns","NL",47.56038,-52.71147,2018-07-20 09:00:00,13,6,19
"4812",10102,"St Johns","NL",47.56038,-52.71147,2018-07-20 10:00:00,NA,4,NA
"4813",10102,"St Johns","NL",47.56038,-52.71147,2018-07-20 11:00:00,NA,NA,NA
"4814",10102,"St Johns","NL",47.56038,-52.71147,2018-07-20 12:00:00,9,7,16
"4815",10102,"St Johns","NL",47.56038,-52.71147,2018-07-20 13:00:00,5,18,23
"4816",10102,"St Johns","NL",47.56038,-52.71147,2018-07-20 14:00:00,4,26,30
"4817",10102,"St Johns","NL",47.56038,-52.71147,2018-07-20 15:00:00,4,24,28
"4818",10102,"St Johns","NL",47.56038,-52.71147,2018-07-20 16:00:00,7,11,18
"4819",10102,"St Johns","NL",47.56038,-52.71147,2018-07-20 17:00:00,8,14,22
"4820",10102,"St Johns","NL",47.56038,-52.71147,2018-07-20 18:00:00,4,23,27
"4821",10102,"St Johns","NL",47.56038,-52.71147,2018-07-20 19:00:00,1,31,32
"4822",10102,"St Johns","NL",47.56038,-52.71147,2018-07-20 20:00:00,1,28,29
"4823",10102,"St Johns","NL",47.56038,-52.71147,2018-07-20 21:00:00,0,27,27
"4824",10102,"St Johns","NL",47.56038,-52.71147,2018-07-20 22:00:00,4,12,16
"4825",10102,"St Johns","NL",47.56038,-52.71147,2018-07-20 23:00:00,7,7,14
"4826",10102,"St Johns","NL",47.56038,-52.71147,2018-07-21 00:00:00,10,4,14
"4827",10102,"St Johns","NL",47.56038,-52.71147,2018-07-21 01:00:00,12,2,14
"4828",10102,"St Johns","NL",47.56038,-52.71147,2018-07-21 02:00:00,15,1,16
"4829",10102,"St Johns","NL",47.56038,-52.71147,2018-07-21 03:00:00,18,1,19
"4830",10102,"St Johns","NL",47.56038,-52.71147,2018-07-21 04:00:00,19,0,19
"4831",10102,"St Johns","NL",47.56038,-52.71147,2018-07-21 05:00:00,20,0,20
"4832",10102,"St Johns","NL",47.56038,-52.71147,2018-07-21 06:00:00,20,0,20
"4833",10102,"St Johns","NL",47.56038,-52.71147,2018-07-21 07:00:00,18,3,21
"4834",10102,"St Johns","NL",47.56038,-52.71147,2018-07-21 08:00:00,17,4,21
"4835",10102,"St Johns","NL",47.56038,-52.71147,2018-07-21 09:00:00,20,3,23
"4836",10102,"St Johns","NL",47.56038,-52.71147,2018-07-21 10:00:00,23,0,23
"4837",10102,"St Johns","NL",47.56038,-52.71147,2018-07-21 11:00:00,22,0,22
"4838",10102,"St Johns","NL",47.56038,-52.71147,2018-07-21 12:00:00,22,2,24
"4839",10102,"St Johns","NL",47.56038,-52.71147,2018-07-21 13:00:00,22,2,24
"4840",10102,"St Johns","NL",47.56038,-52.71147,2018-07-21 14:00:00,23,2,25
"4841",10102,"St Johns","NL",47.56038,-52.71147,2018-07-21 15:00:00,23,3,26
"4842",10102,"St Johns","NL",47.56038,-52.71147,2018-07-21 16:00:00,14,11,25
"4843",10102,"St Johns","NL",47.56038,-52.71147,2018-07-21 17:00:00,22,3,25
"4844",10102,"St Johns","NL",47.56038,-52.71147,2018-07-21 18:00:00,22,3,25
"4845",10102,"St Johns","NL",47.56038,-52.71147,2018-07-21 19:00:00,21,3,24
"4846",10102,"St Johns","NL",47.56038,-52.71147,2018-07-21 20:00:00,18,5,23
"4847",10102,"St Johns","NL",47.56038,-52.71147,2018-07-21 21:00:00,19,4,23
"4848",10102,"St Johns","NL",47.56038,-52.71147,2018-07-21 22:00:00,20,4,24
"4849",10102,"St Johns","NL",47.56038,-52.71147,2018-07-21 23:00:00,19,3,22
"4850",10102,"St Johns","NL",47.56038,-52.71147,2018-07-22 00:00:00,22,2,24
"4851",10102,"St Johns","NL",47.56038,-52.71147,2018-07-22 01:00:00,26,2,28
"4852",10102,"St Johns","NL",47.56038,-52.71147,2018-07-22 02:00:00,32,2,34
"4853",10102,"St Johns","NL",47.56038,-52.71147,2018-07-22 03:00:00,31,3,34
"4854",10102,"St Johns","NL",47.56038,-52.71147,2018-07-22 04:00:00,28,2,30
"4855",10102,"St Johns","NL",47.56038,-52.71147,2018-07-22 05:00:00,22,2,24
"4856",10102,"St Johns","NL",47.56038,-52.71147,2018-07-22 06:00:00,15,2,17
"4857",10102,"St Johns","NL",47.56038,-52.71147,2018-07-22 07:00:00,10,2,12
"4858",10102,"St Johns","NL",47.56038,-52.71147,2018-07-22 08:00:00,9,3,12
"4859",10102,"St Johns","NL",47.56038,-52.71147,2018-07-22 09:00:00,13,1,14
"4860",10102,"St Johns","NL",47.56038,-52.71147,2018-07-22 10:00:00,12,2,14
"4861",10102,"St Johns","NL",47.56038,-52.71147,2018-07-22 11:00:00,19,1,20
"4862",10102,"St Johns","NL",47.56038,-52.71147,2018-07-22 12:00:00,20,2,22
"4863",10102,"St Johns","NL",47.56038,-52.71147,2018-07-22 13:00:00,25,1,26
"4864",10102,"St Johns","NL",47.56038,-52.71147,2018-07-22 14:00:00,27,1,28
"4865",10102,"St Johns","NL",47.56038,-52.71147,2018-07-22 15:00:00,31,1,32
"4866",10102,"St Johns","NL",47.56038,-52.71147,2018-07-22 16:00:00,34,2,36
"4867",10102,"St Johns","NL",47.56038,-52.71147,2018-07-22 17:00:00,34,2,36
"4868",10102,"St Johns","NL",47.56038,-52.71147,2018-07-22 18:00:00,32,2,34
"4869",10102,"St Johns","NL",47.56038,-52.71147,2018-07-22 19:00:00,21,1,22
"4870",10102,"St Johns","NL",47.56038,-52.71147,2018-07-22 20:00:00,18,1,19
"4871",10102,"St Johns","NL",47.56038,-52.71147,2018-07-22 21:00:00,NA,NA,NA
"4872",10102,"St Johns","NL",47.56038,-52.71147,2018-07-22 22:00:00,NA,NA,NA
"4873",10102,"St Johns","NL",47.56038,-52.71147,2018-07-22 23:00:00,NA,NA,NA
"4874",10102,"St Johns","NL",47.56038,-52.71147,2018-07-23 00:00:00,NA,NA,NA
"4875",10102,"St Johns","NL",47.56038,-52.71147,2018-07-23 01:00:00,NA,NA,NA
"4876",10102,"St Johns","NL",47.56038,-52.71147,2018-07-23 02:00:00,NA,NA,NA
"4877",10102,"St Johns","NL",47.56038,-52.71147,2018-07-23 03:00:00,NA,NA,NA
"4878",10102,"St Johns","NL",47.56038,-52.71147,2018-07-23 04:00:00,NA,NA,NA
"4879",10102,"St Johns","NL",47.56038,-52.71147,2018-07-23 05:00:00,NA,NA,NA
"4880",10102,"St Johns","NL",47.56038,-52.71147,2018-07-23 06:00:00,NA,NA,NA
"4881",10102,"St Johns","NL",47.56038,-52.71147,2018-07-23 07:00:00,NA,NA,NA
"4882",10102,"St Johns","NL",47.56038,-52.71147,2018-07-23 08:00:00,NA,NA,NA
"4883",10102,"St Johns","NL",47.56038,-52.71147,2018-07-23 09:00:00,NA,NA,NA
"4884",10102,"St Johns","NL",47.56038,-52.71147,2018-07-23 10:00:00,NA,NA,NA
"4885",10102,"St Johns","NL",47.56038,-52.71147,2018-07-23 11:00:00,NA,NA,NA
"4886",10102,"St Johns","NL",47.56038,-52.71147,2018-07-23 12:00:00,NA,NA,NA
"4887",10102,"St Johns","NL",47.56038,-52.71147,2018-07-23 13:00:00,NA,NA,NA
"4888",10102,"St Johns","NL",47.56038,-52.71147,2018-07-23 14:00:00,NA,NA,NA
"4889",10102,"St Johns","NL",47.56038,-52.71147,2018-07-23 15:00:00,NA,NA,NA
"4890",10102,"St Johns","NL",47.56038,-52.71147,2018-07-23 16:00:00,NA,NA,NA
"4891",10102,"St Johns","NL",47.56038,-52.71147,2018-07-23 17:00:00,NA,NA,NA
"4892",10102,"St Johns","NL",47.56038,-52.71147,2018-07-23 18:00:00,NA,NA,NA
"4893",10102,"St Johns","NL",47.56038,-52.71147,2018-07-23 19:00:00,NA,NA,NA
"4894",10102,"St Johns","NL",47.56038,-52.71147,2018-07-23 20:00:00,NA,NA,NA
"4895",10102,"St Johns","NL",47.56038,-52.71147,2018-07-23 21:00:00,NA,NA,NA
"4896",10102,"St Johns","NL",47.56038,-52.71147,2018-07-23 22:00:00,NA,NA,NA
"4897",10102,"St Johns","NL",47.56038,-52.71147,2018-07-23 23:00:00,NA,NA,NA
"4898",10102,"St Johns","NL",47.56038,-52.71147,2018-07-24 00:00:00,NA,NA,NA
"4899",10102,"St Johns","NL",47.56038,-52.71147,2018-07-24 01:00:00,NA,NA,NA
"4900",10102,"St Johns","NL",47.56038,-52.71147,2018-07-24 02:00:00,NA,NA,NA
"4901",10102,"St Johns","NL",47.56038,-52.71147,2018-07-24 03:00:00,NA,NA,NA
"4902",10102,"St Johns","NL",47.56038,-52.71147,2018-07-24 04:00:00,NA,NA,NA
"4903",10102,"St Johns","NL",47.56038,-52.71147,2018-07-24 05:00:00,NA,NA,NA
"4904",10102,"St Johns","NL",47.56038,-52.71147,2018-07-24 06:00:00,NA,NA,NA
"4905",10102,"St Johns","NL",47.56038,-52.71147,2018-07-24 07:00:00,NA,NA,NA
"4906",10102,"St Johns","NL",47.56038,-52.71147,2018-07-24 08:00:00,NA,NA,NA
"4907",10102,"St Johns","NL",47.56038,-52.71147,2018-07-24 09:00:00,NA,NA,NA
"4908",10102,"St Johns","NL",47.56038,-52.71147,2018-07-24 10:00:00,NA,NA,NA
"4909",10102,"St Johns","NL",47.56038,-52.71147,2018-07-24 11:00:00,13,8,21
"4910",10102,"St Johns","NL",47.56038,-52.71147,2018-07-24 12:00:00,14,7,21
"4911",10102,"St Johns","NL",47.56038,-52.71147,2018-07-24 13:00:00,13,8,21
"4912",10102,"St Johns","NL",47.56038,-52.71147,2018-07-24 14:00:00,14,6,20
"4913",10102,"St Johns","NL",47.56038,-52.71147,2018-07-24 15:00:00,12,7,19
"4914",10102,"St Johns","NL",47.56038,-52.71147,2018-07-24 16:00:00,17,2,19
"4915",10102,"St Johns","NL",47.56038,-52.71147,2018-07-24 17:00:00,15,3,18
"4916",10102,"St Johns","NL",47.56038,-52.71147,2018-07-24 18:00:00,9,9,18
"4917",10102,"St Johns","NL",47.56038,-52.71147,2018-07-24 19:00:00,13,2,15
"4918",10102,"St Johns","NL",47.56038,-52.71147,2018-07-24 20:00:00,12,2,14
"4919",10102,"St Johns","NL",47.56038,-52.71147,2018-07-24 21:00:00,10,3,13
"4920",10102,"St Johns","NL",47.56038,-52.71147,2018-07-24 22:00:00,10,2,12
"4921",10102,"St Johns","NL",47.56038,-52.71147,2018-07-24 23:00:00,12,2,14
"4922",10102,"St Johns","NL",47.56038,-52.71147,2018-07-25 00:00:00,12,1,13
"4923",10102,"St Johns","NL",47.56038,-52.71147,2018-07-25 01:00:00,11,1,12
"4924",10102,"St Johns","NL",47.56038,-52.71147,2018-07-25 02:00:00,12,1,13
"4925",10102,"St Johns","NL",47.56038,-52.71147,2018-07-25 03:00:00,12,1,13
"4926",10102,"St Johns","NL",47.56038,-52.71147,2018-07-25 04:00:00,12,1,13
"4927",10102,"St Johns","NL",47.56038,-52.71147,2018-07-25 05:00:00,13,1,14
"4928",10102,"St Johns","NL",47.56038,-52.71147,2018-07-25 06:00:00,12,1,13
"4929",10102,"St Johns","NL",47.56038,-52.71147,2018-07-25 07:00:00,11,2,13
"4930",10102,"St Johns","NL",47.56038,-52.71147,2018-07-25 08:00:00,11,2,13
"4931",10102,"St Johns","NL",47.56038,-52.71147,2018-07-25 09:00:00,12,2,14
"4932",10102,"St Johns","NL",47.56038,-52.71147,2018-07-25 10:00:00,13,2,15
"4933",10102,"St Johns","NL",47.56038,-52.71147,2018-07-25 11:00:00,14,1,15
"4934",10102,"St Johns","NL",47.56038,-52.71147,2018-07-25 12:00:00,15,0,15
"4935",10102,"St Johns","NL",47.56038,-52.71147,2018-07-25 13:00:00,15,1,16
"4936",10102,"St Johns","NL",47.56038,-52.71147,2018-07-25 14:00:00,16,1,17
"4937",10102,"St Johns","NL",47.56038,-52.71147,2018-07-25 15:00:00,17,1,18
"4938",10102,"St Johns","NL",47.56038,-52.71147,2018-07-25 16:00:00,16,1,17
"4939",10102,"St Johns","NL",47.56038,-52.71147,2018-07-25 17:00:00,16,1,17
"4940",10102,"St Johns","NL",47.56038,-52.71147,2018-07-25 18:00:00,16,1,17
"4941",10102,"St Johns","NL",47.56038,-52.71147,2018-07-25 19:00:00,15,2,17
"4942",10102,"St Johns","NL",47.56038,-52.71147,2018-07-25 20:00:00,15,2,17
"4943",10102,"St Johns","NL",47.56038,-52.71147,2018-07-25 21:00:00,16,1,17
"4944",10102,"St Johns","NL",47.56038,-52.71147,2018-07-25 22:00:00,16,1,17
"4945",10102,"St Johns","NL",47.56038,-52.71147,2018-07-25 23:00:00,16,1,17
"4946",10102,"St Johns","NL",47.56038,-52.71147,2018-07-26 00:00:00,15,0,15
"4947",10102,"St Johns","NL",47.56038,-52.71147,2018-07-26 01:00:00,15,0,15
"4948",10102,"St Johns","NL",47.56038,-52.71147,2018-07-26 02:00:00,15,1,16
"4949",10102,"St Johns","NL",47.56038,-52.71147,2018-07-26 03:00:00,13,1,14
"4950",10102,"St Johns","NL",47.56038,-52.71147,2018-07-26 04:00:00,12,1,13
"4951",10102,"St Johns","NL",47.56038,-52.71147,2018-07-26 05:00:00,11,1,12
"4952",10102,"St Johns","NL",47.56038,-52.71147,2018-07-26 06:00:00,10,1,11
"4953",10102,"St Johns","NL",47.56038,-52.71147,2018-07-26 07:00:00,10,2,12
"4954",10102,"St Johns","NL",47.56038,-52.71147,2018-07-26 08:00:00,10,1,11
"4955",10102,"St Johns","NL",47.56038,-52.71147,2018-07-26 09:00:00,11,2,13
"4956",10102,"St Johns","NL",47.56038,-52.71147,2018-07-26 10:00:00,13,0,13
"4957",10102,"St Johns","NL",47.56038,-52.71147,2018-07-26 11:00:00,17,2,19
"4958",10102,"St Johns","NL",47.56038,-52.71147,2018-07-26 12:00:00,19,1,20
"4959",10102,"St Johns","NL",47.56038,-52.71147,2018-07-26 13:00:00,19,1,20
"4960",10102,"St Johns","NL",47.56038,-52.71147,2018-07-26 14:00:00,18,1,19
"4961",10102,"St Johns","NL",47.56038,-52.71147,2018-07-26 15:00:00,17,1,18
"4962",10102,"St Johns","NL",47.56038,-52.71147,2018-07-26 16:00:00,16,1,17
"4963",10102,"St Johns","NL",47.56038,-52.71147,2018-07-26 17:00:00,16,1,17
"4964",10102,"St Johns","NL",47.56038,-52.71147,2018-07-26 18:00:00,16,1,17
"4965",10102,"St Johns","NL",47.56038,-52.71147,2018-07-26 19:00:00,15,1,16
"4966",10102,"St Johns","NL",47.56038,-52.71147,2018-07-26 20:00:00,14,1,15
"4967",10102,"St Johns","NL",47.56038,-52.71147,2018-07-26 21:00:00,14,1,15
"4968",10102,"St Johns","NL",47.56038,-52.71147,2018-07-26 22:00:00,15,0,15
"4969",10102,"St Johns","NL",47.56038,-52.71147,2018-07-26 23:00:00,15,0,15
"4970",10102,"St Johns","NL",47.56038,-52.71147,2018-07-27 00:00:00,14,0,14
"4971",10102,"St Johns","NL",47.56038,-52.71147,2018-07-27 01:00:00,15,0,15
"4972",10102,"St Johns","NL",47.56038,-52.71147,2018-07-27 02:00:00,15,0,15
"4973",10102,"St Johns","NL",47.56038,-52.71147,2018-07-27 03:00:00,15,0,15
"4974",10102,"St Johns","NL",47.56038,-52.71147,2018-07-27 04:00:00,15,1,16
"4975",10102,"St Johns","NL",47.56038,-52.71147,2018-07-27 05:00:00,15,0,15
"4976",10102,"St Johns","NL",47.56038,-52.71147,2018-07-27 06:00:00,15,1,16
"4977",10102,"St Johns","NL",47.56038,-52.71147,2018-07-27 07:00:00,14,1,15
"4978",10102,"St Johns","NL",47.56038,-52.71147,2018-07-27 08:00:00,15,2,17
"4979",10102,"St Johns","NL",47.56038,-52.71147,2018-07-27 09:00:00,15,2,17
"4980",10102,"St Johns","NL",47.56038,-52.71147,2018-07-27 10:00:00,15,1,16
"4981",10102,"St Johns","NL",47.56038,-52.71147,2018-07-27 11:00:00,15,1,16
"4982",10102,"St Johns","NL",47.56038,-52.71147,2018-07-27 12:00:00,17,0,17
"4983",10102,"St Johns","NL",47.56038,-52.71147,2018-07-27 13:00:00,17,1,18
"4984",10102,"St Johns","NL",47.56038,-52.71147,2018-07-27 14:00:00,17,1,18
"4985",10102,"St Johns","NL",47.56038,-52.71147,2018-07-27 15:00:00,17,0,17
"4986",10102,"St Johns","NL",47.56038,-52.71147,2018-07-27 16:00:00,20,0,20
"4987",10102,"St Johns","NL",47.56038,-52.71147,2018-07-27 17:00:00,23,1,24
"4988",10102,"St Johns","NL",47.56038,-52.71147,2018-07-27 18:00:00,26,1,27
"4989",10102,"St Johns","NL",47.56038,-52.71147,2018-07-27 19:00:00,27,1,28
"4990",10102,"St Johns","NL",47.56038,-52.71147,2018-07-27 20:00:00,28,1,29
"4991",10102,"St Johns","NL",47.56038,-52.71147,2018-07-27 21:00:00,18,1,19
"4992",10102,"St Johns","NL",47.56038,-52.71147,2018-07-27 22:00:00,12,3,15
"4993",10102,"St Johns","NL",47.56038,-52.71147,2018-07-27 23:00:00,13,1,14
"4994",10102,"St Johns","NL",47.56038,-52.71147,2018-07-28 00:00:00,13,3,16
"4995",10102,"St Johns","NL",47.56038,-52.71147,2018-07-28 01:00:00,15,4,19
"4996",10102,"St Johns","NL",47.56038,-52.71147,2018-07-28 02:00:00,15,2,17
"4997",10102,"St Johns","NL",47.56038,-52.71147,2018-07-28 03:00:00,16,2,18
"4998",10102,"St Johns","NL",47.56038,-52.71147,2018-07-28 04:00:00,12,8,20
"4999",10102,"St Johns","NL",47.56038,-52.71147,2018-07-28 05:00:00,18,3,21
"5000",10102,"St Johns","NL",47.56038,-52.71147,2018-07-28 06:00:00,18,3,21
"5001",10102,"St Johns","NL",47.56038,-52.71147,2018-07-28 07:00:00,17,7,24
"5002",10102,"St Johns","NL",47.56038,-52.71147,2018-07-28 08:00:00,13,12,25
"5003",10102,"St Johns","NL",47.56038,-52.71147,2018-07-28 09:00:00,13,14,27
"5004",10102,"St Johns","NL",47.56038,-52.71147,2018-07-28 10:00:00,10,16,26
"5005",10102,"St Johns","NL",47.56038,-52.71147,2018-07-28 11:00:00,14,10,24
"5006",10102,"St Johns","NL",47.56038,-52.71147,2018-07-28 12:00:00,20,2,22
"5007",10102,"St Johns","NL",47.56038,-52.71147,2018-07-28 13:00:00,19,3,22
"5008",10102,"St Johns","NL",47.56038,-52.71147,2018-07-28 14:00:00,21,1,22
"5009",10102,"St Johns","NL",47.56038,-52.71147,2018-07-28 15:00:00,19,2,21
"5010",10102,"St Johns","NL",47.56038,-52.71147,2018-07-28 16:00:00,19,2,21
"5011",10102,"St Johns","NL",47.56038,-52.71147,2018-07-28 17:00:00,16,3,19
"5012",10102,"St Johns","NL",47.56038,-52.71147,2018-07-28 18:00:00,14,5,19
"5013",10102,"St Johns","NL",47.56038,-52.71147,2018-07-28 19:00:00,15,1,16
"5014",10102,"St Johns","NL",47.56038,-52.71147,2018-07-28 20:00:00,11,6,17
"5015",10102,"St Johns","NL",47.56038,-52.71147,2018-07-28 21:00:00,3,16,19
"5016",10102,"St Johns","NL",47.56038,-52.71147,2018-07-28 22:00:00,4,12,16
"5017",10102,"St Johns","NL",47.56038,-52.71147,2018-07-28 23:00:00,7,5,12
"5018",10102,"St Johns","NL",47.56038,-52.71147,2018-07-29 00:00:00,7,5,12
"5019",10102,"St Johns","NL",47.56038,-52.71147,2018-07-29 01:00:00,8,1,9
"5020",10102,"St Johns","NL",47.56038,-52.71147,2018-07-29 02:00:00,6,7,13
"5021",10102,"St Johns","NL",47.56038,-52.71147,2018-07-29 03:00:00,7,5,12
"5022",10102,"St Johns","NL",47.56038,-52.71147,2018-07-29 04:00:00,16,1,17
"5023",10102,"St Johns","NL",47.56038,-52.71147,2018-07-29 05:00:00,16,1,17
"5024",10102,"St Johns","NL",47.56038,-52.71147,2018-07-29 06:00:00,16,1,17
"5025",10102,"St Johns","NL",47.56038,-52.71147,2018-07-29 07:00:00,12,3,15
"5026",10102,"St Johns","NL",47.56038,-52.71147,2018-07-29 08:00:00,13,3,16
"5027",10102,"St Johns","NL",47.56038,-52.71147,2018-07-29 09:00:00,12,3,15
"5028",10102,"St Johns","NL",47.56038,-52.71147,2018-07-29 10:00:00,14,2,16
"5029",10102,"St Johns","NL",47.56038,-52.71147,2018-07-29 11:00:00,18,1,19
"5030",10102,"St Johns","NL",47.56038,-52.71147,2018-07-29 12:00:00,15,1,16
"5031",10102,"St Johns","NL",47.56038,-52.71147,2018-07-29 13:00:00,19,1,20
"5032",10102,"St Johns","NL",47.56038,-52.71147,2018-07-29 14:00:00,22,1,23
"5033",10102,"St Johns","NL",47.56038,-52.71147,2018-07-29 15:00:00,21,1,22
"5034",10102,"St Johns","NL",47.56038,-52.71147,2018-07-29 16:00:00,19,1,20
"5035",10102,"St Johns","NL",47.56038,-52.71147,2018-07-29 17:00:00,17,2,19
"5036",10102,"St Johns","NL",47.56038,-52.71147,2018-07-29 18:00:00,18,1,19
"5037",10102,"St Johns","NL",47.56038,-52.71147,2018-07-29 19:00:00,18,1,19
"5038",10102,"St Johns","NL",47.56038,-52.71147,2018-07-29 20:00:00,17,2,19
"5039",10102,"St Johns","NL",47.56038,-52.71147,2018-07-29 21:00:00,18,2,20
"5040",10102,"St Johns","NL",47.56038,-52.71147,2018-07-29 22:00:00,15,1,16
"5041",10102,"St Johns","NL",47.56038,-52.71147,2018-07-29 23:00:00,17,1,18
"5042",10102,"St Johns","NL",47.56038,-52.71147,2018-07-30 00:00:00,26,1,27
"5043",10102,"St Johns","NL",47.56038,-52.71147,2018-07-30 01:00:00,28,1,29
"5044",10102,"St Johns","NL",47.56038,-52.71147,2018-07-30 02:00:00,26,1,27
"5045",10102,"St Johns","NL",47.56038,-52.71147,2018-07-30 03:00:00,27,0,27
"5046",10102,"St Johns","NL",47.56038,-52.71147,2018-07-30 04:00:00,26,1,27
"5047",10102,"St Johns","NL",47.56038,-52.71147,2018-07-30 05:00:00,26,0,26
"5048",10102,"St Johns","NL",47.56038,-52.71147,2018-07-30 06:00:00,25,1,26
"5049",10102,"St Johns","NL",47.56038,-52.71147,2018-07-30 07:00:00,23,2,25
"5050",10102,"St Johns","NL",47.56038,-52.71147,2018-07-30 08:00:00,23,3,26
"5051",10102,"St Johns","NL",47.56038,-52.71147,2018-07-30 09:00:00,23,2,25
"5052",10102,"St Johns","NL",47.56038,-52.71147,2018-07-30 10:00:00,23,1,24
"5053",10102,"St Johns","NL",47.56038,-52.71147,2018-07-30 11:00:00,24,1,25
"5054",10102,"St Johns","NL",47.56038,-52.71147,2018-07-30 12:00:00,27,2,29
"5055",10102,"St Johns","NL",47.56038,-52.71147,2018-07-30 13:00:00,31,3,34
"5056",10102,"St Johns","NL",47.56038,-52.71147,2018-07-30 14:00:00,30,3,33
"5057",10102,"St Johns","NL",47.56038,-52.71147,2018-07-30 15:00:00,30,3,33
"5058",10102,"St Johns","NL",47.56038,-52.71147,2018-07-30 16:00:00,30,3,33
"5059",10102,"St Johns","NL",47.56038,-52.71147,2018-07-30 17:00:00,28,3,31
"5060",10102,"St Johns","NL",47.56038,-52.71147,2018-07-30 18:00:00,27,2,29
"5061",10102,"St Johns","NL",47.56038,-52.71147,2018-07-30 19:00:00,26,3,29
"5062",10102,"St Johns","NL",47.56038,-52.71147,2018-07-30 20:00:00,27,3,30
"5063",10102,"St Johns","NL",47.56038,-52.71147,2018-07-30 21:00:00,26,2,28
"5064",10102,"St Johns","NL",47.56038,-52.71147,2018-07-30 22:00:00,25,2,27
"5065",10102,"St Johns","NL",47.56038,-52.71147,2018-07-30 23:00:00,23,2,25
"5066",10102,"St Johns","NL",47.56038,-52.71147,2018-07-31 00:00:00,21,2,23
"5067",10102,"St Johns","NL",47.56038,-52.71147,2018-07-31 01:00:00,20,2,22
"5068",10102,"St Johns","NL",47.56038,-52.71147,2018-07-31 02:00:00,19,2,21
"5069",10102,"St Johns","NL",47.56038,-52.71147,2018-07-31 03:00:00,18,2,20
"5070",10102,"St Johns","NL",47.56038,-52.71147,2018-07-31 04:00:00,17,2,19
"5071",10102,"St Johns","NL",47.56038,-52.71147,2018-07-31 05:00:00,16,2,18
"5072",10102,"St Johns","NL",47.56038,-52.71147,2018-07-31 06:00:00,15,3,18
"5073",10102,"St Johns","NL",47.56038,-52.71147,2018-07-31 07:00:00,15,3,18
"5074",10102,"St Johns","NL",47.56038,-52.71147,2018-07-31 08:00:00,15,3,18
"5075",10102,"St Johns","NL",47.56038,-52.71147,2018-07-31 09:00:00,17,2,19
"5076",10102,"St Johns","NL",47.56038,-52.71147,2018-07-31 10:00:00,18,3,21
"5077",10102,"St Johns","NL",47.56038,-52.71147,2018-07-31 11:00:00,20,2,22
"5078",10102,"St Johns","NL",47.56038,-52.71147,2018-07-31 12:00:00,22,2,24
"5079",10102,"St Johns","NL",47.56038,-52.71147,2018-07-31 13:00:00,22,3,25
"5080",10102,"St Johns","NL",47.56038,-52.71147,2018-07-31 14:00:00,24,2,26
"5081",10102,"St Johns","NL",47.56038,-52.71147,2018-07-31 15:00:00,22,2,24
"5082",10102,"St Johns","NL",47.56038,-52.71147,2018-07-31 16:00:00,21,3,24
"5083",10102,"St Johns","NL",47.56038,-52.71147,2018-07-31 17:00:00,22,3,25
"5084",10102,"St Johns","NL",47.56038,-52.71147,2018-07-31 18:00:00,22,3,25
"5085",10102,"St Johns","NL",47.56038,-52.71147,2018-07-31 19:00:00,21,4,25
"5086",10102,"St Johns","NL",47.56038,-52.71147,2018-07-31 20:00:00,19,4,23
"5087",10102,"St Johns","NL",47.56038,-52.71147,2018-07-31 21:00:00,8,18,26
"5088",10102,"St Johns","NL",47.56038,-52.71147,2018-07-31 22:00:00,13,11,24
"5089",10102,"St Johns","NL",47.56038,-52.71147,2018-07-31 23:00:00,18,4,22
"5090",10102,"St Johns","NL",47.56038,-52.71147,2018-08-01 00:00:00,17,6,23
"5091",10102,"St Johns","NL",47.56038,-52.71147,2018-08-01 01:00:00,18,3,21
"5092",10102,"St Johns","NL",47.56038,-52.71147,2018-08-01 02:00:00,17,4,21
"5093",10102,"St Johns","NL",47.56038,-52.71147,2018-08-01 03:00:00,17,3,20
"5094",10102,"St Johns","NL",47.56038,-52.71147,2018-08-01 04:00:00,16,3,19
"5095",10102,"St Johns","NL",47.56038,-52.71147,2018-08-01 05:00:00,18,3,21
"5096",10102,"St Johns","NL",47.56038,-52.71147,2018-08-01 06:00:00,16,4,20
"5097",10102,"St Johns","NL",47.56038,-52.71147,2018-08-01 07:00:00,16,5,21
"5098",10102,"St Johns","NL",47.56038,-52.71147,2018-08-01 08:00:00,17,6,23
"5099",10102,"St Johns","NL",47.56038,-52.71147,2018-08-01 09:00:00,20,5,25
"5100",10102,"St Johns","NL",47.56038,-52.71147,2018-08-01 10:00:00,24,3,27
"5101",10102,"St Johns","NL",47.56038,-52.71147,2018-08-01 11:00:00,27,2,29
"5102",10102,"St Johns","NL",47.56038,-52.71147,2018-08-01 12:00:00,24,2,26
"5103",10102,"St Johns","NL",47.56038,-52.71147,2018-08-01 13:00:00,25,2,27
"5104",10102,"St Johns","NL",47.56038,-52.71147,2018-08-01 14:00:00,25,2,27
"5105",10102,"St Johns","NL",47.56038,-52.71147,2018-08-01 15:00:00,26,2,28
"5106",10102,"St Johns","NL",47.56038,-52.71147,2018-08-01 16:00:00,25,2,27
"5107",10102,"St Johns","NL",47.56038,-52.71147,2018-08-01 17:00:00,24,2,26
"5108",10102,"St Johns","NL",47.56038,-52.71147,2018-08-01 18:00:00,22,3,25
"5109",10102,"St Johns","NL",47.56038,-52.71147,2018-08-01 19:00:00,21,3,24
"5110",10102,"St Johns","NL",47.56038,-52.71147,2018-08-01 20:00:00,19,5,24
"5111",10102,"St Johns","NL",47.56038,-52.71147,2018-08-01 21:00:00,18,5,23
"5112",10102,"St Johns","NL",47.56038,-52.71147,2018-08-01 22:00:00,21,4,25
"5113",10102,"St Johns","NL",47.56038,-52.71147,2018-08-01 23:00:00,24,4,28
"5114",10102,"St Johns","NL",47.56038,-52.71147,2018-08-02 00:00:00,26,4,30
"5115",10102,"St Johns","NL",47.56038,-52.71147,2018-08-02 01:00:00,26,2,28
"5116",10102,"St Johns","NL",47.56038,-52.71147,2018-08-02 02:00:00,28,2,30
"5117",10102,"St Johns","NL",47.56038,-52.71147,2018-08-02 03:00:00,29,2,31
"5118",10102,"St Johns","NL",47.56038,-52.71147,2018-08-02 04:00:00,30,2,32
"5119",10102,"St Johns","NL",47.56038,-52.71147,2018-08-02 05:00:00,30,2,32
"5120",10102,"St Johns","NL",47.56038,-52.71147,2018-08-02 06:00:00,30,3,33
"5121",10102,"St Johns","NL",47.56038,-52.71147,2018-08-02 07:00:00,28,6,34
"5122",10102,"St Johns","NL",47.56038,-52.71147,2018-08-02 08:00:00,30,5,35
"5123",10102,"St Johns","NL",47.56038,-52.71147,2018-08-02 09:00:00,29,4,33
"5124",10102,"St Johns","NL",47.56038,-52.71147,2018-08-02 10:00:00,29,6,35
"5125",10102,"St Johns","NL",47.56038,-52.71147,2018-08-02 11:00:00,29,6,35
"5126",10102,"St Johns","NL",47.56038,-52.71147,2018-08-02 12:00:00,30,5,35
"5127",10102,"St Johns","NL",47.56038,-52.71147,2018-08-02 13:00:00,31,4,35
"5128",10102,"St Johns","NL",47.56038,-52.71147,2018-08-02 14:00:00,31,4,35
"5129",10102,"St Johns","NL",47.56038,-52.71147,2018-08-02 15:00:00,31,4,35
"5130",10102,"St Johns","NL",47.56038,-52.71147,2018-08-02 16:00:00,32,4,36
"5131",10102,"St Johns","NL",47.56038,-52.71147,2018-08-02 17:00:00,30,4,34
"5132",10102,"St Johns","NL",47.56038,-52.71147,2018-08-02 18:00:00,30,3,33
"5133",10102,"St Johns","NL",47.56038,-52.71147,2018-08-02 19:00:00,NA,NA,NA
"5134",10102,"St Johns","NL",47.56038,-52.71147,2018-08-02 20:00:00,NA,NA,NA
"5135",10102,"St Johns","NL",47.56038,-52.71147,2018-08-02 21:00:00,NA,NA,NA
"5136",10102,"St Johns","NL",47.56038,-52.71147,2018-08-02 22:00:00,NA,NA,NA
"5137",10102,"St Johns","NL",47.56038,-52.71147,2018-08-02 23:00:00,NA,NA,NA
"5138",10102,"St Johns","NL",47.56038,-52.71147,2018-08-03 00:00:00,NA,NA,NA
"5139",10102,"St Johns","NL",47.56038,-52.71147,2018-08-03 01:00:00,NA,NA,NA
"5140",10102,"St Johns","NL",47.56038,-52.71147,2018-08-03 02:00:00,NA,NA,NA
"5141",10102,"St Johns","NL",47.56038,-52.71147,2018-08-03 03:00:00,NA,NA,NA
"5142",10102,"St Johns","NL",47.56038,-52.71147,2018-08-03 04:00:00,NA,NA,NA
"5143",10102,"St Johns","NL",47.56038,-52.71147,2018-08-03 05:00:00,NA,NA,NA
"5144",10102,"St Johns","NL",47.56038,-52.71147,2018-08-03 06:00:00,NA,NA,NA
"5145",10102,"St Johns","NL",47.56038,-52.71147,2018-08-03 07:00:00,NA,NA,NA
"5146",10102,"St Johns","NL",47.56038,-52.71147,2018-08-03 08:00:00,NA,NA,NA
"5147",10102,"St Johns","NL",47.56038,-52.71147,2018-08-03 09:00:00,NA,NA,NA
"5148",10102,"St Johns","NL",47.56038,-52.71147,2018-08-03 10:00:00,NA,NA,NA
"5149",10102,"St Johns","NL",47.56038,-52.71147,2018-08-03 11:00:00,NA,NA,NA
"5150",10102,"St Johns","NL",47.56038,-52.71147,2018-08-03 12:00:00,24,3,27
"5151",10102,"St Johns","NL",47.56038,-52.71147,2018-08-03 13:00:00,29,2,31
"5152",10102,"St Johns","NL",47.56038,-52.71147,2018-08-03 14:00:00,28,4,32
"5153",10102,"St Johns","NL",47.56038,-52.71147,2018-08-03 15:00:00,14,16,30
"5154",10102,"St Johns","NL",47.56038,-52.71147,2018-08-03 16:00:00,16,11,27
"5155",10102,"St Johns","NL",47.56038,-52.71147,2018-08-03 17:00:00,14,8,22
"5156",10102,"St Johns","NL",47.56038,-52.71147,2018-08-03 18:00:00,16,4,20
"5157",10102,"St Johns","NL",47.56038,-52.71147,2018-08-03 19:00:00,13,5,18
"5158",10102,"St Johns","NL",47.56038,-52.71147,2018-08-03 20:00:00,11,6,17
"5159",10102,"St Johns","NL",47.56038,-52.71147,2018-08-03 21:00:00,11,6,17
"5160",10102,"St Johns","NL",47.56038,-52.71147,2018-08-03 22:00:00,10,7,17
"5161",10102,"St Johns","NL",47.56038,-52.71147,2018-08-03 23:00:00,12,5,17
"5162",10102,"St Johns","NL",47.56038,-52.71147,2018-08-04 00:00:00,12,5,17
"5163",10102,"St Johns","NL",47.56038,-52.71147,2018-08-04 01:00:00,13,5,18
"5164",10102,"St Johns","NL",47.56038,-52.71147,2018-08-04 02:00:00,16,3,19
"5165",10102,"St Johns","NL",47.56038,-52.71147,2018-08-04 03:00:00,17,3,20
"5166",10102,"St Johns","NL",47.56038,-52.71147,2018-08-04 04:00:00,18,2,20
"5167",10102,"St Johns","NL",47.56038,-52.71147,2018-08-04 05:00:00,18,3,21
"5168",10102,"St Johns","NL",47.56038,-52.71147,2018-08-04 06:00:00,17,5,22
"5169",10102,"St Johns","NL",47.56038,-52.71147,2018-08-04 07:00:00,15,7,22
"5170",10102,"St Johns","NL",47.56038,-52.71147,2018-08-04 08:00:00,16,6,22
"5171",10102,"St Johns","NL",47.56038,-52.71147,2018-08-04 09:00:00,17,6,23
"5172",10102,"St Johns","NL",47.56038,-52.71147,2018-08-04 10:00:00,19,2,21
"5173",10102,"St Johns","NL",47.56038,-52.71147,2018-08-04 11:00:00,18,2,20
"5174",10102,"St Johns","NL",47.56038,-52.71147,2018-08-04 12:00:00,18,3,21
"5175",10102,"St Johns","NL",47.56038,-52.71147,2018-08-04 13:00:00,17,3,20
"5176",10102,"St Johns","NL",47.56038,-52.71147,2018-08-04 14:00:00,18,2,20
"5177",10102,"St Johns","NL",47.56038,-52.71147,2018-08-04 15:00:00,18,2,20
"5178",10102,"St Johns","NL",47.56038,-52.71147,2018-08-04 16:00:00,16,5,21
"5179",10102,"St Johns","NL",47.56038,-52.71147,2018-08-04 17:00:00,17,3,20
"5180",10102,"St Johns","NL",47.56038,-52.71147,2018-08-04 18:00:00,17,3,20
"5181",10102,"St Johns","NL",47.56038,-52.71147,2018-08-04 19:00:00,17,2,19
"5182",10102,"St Johns","NL",47.56038,-52.71147,2018-08-04 20:00:00,15,3,18
"5183",10102,"St Johns","NL",47.56038,-52.71147,2018-08-04 21:00:00,16,2,18
"5184",10102,"St Johns","NL",47.56038,-52.71147,2018-08-04 22:00:00,14,3,17
"5185",10102,"St Johns","NL",47.56038,-52.71147,2018-08-04 23:00:00,15,3,18
"5186",10102,"St Johns","NL",47.56038,-52.71147,2018-08-05 00:00:00,15,1,16
"5187",10102,"St Johns","NL",47.56038,-52.71147,2018-08-05 01:00:00,14,1,15
"5188",10102,"St Johns","NL",47.56038,-52.71147,2018-08-05 02:00:00,12,1,13
"5189",10102,"St Johns","NL",47.56038,-52.71147,2018-08-05 03:00:00,12,1,13
"5190",10102,"St Johns","NL",47.56038,-52.71147,2018-08-05 04:00:00,11,1,12
"5191",10102,"St Johns","NL",47.56038,-52.71147,2018-08-05 05:00:00,14,1,15
"5192",10102,"St Johns","NL",47.56038,-52.71147,2018-08-05 06:00:00,15,1,16
"5193",10102,"St Johns","NL",47.56038,-52.71147,2018-08-05 07:00:00,15,3,18
"5194",10102,"St Johns","NL",47.56038,-52.71147,2018-08-05 08:00:00,15,4,19
"5195",10102,"St Johns","NL",47.56038,-52.71147,2018-08-05 09:00:00,17,3,20
"5196",10102,"St Johns","NL",47.56038,-52.71147,2018-08-05 10:00:00,13,8,21
"5197",10102,"St Johns","NL",47.56038,-52.71147,2018-08-05 11:00:00,17,4,21
"5198",10102,"St Johns","NL",47.56038,-52.71147,2018-08-05 12:00:00,18,2,20
"5199",10102,"St Johns","NL",47.56038,-52.71147,2018-08-05 13:00:00,16,3,19
"5200",10102,"St Johns","NL",47.56038,-52.71147,2018-08-05 14:00:00,18,3,21
"5201",10102,"St Johns","NL",47.56038,-52.71147,2018-08-05 15:00:00,18,4,22
"5202",10102,"St Johns","NL",47.56038,-52.71147,2018-08-05 16:00:00,15,7,22
"5203",10102,"St Johns","NL",47.56038,-52.71147,2018-08-05 17:00:00,18,4,22
"5204",10102,"St Johns","NL",47.56038,-52.71147,2018-08-05 18:00:00,19,1,20
"5205",10102,"St Johns","NL",47.56038,-52.71147,2018-08-05 19:00:00,19,1,20
"5206",10102,"St Johns","NL",47.56038,-52.71147,2018-08-05 20:00:00,19,1,20
"5207",10102,"St Johns","NL",47.56038,-52.71147,2018-08-05 21:00:00,20,2,22
"5208",10102,"St Johns","NL",47.56038,-52.71147,2018-08-05 22:00:00,22,1,23
"5209",10102,"St Johns","NL",47.56038,-52.71147,2018-08-05 23:00:00,23,0,23
"5210",10102,"St Johns","NL",47.56038,-52.71147,2018-08-06 00:00:00,20,0,20
"5211",10102,"St Johns","NL",47.56038,-52.71147,2018-08-06 01:00:00,19,0,19
"5212",10102,"St Johns","NL",47.56038,-52.71147,2018-08-06 02:00:00,18,1,19
"5213",10102,"St Johns","NL",47.56038,-52.71147,2018-08-06 03:00:00,21,0,21
"5214",10102,"St Johns","NL",47.56038,-52.71147,2018-08-06 04:00:00,19,0,19
"5215",10102,"St Johns","NL",47.56038,-52.71147,2018-08-06 05:00:00,19,1,20
"5216",10102,"St Johns","NL",47.56038,-52.71147,2018-08-06 06:00:00,18,2,20
"5217",10102,"St Johns","NL",47.56038,-52.71147,2018-08-06 07:00:00,19,3,22
"5218",10102,"St Johns","NL",47.56038,-52.71147,2018-08-06 08:00:00,18,4,22
"5219",10102,"St Johns","NL",47.56038,-52.71147,2018-08-06 09:00:00,19,3,22
"5220",10102,"St Johns","NL",47.56038,-52.71147,2018-08-06 10:00:00,20,3,23
"5221",10102,"St Johns","NL",47.56038,-52.71147,2018-08-06 11:00:00,14,7,21
"5222",10102,"St Johns","NL",47.56038,-52.71147,2018-08-06 12:00:00,19,5,24
"5223",10102,"St Johns","NL",47.56038,-52.71147,2018-08-06 13:00:00,17,9,26
"5224",10102,"St Johns","NL",47.56038,-52.71147,2018-08-06 14:00:00,20,12,32
"5225",10102,"St Johns","NL",47.56038,-52.71147,2018-08-06 15:00:00,20,10,30
"5226",10102,"St Johns","NL",47.56038,-52.71147,2018-08-06 16:00:00,21,7,28
"5227",10102,"St Johns","NL",47.56038,-52.71147,2018-08-06 17:00:00,22,6,28
"5228",10102,"St Johns","NL",47.56038,-52.71147,2018-08-06 18:00:00,20,6,26
"5229",10102,"St Johns","NL",47.56038,-52.71147,2018-08-06 19:00:00,24,4,28
"5230",10102,"St Johns","NL",47.56038,-52.71147,2018-08-06 20:00:00,24,3,27
"5231",10102,"St Johns","NL",47.56038,-52.71147,2018-08-06 21:00:00,22,2,24
"5232",10102,"St Johns","NL",47.56038,-52.71147,2018-08-06 22:00:00,19,3,22
"5233",10102,"St Johns","NL",47.56038,-52.71147,2018-08-06 23:00:00,17,4,21
"5234",10102,"St Johns","NL",47.56038,-52.71147,2018-08-07 00:00:00,7,14,21
"5235",10102,"St Johns","NL",47.56038,-52.71147,2018-08-07 01:00:00,6,15,21
"5236",10102,"St Johns","NL",47.56038,-52.71147,2018-08-07 02:00:00,5,17,22
"5237",10102,"St Johns","NL",47.56038,-52.71147,2018-08-07 03:00:00,7,9,16
"5238",10102,"St Johns","NL",47.56038,-52.71147,2018-08-07 04:00:00,6,13,19
"5239",10102,"St Johns","NL",47.56038,-52.71147,2018-08-07 05:00:00,1,21,22
"5240",10102,"St Johns","NL",47.56038,-52.71147,2018-08-07 06:00:00,0,25,25
"5241",10102,"St Johns","NL",47.56038,-52.71147,2018-08-07 07:00:00,0,24,24
"5242",10102,"St Johns","NL",47.56038,-52.71147,2018-08-07 08:00:00,0,28,28
"5243",10102,"St Johns","NL",47.56038,-52.71147,2018-08-07 09:00:00,5,20,25
"5244",10102,"St Johns","NL",47.56038,-52.71147,2018-08-07 10:00:00,13,9,22
"5245",10102,"St Johns","NL",47.56038,-52.71147,2018-08-07 11:00:00,14,6,20
"5246",10102,"St Johns","NL",47.56038,-52.71147,2018-08-07 12:00:00,13,7,20
"5247",10102,"St Johns","NL",47.56038,-52.71147,2018-08-07 13:00:00,13,12,25
"5248",10102,"St Johns","NL",47.56038,-52.71147,2018-08-07 14:00:00,14,8,22
"5249",10102,"St Johns","NL",47.56038,-52.71147,2018-08-07 15:00:00,13,8,21
"5250",10102,"St Johns","NL",47.56038,-52.71147,2018-08-07 16:00:00,14,6,20
"5251",10102,"St Johns","NL",47.56038,-52.71147,2018-08-07 17:00:00,15,3,18
"5252",10102,"St Johns","NL",47.56038,-52.71147,2018-08-07 18:00:00,14,4,18
"5253",10102,"St Johns","NL",47.56038,-52.71147,2018-08-07 19:00:00,10,7,17
"5254",10102,"St Johns","NL",47.56038,-52.71147,2018-08-07 20:00:00,12,6,18
"5255",10102,"St Johns","NL",47.56038,-52.71147,2018-08-07 21:00:00,12,4,16
"5256",10102,"St Johns","NL",47.56038,-52.71147,2018-08-07 22:00:00,9,3,12
"5257",10102,"St Johns","NL",47.56038,-52.71147,2018-08-07 23:00:00,7,3,10
"5258",10102,"St Johns","NL",47.56038,-52.71147,2018-08-08 00:00:00,6,3,9
"5259",10102,"St Johns","NL",47.56038,-52.71147,2018-08-08 01:00:00,6,2,8
"5260",10102,"St Johns","NL",47.56038,-52.71147,2018-08-08 02:00:00,3,4,7
"5261",10102,"St Johns","NL",47.56038,-52.71147,2018-08-08 03:00:00,5,1,6
"5262",10102,"St Johns","NL",47.56038,-52.71147,2018-08-08 04:00:00,8,1,9
"5263",10102,"St Johns","NL",47.56038,-52.71147,2018-08-08 05:00:00,8,1,9
"5264",10102,"St Johns","NL",47.56038,-52.71147,2018-08-08 06:00:00,6,3,9
"5265",10102,"St Johns","NL",47.56038,-52.71147,2018-08-08 07:00:00,9,2,11
"5266",10102,"St Johns","NL",47.56038,-52.71147,2018-08-08 08:00:00,9,1,10
"5267",10102,"St Johns","NL",47.56038,-52.71147,2018-08-08 09:00:00,10,2,12
"5268",10102,"St Johns","NL",47.56038,-52.71147,2018-08-08 10:00:00,13,1,14
"5269",10102,"St Johns","NL",47.56038,-52.71147,2018-08-08 11:00:00,13,2,15
"5270",10102,"St Johns","NL",47.56038,-52.71147,2018-08-08 12:00:00,15,4,19
"5271",10102,"St Johns","NL",47.56038,-52.71147,2018-08-08 13:00:00,17,4,21
"5272",10102,"St Johns","NL",47.56038,-52.71147,2018-08-08 14:00:00,20,3,23
"5273",10102,"St Johns","NL",47.56038,-52.71147,2018-08-08 15:00:00,20,4,24
"5274",10102,"St Johns","NL",47.56038,-52.71147,2018-08-08 16:00:00,20,4,24
"5275",10102,"St Johns","NL",47.56038,-52.71147,2018-08-08 17:00:00,19,4,23
"5276",10102,"St Johns","NL",47.56038,-52.71147,2018-08-08 18:00:00,21,4,25
"5277",10102,"St Johns","NL",47.56038,-52.71147,2018-08-08 19:00:00,25,4,29
"5278",10102,"St Johns","NL",47.56038,-52.71147,2018-08-08 20:00:00,35,4,39
"5279",10102,"St Johns","NL",47.56038,-52.71147,2018-08-08 21:00:00,33,4,37
"5280",10102,"St Johns","NL",47.56038,-52.71147,2018-08-08 22:00:00,31,4,35
"5281",10102,"St Johns","NL",47.56038,-52.71147,2018-08-08 23:00:00,30,4,34
"5282",10102,"St Johns","NL",47.56038,-52.71147,2018-08-09 00:00:00,28,3,31
"5283",10102,"St Johns","NL",47.56038,-52.71147,2018-08-09 01:00:00,28,4,32
"5284",10102,"St Johns","NL",47.56038,-52.71147,2018-08-09 02:00:00,23,4,27
"5285",10102,"St Johns","NL",47.56038,-52.71147,2018-08-09 03:00:00,16,3,19
"5286",10102,"St Johns","NL",47.56038,-52.71147,2018-08-09 04:00:00,17,3,20
"5287",10102,"St Johns","NL",47.56038,-52.71147,2018-08-09 05:00:00,18,3,21
"5288",10102,"St Johns","NL",47.56038,-52.71147,2018-08-09 06:00:00,21,4,25
"5289",10102,"St Johns","NL",47.56038,-52.71147,2018-08-09 07:00:00,23,4,27
"5290",10102,"St Johns","NL",47.56038,-52.71147,2018-08-09 08:00:00,24,5,29
"5291",10102,"St Johns","NL",47.56038,-52.71147,2018-08-09 09:00:00,25,5,30
"5292",10102,"St Johns","NL",47.56038,-52.71147,2018-08-09 10:00:00,25,5,30
"5293",10102,"St Johns","NL",47.56038,-52.71147,2018-08-09 11:00:00,22,7,29
"5294",10102,"St Johns","NL",47.56038,-52.71147,2018-08-09 12:00:00,21,5,26
"5295",10102,"St Johns","NL",47.56038,-52.71147,2018-08-09 13:00:00,20,8,28
"5296",10102,"St Johns","NL",47.56038,-52.71147,2018-08-09 14:00:00,23,5,28
"5297",10102,"St Johns","NL",47.56038,-52.71147,2018-08-09 15:00:00,23,4,27
"5298",10102,"St Johns","NL",47.56038,-52.71147,2018-08-09 16:00:00,21,6,27
"5299",10102,"St Johns","NL",47.56038,-52.71147,2018-08-09 17:00:00,24,4,28
"5300",10102,"St Johns","NL",47.56038,-52.71147,2018-08-09 18:00:00,23,4,27
"5301",10102,"St Johns","NL",47.56038,-52.71147,2018-08-09 19:00:00,25,2,27
"5302",10102,"St Johns","NL",47.56038,-52.71147,2018-08-09 20:00:00,24,2,26
"5303",10102,"St Johns","NL",47.56038,-52.71147,2018-08-09 21:00:00,24,2,26
"5304",10102,"St Johns","NL",47.56038,-52.71147,2018-08-09 22:00:00,NA,NA,NA
"5305",10102,"St Johns","NL",47.56038,-52.71147,2018-08-09 23:00:00,NA,NA,NA
"5306",10102,"St Johns","NL",47.56038,-52.71147,2018-08-10 00:00:00,NA,NA,NA
"5307",10102,"St Johns","NL",47.56038,-52.71147,2018-08-10 01:00:00,NA,NA,NA
"5308",10102,"St Johns","NL",47.56038,-52.71147,2018-08-10 02:00:00,NA,NA,NA
"5309",10102,"St Johns","NL",47.56038,-52.71147,2018-08-10 03:00:00,NA,NA,NA
"5310",10102,"St Johns","NL",47.56038,-52.71147,2018-08-10 04:00:00,NA,NA,NA
"5311",10102,"St Johns","NL",47.56038,-52.71147,2018-08-10 05:00:00,NA,NA,NA
"5312",10102,"St Johns","NL",47.56038,-52.71147,2018-08-10 06:00:00,NA,NA,NA
"5313",10102,"St Johns","NL",47.56038,-52.71147,2018-08-10 07:00:00,NA,NA,NA
"5314",10102,"St Johns","NL",47.56038,-52.71147,2018-08-10 08:00:00,NA,NA,NA
"5315",10102,"St Johns","NL",47.56038,-52.71147,2018-08-10 09:00:00,NA,NA,NA
"5316",10102,"St Johns","NL",47.56038,-52.71147,2018-08-10 10:00:00,NA,NA,NA
"5317",10102,"St Johns","NL",47.56038,-52.71147,2018-08-10 11:00:00,NA,NA,NA
"5318",10102,"St Johns","NL",47.56038,-52.71147,2018-08-10 12:00:00,NA,NA,NA
"5319",10102,"St Johns","NL",47.56038,-52.71147,2018-08-10 13:00:00,24,2,26
"5320",10102,"St Johns","NL",47.56038,-52.71147,2018-08-10 14:00:00,24,2,26
"5321",10102,"St Johns","NL",47.56038,-52.71147,2018-08-10 15:00:00,25,2,27
"5322",10102,"St Johns","NL",47.56038,-52.71147,2018-08-10 16:00:00,25,3,28
"5323",10102,"St Johns","NL",47.56038,-52.71147,2018-08-10 17:00:00,26,2,28
"5324",10102,"St Johns","NL",47.56038,-52.71147,2018-08-10 18:00:00,28,2,30
"5325",10102,"St Johns","NL",47.56038,-52.71147,2018-08-10 19:00:00,30,2,32
"5326",10102,"St Johns","NL",47.56038,-52.71147,2018-08-10 20:00:00,32,2,34
"5327",10102,"St Johns","NL",47.56038,-52.71147,2018-08-10 21:00:00,29,2,31
"5328",10102,"St Johns","NL",47.56038,-52.71147,2018-08-10 22:00:00,28,2,30
"5329",10102,"St Johns","NL",47.56038,-52.71147,2018-08-10 23:00:00,32,1,33
"5330",10102,"St Johns","NL",47.56038,-52.71147,2018-08-11 00:00:00,31,2,33
"5331",10102,"St Johns","NL",47.56038,-52.71147,2018-08-11 01:00:00,33,1,34
"5332",10102,"St Johns","NL",47.56038,-52.71147,2018-08-11 02:00:00,31,1,32
"5333",10102,"St Johns","NL",47.56038,-52.71147,2018-08-11 03:00:00,28,2,30
"5334",10102,"St Johns","NL",47.56038,-52.71147,2018-08-11 04:00:00,27,1,28
"5335",10102,"St Johns","NL",47.56038,-52.71147,2018-08-11 05:00:00,28,1,29
"5336",10102,"St Johns","NL",47.56038,-52.71147,2018-08-11 06:00:00,26,2,28
"5337",10102,"St Johns","NL",47.56038,-52.71147,2018-08-11 07:00:00,28,2,30
"5338",10102,"St Johns","NL",47.56038,-52.71147,2018-08-11 08:00:00,29,2,31
"5339",10102,"St Johns","NL",47.56038,-52.71147,2018-08-11 09:00:00,30,3,33
"5340",10102,"St Johns","NL",47.56038,-52.71147,2018-08-11 10:00:00,31,2,33
"5341",10102,"St Johns","NL",47.56038,-52.71147,2018-08-11 11:00:00,29,2,31
"5342",10102,"St Johns","NL",47.56038,-52.71147,2018-08-11 12:00:00,27,1,28
"5343",10102,"St Johns","NL",47.56038,-52.71147,2018-08-11 13:00:00,24,1,25
"5344",10102,"St Johns","NL",47.56038,-52.71147,2018-08-11 14:00:00,23,1,24
"5345",10102,"St Johns","NL",47.56038,-52.71147,2018-08-11 15:00:00,26,1,27
"5346",10102,"St Johns","NL",47.56038,-52.71147,2018-08-11 16:00:00,27,1,28
"5347",10102,"St Johns","NL",47.56038,-52.71147,2018-08-11 17:00:00,25,1,26
"5348",10102,"St Johns","NL",47.56038,-52.71147,2018-08-11 18:00:00,25,1,26
"5349",10102,"St Johns","NL",47.56038,-52.71147,2018-08-11 19:00:00,23,2,25
"5350",10102,"St Johns","NL",47.56038,-52.71147,2018-08-11 20:00:00,22,1,23
"5351",10102,"St Johns","NL",47.56038,-52.71147,2018-08-11 21:00:00,20,1,21
"5352",10102,"St Johns","NL",47.56038,-52.71147,2018-08-11 22:00:00,21,1,22
"5353",10102,"St Johns","NL",47.56038,-52.71147,2018-08-11 23:00:00,20,1,21
"5354",10102,"St Johns","NL",47.56038,-52.71147,2018-08-12 00:00:00,20,1,21
"5355",10102,"St Johns","NL",47.56038,-52.71147,2018-08-12 01:00:00,19,1,20
"5356",10102,"St Johns","NL",47.56038,-52.71147,2018-08-12 02:00:00,19,1,20
"5357",10102,"St Johns","NL",47.56038,-52.71147,2018-08-12 03:00:00,19,1,20
"5358",10102,"St Johns","NL",47.56038,-52.71147,2018-08-12 04:00:00,19,0,19
"5359",10102,"St Johns","NL",47.56038,-52.71147,2018-08-12 05:00:00,18,0,18
"5360",10102,"St Johns","NL",47.56038,-52.71147,2018-08-12 06:00:00,16,1,17
"5361",10102,"St Johns","NL",47.56038,-52.71147,2018-08-12 07:00:00,15,1,16
"5362",10102,"St Johns","NL",47.56038,-52.71147,2018-08-12 08:00:00,15,1,16
"5363",10102,"St Johns","NL",47.56038,-52.71147,2018-08-12 09:00:00,16,1,17
"5364",10102,"St Johns","NL",47.56038,-52.71147,2018-08-12 10:00:00,16,0,16
"5365",10102,"St Johns","NL",47.56038,-52.71147,2018-08-12 11:00:00,16,0,16
"5366",10102,"St Johns","NL",47.56038,-52.71147,2018-08-12 12:00:00,17,1,18
"5367",10102,"St Johns","NL",47.56038,-52.71147,2018-08-12 13:00:00,19,1,20
"5368",10102,"St Johns","NL",47.56038,-52.71147,2018-08-12 14:00:00,18,3,21
"5369",10102,"St Johns","NL",47.56038,-52.71147,2018-08-12 15:00:00,13,10,23
"5370",10102,"St Johns","NL",47.56038,-52.71147,2018-08-12 16:00:00,17,1,18
"5371",10102,"St Johns","NL",47.56038,-52.71147,2018-08-12 17:00:00,16,1,17
"5372",10102,"St Johns","NL",47.56038,-52.71147,2018-08-12 18:00:00,16,2,18
"5373",10102,"St Johns","NL",47.56038,-52.71147,2018-08-12 19:00:00,14,2,16
"5374",10102,"St Johns","NL",47.56038,-52.71147,2018-08-12 20:00:00,14,4,18
"5375",10102,"St Johns","NL",47.56038,-52.71147,2018-08-12 21:00:00,15,3,18
"5376",10102,"St Johns","NL",47.56038,-52.71147,2018-08-12 22:00:00,15,2,17
"5377",10102,"St Johns","NL",47.56038,-52.71147,2018-08-12 23:00:00,13,2,15
"5378",10102,"St Johns","NL",47.56038,-52.71147,2018-08-13 00:00:00,12,2,14
"5379",10102,"St Johns","NL",47.56038,-52.71147,2018-08-13 01:00:00,10,3,13
"5380",10102,"St Johns","NL",47.56038,-52.71147,2018-08-13 02:00:00,8,3,11
"5381",10102,"St Johns","NL",47.56038,-52.71147,2018-08-13 03:00:00,6,4,10
"5382",10102,"St Johns","NL",47.56038,-52.71147,2018-08-13 04:00:00,5,4,9
"5383",10102,"St Johns","NL",47.56038,-52.71147,2018-08-13 05:00:00,5,4,9
"5384",10102,"St Johns","NL",47.56038,-52.71147,2018-08-13 06:00:00,5,5,10
"5385",10102,"St Johns","NL",47.56038,-52.71147,2018-08-13 07:00:00,6,6,12
"5386",10102,"St Johns","NL",47.56038,-52.71147,2018-08-13 08:00:00,9,8,17
"5387",10102,"St Johns","NL",47.56038,-52.71147,2018-08-13 09:00:00,16,5,21
"5388",10102,"St Johns","NL",47.56038,-52.71147,2018-08-13 10:00:00,17,3,20
"5389",10102,"St Johns","NL",47.56038,-52.71147,2018-08-13 11:00:00,18,3,21
"5390",10102,"St Johns","NL",47.56038,-52.71147,2018-08-13 12:00:00,18,2,20
"5391",10102,"St Johns","NL",47.56038,-52.71147,2018-08-13 13:00:00,19,2,21
"5392",10102,"St Johns","NL",47.56038,-52.71147,2018-08-13 14:00:00,20,2,22
"5393",10102,"St Johns","NL",47.56038,-52.71147,2018-08-13 15:00:00,21,3,24
"5394",10102,"St Johns","NL",47.56038,-52.71147,2018-08-13 16:00:00,21,3,24
"5395",10102,"St Johns","NL",47.56038,-52.71147,2018-08-13 17:00:00,22,2,24
"5396",10102,"St Johns","NL",47.56038,-52.71147,2018-08-13 18:00:00,22,2,24
"5397",10102,"St Johns","NL",47.56038,-52.71147,2018-08-13 19:00:00,21,2,23
"5398",10102,"St Johns","NL",47.56038,-52.71147,2018-08-13 20:00:00,21,2,23
"5399",10102,"St Johns","NL",47.56038,-52.71147,2018-08-13 21:00:00,22,2,24
"5400",10102,"St Johns","NL",47.56038,-52.71147,2018-08-13 22:00:00,23,1,24
"5401",10102,"St Johns","NL",47.56038,-52.71147,2018-08-13 23:00:00,23,2,25
"5402",10102,"St Johns","NL",47.56038,-52.71147,2018-08-14 00:00:00,22,1,23
"5403",10102,"St Johns","NL",47.56038,-52.71147,2018-08-14 01:00:00,21,2,23
"5404",10102,"St Johns","NL",47.56038,-52.71147,2018-08-14 02:00:00,21,1,22
"5405",10102,"St Johns","NL",47.56038,-52.71147,2018-08-14 03:00:00,21,1,22
"5406",10102,"St Johns","NL",47.56038,-52.71147,2018-08-14 04:00:00,22,1,23
"5407",10102,"St Johns","NL",47.56038,-52.71147,2018-08-14 05:00:00,23,1,24
"5408",10102,"St Johns","NL",47.56038,-52.71147,2018-08-14 06:00:00,24,3,27
"5409",10102,"St Johns","NL",47.56038,-52.71147,2018-08-14 07:00:00,23,4,27
"5410",10102,"St Johns","NL",47.56038,-52.71147,2018-08-14 08:00:00,21,6,27
"5411",10102,"St Johns","NL",47.56038,-52.71147,2018-08-14 09:00:00,24,4,28
"5412",10102,"St Johns","NL",47.56038,-52.71147,2018-08-14 10:00:00,23,3,26
"5413",10102,"St Johns","NL",47.56038,-52.71147,2018-08-14 11:00:00,22,2,24
"5414",10102,"St Johns","NL",47.56038,-52.71147,2018-08-14 12:00:00,24,2,26
"5415",10102,"St Johns","NL",47.56038,-52.71147,2018-08-14 13:00:00,26,3,29
"5416",10102,"St Johns","NL",47.56038,-52.71147,2018-08-14 14:00:00,26,3,29
"5417",10102,"St Johns","NL",47.56038,-52.71147,2018-08-14 15:00:00,27,3,30
"5418",10102,"St Johns","NL",47.56038,-52.71147,2018-08-14 16:00:00,26,3,29
"5419",10102,"St Johns","NL",47.56038,-52.71147,2018-08-14 17:00:00,22,3,25
"5420",10102,"St Johns","NL",47.56038,-52.71147,2018-08-14 18:00:00,22,2,24
"5421",10102,"St Johns","NL",47.56038,-52.71147,2018-08-14 19:00:00,24,3,27
"5422",10102,"St Johns","NL",47.56038,-52.71147,2018-08-14 20:00:00,20,3,23
"5423",10102,"St Johns","NL",47.56038,-52.71147,2018-08-14 21:00:00,17,4,21
"5424",10102,"St Johns","NL",47.56038,-52.71147,2018-08-14 22:00:00,17,3,20
"5425",10102,"St Johns","NL",47.56038,-52.71147,2018-08-14 23:00:00,17,2,19
"5426",10102,"St Johns","NL",47.56038,-52.71147,2018-08-15 00:00:00,18,1,19
"5427",10102,"St Johns","NL",47.56038,-52.71147,2018-08-15 01:00:00,16,2,18
"5428",10102,"St Johns","NL",47.56038,-52.71147,2018-08-15 02:00:00,15,2,17
"5429",10102,"St Johns","NL",47.56038,-52.71147,2018-08-15 03:00:00,17,2,19
"5430",10102,"St Johns","NL",47.56038,-52.71147,2018-08-15 04:00:00,16,2,18
"5431",10102,"St Johns","NL",47.56038,-52.71147,2018-08-15 05:00:00,17,2,19
"5432",10102,"St Johns","NL",47.56038,-52.71147,2018-08-15 06:00:00,16,2,18
"5433",10102,"St Johns","NL",47.56038,-52.71147,2018-08-15 07:00:00,16,4,20
"5434",10102,"St Johns","NL",47.56038,-52.71147,2018-08-15 08:00:00,19,3,22
"5435",10102,"St Johns","NL",47.56038,-52.71147,2018-08-15 09:00:00,24,3,27
"5436",10102,"St Johns","NL",47.56038,-52.71147,2018-08-15 10:00:00,24,2,26
"5437",10102,"St Johns","NL",47.56038,-52.71147,2018-08-15 11:00:00,26,2,28
"5438",10102,"St Johns","NL",47.56038,-52.71147,2018-08-15 12:00:00,26,2,28
"5439",10102,"St Johns","NL",47.56038,-52.71147,2018-08-15 13:00:00,25,2,27
"5440",10102,"St Johns","NL",47.56038,-52.71147,2018-08-15 14:00:00,22,3,25
"5441",10102,"St Johns","NL",47.56038,-52.71147,2018-08-15 15:00:00,23,3,26
"5442",10102,"St Johns","NL",47.56038,-52.71147,2018-08-15 16:00:00,22,3,25
"5443",10102,"St Johns","NL",47.56038,-52.71147,2018-08-15 17:00:00,21,2,23
"5444",10102,"St Johns","NL",47.56038,-52.71147,2018-08-15 18:00:00,21,3,24
"5445",10102,"St Johns","NL",47.56038,-52.71147,2018-08-15 19:00:00,20,2,22
"5446",10102,"St Johns","NL",47.56038,-52.71147,2018-08-15 20:00:00,18,2,20
"5447",10102,"St Johns","NL",47.56038,-52.71147,2018-08-15 21:00:00,17,2,19
"5448",10102,"St Johns","NL",47.56038,-52.71147,2018-08-15 22:00:00,16,3,19
"5449",10102,"St Johns","NL",47.56038,-52.71147,2018-08-15 23:00:00,15,2,17
"5450",10102,"St Johns","NL",47.56038,-52.71147,2018-08-16 00:00:00,15,2,17
"5451",10102,"St Johns","NL",47.56038,-52.71147,2018-08-16 01:00:00,17,1,18
"5452",10102,"St Johns","NL",47.56038,-52.71147,2018-08-16 02:00:00,26,6,32
"5453",10102,"St Johns","NL",47.56038,-52.71147,2018-08-16 03:00:00,20,3,23
"5454",10102,"St Johns","NL",47.56038,-52.71147,2018-08-16 04:00:00,15,2,17
"5455",10102,"St Johns","NL",47.56038,-52.71147,2018-08-16 05:00:00,14,2,16
"5456",10102,"St Johns","NL",47.56038,-52.71147,2018-08-16 06:00:00,16,3,19
"5457",10102,"St Johns","NL",47.56038,-52.71147,2018-08-16 07:00:00,18,5,23
"5458",10102,"St Johns","NL",47.56038,-52.71147,2018-08-16 08:00:00,20,6,26
"5459",10102,"St Johns","NL",47.56038,-52.71147,2018-08-16 09:00:00,22,5,27
"5460",10102,"St Johns","NL",47.56038,-52.71147,2018-08-16 10:00:00,22,5,27
"5461",10102,"St Johns","NL",47.56038,-52.71147,2018-08-16 11:00:00,16,11,27
"5462",10102,"St Johns","NL",47.56038,-52.71147,2018-08-16 12:00:00,15,12,27
"5463",10102,"St Johns","NL",47.56038,-52.71147,2018-08-16 13:00:00,11,17,28
"5464",10102,"St Johns","NL",47.56038,-52.71147,2018-08-16 14:00:00,8,16,24
"5465",10102,"St Johns","NL",47.56038,-52.71147,2018-08-16 15:00:00,12,9,21
"5466",10102,"St Johns","NL",47.56038,-52.71147,2018-08-16 16:00:00,3,18,21
"5467",10102,"St Johns","NL",47.56038,-52.71147,2018-08-16 17:00:00,24,8,32
"5468",10102,"St Johns","NL",47.56038,-52.71147,2018-08-16 18:00:00,28,4,32
"5469",10102,"St Johns","NL",47.56038,-52.71147,2018-08-16 19:00:00,30,4,34
"5470",10102,"St Johns","NL",47.56038,-52.71147,2018-08-16 20:00:00,38,4,42
"5471",10102,"St Johns","NL",47.56038,-52.71147,2018-08-16 21:00:00,34,7,41
"5472",10102,"St Johns","NL",47.56038,-52.71147,2018-08-16 22:00:00,19,7,26
"5473",10102,"St Johns","NL",47.56038,-52.71147,2018-08-16 23:00:00,17,2,19
"5474",10102,"St Johns","NL",47.56038,-52.71147,2018-08-17 00:00:00,18,1,19
"5475",10102,"St Johns","NL",47.56038,-52.71147,2018-08-17 01:00:00,18,2,20
"5476",10102,"St Johns","NL",47.56038,-52.71147,2018-08-17 02:00:00,18,1,19
"5477",10102,"St Johns","NL",47.56038,-52.71147,2018-08-17 03:00:00,18,1,19
"5478",10102,"St Johns","NL",47.56038,-52.71147,2018-08-17 04:00:00,20,1,21
"5479",10102,"St Johns","NL",47.56038,-52.71147,2018-08-17 05:00:00,21,1,22
"5480",10102,"St Johns","NL",47.56038,-52.71147,2018-08-17 06:00:00,21,1,22
"5481",10102,"St Johns","NL",47.56038,-52.71147,2018-08-17 07:00:00,20,3,23
"5482",10102,"St Johns","NL",47.56038,-52.71147,2018-08-17 08:00:00,19,3,22
"5483",10102,"St Johns","NL",47.56038,-52.71147,2018-08-17 09:00:00,18,4,22
"5484",10102,"St Johns","NL",47.56038,-52.71147,2018-08-17 10:00:00,19,3,22
"5485",10102,"St Johns","NL",47.56038,-52.71147,2018-08-17 11:00:00,17,4,21
"5486",10102,"St Johns","NL",47.56038,-52.71147,2018-08-17 12:00:00,17,3,20
"5487",10102,"St Johns","NL",47.56038,-52.71147,2018-08-17 13:00:00,16,3,19
"5488",10102,"St Johns","NL",47.56038,-52.71147,2018-08-17 14:00:00,17,3,20
"5489",10102,"St Johns","NL",47.56038,-52.71147,2018-08-17 15:00:00,18,4,22
"5490",10102,"St Johns","NL",47.56038,-52.71147,2018-08-17 16:00:00,20,3,23
"5491",10102,"St Johns","NL",47.56038,-52.71147,2018-08-17 17:00:00,19,4,23
"5492",10102,"St Johns","NL",47.56038,-52.71147,2018-08-17 18:00:00,21,4,25
"5493",10102,"St Johns","NL",47.56038,-52.71147,2018-08-17 19:00:00,21,2,23
"5494",10102,"St Johns","NL",47.56038,-52.71147,2018-08-17 20:00:00,20,4,24
"5495",10102,"St Johns","NL",47.56038,-52.71147,2018-08-17 21:00:00,20,4,24
"5496",10102,"St Johns","NL",47.56038,-52.71147,2018-08-17 22:00:00,21,3,24
"5497",10102,"St Johns","NL",47.56038,-52.71147,2018-08-17 23:00:00,21,3,24
"5498",10102,"St Johns","NL",47.56038,-52.71147,2018-08-18 00:00:00,19,5,24
"5499",10102,"St Johns","NL",47.56038,-52.71147,2018-08-18 01:00:00,24,1,25
"5500",10102,"St Johns","NL",47.56038,-52.71147,2018-08-18 02:00:00,20,2,22
"5501",10102,"St Johns","NL",47.56038,-52.71147,2018-08-18 03:00:00,19,3,22
"5502",10102,"St Johns","NL",47.56038,-52.71147,2018-08-18 04:00:00,17,4,21
"5503",10102,"St Johns","NL",47.56038,-52.71147,2018-08-18 05:00:00,12,2,14
"5504",10102,"St Johns","NL",47.56038,-52.71147,2018-08-18 06:00:00,15,2,17
"5505",10102,"St Johns","NL",47.56038,-52.71147,2018-08-18 07:00:00,18,4,22
"5506",10102,"St Johns","NL",47.56038,-52.71147,2018-08-18 08:00:00,18,3,21
"5507",10102,"St Johns","NL",47.56038,-52.71147,2018-08-18 09:00:00,17,3,20
"5508",10102,"St Johns","NL",47.56038,-52.71147,2018-08-18 10:00:00,17,3,20
"5509",10102,"St Johns","NL",47.56038,-52.71147,2018-08-18 11:00:00,18,3,21
"5510",10102,"St Johns","NL",47.56038,-52.71147,2018-08-18 12:00:00,15,3,18
"5511",10102,"St Johns","NL",47.56038,-52.71147,2018-08-18 13:00:00,15,1,16
"5512",10102,"St Johns","NL",47.56038,-52.71147,2018-08-18 14:00:00,15,2,17
"5513",10102,"St Johns","NL",47.56038,-52.71147,2018-08-18 15:00:00,15,1,16
"5514",10102,"St Johns","NL",47.56038,-52.71147,2018-08-18 16:00:00,16,1,17
"5515",10102,"St Johns","NL",47.56038,-52.71147,2018-08-18 17:00:00,15,1,16
"5516",10102,"St Johns","NL",47.56038,-52.71147,2018-08-18 18:00:00,15,1,16
"5517",10102,"St Johns","NL",47.56038,-52.71147,2018-08-18 19:00:00,15,1,16
"5518",10102,"St Johns","NL",47.56038,-52.71147,2018-08-18 20:00:00,15,3,18
"5519",10102,"St Johns","NL",47.56038,-52.71147,2018-08-18 21:00:00,12,4,16
"5520",10102,"St Johns","NL",47.56038,-52.71147,2018-08-18 22:00:00,9,3,12
"5521",10102,"St Johns","NL",47.56038,-52.71147,2018-08-18 23:00:00,9,4,13
"5522",10102,"St Johns","NL",47.56038,-52.71147,2018-08-19 00:00:00,13,3,16
"5523",10102,"St Johns","NL",47.56038,-52.71147,2018-08-19 01:00:00,13,3,16
"5524",10102,"St Johns","NL",47.56038,-52.71147,2018-08-19 02:00:00,11,3,14
"5525",10102,"St Johns","NL",47.56038,-52.71147,2018-08-19 03:00:00,10,2,12
"5526",10102,"St Johns","NL",47.56038,-52.71147,2018-08-19 04:00:00,11,2,13
"5527",10102,"St Johns","NL",47.56038,-52.71147,2018-08-19 05:00:00,11,2,13
"5528",10102,"St Johns","NL",47.56038,-52.71147,2018-08-19 06:00:00,5,10,15
"5529",10102,"St Johns","NL",47.56038,-52.71147,2018-08-19 07:00:00,6,10,16
"5530",10102,"St Johns","NL",47.56038,-52.71147,2018-08-19 08:00:00,3,15,18
"5531",10102,"St Johns","NL",47.56038,-52.71147,2018-08-19 09:00:00,9,12,21
"5532",10102,"St Johns","NL",47.56038,-52.71147,2018-08-19 10:00:00,23,2,25
"5533",10102,"St Johns","NL",47.56038,-52.71147,2018-08-19 11:00:00,22,5,27
"5534",10102,"St Johns","NL",47.56038,-52.71147,2018-08-19 12:00:00,19,5,24
"5535",10102,"St Johns","NL",47.56038,-52.71147,2018-08-19 13:00:00,14,9,23
"5536",10102,"St Johns","NL",47.56038,-52.71147,2018-08-19 14:00:00,18,12,30
"5537",10102,"St Johns","NL",47.56038,-52.71147,2018-08-19 15:00:00,21,8,29
"5538",10102,"St Johns","NL",47.56038,-52.71147,2018-08-19 16:00:00,13,13,26
"5539",10102,"St Johns","NL",47.56038,-52.71147,2018-08-19 17:00:00,8,18,26
"5540",10102,"St Johns","NL",47.56038,-52.71147,2018-08-19 18:00:00,8,20,28
"5541",10102,"St Johns","NL",47.56038,-52.71147,2018-08-19 19:00:00,15,10,25
"5542",10102,"St Johns","NL",47.56038,-52.71147,2018-08-19 20:00:00,16,5,21
"5543",10102,"St Johns","NL",47.56038,-52.71147,2018-08-19 21:00:00,15,3,18
"5544",10102,"St Johns","NL",47.56038,-52.71147,2018-08-19 22:00:00,14,5,19
"5545",10102,"St Johns","NL",47.56038,-52.71147,2018-08-19 23:00:00,13,5,18
"5546",10102,"St Johns","NL",47.56038,-52.71147,2018-08-20 00:00:00,15,2,17
"5547",10102,"St Johns","NL",47.56038,-52.71147,2018-08-20 01:00:00,15,4,19
"5548",10102,"St Johns","NL",47.56038,-52.71147,2018-08-20 02:00:00,16,4,20
"5549",10102,"St Johns","NL",47.56038,-52.71147,2018-08-20 03:00:00,13,4,17
"5550",10102,"St Johns","NL",47.56038,-52.71147,2018-08-20 04:00:00,9,5,14
"5551",10102,"St Johns","NL",47.56038,-52.71147,2018-08-20 05:00:00,3,8,11
"5552",10102,"St Johns","NL",47.56038,-52.71147,2018-08-20 06:00:00,5,11,16
"5553",10102,"St Johns","NL",47.56038,-52.71147,2018-08-20 07:00:00,0,19,19
"5554",10102,"St Johns","NL",47.56038,-52.71147,2018-08-20 08:00:00,7,16,23
"5555",10102,"St Johns","NL",47.56038,-52.71147,2018-08-20 09:00:00,14,9,23
"5556",10102,"St Johns","NL",47.56038,-52.71147,2018-08-20 10:00:00,16,7,23
"5557",10102,"St Johns","NL",47.56038,-52.71147,2018-08-20 11:00:00,17,6,23
"5558",10102,"St Johns","NL",47.56038,-52.71147,2018-08-20 12:00:00,18,5,23
"5559",10102,"St Johns","NL",47.56038,-52.71147,2018-08-20 13:00:00,17,5,22
"5560",10102,"St Johns","NL",47.56038,-52.71147,2018-08-20 14:00:00,17,3,20
"5561",10102,"St Johns","NL",47.56038,-52.71147,2018-08-20 15:00:00,13,9,22
"5562",10102,"St Johns","NL",47.56038,-52.71147,2018-08-20 16:00:00,17,4,21
"5563",10102,"St Johns","NL",47.56038,-52.71147,2018-08-20 17:00:00,18,4,22
"5564",10102,"St Johns","NL",47.56038,-52.71147,2018-08-20 18:00:00,16,5,21
"5565",10102,"St Johns","NL",47.56038,-52.71147,2018-08-20 19:00:00,14,8,22
"5566",10102,"St Johns","NL",47.56038,-52.71147,2018-08-20 20:00:00,16,4,20
"5567",10102,"St Johns","NL",47.56038,-52.71147,2018-08-20 21:00:00,7,10,17
"5568",10102,"St Johns","NL",47.56038,-52.71147,2018-08-20 22:00:00,7,6,13
"5569",10102,"St Johns","NL",47.56038,-52.71147,2018-08-20 23:00:00,7,4,11
"5570",10102,"St Johns","NL",47.56038,-52.71147,2018-08-21 00:00:00,6,4,10
"5571",10102,"St Johns","NL",47.56038,-52.71147,2018-08-21 01:00:00,4,5,9
"5572",10102,"St Johns","NL",47.56038,-52.71147,2018-08-21 02:00:00,6,2,8
"5573",10102,"St Johns","NL",47.56038,-52.71147,2018-08-21 03:00:00,4,2,6
"5574",10102,"St Johns","NL",47.56038,-52.71147,2018-08-21 04:00:00,4,2,6
"5575",10102,"St Johns","NL",47.56038,-52.71147,2018-08-21 05:00:00,4,4,8
"5576",10102,"St Johns","NL",47.56038,-52.71147,2018-08-21 06:00:00,6,7,13
"5577",10102,"St Johns","NL",47.56038,-52.71147,2018-08-21 07:00:00,5,14,19
"5578",10102,"St Johns","NL",47.56038,-52.71147,2018-08-21 08:00:00,12,12,24
"5579",10102,"St Johns","NL",47.56038,-52.71147,2018-08-21 09:00:00,17,10,27
"5580",10102,"St Johns","NL",47.56038,-52.71147,2018-08-21 10:00:00,19,10,29
"5581",10102,"St Johns","NL",47.56038,-52.71147,2018-08-21 11:00:00,19,8,27
"5582",10102,"St Johns","NL",47.56038,-52.71147,2018-08-21 12:00:00,18,6,24
"5583",10102,"St Johns","NL",47.56038,-52.71147,2018-08-21 13:00:00,18,7,25
"5584",10102,"St Johns","NL",47.56038,-52.71147,2018-08-21 14:00:00,19,8,27
"5585",10102,"St Johns","NL",47.56038,-52.71147,2018-08-21 15:00:00,15,12,27
"5586",10102,"St Johns","NL",47.56038,-52.71147,2018-08-21 16:00:00,9,19,28
"5587",10102,"St Johns","NL",47.56038,-52.71147,2018-08-21 17:00:00,20,5,25
"5588",10102,"St Johns","NL",47.56038,-52.71147,2018-08-21 18:00:00,19,6,25
"5589",10102,"St Johns","NL",47.56038,-52.71147,2018-08-21 19:00:00,6,21,27
"5590",10102,"St Johns","NL",47.56038,-52.71147,2018-08-21 20:00:00,10,18,28
"5591",10102,"St Johns","NL",47.56038,-52.71147,2018-08-21 21:00:00,8,20,28
"5592",10102,"St Johns","NL",47.56038,-52.71147,2018-08-21 22:00:00,6,28,34
"5593",10102,"St Johns","NL",47.56038,-52.71147,2018-08-21 23:00:00,5,23,28
"5594",10102,"St Johns","NL",47.56038,-52.71147,2018-08-22 00:00:00,8,19,27
"5595",10102,"St Johns","NL",47.56038,-52.71147,2018-08-22 01:00:00,4,26,30
"5596",10102,"St Johns","NL",47.56038,-52.71147,2018-08-22 02:00:00,18,9,27
"5597",10102,"St Johns","NL",47.56038,-52.71147,2018-08-22 03:00:00,9,18,27
"5598",10102,"St Johns","NL",47.56038,-52.71147,2018-08-22 04:00:00,16,11,27
"5599",10102,"St Johns","NL",47.56038,-52.71147,2018-08-22 05:00:00,11,17,28
"5600",10102,"St Johns","NL",47.56038,-52.71147,2018-08-22 06:00:00,11,18,29
"5601",10102,"St Johns","NL",47.56038,-52.71147,2018-08-22 07:00:00,14,16,30
"5602",10102,"St Johns","NL",47.56038,-52.71147,2018-08-22 08:00:00,20,6,26
"5603",10102,"St Johns","NL",47.56038,-52.71147,2018-08-22 09:00:00,19,6,25
"5604",10102,"St Johns","NL",47.56038,-52.71147,2018-08-22 10:00:00,19,6,25
"5605",10102,"St Johns","NL",47.56038,-52.71147,2018-08-22 11:00:00,20,5,25
"5606",10102,"St Johns","NL",47.56038,-52.71147,2018-08-22 12:00:00,20,3,23
"5607",10102,"St Johns","NL",47.56038,-52.71147,2018-08-22 13:00:00,20,4,24
"5608",10102,"St Johns","NL",47.56038,-52.71147,2018-08-22 14:00:00,19,3,22
"5609",10102,"St Johns","NL",47.56038,-52.71147,2018-08-22 15:00:00,22,1,23
"5610",10102,"St Johns","NL",47.56038,-52.71147,2018-08-22 16:00:00,27,1,28
"5611",10102,"St Johns","NL",47.56038,-52.71147,2018-08-22 17:00:00,25,0,25
"5612",10102,"St Johns","NL",47.56038,-52.71147,2018-08-22 18:00:00,21,6,27
"5613",10102,"St Johns","NL",47.56038,-52.71147,2018-08-22 19:00:00,8,20,28
"5614",10102,"St Johns","NL",47.56038,-52.71147,2018-08-22 20:00:00,1,27,28
"5615",10102,"St Johns","NL",47.56038,-52.71147,2018-08-22 21:00:00,1,25,26
"5616",10102,"St Johns","NL",47.56038,-52.71147,2018-08-22 22:00:00,2,19,21
"5617",10102,"St Johns","NL",47.56038,-52.71147,2018-08-22 23:00:00,9,5,14
"5618",10102,"St Johns","NL",47.56038,-52.71147,2018-08-23 00:00:00,11,3,14
"5619",10102,"St Johns","NL",47.56038,-52.71147,2018-08-23 01:00:00,16,1,17
"5620",10102,"St Johns","NL",47.56038,-52.71147,2018-08-23 02:00:00,19,1,20
"5621",10102,"St Johns","NL",47.56038,-52.71147,2018-08-23 03:00:00,19,1,20
"5622",10102,"St Johns","NL",47.56038,-52.71147,2018-08-23 04:00:00,18,0,18
"5623",10102,"St Johns","NL",47.56038,-52.71147,2018-08-23 05:00:00,18,1,19
"5624",10102,"St Johns","NL",47.56038,-52.71147,2018-08-23 06:00:00,16,2,18
"5625",10102,"St Johns","NL",47.56038,-52.71147,2018-08-23 07:00:00,19,4,23
"5626",10102,"St Johns","NL",47.56038,-52.71147,2018-08-23 08:00:00,19,2,21
"5627",10102,"St Johns","NL",47.56038,-52.71147,2018-08-23 09:00:00,22,1,23
"5628",10102,"St Johns","NL",47.56038,-52.71147,2018-08-23 10:00:00,21,1,22
"5629",10102,"St Johns","NL",47.56038,-52.71147,2018-08-23 11:00:00,23,1,24
"5630",10102,"St Johns","NL",47.56038,-52.71147,2018-08-23 12:00:00,24,2,26
"5631",10102,"St Johns","NL",47.56038,-52.71147,2018-08-23 13:00:00,23,2,25
"5632",10102,"St Johns","NL",47.56038,-52.71147,2018-08-23 14:00:00,22,2,24
"5633",10102,"St Johns","NL",47.56038,-52.71147,2018-08-23 15:00:00,25,1,26
"5634",10102,"St Johns","NL",47.56038,-52.71147,2018-08-23 16:00:00,26,2,28
"5635",10102,"St Johns","NL",47.56038,-52.71147,2018-08-23 17:00:00,21,1,22
"5636",10102,"St Johns","NL",47.56038,-52.71147,2018-08-23 18:00:00,20,1,21
"5637",10102,"St Johns","NL",47.56038,-52.71147,2018-08-23 19:00:00,22,0,22
"5638",10102,"St Johns","NL",47.56038,-52.71147,2018-08-23 20:00:00,26,0,26
"5639",10102,"St Johns","NL",47.56038,-52.71147,2018-08-23 21:00:00,32,1,33
"5640",10102,"St Johns","NL",47.56038,-52.71147,2018-08-23 22:00:00,33,1,34
"5641",10102,"St Johns","NL",47.56038,-52.71147,2018-08-23 23:00:00,37,1,38
"5642",10102,"St Johns","NL",47.56038,-52.71147,2018-08-24 00:00:00,36,0,36
"5643",10102,"St Johns","NL",47.56038,-52.71147,2018-08-24 01:00:00,30,0,30
"5644",10102,"St Johns","NL",47.56038,-52.71147,2018-08-24 02:00:00,30,0,30
"5645",10102,"St Johns","NL",47.56038,-52.71147,2018-08-24 03:00:00,32,0,32
"5646",10102,"St Johns","NL",47.56038,-52.71147,2018-08-24 04:00:00,30,0,30
"5647",10102,"St Johns","NL",47.56038,-52.71147,2018-08-24 05:00:00,25,1,26
"5648",10102,"St Johns","NL",47.56038,-52.71147,2018-08-24 06:00:00,22,1,23
"5649",10102,"St Johns","NL",47.56038,-52.71147,2018-08-24 07:00:00,19,1,20
"5650",10102,"St Johns","NL",47.56038,-52.71147,2018-08-24 08:00:00,21,1,22
"5651",10102,"St Johns","NL",47.56038,-52.71147,2018-08-24 09:00:00,25,2,27
"5652",10102,"St Johns","NL",47.56038,-52.71147,2018-08-24 10:00:00,27,3,30
"5653",10102,"St Johns","NL",47.56038,-52.71147,2018-08-24 11:00:00,30,3,33
"5654",10102,"St Johns","NL",47.56038,-52.71147,2018-08-24 12:00:00,28,2,30
"5655",10102,"St Johns","NL",47.56038,-52.71147,2018-08-24 13:00:00,27,2,29
"5656",10102,"St Johns","NL",47.56038,-52.71147,2018-08-24 14:00:00,25,3,28
"5657",10102,"St Johns","NL",47.56038,-52.71147,2018-08-24 15:00:00,26,2,28
"5658",10102,"St Johns","NL",47.56038,-52.71147,2018-08-24 16:00:00,27,3,30
"5659",10102,"St Johns","NL",47.56038,-52.71147,2018-08-24 17:00:00,25,3,28
"5660",10102,"St Johns","NL",47.56038,-52.71147,2018-08-24 18:00:00,24,4,28
"5661",10102,"St Johns","NL",47.56038,-52.71147,2018-08-24 19:00:00,23,4,27
"5662",10102,"St Johns","NL",47.56038,-52.71147,2018-08-24 20:00:00,23,3,26
"5663",10102,"St Johns","NL",47.56038,-52.71147,2018-08-24 21:00:00,22,3,25
"5664",10102,"St Johns","NL",47.56038,-52.71147,2018-08-24 22:00:00,20,4,24
"5665",10102,"St Johns","NL",47.56038,-52.71147,2018-08-24 23:00:00,20,3,23
"5666",10102,"St Johns","NL",47.56038,-52.71147,2018-08-25 00:00:00,19,2,21
"5667",10102,"St Johns","NL",47.56038,-52.71147,2018-08-25 01:00:00,19,2,21
"5668",10102,"St Johns","NL",47.56038,-52.71147,2018-08-25 02:00:00,18,2,20
"5669",10102,"St Johns","NL",47.56038,-52.71147,2018-08-25 03:00:00,17,2,19
"5670",10102,"St Johns","NL",47.56038,-52.71147,2018-08-25 04:00:00,18,2,20
"5671",10102,"St Johns","NL",47.56038,-52.71147,2018-08-25 05:00:00,17,3,20
"5672",10102,"St Johns","NL",47.56038,-52.71147,2018-08-25 06:00:00,15,3,18
"5673",10102,"St Johns","NL",47.56038,-52.71147,2018-08-25 07:00:00,12,3,15
"5674",10102,"St Johns","NL",47.56038,-52.71147,2018-08-25 08:00:00,14,5,19
"5675",10102,"St Johns","NL",47.56038,-52.71147,2018-08-25 09:00:00,18,4,22
"5676",10102,"St Johns","NL",47.56038,-52.71147,2018-08-25 10:00:00,19,3,22
"5677",10102,"St Johns","NL",47.56038,-52.71147,2018-08-25 11:00:00,21,2,23
"5678",10102,"St Johns","NL",47.56038,-52.71147,2018-08-25 12:00:00,23,3,26
"5679",10102,"St Johns","NL",47.56038,-52.71147,2018-08-25 13:00:00,26,4,30
"5680",10102,"St Johns","NL",47.56038,-52.71147,2018-08-25 14:00:00,27,3,30
"5681",10102,"St Johns","NL",47.56038,-52.71147,2018-08-25 15:00:00,27,4,31
"5682",10102,"St Johns","NL",47.56038,-52.71147,2018-08-25 16:00:00,27,4,31
"5683",10102,"St Johns","NL",47.56038,-52.71147,2018-08-25 17:00:00,24,4,28
"5684",10102,"St Johns","NL",47.56038,-52.71147,2018-08-25 18:00:00,23,4,27
"5685",10102,"St Johns","NL",47.56038,-52.71147,2018-08-25 19:00:00,24,4,28
"5686",10102,"St Johns","NL",47.56038,-52.71147,2018-08-25 20:00:00,24,4,28
"5687",10102,"St Johns","NL",47.56038,-52.71147,2018-08-25 21:00:00,23,5,28
"5688",10102,"St Johns","NL",47.56038,-52.71147,2018-08-25 22:00:00,23,4,27
"5689",10102,"St Johns","NL",47.56038,-52.71147,2018-08-25 23:00:00,24,4,28
"5690",10102,"St Johns","NL",47.56038,-52.71147,2018-08-26 00:00:00,24,3,27
"5691",10102,"St Johns","NL",47.56038,-52.71147,2018-08-26 01:00:00,26,3,29
"5692",10102,"St Johns","NL",47.56038,-52.71147,2018-08-26 02:00:00,26,3,29
"5693",10102,"St Johns","NL",47.56038,-52.71147,2018-08-26 03:00:00,25,3,28
"5694",10102,"St Johns","NL",47.56038,-52.71147,2018-08-26 04:00:00,24,3,27
"5695",10102,"St Johns","NL",47.56038,-52.71147,2018-08-26 05:00:00,24,3,27
"5696",10102,"St Johns","NL",47.56038,-52.71147,2018-08-26 06:00:00,23,3,26
"5697",10102,"St Johns","NL",47.56038,-52.71147,2018-08-26 07:00:00,24,3,27
"5698",10102,"St Johns","NL",47.56038,-52.71147,2018-08-26 08:00:00,27,3,30
"5699",10102,"St Johns","NL",47.56038,-52.71147,2018-08-26 09:00:00,29,3,32
"5700",10102,"St Johns","NL",47.56038,-52.71147,2018-08-26 10:00:00,29,2,31
"5701",10102,"St Johns","NL",47.56038,-52.71147,2018-08-26 11:00:00,30,3,33
"5702",10102,"St Johns","NL",47.56038,-52.71147,2018-08-26 12:00:00,30,2,32
"5703",10102,"St Johns","NL",47.56038,-52.71147,2018-08-26 13:00:00,33,1,34
"5704",10102,"St Johns","NL",47.56038,-52.71147,2018-08-26 14:00:00,32,1,33
"5705",10102,"St Johns","NL",47.56038,-52.71147,2018-08-26 15:00:00,32,2,34
"5706",10102,"St Johns","NL",47.56038,-52.71147,2018-08-26 16:00:00,32,2,34
"5707",10102,"St Johns","NL",47.56038,-52.71147,2018-08-26 17:00:00,33,2,35
"5708",10102,"St Johns","NL",47.56038,-52.71147,2018-08-26 18:00:00,33,2,35
"5709",10102,"St Johns","NL",47.56038,-52.71147,2018-08-26 19:00:00,30,3,33
"5710",10102,"St Johns","NL",47.56038,-52.71147,2018-08-26 20:00:00,25,4,29
"5711",10102,"St Johns","NL",47.56038,-52.71147,2018-08-26 21:00:00,26,4,30
"5712",10102,"St Johns","NL",47.56038,-52.71147,2018-08-26 22:00:00,27,2,29
"5713",10102,"St Johns","NL",47.56038,-52.71147,2018-08-26 23:00:00,26,1,27
"5714",10102,"St Johns","NL",47.56038,-52.71147,2018-08-27 00:00:00,22,1,23
"5715",10102,"St Johns","NL",47.56038,-52.71147,2018-08-27 01:00:00,21,1,22
"5716",10102,"St Johns","NL",47.56038,-52.71147,2018-08-27 02:00:00,21,1,22
"5717",10102,"St Johns","NL",47.56038,-52.71147,2018-08-27 03:00:00,22,1,23
"5718",10102,"St Johns","NL",47.56038,-52.71147,2018-08-27 04:00:00,21,2,23
"5719",10102,"St Johns","NL",47.56038,-52.71147,2018-08-27 05:00:00,22,1,23
"5720",10102,"St Johns","NL",47.56038,-52.71147,2018-08-27 06:00:00,22,2,24
"5721",10102,"St Johns","NL",47.56038,-52.71147,2018-08-27 07:00:00,20,3,23
"5722",10102,"St Johns","NL",47.56038,-52.71147,2018-08-27 08:00:00,19,6,25
"5723",10102,"St Johns","NL",47.56038,-52.71147,2018-08-27 09:00:00,20,8,28
"5724",10102,"St Johns","NL",47.56038,-52.71147,2018-08-27 10:00:00,20,8,28
"5725",10102,"St Johns","NL",47.56038,-52.71147,2018-08-27 11:00:00,24,7,31
"5726",10102,"St Johns","NL",47.56038,-52.71147,2018-08-27 12:00:00,19,9,28
"5727",10102,"St Johns","NL",47.56038,-52.71147,2018-08-27 13:00:00,32,4,36
"5728",10102,"St Johns","NL",47.56038,-52.71147,2018-08-27 14:00:00,28,6,34
"5729",10102,"St Johns","NL",47.56038,-52.71147,2018-08-27 15:00:00,28,6,34
"5730",10102,"St Johns","NL",47.56038,-52.71147,2018-08-27 16:00:00,28,3,31
"5731",10102,"St Johns","NL",47.56038,-52.71147,2018-08-27 17:00:00,28,2,30
"5732",10102,"St Johns","NL",47.56038,-52.71147,2018-08-27 18:00:00,28,3,31
"5733",10102,"St Johns","NL",47.56038,-52.71147,2018-08-27 19:00:00,24,5,29
"5734",10102,"St Johns","NL",47.56038,-52.71147,2018-08-27 20:00:00,22,4,26
"5735",10102,"St Johns","NL",47.56038,-52.71147,2018-08-27 21:00:00,18,6,24
"5736",10102,"St Johns","NL",47.56038,-52.71147,2018-08-27 22:00:00,15,5,20
"5737",10102,"St Johns","NL",47.56038,-52.71147,2018-08-27 23:00:00,12,4,16
"5738",10102,"St Johns","NL",47.56038,-52.71147,2018-08-28 00:00:00,15,5,20
"5739",10102,"St Johns","NL",47.56038,-52.71147,2018-08-28 01:00:00,24,4,28
"5740",10102,"St Johns","NL",47.56038,-52.71147,2018-08-28 02:00:00,33,0,33
"5741",10102,"St Johns","NL",47.56038,-52.71147,2018-08-28 03:00:00,31,0,31
"5742",10102,"St Johns","NL",47.56038,-52.71147,2018-08-28 04:00:00,26,2,28
"5743",10102,"St Johns","NL",47.56038,-52.71147,2018-08-28 05:00:00,27,1,28
"5744",10102,"St Johns","NL",47.56038,-52.71147,2018-08-28 06:00:00,25,2,27
"5745",10102,"St Johns","NL",47.56038,-52.71147,2018-08-28 07:00:00,21,3,24
"5746",10102,"St Johns","NL",47.56038,-52.71147,2018-08-28 08:00:00,22,3,25
"5747",10102,"St Johns","NL",47.56038,-52.71147,2018-08-28 09:00:00,25,3,28
"5748",10102,"St Johns","NL",47.56038,-52.71147,2018-08-28 10:00:00,28,3,31
"5749",10102,"St Johns","NL",47.56038,-52.71147,2018-08-28 11:00:00,28,2,30
"5750",10102,"St Johns","NL",47.56038,-52.71147,2018-08-28 12:00:00,29,2,31
"5751",10102,"St Johns","NL",47.56038,-52.71147,2018-08-28 13:00:00,29,2,31
"5752",10102,"St Johns","NL",47.56038,-52.71147,2018-08-28 14:00:00,30,1,31
"5753",10102,"St Johns","NL",47.56038,-52.71147,2018-08-28 15:00:00,30,1,31
"5754",10102,"St Johns","NL",47.56038,-52.71147,2018-08-28 16:00:00,30,1,31
"5755",10102,"St Johns","NL",47.56038,-52.71147,2018-08-28 17:00:00,30,1,31
"5756",10102,"St Johns","NL",47.56038,-52.71147,2018-08-28 18:00:00,30,2,32
"5757",10102,"St Johns","NL",47.56038,-52.71147,2018-08-28 19:00:00,29,1,30
"5758",10102,"St Johns","NL",47.56038,-52.71147,2018-08-28 20:00:00,25,2,27
"5759",10102,"St Johns","NL",47.56038,-52.71147,2018-08-28 21:00:00,23,2,25
"5760",10102,"St Johns","NL",47.56038,-52.71147,2018-08-28 22:00:00,22,1,23
"5761",10102,"St Johns","NL",47.56038,-52.71147,2018-08-28 23:00:00,25,1,26
"5762",10102,"St Johns","NL",47.56038,-52.71147,2018-08-29 00:00:00,25,1,26
"5763",10102,"St Johns","NL",47.56038,-52.71147,2018-08-29 01:00:00,24,1,25
"5764",10102,"St Johns","NL",47.56038,-52.71147,2018-08-29 02:00:00,27,0,27
"5765",10102,"St Johns","NL",47.56038,-52.71147,2018-08-29 03:00:00,28,0,28
"5766",10102,"St Johns","NL",47.56038,-52.71147,2018-08-29 04:00:00,29,0,29
"5767",10102,"St Johns","NL",47.56038,-52.71147,2018-08-29 05:00:00,30,1,31
"5768",10102,"St Johns","NL",47.56038,-52.71147,2018-08-29 06:00:00,27,0,27
"5769",10102,"St Johns","NL",47.56038,-52.71147,2018-08-29 07:00:00,26,1,27
"5770",10102,"St Johns","NL",47.56038,-52.71147,2018-08-29 08:00:00,27,1,28
"5771",10102,"St Johns","NL",47.56038,-52.71147,2018-08-29 09:00:00,25,1,26
"5772",10102,"St Johns","NL",47.56038,-52.71147,2018-08-29 10:00:00,28,1,29
"5773",10102,"St Johns","NL",47.56038,-52.71147,2018-08-29 11:00:00,28,0,28
"5774",10102,"St Johns","NL",47.56038,-52.71147,2018-08-29 12:00:00,33,0,33
"5775",10102,"St Johns","NL",47.56038,-52.71147,2018-08-29 13:00:00,36,1,37
"5776",10102,"St Johns","NL",47.56038,-52.71147,2018-08-29 14:00:00,34,1,35
"5777",10102,"St Johns","NL",47.56038,-52.71147,2018-08-29 15:00:00,33,2,35
"5778",10102,"St Johns","NL",47.56038,-52.71147,2018-08-29 16:00:00,32,2,34
"5779",10102,"St Johns","NL",47.56038,-52.71147,2018-08-29 17:00:00,32,1,33
"5780",10102,"St Johns","NL",47.56038,-52.71147,2018-08-29 18:00:00,29,0,29
"5781",10102,"St Johns","NL",47.56038,-52.71147,2018-08-29 19:00:00,20,1,21
"5782",10102,"St Johns","NL",47.56038,-52.71147,2018-08-29 20:00:00,16,1,17
"5783",10102,"St Johns","NL",47.56038,-52.71147,2018-08-29 21:00:00,16,1,17
"5784",10102,"St Johns","NL",47.56038,-52.71147,2018-08-29 22:00:00,18,1,19
"5785",10102,"St Johns","NL",47.56038,-52.71147,2018-08-29 23:00:00,18,1,19
"5786",10102,"St Johns","NL",47.56038,-52.71147,2018-08-30 00:00:00,18,2,20
"5787",10102,"St Johns","NL",47.56038,-52.71147,2018-08-30 01:00:00,21,2,23
"5788",10102,"St Johns","NL",47.56038,-52.71147,2018-08-30 02:00:00,23,2,25
"5789",10102,"St Johns","NL",47.56038,-52.71147,2018-08-30 03:00:00,21,2,23
"5790",10102,"St Johns","NL",47.56038,-52.71147,2018-08-30 04:00:00,18,5,23
"5791",10102,"St Johns","NL",47.56038,-52.71147,2018-08-30 05:00:00,14,9,23
"5792",10102,"St Johns","NL",47.56038,-52.71147,2018-08-30 06:00:00,17,5,22
"5793",10102,"St Johns","NL",47.56038,-52.71147,2018-08-30 07:00:00,15,8,23
"5794",10102,"St Johns","NL",47.56038,-52.71147,2018-08-30 08:00:00,19,4,23
"5795",10102,"St Johns","NL",47.56038,-52.71147,2018-08-30 09:00:00,20,3,23
"5796",10102,"St Johns","NL",47.56038,-52.71147,2018-08-30 10:00:00,19,2,21
"5797",10102,"St Johns","NL",47.56038,-52.71147,2018-08-30 11:00:00,19,3,22
"5798",10102,"St Johns","NL",47.56038,-52.71147,2018-08-30 12:00:00,20,2,22
"5799",10102,"St Johns","NL",47.56038,-52.71147,2018-08-30 13:00:00,20,3,23
"5800",10102,"St Johns","NL",47.56038,-52.71147,2018-08-30 14:00:00,21,3,24
"5801",10102,"St Johns","NL",47.56038,-52.71147,2018-08-30 15:00:00,22,3,25
"5802",10102,"St Johns","NL",47.56038,-52.71147,2018-08-30 16:00:00,22,3,25
"5803",10102,"St Johns","NL",47.56038,-52.71147,2018-08-30 17:00:00,23,1,24
"5804",10102,"St Johns","NL",47.56038,-52.71147,2018-08-30 18:00:00,22,2,24
"5805",10102,"St Johns","NL",47.56038,-52.71147,2018-08-30 19:00:00,22,2,24
"5806",10102,"St Johns","NL",47.56038,-52.71147,2018-08-30 20:00:00,22,1,23
"5807",10102,"St Johns","NL",47.56038,-52.71147,2018-08-30 21:00:00,25,1,26
"5808",10102,"St Johns","NL",47.56038,-52.71147,2018-08-30 22:00:00,23,1,24
"5809",10102,"St Johns","NL",47.56038,-52.71147,2018-08-30 23:00:00,22,1,23
"5810",10102,"St Johns","NL",47.56038,-52.71147,2018-08-31 00:00:00,22,0,22
"5811",10102,"St Johns","NL",47.56038,-52.71147,2018-08-31 01:00:00,21,0,21
"5812",10102,"St Johns","NL",47.56038,-52.71147,2018-08-31 02:00:00,19,1,20
"5813",10102,"St Johns","NL",47.56038,-52.71147,2018-08-31 03:00:00,19,1,20
"5814",10102,"St Johns","NL",47.56038,-52.71147,2018-08-31 04:00:00,24,1,25
"5815",10102,"St Johns","NL",47.56038,-52.71147,2018-08-31 05:00:00,22,2,24
"5816",10102,"St Johns","NL",47.56038,-52.71147,2018-08-31 06:00:00,21,2,23
"5817",10102,"St Johns","NL",47.56038,-52.71147,2018-08-31 07:00:00,12,1,13
"5818",10102,"St Johns","NL",47.56038,-52.71147,2018-08-31 08:00:00,12,2,14
"5819",10102,"St Johns","NL",47.56038,-52.71147,2018-08-31 09:00:00,13,2,15
"5820",10102,"St Johns","NL",47.56038,-52.71147,2018-08-31 10:00:00,13,2,15
"5821",10102,"St Johns","NL",47.56038,-52.71147,2018-08-31 11:00:00,15,3,18
"5822",10102,"St Johns","NL",47.56038,-52.71147,2018-08-31 12:00:00,19,1,20
"5823",10102,"St Johns","NL",47.56038,-52.71147,2018-08-31 13:00:00,20,2,22
"5824",10102,"St Johns","NL",47.56038,-52.71147,2018-08-31 14:00:00,19,1,20
"5825",10102,"St Johns","NL",47.56038,-52.71147,2018-08-31 15:00:00,19,1,20
"5826",10102,"St Johns","NL",47.56038,-52.71147,2018-08-31 16:00:00,20,1,21
"5827",10102,"St Johns","NL",47.56038,-52.71147,2018-08-31 17:00:00,22,0,22
"5828",10102,"St Johns","NL",47.56038,-52.71147,2018-08-31 18:00:00,21,2,23
"5829",10102,"St Johns","NL",47.56038,-52.71147,2018-08-31 19:00:00,21,2,23
"5830",10102,"St Johns","NL",47.56038,-52.71147,2018-08-31 20:00:00,21,3,24
"5831",10102,"St Johns","NL",47.56038,-52.71147,2018-08-31 21:00:00,22,2,24
"5832",10102,"St Johns","NL",47.56038,-52.71147,2018-08-31 22:00:00,20,3,23
"5833",10102,"St Johns","NL",47.56038,-52.71147,2018-08-31 23:00:00,16,6,22
"5834",10102,"St Johns","NL",47.56038,-52.71147,2018-09-01 00:00:00,15,7,22
"5835",10102,"St Johns","NL",47.56038,-52.71147,2018-09-01 01:00:00,13,10,23
"5836",10102,"St Johns","NL",47.56038,-52.71147,2018-09-01 02:00:00,11,12,23
"5837",10102,"St Johns","NL",47.56038,-52.71147,2018-09-01 03:00:00,17,3,20
"5838",10102,"St Johns","NL",47.56038,-52.71147,2018-09-01 04:00:00,16,2,18
"5839",10102,"St Johns","NL",47.56038,-52.71147,2018-09-01 05:00:00,8,5,13
"5840",10102,"St Johns","NL",47.56038,-52.71147,2018-09-01 06:00:00,4,4,8
"5841",10102,"St Johns","NL",47.56038,-52.71147,2018-09-01 07:00:00,4,3,7
"5842",10102,"St Johns","NL",47.56038,-52.71147,2018-09-01 08:00:00,7,9,16
"5843",10102,"St Johns","NL",47.56038,-52.71147,2018-09-01 09:00:00,17,3,20
"5844",10102,"St Johns","NL",47.56038,-52.71147,2018-09-01 10:00:00,17,2,19
"5845",10102,"St Johns","NL",47.56038,-52.71147,2018-09-01 11:00:00,18,1,19
"5846",10102,"St Johns","NL",47.56038,-52.71147,2018-09-01 12:00:00,17,3,20
"5847",10102,"St Johns","NL",47.56038,-52.71147,2018-09-01 13:00:00,17,2,19
"5848",10102,"St Johns","NL",47.56038,-52.71147,2018-09-01 14:00:00,18,2,20
"5849",10102,"St Johns","NL",47.56038,-52.71147,2018-09-01 15:00:00,21,1,22
"5850",10102,"St Johns","NL",47.56038,-52.71147,2018-09-01 16:00:00,21,1,22
"5851",10102,"St Johns","NL",47.56038,-52.71147,2018-09-01 17:00:00,22,1,23
"5852",10102,"St Johns","NL",47.56038,-52.71147,2018-09-01 18:00:00,22,1,23
"5853",10102,"St Johns","NL",47.56038,-52.71147,2018-09-01 19:00:00,22,1,23
"5854",10102,"St Johns","NL",47.56038,-52.71147,2018-09-01 20:00:00,20,2,22
"5855",10102,"St Johns","NL",47.56038,-52.71147,2018-09-01 21:00:00,13,6,19
"5856",10102,"St Johns","NL",47.56038,-52.71147,2018-09-01 22:00:00,11,3,14
"5857",10102,"St Johns","NL",47.56038,-52.71147,2018-09-01 23:00:00,8,3,11
"5858",10102,"St Johns","NL",47.56038,-52.71147,2018-09-02 00:00:00,8,3,11
"5859",10102,"St Johns","NL",47.56038,-52.71147,2018-09-02 01:00:00,9,3,12
"5860",10102,"St Johns","NL",47.56038,-52.71147,2018-09-02 02:00:00,9,3,12
"5861",10102,"St Johns","NL",47.56038,-52.71147,2018-09-02 03:00:00,7,3,10
"5862",10102,"St Johns","NL",47.56038,-52.71147,2018-09-02 04:00:00,5,4,9
"5863",10102,"St Johns","NL",47.56038,-52.71147,2018-09-02 05:00:00,4,4,8
"5864",10102,"St Johns","NL",47.56038,-52.71147,2018-09-02 06:00:00,6,3,9
"5865",10102,"St Johns","NL",47.56038,-52.71147,2018-09-02 07:00:00,7,3,10
"5866",10102,"St Johns","NL",47.56038,-52.71147,2018-09-02 08:00:00,10,4,14
"5867",10102,"St Johns","NL",47.56038,-52.71147,2018-09-02 09:00:00,17,5,22
"5868",10102,"St Johns","NL",47.56038,-52.71147,2018-09-02 10:00:00,18,7,25
"5869",10102,"St Johns","NL",47.56038,-52.71147,2018-09-02 11:00:00,23,7,30
"5870",10102,"St Johns","NL",47.56038,-52.71147,2018-09-02 12:00:00,23,8,31
"5871",10102,"St Johns","NL",47.56038,-52.71147,2018-09-02 13:00:00,20,12,32
"5872",10102,"St Johns","NL",47.56038,-52.71147,2018-09-02 14:00:00,25,4,29
"5873",10102,"St Johns","NL",47.56038,-52.71147,2018-09-02 15:00:00,25,4,29
"5874",10102,"St Johns","NL",47.56038,-52.71147,2018-09-02 16:00:00,25,5,30
"5875",10102,"St Johns","NL",47.56038,-52.71147,2018-09-02 17:00:00,26,4,30
"5876",10102,"St Johns","NL",47.56038,-52.71147,2018-09-02 18:00:00,25,2,27
"5877",10102,"St Johns","NL",47.56038,-52.71147,2018-09-02 19:00:00,21,2,23
"5878",10102,"St Johns","NL",47.56038,-52.71147,2018-09-02 20:00:00,16,3,19
"5879",10102,"St Johns","NL",47.56038,-52.71147,2018-09-02 21:00:00,16,2,18
"5880",10102,"St Johns","NL",47.56038,-52.71147,2018-09-02 22:00:00,17,2,19
"5881",10102,"St Johns","NL",47.56038,-52.71147,2018-09-02 23:00:00,22,1,23
"5882",10102,"St Johns","NL",47.56038,-52.71147,2018-09-03 00:00:00,22,1,23
"5883",10102,"St Johns","NL",47.56038,-52.71147,2018-09-03 01:00:00,21,2,23
"5884",10102,"St Johns","NL",47.56038,-52.71147,2018-09-03 02:00:00,19,1,20
"5885",10102,"St Johns","NL",47.56038,-52.71147,2018-09-03 03:00:00,21,0,21
"5886",10102,"St Johns","NL",47.56038,-52.71147,2018-09-03 04:00:00,22,0,22
"5887",10102,"St Johns","NL",47.56038,-52.71147,2018-09-03 05:00:00,21,0,21
"5888",10102,"St Johns","NL",47.56038,-52.71147,2018-09-03 06:00:00,20,1,21
"5889",10102,"St Johns","NL",47.56038,-52.71147,2018-09-03 07:00:00,20,1,21
"5890",10102,"St Johns","NL",47.56038,-52.71147,2018-09-03 08:00:00,20,1,21
"5891",10102,"St Johns","NL",47.56038,-52.71147,2018-09-03 09:00:00,23,0,23
"5892",10102,"St Johns","NL",47.56038,-52.71147,2018-09-03 10:00:00,23,2,25
"5893",10102,"St Johns","NL",47.56038,-52.71147,2018-09-03 11:00:00,25,2,27
"5894",10102,"St Johns","NL",47.56038,-52.71147,2018-09-03 12:00:00,22,2,24
"5895",10102,"St Johns","NL",47.56038,-52.71147,2018-09-03 13:00:00,23,3,26
"5896",10102,"St Johns","NL",47.56038,-52.71147,2018-09-03 14:00:00,23,3,26
"5897",10102,"St Johns","NL",47.56038,-52.71147,2018-09-03 15:00:00,28,2,30
"5898",10102,"St Johns","NL",47.56038,-52.71147,2018-09-03 16:00:00,31,0,31
"5899",10102,"St Johns","NL",47.56038,-52.71147,2018-09-03 17:00:00,32,1,33
"5900",10102,"St Johns","NL",47.56038,-52.71147,2018-09-03 18:00:00,29,1,30
"5901",10102,"St Johns","NL",47.56038,-52.71147,2018-09-03 19:00:00,24,2,26
"5902",10102,"St Johns","NL",47.56038,-52.71147,2018-09-03 20:00:00,21,4,25
"5903",10102,"St Johns","NL",47.56038,-52.71147,2018-09-03 21:00:00,21,2,23
"5904",10102,"St Johns","NL",47.56038,-52.71147,2018-09-03 22:00:00,21,1,22
"5905",10102,"St Johns","NL",47.56038,-52.71147,2018-09-03 23:00:00,20,2,22
"5906",10102,"St Johns","NL",47.56038,-52.71147,2018-09-04 00:00:00,23,0,23
"5907",10102,"St Johns","NL",47.56038,-52.71147,2018-09-04 01:00:00,25,0,25
"5908",10102,"St Johns","NL",47.56038,-52.71147,2018-09-04 02:00:00,27,0,27
"5909",10102,"St Johns","NL",47.56038,-52.71147,2018-09-04 03:00:00,25,1,26
"5910",10102,"St Johns","NL",47.56038,-52.71147,2018-09-04 04:00:00,25,0,25
"5911",10102,"St Johns","NL",47.56038,-52.71147,2018-09-04 05:00:00,23,1,24
"5912",10102,"St Johns","NL",47.56038,-52.71147,2018-09-04 06:00:00,23,0,23
"5913",10102,"St Johns","NL",47.56038,-52.71147,2018-09-04 07:00:00,21,3,24
"5914",10102,"St Johns","NL",47.56038,-52.71147,2018-09-04 08:00:00,25,3,28
"5915",10102,"St Johns","NL",47.56038,-52.71147,2018-09-04 09:00:00,27,2,29
"5916",10102,"St Johns","NL",47.56038,-52.71147,2018-09-04 10:00:00,28,1,29
"5917",10102,"St Johns","NL",47.56038,-52.71147,2018-09-04 11:00:00,29,2,31
"5918",10102,"St Johns","NL",47.56038,-52.71147,2018-09-04 12:00:00,31,1,32
"5919",10102,"St Johns","NL",47.56038,-52.71147,2018-09-04 13:00:00,30,2,32
"5920",10102,"St Johns","NL",47.56038,-52.71147,2018-09-04 14:00:00,31,1,32
"5921",10102,"St Johns","NL",47.56038,-52.71147,2018-09-04 15:00:00,30,0,30
"5922",10102,"St Johns","NL",47.56038,-52.71147,2018-09-04 16:00:00,30,1,31
"5923",10102,"St Johns","NL",47.56038,-52.71147,2018-09-04 17:00:00,25,2,27
"5924",10102,"St Johns","NL",47.56038,-52.71147,2018-09-04 18:00:00,24,0,24
"5925",10102,"St Johns","NL",47.56038,-52.71147,2018-09-04 19:00:00,24,1,25
"5926",10102,"St Johns","NL",47.56038,-52.71147,2018-09-04 20:00:00,23,1,24
"5927",10102,"St Johns","NL",47.56038,-52.71147,2018-09-04 21:00:00,23,1,24
"5928",10102,"St Johns","NL",47.56038,-52.71147,2018-09-04 22:00:00,22,0,22
"5929",10102,"St Johns","NL",47.56038,-52.71147,2018-09-04 23:00:00,21,0,21
"5930",10102,"St Johns","NL",47.56038,-52.71147,2018-09-05 00:00:00,22,0,22
"5931",10102,"St Johns","NL",47.56038,-52.71147,2018-09-05 01:00:00,21,0,21
"5932",10102,"St Johns","NL",47.56038,-52.71147,2018-09-05 02:00:00,20,2,22
"5933",10102,"St Johns","NL",47.56038,-52.71147,2018-09-05 03:00:00,19,1,20
"5934",10102,"St Johns","NL",47.56038,-52.71147,2018-09-05 04:00:00,18,0,18
"5935",10102,"St Johns","NL",47.56038,-52.71147,2018-09-05 05:00:00,17,0,17
"5936",10102,"St Johns","NL",47.56038,-52.71147,2018-09-05 06:00:00,15,3,18
"5937",10102,"St Johns","NL",47.56038,-52.71147,2018-09-05 07:00:00,13,4,17
"5938",10102,"St Johns","NL",47.56038,-52.71147,2018-09-05 08:00:00,12,5,17
"5939",10102,"St Johns","NL",47.56038,-52.71147,2018-09-05 09:00:00,17,0,17
"5940",10102,"St Johns","NL",47.56038,-52.71147,2018-09-05 10:00:00,18,0,18
"5941",10102,"St Johns","NL",47.56038,-52.71147,2018-09-05 11:00:00,19,1,20
"5942",10102,"St Johns","NL",47.56038,-52.71147,2018-09-05 12:00:00,20,2,22
"5943",10102,"St Johns","NL",47.56038,-52.71147,2018-09-05 13:00:00,20,3,23
"5944",10102,"St Johns","NL",47.56038,-52.71147,2018-09-05 14:00:00,16,7,23
"5945",10102,"St Johns","NL",47.56038,-52.71147,2018-09-05 15:00:00,12,6,18
"5946",10102,"St Johns","NL",47.56038,-52.71147,2018-09-05 16:00:00,14,5,19
"5947",10102,"St Johns","NL",47.56038,-52.71147,2018-09-05 17:00:00,15,3,18
"5948",10102,"St Johns","NL",47.56038,-52.71147,2018-09-05 18:00:00,15,3,18
"5949",10102,"St Johns","NL",47.56038,-52.71147,2018-09-05 19:00:00,12,8,20
"5950",10102,"St Johns","NL",47.56038,-52.71147,2018-09-05 20:00:00,14,6,20
"5951",10102,"St Johns","NL",47.56038,-52.71147,2018-09-05 21:00:00,13,8,21
"5952",10102,"St Johns","NL",47.56038,-52.71147,2018-09-05 22:00:00,13,6,19
"5953",10102,"St Johns","NL",47.56038,-52.71147,2018-09-05 23:00:00,5,14,19
"5954",10102,"St Johns","NL",47.56038,-52.71147,2018-09-06 00:00:00,4,7,11
"5955",10102,"St Johns","NL",47.56038,-52.71147,2018-09-06 01:00:00,5,6,11
"5956",10102,"St Johns","NL",47.56038,-52.71147,2018-09-06 02:00:00,5,4,9
"5957",10102,"St Johns","NL",47.56038,-52.71147,2018-09-06 03:00:00,5,4,9
"5958",10102,"St Johns","NL",47.56038,-52.71147,2018-09-06 04:00:00,6,4,10
"5959",10102,"St Johns","NL",47.56038,-52.71147,2018-09-06 05:00:00,7,3,10
"5960",10102,"St Johns","NL",47.56038,-52.71147,2018-09-06 06:00:00,5,6,11
"5961",10102,"St Johns","NL",47.56038,-52.71147,2018-09-06 07:00:00,6,5,11
"5962",10102,"St Johns","NL",47.56038,-52.71147,2018-09-06 08:00:00,9,5,14
"5963",10102,"St Johns","NL",47.56038,-52.71147,2018-09-06 09:00:00,15,4,19
"5964",10102,"St Johns","NL",47.56038,-52.71147,2018-09-06 10:00:00,18,3,21
"5965",10102,"St Johns","NL",47.56038,-52.71147,2018-09-06 11:00:00,19,3,22
"5966",10102,"St Johns","NL",47.56038,-52.71147,2018-09-06 12:00:00,20,1,21
"5967",10102,"St Johns","NL",47.56038,-52.71147,2018-09-06 13:00:00,22,1,23
"5968",10102,"St Johns","NL",47.56038,-52.71147,2018-09-06 14:00:00,22,1,23
"5969",10102,"St Johns","NL",47.56038,-52.71147,2018-09-06 15:00:00,23,1,24
"5970",10102,"St Johns","NL",47.56038,-52.71147,2018-09-06 16:00:00,26,1,27
"5971",10102,"St Johns","NL",47.56038,-52.71147,2018-09-06 17:00:00,25,1,26
"5972",10102,"St Johns","NL",47.56038,-52.71147,2018-09-06 18:00:00,24,1,25
"5973",10102,"St Johns","NL",47.56038,-52.71147,2018-09-06 19:00:00,24,1,25
"5974",10102,"St Johns","NL",47.56038,-52.71147,2018-09-06 20:00:00,23,1,24
"5975",10102,"St Johns","NL",47.56038,-52.71147,2018-09-06 21:00:00,24,1,25
"5976",10102,"St Johns","NL",47.56038,-52.71147,2018-09-06 22:00:00,24,1,25
"5977",10102,"St Johns","NL",47.56038,-52.71147,2018-09-06 23:00:00,24,1,25
"5978",10102,"St Johns","NL",47.56038,-52.71147,2018-09-07 00:00:00,24,1,25
"5979",10102,"St Johns","NL",47.56038,-52.71147,2018-09-07 01:00:00,22,1,23
"5980",10102,"St Johns","NL",47.56038,-52.71147,2018-09-07 02:00:00,17,0,17
"5981",10102,"St Johns","NL",47.56038,-52.71147,2018-09-07 03:00:00,16,1,17
"5982",10102,"St Johns","NL",47.56038,-52.71147,2018-09-07 04:00:00,13,1,14
"5983",10102,"St Johns","NL",47.56038,-52.71147,2018-09-07 05:00:00,11,2,13
"5984",10102,"St Johns","NL",47.56038,-52.71147,2018-09-07 06:00:00,5,9,14
"5985",10102,"St Johns","NL",47.56038,-52.71147,2018-09-07 07:00:00,8,4,12
"5986",10102,"St Johns","NL",47.56038,-52.71147,2018-09-07 08:00:00,10,3,13
"5987",10102,"St Johns","NL",47.56038,-52.71147,2018-09-07 09:00:00,13,1,14
"5988",10102,"St Johns","NL",47.56038,-52.71147,2018-09-07 10:00:00,18,2,20
"5989",10102,"St Johns","NL",47.56038,-52.71147,2018-09-07 11:00:00,23,2,25
"5990",10102,"St Johns","NL",47.56038,-52.71147,2018-09-07 12:00:00,23,4,27
"5991",10102,"St Johns","NL",47.56038,-52.71147,2018-09-07 13:00:00,24,2,26
"5992",10102,"St Johns","NL",47.56038,-52.71147,2018-09-07 14:00:00,22,3,25
"5993",10102,"St Johns","NL",47.56038,-52.71147,2018-09-07 15:00:00,23,3,26
"5994",10102,"St Johns","NL",47.56038,-52.71147,2018-09-07 16:00:00,24,2,26
"5995",10102,"St Johns","NL",47.56038,-52.71147,2018-09-07 17:00:00,19,4,23
"5996",10102,"St Johns","NL",47.56038,-52.71147,2018-09-07 18:00:00,18,4,22
"5997",10102,"St Johns","NL",47.56038,-52.71147,2018-09-07 19:00:00,16,2,18
"5998",10102,"St Johns","NL",47.56038,-52.71147,2018-09-07 20:00:00,16,1,17
"5999",10102,"St Johns","NL",47.56038,-52.71147,2018-09-07 21:00:00,15,2,17
"6000",10102,"St Johns","NL",47.56038,-52.71147,2018-09-07 22:00:00,13,2,15
"6001",10102,"St Johns","NL",47.56038,-52.71147,2018-09-07 23:00:00,11,4,15
"6002",10102,"St Johns","NL",47.56038,-52.71147,2018-09-08 00:00:00,13,3,16
"6003",10102,"St Johns","NL",47.56038,-52.71147,2018-09-08 01:00:00,15,3,18
"6004",10102,"St Johns","NL",47.56038,-52.71147,2018-09-08 02:00:00,16,2,18
"6005",10102,"St Johns","NL",47.56038,-52.71147,2018-09-08 03:00:00,15,2,17
"6006",10102,"St Johns","NL",47.56038,-52.71147,2018-09-08 04:00:00,13,1,14
"6007",10102,"St Johns","NL",47.56038,-52.71147,2018-09-08 05:00:00,12,2,14
"6008",10102,"St Johns","NL",47.56038,-52.71147,2018-09-08 06:00:00,12,2,14
"6009",10102,"St Johns","NL",47.56038,-52.71147,2018-09-08 07:00:00,13,3,16
"6010",10102,"St Johns","NL",47.56038,-52.71147,2018-09-08 08:00:00,15,2,17
"6011",10102,"St Johns","NL",47.56038,-52.71147,2018-09-08 09:00:00,21,2,23
"6012",10102,"St Johns","NL",47.56038,-52.71147,2018-09-08 10:00:00,22,2,24
"6013",10102,"St Johns","NL",47.56038,-52.71147,2018-09-08 11:00:00,23,2,25
"6014",10102,"St Johns","NL",47.56038,-52.71147,2018-09-08 12:00:00,24,1,25
"6015",10102,"St Johns","NL",47.56038,-52.71147,2018-09-08 13:00:00,27,1,28
"6016",10102,"St Johns","NL",47.56038,-52.71147,2018-09-08 14:00:00,28,2,30
"6017",10102,"St Johns","NL",47.56038,-52.71147,2018-09-08 15:00:00,28,2,30
"6018",10102,"St Johns","NL",47.56038,-52.71147,2018-09-08 16:00:00,27,1,28
"6019",10102,"St Johns","NL",47.56038,-52.71147,2018-09-08 17:00:00,26,1,27
"6020",10102,"St Johns","NL",47.56038,-52.71147,2018-09-08 18:00:00,26,2,28
"6021",10102,"St Johns","NL",47.56038,-52.71147,2018-09-08 19:00:00,26,3,29
"6022",10102,"St Johns","NL",47.56038,-52.71147,2018-09-08 20:00:00,24,3,27
"6023",10102,"St Johns","NL",47.56038,-52.71147,2018-09-08 21:00:00,20,7,27
"6024",10102,"St Johns","NL",47.56038,-52.71147,2018-09-08 22:00:00,18,8,26
"6025",10102,"St Johns","NL",47.56038,-52.71147,2018-09-08 23:00:00,17,6,23
"6026",10102,"St Johns","NL",47.56038,-52.71147,2018-09-09 00:00:00,8,8,16
"6027",10102,"St Johns","NL",47.56038,-52.71147,2018-09-09 01:00:00,5,6,11
"6028",10102,"St Johns","NL",47.56038,-52.71147,2018-09-09 02:00:00,4,6,10
"6029",10102,"St Johns","NL",47.56038,-52.71147,2018-09-09 03:00:00,3,4,7
"6030",10102,"St Johns","NL",47.56038,-52.71147,2018-09-09 04:00:00,5,4,9
"6031",10102,"St Johns","NL",47.56038,-52.71147,2018-09-09 05:00:00,5,4,9
"6032",10102,"St Johns","NL",47.56038,-52.71147,2018-09-09 06:00:00,5,4,9
"6033",10102,"St Johns","NL",47.56038,-52.71147,2018-09-09 07:00:00,8,3,11
"6034",10102,"St Johns","NL",47.56038,-52.71147,2018-09-09 08:00:00,11,5,16
"6035",10102,"St Johns","NL",47.56038,-52.71147,2018-09-09 09:00:00,16,1,17
"6036",10102,"St Johns","NL",47.56038,-52.71147,2018-09-09 10:00:00,18,1,19
"6037",10102,"St Johns","NL",47.56038,-52.71147,2018-09-09 11:00:00,22,0,22
"6038",10102,"St Johns","NL",47.56038,-52.71147,2018-09-09 12:00:00,21,1,22
"6039",10102,"St Johns","NL",47.56038,-52.71147,2018-09-09 13:00:00,22,0,22
"6040",10102,"St Johns","NL",47.56038,-52.71147,2018-09-09 14:00:00,22,1,23
"6041",10102,"St Johns","NL",47.56038,-52.71147,2018-09-09 15:00:00,20,2,22
"6042",10102,"St Johns","NL",47.56038,-52.71147,2018-09-09 16:00:00,15,5,20
"6043",10102,"St Johns","NL",47.56038,-52.71147,2018-09-09 17:00:00,18,2,20
"6044",10102,"St Johns","NL",47.56038,-52.71147,2018-09-09 18:00:00,18,2,20
"6045",10102,"St Johns","NL",47.56038,-52.71147,2018-09-09 19:00:00,16,6,22
"6046",10102,"St Johns","NL",47.56038,-52.71147,2018-09-09 20:00:00,16,4,20
"6047",10102,"St Johns","NL",47.56038,-52.71147,2018-09-09 21:00:00,16,3,19
"6048",10102,"St Johns","NL",47.56038,-52.71147,2018-09-09 22:00:00,16,3,19
"6049",10102,"St Johns","NL",47.56038,-52.71147,2018-09-09 23:00:00,16,2,18
"6050",10102,"St Johns","NL",47.56038,-52.71147,2018-09-10 00:00:00,13,5,18
"6051",10102,"St Johns","NL",47.56038,-52.71147,2018-09-10 01:00:00,13,7,20
"6052",10102,"St Johns","NL",47.56038,-52.71147,2018-09-10 02:00:00,13,7,20
"6053",10102,"St Johns","NL",47.56038,-52.71147,2018-09-10 03:00:00,11,4,15
"6054",10102,"St Johns","NL",47.56038,-52.71147,2018-09-10 04:00:00,4,5,9
"6055",10102,"St Johns","NL",47.56038,-52.71147,2018-09-10 05:00:00,3,5,8
"6056",10102,"St Johns","NL",47.56038,-52.71147,2018-09-10 06:00:00,1,6,7
"6057",10102,"St Johns","NL",47.56038,-52.71147,2018-09-10 07:00:00,2,6,8
"6058",10102,"St Johns","NL",47.56038,-52.71147,2018-09-10 08:00:00,5,12,17
"6059",10102,"St Johns","NL",47.56038,-52.71147,2018-09-10 09:00:00,16,3,19
"6060",10102,"St Johns","NL",47.56038,-52.71147,2018-09-10 10:00:00,18,1,19
"6061",10102,"St Johns","NL",47.56038,-52.71147,2018-09-10 11:00:00,19,3,22
"6062",10102,"St Johns","NL",47.56038,-52.71147,2018-09-10 12:00:00,16,2,18
"6063",10102,"St Johns","NL",47.56038,-52.71147,2018-09-10 13:00:00,13,9,22
"6064",10102,"St Johns","NL",47.56038,-52.71147,2018-09-10 14:00:00,16,3,19
"6065",10102,"St Johns","NL",47.56038,-52.71147,2018-09-10 15:00:00,17,3,20
"6066",10102,"St Johns","NL",47.56038,-52.71147,2018-09-10 16:00:00,17,2,19
"6067",10102,"St Johns","NL",47.56038,-52.71147,2018-09-10 17:00:00,18,2,20
"6068",10102,"St Johns","NL",47.56038,-52.71147,2018-09-10 18:00:00,18,2,20
"6069",10102,"St Johns","NL",47.56038,-52.71147,2018-09-10 19:00:00,17,1,18
"6070",10102,"St Johns","NL",47.56038,-52.71147,2018-09-10 20:00:00,17,2,19
"6071",10102,"St Johns","NL",47.56038,-52.71147,2018-09-10 21:00:00,17,2,19
"6072",10102,"St Johns","NL",47.56038,-52.71147,2018-09-10 22:00:00,14,2,16
"6073",10102,"St Johns","NL",47.56038,-52.71147,2018-09-10 23:00:00,13,2,15
"6074",10102,"St Johns","NL",47.56038,-52.71147,2018-09-11 00:00:00,14,2,16
"6075",10102,"St Johns","NL",47.56038,-52.71147,2018-09-11 01:00:00,15,1,16
"6076",10102,"St Johns","NL",47.56038,-52.71147,2018-09-11 02:00:00,15,1,16
"6077",10102,"St Johns","NL",47.56038,-52.71147,2018-09-11 03:00:00,15,1,16
"6078",10102,"St Johns","NL",47.56038,-52.71147,2018-09-11 04:00:00,15,2,17
"6079",10102,"St Johns","NL",47.56038,-52.71147,2018-09-11 05:00:00,14,2,16
"6080",10102,"St Johns","NL",47.56038,-52.71147,2018-09-11 06:00:00,15,3,18
"6081",10102,"St Johns","NL",47.56038,-52.71147,2018-09-11 07:00:00,12,8,20
"6082",10102,"St Johns","NL",47.56038,-52.71147,2018-09-11 08:00:00,15,8,23
"6083",10102,"St Johns","NL",47.56038,-52.71147,2018-09-11 09:00:00,19,3,22
"6084",10102,"St Johns","NL",47.56038,-52.71147,2018-09-11 10:00:00,21,2,23
"6085",10102,"St Johns","NL",47.56038,-52.71147,2018-09-11 11:00:00,22,2,24
"6086",10102,"St Johns","NL",47.56038,-52.71147,2018-09-11 12:00:00,24,3,27
"6087",10102,"St Johns","NL",47.56038,-52.71147,2018-09-11 13:00:00,25,2,27
"6088",10102,"St Johns","NL",47.56038,-52.71147,2018-09-11 14:00:00,25,3,28
"6089",10102,"St Johns","NL",47.56038,-52.71147,2018-09-11 15:00:00,25,2,27
"6090",10102,"St Johns","NL",47.56038,-52.71147,2018-09-11 16:00:00,25,3,28
"6091",10102,"St Johns","NL",47.56038,-52.71147,2018-09-11 17:00:00,22,4,26
"6092",10102,"St Johns","NL",47.56038,-52.71147,2018-09-11 18:00:00,24,3,27
"6093",10102,"St Johns","NL",47.56038,-52.71147,2018-09-11 19:00:00,24,2,26
"6094",10102,"St Johns","NL",47.56038,-52.71147,2018-09-11 20:00:00,24,2,26
"6095",10102,"St Johns","NL",47.56038,-52.71147,2018-09-11 21:00:00,23,2,25
"6096",10102,"St Johns","NL",47.56038,-52.71147,2018-09-11 22:00:00,22,3,25
"6097",10102,"St Johns","NL",47.56038,-52.71147,2018-09-11 23:00:00,20,4,24
"6098",10102,"St Johns","NL",47.56038,-52.71147,2018-09-12 00:00:00,22,2,24
"6099",10102,"St Johns","NL",47.56038,-52.71147,2018-09-12 01:00:00,22,2,24
"6100",10102,"St Johns","NL",47.56038,-52.71147,2018-09-12 02:00:00,20,2,22
"6101",10102,"St Johns","NL",47.56038,-52.71147,2018-09-12 03:00:00,23,1,24
"6102",10102,"St Johns","NL",47.56038,-52.71147,2018-09-12 04:00:00,22,2,24
"6103",10102,"St Johns","NL",47.56038,-52.71147,2018-09-12 05:00:00,20,2,22
"6104",10102,"St Johns","NL",47.56038,-52.71147,2018-09-12 06:00:00,20,1,21
"6105",10102,"St Johns","NL",47.56038,-52.71147,2018-09-12 07:00:00,19,4,23
"6106",10102,"St Johns","NL",47.56038,-52.71147,2018-09-12 08:00:00,23,3,26
"6107",10102,"St Johns","NL",47.56038,-52.71147,2018-09-12 09:00:00,25,4,29
"6108",10102,"St Johns","NL",47.56038,-52.71147,2018-09-12 10:00:00,23,4,27
"6109",10102,"St Johns","NL",47.56038,-52.71147,2018-09-12 11:00:00,20,7,27
"6110",10102,"St Johns","NL",47.56038,-52.71147,2018-09-12 12:00:00,23,5,28
"6111",10102,"St Johns","NL",47.56038,-52.71147,2018-09-12 13:00:00,23,4,27
"6112",10102,"St Johns","NL",47.56038,-52.71147,2018-09-12 14:00:00,23,5,28
"6113",10102,"St Johns","NL",47.56038,-52.71147,2018-09-12 15:00:00,22,5,27
"6114",10102,"St Johns","NL",47.56038,-52.71147,2018-09-12 16:00:00,10,19,29
"6115",10102,"St Johns","NL",47.56038,-52.71147,2018-09-12 17:00:00,22,8,30
"6116",10102,"St Johns","NL",47.56038,-52.71147,2018-09-12 18:00:00,25,7,32
"6117",10102,"St Johns","NL",47.56038,-52.71147,2018-09-12 19:00:00,8,23,31
"6118",10102,"St Johns","NL",47.56038,-52.71147,2018-09-12 20:00:00,17,13,30
"6119",10102,"St Johns","NL",47.56038,-52.71147,2018-09-12 21:00:00,18,9,27
"6120",10102,"St Johns","NL",47.56038,-52.71147,2018-09-12 22:00:00,24,4,28
"6121",10102,"St Johns","NL",47.56038,-52.71147,2018-09-12 23:00:00,22,2,24
"6122",10102,"St Johns","NL",47.56038,-52.71147,2018-09-13 00:00:00,22,2,24
"6123",10102,"St Johns","NL",47.56038,-52.71147,2018-09-13 01:00:00,25,2,27
"6124",10102,"St Johns","NL",47.56038,-52.71147,2018-09-13 02:00:00,25,2,27
"6125",10102,"St Johns","NL",47.56038,-52.71147,2018-09-13 03:00:00,27,1,28
"6126",10102,"St Johns","NL",47.56038,-52.71147,2018-09-13 04:00:00,25,2,27
"6127",10102,"St Johns","NL",47.56038,-52.71147,2018-09-13 05:00:00,24,4,28
"6128",10102,"St Johns","NL",47.56038,-52.71147,2018-09-13 06:00:00,26,1,27
"6129",10102,"St Johns","NL",47.56038,-52.71147,2018-09-13 07:00:00,24,4,28
"6130",10102,"St Johns","NL",47.56038,-52.71147,2018-09-13 08:00:00,24,6,30
"6131",10102,"St Johns","NL",47.56038,-52.71147,2018-09-13 09:00:00,25,4,29
"6132",10102,"St Johns","NL",47.56038,-52.71147,2018-09-13 10:00:00,24,3,27
"6133",10102,"St Johns","NL",47.56038,-52.71147,2018-09-13 11:00:00,23,4,27
"6134",10102,"St Johns","NL",47.56038,-52.71147,2018-09-13 12:00:00,17,8,25
"6135",10102,"St Johns","NL",47.56038,-52.71147,2018-09-13 13:00:00,15,13,28
"6136",10102,"St Johns","NL",47.56038,-52.71147,2018-09-13 14:00:00,15,13,28
"6137",10102,"St Johns","NL",47.56038,-52.71147,2018-09-13 15:00:00,14,15,29
"6138",10102,"St Johns","NL",47.56038,-52.71147,2018-09-13 16:00:00,13,15,28
"6139",10102,"St Johns","NL",47.56038,-52.71147,2018-09-13 17:00:00,25,4,29
"6140",10102,"St Johns","NL",47.56038,-52.71147,2018-09-13 18:00:00,22,8,30
"6141",10102,"St Johns","NL",47.56038,-52.71147,2018-09-13 19:00:00,22,9,31
"6142",10102,"St Johns","NL",47.56038,-52.71147,2018-09-13 20:00:00,20,12,32
"6143",10102,"St Johns","NL",47.56038,-52.71147,2018-09-13 21:00:00,20,10,30
"6144",10102,"St Johns","NL",47.56038,-52.71147,2018-09-13 22:00:00,20,10,30
"6145",10102,"St Johns","NL",47.56038,-52.71147,2018-09-13 23:00:00,20,12,32
"6146",10102,"St Johns","NL",47.56038,-52.71147,2018-09-14 00:00:00,19,10,29
"6147",10102,"St Johns","NL",47.56038,-52.71147,2018-09-14 01:00:00,19,3,22
"6148",10102,"St Johns","NL",47.56038,-52.71147,2018-09-14 02:00:00,18,3,21
"6149",10102,"St Johns","NL",47.56038,-52.71147,2018-09-14 03:00:00,14,5,19
"6150",10102,"St Johns","NL",47.56038,-52.71147,2018-09-14 04:00:00,22,2,24
"6151",10102,"St Johns","NL",47.56038,-52.71147,2018-09-14 05:00:00,20,1,21
"6152",10102,"St Johns","NL",47.56038,-52.71147,2018-09-14 06:00:00,17,1,18
"6153",10102,"St Johns","NL",47.56038,-52.71147,2018-09-14 07:00:00,13,4,17
"6154",10102,"St Johns","NL",47.56038,-52.71147,2018-09-14 08:00:00,14,3,17
"6155",10102,"St Johns","NL",47.56038,-52.71147,2018-09-14 09:00:00,15,3,18
"6156",10102,"St Johns","NL",47.56038,-52.71147,2018-09-14 10:00:00,15,4,19
"6157",10102,"St Johns","NL",47.56038,-52.71147,2018-09-14 11:00:00,15,4,19
"6158",10102,"St Johns","NL",47.56038,-52.71147,2018-09-14 12:00:00,15,4,19
"6159",10102,"St Johns","NL",47.56038,-52.71147,2018-09-14 13:00:00,12,9,21
"6160",10102,"St Johns","NL",47.56038,-52.71147,2018-09-14 14:00:00,16,5,21
"6161",10102,"St Johns","NL",47.56038,-52.71147,2018-09-14 15:00:00,16,4,20
"6162",10102,"St Johns","NL",47.56038,-52.71147,2018-09-14 16:00:00,18,2,20
"6163",10102,"St Johns","NL",47.56038,-52.71147,2018-09-14 17:00:00,14,7,21
"6164",10102,"St Johns","NL",47.56038,-52.71147,2018-09-14 18:00:00,17,4,21
"6165",10102,"St Johns","NL",47.56038,-52.71147,2018-09-14 19:00:00,16,5,21
"6166",10102,"St Johns","NL",47.56038,-52.71147,2018-09-14 20:00:00,13,7,20
"6167",10102,"St Johns","NL",47.56038,-52.71147,2018-09-14 21:00:00,13,6,19
"6168",10102,"St Johns","NL",47.56038,-52.71147,2018-09-14 22:00:00,12,4,16
"6169",10102,"St Johns","NL",47.56038,-52.71147,2018-09-14 23:00:00,11,1,12
"6170",10102,"St Johns","NL",47.56038,-52.71147,2018-09-15 00:00:00,10,1,11
"6171",10102,"St Johns","NL",47.56038,-52.71147,2018-09-15 01:00:00,9,1,10
"6172",10102,"St Johns","NL",47.56038,-52.71147,2018-09-15 02:00:00,12,1,13
"6173",10102,"St Johns","NL",47.56038,-52.71147,2018-09-15 03:00:00,16,1,17
"6174",10102,"St Johns","NL",47.56038,-52.71147,2018-09-15 04:00:00,15,0,15
"6175",10102,"St Johns","NL",47.56038,-52.71147,2018-09-15 05:00:00,16,0,16
"6176",10102,"St Johns","NL",47.56038,-52.71147,2018-09-15 06:00:00,16,1,17
"6177",10102,"St Johns","NL",47.56038,-52.71147,2018-09-15 07:00:00,16,1,17
"6178",10102,"St Johns","NL",47.56038,-52.71147,2018-09-15 08:00:00,16,1,17
"6179",10102,"St Johns","NL",47.56038,-52.71147,2018-09-15 09:00:00,17,1,18
"6180",10102,"St Johns","NL",47.56038,-52.71147,2018-09-15 10:00:00,17,1,18
"6181",10102,"St Johns","NL",47.56038,-52.71147,2018-09-15 11:00:00,18,1,19
"6182",10102,"St Johns","NL",47.56038,-52.71147,2018-09-15 12:00:00,20,0,20
"6183",10102,"St Johns","NL",47.56038,-52.71147,2018-09-15 13:00:00,21,0,21
"6184",10102,"St Johns","NL",47.56038,-52.71147,2018-09-15 14:00:00,22,0,22
"6185",10102,"St Johns","NL",47.56038,-52.71147,2018-09-15 15:00:00,22,0,22
"6186",10102,"St Johns","NL",47.56038,-52.71147,2018-09-15 16:00:00,23,0,23
"6187",10102,"St Johns","NL",47.56038,-52.71147,2018-09-15 17:00:00,24,0,24
"6188",10102,"St Johns","NL",47.56038,-52.71147,2018-09-15 18:00:00,23,1,24
"6189",10102,"St Johns","NL",47.56038,-52.71147,2018-09-15 19:00:00,22,1,23
"6190",10102,"St Johns","NL",47.56038,-52.71147,2018-09-15 20:00:00,23,0,23
"6191",10102,"St Johns","NL",47.56038,-52.71147,2018-09-15 21:00:00,23,0,23
"6192",10102,"St Johns","NL",47.56038,-52.71147,2018-09-15 22:00:00,23,1,24
"6193",10102,"St Johns","NL",47.56038,-52.71147,2018-09-15 23:00:00,22,0,22
"6194",10102,"St Johns","NL",47.56038,-52.71147,2018-09-16 00:00:00,22,0,22
"6195",10102,"St Johns","NL",47.56038,-52.71147,2018-09-16 01:00:00,22,0,22
"6196",10102,"St Johns","NL",47.56038,-52.71147,2018-09-16 02:00:00,22,0,22
"6197",10102,"St Johns","NL",47.56038,-52.71147,2018-09-16 03:00:00,21,1,22
"6198",10102,"St Johns","NL",47.56038,-52.71147,2018-09-16 04:00:00,21,0,21
"6199",10102,"St Johns","NL",47.56038,-52.71147,2018-09-16 05:00:00,21,0,21
"6200",10102,"St Johns","NL",47.56038,-52.71147,2018-09-16 06:00:00,16,3,19
"6201",10102,"St Johns","NL",47.56038,-52.71147,2018-09-16 07:00:00,3,16,19
"6202",10102,"St Johns","NL",47.56038,-52.71147,2018-09-16 08:00:00,13,5,18
"6203",10102,"St Johns","NL",47.56038,-52.71147,2018-09-16 09:00:00,16,3,19
"6204",10102,"St Johns","NL",47.56038,-52.71147,2018-09-16 10:00:00,12,11,23
"6205",10102,"St Johns","NL",47.56038,-52.71147,2018-09-16 11:00:00,14,8,22
"6206",10102,"St Johns","NL",47.56038,-52.71147,2018-09-16 12:00:00,15,8,23
"6207",10102,"St Johns","NL",47.56038,-52.71147,2018-09-16 13:00:00,15,10,25
"6208",10102,"St Johns","NL",47.56038,-52.71147,2018-09-16 14:00:00,21,3,24
"6209",10102,"St Johns","NL",47.56038,-52.71147,2018-09-16 15:00:00,22,3,25
"6210",10102,"St Johns","NL",47.56038,-52.71147,2018-09-16 16:00:00,22,3,25
"6211",10102,"St Johns","NL",47.56038,-52.71147,2018-09-16 17:00:00,17,10,27
"6212",10102,"St Johns","NL",47.56038,-52.71147,2018-09-16 18:00:00,22,3,25
"6213",10102,"St Johns","NL",47.56038,-52.71147,2018-09-16 19:00:00,19,6,25
"6214",10102,"St Johns","NL",47.56038,-52.71147,2018-09-16 20:00:00,21,4,25
"6215",10102,"St Johns","NL",47.56038,-52.71147,2018-09-16 21:00:00,21,5,26
"6216",10102,"St Johns","NL",47.56038,-52.71147,2018-09-16 22:00:00,20,5,25
"6217",10102,"St Johns","NL",47.56038,-52.71147,2018-09-16 23:00:00,20,5,25
"6218",10102,"St Johns","NL",47.56038,-52.71147,2018-09-17 00:00:00,19,5,24
"6219",10102,"St Johns","NL",47.56038,-52.71147,2018-09-17 01:00:00,15,5,20
"6220",10102,"St Johns","NL",47.56038,-52.71147,2018-09-17 02:00:00,14,4,18
"6221",10102,"St Johns","NL",47.56038,-52.71147,2018-09-17 03:00:00,12,3,15
"6222",10102,"St Johns","NL",47.56038,-52.71147,2018-09-17 04:00:00,10,3,13
"6223",10102,"St Johns","NL",47.56038,-52.71147,2018-09-17 05:00:00,11,4,15
"6224",10102,"St Johns","NL",47.56038,-52.71147,2018-09-17 06:00:00,10,5,15
"6225",10102,"St Johns","NL",47.56038,-52.71147,2018-09-17 07:00:00,11,7,18
"6226",10102,"St Johns","NL",47.56038,-52.71147,2018-09-17 08:00:00,14,5,19
"6227",10102,"St Johns","NL",47.56038,-52.71147,2018-09-17 09:00:00,16,6,22
"6228",10102,"St Johns","NL",47.56038,-52.71147,2018-09-17 10:00:00,18,5,23
"6229",10102,"St Johns","NL",47.56038,-52.71147,2018-09-17 11:00:00,15,6,21
"6230",10102,"St Johns","NL",47.56038,-52.71147,2018-09-17 12:00:00,17,4,21
"6231",10102,"St Johns","NL",47.56038,-52.71147,2018-09-17 13:00:00,18,5,23
"6232",10102,"St Johns","NL",47.56038,-52.71147,2018-09-17 14:00:00,18,4,22
"6233",10102,"St Johns","NL",47.56038,-52.71147,2018-09-17 15:00:00,19,4,23
"6234",10102,"St Johns","NL",47.56038,-52.71147,2018-09-17 16:00:00,19,6,25
"6235",10102,"St Johns","NL",47.56038,-52.71147,2018-09-17 17:00:00,19,5,24
"6236",10102,"St Johns","NL",47.56038,-52.71147,2018-09-17 18:00:00,19,6,25
"6237",10102,"St Johns","NL",47.56038,-52.71147,2018-09-17 19:00:00,20,4,24
"6238",10102,"St Johns","NL",47.56038,-52.71147,2018-09-17 20:00:00,23,3,26
"6239",10102,"St Johns","NL",47.56038,-52.71147,2018-09-17 21:00:00,24,2,26
"6240",10102,"St Johns","NL",47.56038,-52.71147,2018-09-17 22:00:00,25,2,27
"6241",10102,"St Johns","NL",47.56038,-52.71147,2018-09-17 23:00:00,24,2,26
"6242",10102,"St Johns","NL",47.56038,-52.71147,2018-09-18 00:00:00,26,4,30
"6243",10102,"St Johns","NL",47.56038,-52.71147,2018-09-18 01:00:00,30,3,33
"6244",10102,"St Johns","NL",47.56038,-52.71147,2018-09-18 02:00:00,23,7,30
"6245",10102,"St Johns","NL",47.56038,-52.71147,2018-09-18 03:00:00,22,6,28
"6246",10102,"St Johns","NL",47.56038,-52.71147,2018-09-18 04:00:00,21,8,29
"6247",10102,"St Johns","NL",47.56038,-52.71147,2018-09-18 05:00:00,20,7,27
"6248",10102,"St Johns","NL",47.56038,-52.71147,2018-09-18 06:00:00,19,9,28
"6249",10102,"St Johns","NL",47.56038,-52.71147,2018-09-18 07:00:00,13,16,29
"6250",10102,"St Johns","NL",47.56038,-52.71147,2018-09-18 08:00:00,8,22,30
"6251",10102,"St Johns","NL",47.56038,-52.71147,2018-09-18 09:00:00,2,29,31
"6252",10102,"St Johns","NL",47.56038,-52.71147,2018-09-18 10:00:00,3,30,33
"6253",10102,"St Johns","NL",47.56038,-52.71147,2018-09-18 11:00:00,4,28,32
"6254",10102,"St Johns","NL",47.56038,-52.71147,2018-09-18 12:00:00,4,24,28
"6255",10102,"St Johns","NL",47.56038,-52.71147,2018-09-18 13:00:00,2,32,34
"6256",10102,"St Johns","NL",47.56038,-52.71147,2018-09-18 14:00:00,3,30,33
"6257",10102,"St Johns","NL",47.56038,-52.71147,2018-09-18 15:00:00,1,30,31
"6258",10102,"St Johns","NL",47.56038,-52.71147,2018-09-18 16:00:00,4,26,30
"6259",10102,"St Johns","NL",47.56038,-52.71147,2018-09-18 17:00:00,6,23,29
"6260",10102,"St Johns","NL",47.56038,-52.71147,2018-09-18 18:00:00,8,24,32
"6261",10102,"St Johns","NL",47.56038,-52.71147,2018-09-18 19:00:00,6,26,32
"6262",10102,"St Johns","NL",47.56038,-52.71147,2018-09-18 20:00:00,14,14,28
"6263",10102,"St Johns","NL",47.56038,-52.71147,2018-09-18 21:00:00,22,5,27
"6264",10102,"St Johns","NL",47.56038,-52.71147,2018-09-18 22:00:00,22,6,28
"6265",10102,"St Johns","NL",47.56038,-52.71147,2018-09-18 23:00:00,22,4,26
"6266",10102,"St Johns","NL",47.56038,-52.71147,2018-09-19 00:00:00,21,3,24
"6267",10102,"St Johns","NL",47.56038,-52.71147,2018-09-19 01:00:00,22,2,24
"6268",10102,"St Johns","NL",47.56038,-52.71147,2018-09-19 02:00:00,23,1,24
"6269",10102,"St Johns","NL",47.56038,-52.71147,2018-09-19 03:00:00,23,1,24
"6270",10102,"St Johns","NL",47.56038,-52.71147,2018-09-19 04:00:00,24,0,24
"6271",10102,"St Johns","NL",47.56038,-52.71147,2018-09-19 05:00:00,24,0,24
"6272",10102,"St Johns","NL",47.56038,-52.71147,2018-09-19 06:00:00,16,10,26
"6273",10102,"St Johns","NL",47.56038,-52.71147,2018-09-19 07:00:00,12,16,28
"6274",10102,"St Johns","NL",47.56038,-52.71147,2018-09-19 08:00:00,15,12,27
"6275",10102,"St Johns","NL",47.56038,-52.71147,2018-09-19 09:00:00,15,10,25
"6276",10102,"St Johns","NL",47.56038,-52.71147,2018-09-19 10:00:00,15,9,24
"6277",10102,"St Johns","NL",47.56038,-52.71147,2018-09-19 11:00:00,14,10,24
"6278",10102,"St Johns","NL",47.56038,-52.71147,2018-09-19 12:00:00,16,10,26
"6279",10102,"St Johns","NL",47.56038,-52.71147,2018-09-19 13:00:00,14,12,26
"6280",10102,"St Johns","NL",47.56038,-52.71147,2018-09-19 14:00:00,13,17,30
"6281",10102,"St Johns","NL",47.56038,-52.71147,2018-09-19 15:00:00,14,29,43
"6282",10102,"St Johns","NL",47.56038,-52.71147,2018-09-19 16:00:00,19,10,29
"6283",10102,"St Johns","NL",47.56038,-52.71147,2018-09-19 17:00:00,15,16,31
"6284",10102,"St Johns","NL",47.56038,-52.71147,2018-09-19 18:00:00,16,14,30
"6285",10102,"St Johns","NL",47.56038,-52.71147,2018-09-19 19:00:00,14,16,30
"6286",10102,"St Johns","NL",47.56038,-52.71147,2018-09-19 20:00:00,19,11,30
"6287",10102,"St Johns","NL",47.56038,-52.71147,2018-09-19 21:00:00,18,14,32
"6288",10102,"St Johns","NL",47.56038,-52.71147,2018-09-19 22:00:00,17,15,32
"6289",10102,"St Johns","NL",47.56038,-52.71147,2018-09-19 23:00:00,18,15,33
"6290",10102,"St Johns","NL",47.56038,-52.71147,2018-09-20 00:00:00,19,14,33
"6291",10102,"St Johns","NL",47.56038,-52.71147,2018-09-20 01:00:00,20,14,34
"6292",10102,"St Johns","NL",47.56038,-52.71147,2018-09-20 02:00:00,21,14,35
"6293",10102,"St Johns","NL",47.56038,-52.71147,2018-09-20 03:00:00,20,15,35
"6294",10102,"St Johns","NL",47.56038,-52.71147,2018-09-20 04:00:00,21,17,38
"6295",10102,"St Johns","NL",47.56038,-52.71147,2018-09-20 05:00:00,22,13,35
"6296",10102,"St Johns","NL",47.56038,-52.71147,2018-09-20 06:00:00,29,2,31
"6297",10102,"St Johns","NL",47.56038,-52.71147,2018-09-20 07:00:00,26,6,32
"6298",10102,"St Johns","NL",47.56038,-52.71147,2018-09-20 08:00:00,27,5,32
"6299",10102,"St Johns","NL",47.56038,-52.71147,2018-09-20 09:00:00,24,8,32
"6300",10102,"St Johns","NL",47.56038,-52.71147,2018-09-20 10:00:00,20,14,34
"6301",10102,"St Johns","NL",47.56038,-52.71147,2018-09-20 11:00:00,27,6,33
"6302",10102,"St Johns","NL",47.56038,-52.71147,2018-09-20 12:00:00,27,4,31
"6303",10102,"St Johns","NL",47.56038,-52.71147,2018-09-20 13:00:00,27,5,32
"6304",10102,"St Johns","NL",47.56038,-52.71147,2018-09-20 14:00:00,24,10,34
"6305",10102,"St Johns","NL",47.56038,-52.71147,2018-09-20 15:00:00,25,9,34
"6306",10102,"St Johns","NL",47.56038,-52.71147,2018-09-20 16:00:00,27,4,31
"6307",10102,"St Johns","NL",47.56038,-52.71147,2018-09-20 17:00:00,28,4,32
"6308",10102,"St Johns","NL",47.56038,-52.71147,2018-09-20 18:00:00,27,4,31
"6309",10102,"St Johns","NL",47.56038,-52.71147,2018-09-20 19:00:00,27,4,31
"6310",10102,"St Johns","NL",47.56038,-52.71147,2018-09-20 20:00:00,27,5,32
"6311",10102,"St Johns","NL",47.56038,-52.71147,2018-09-20 21:00:00,27,5,32
"6312",10102,"St Johns","NL",47.56038,-52.71147,2018-09-20 22:00:00,26,4,30
"6313",10102,"St Johns","NL",47.56038,-52.71147,2018-09-20 23:00:00,26,4,30
"6314",10102,"St Johns","NL",47.56038,-52.71147,2018-09-21 00:00:00,27,5,32
"6315",10102,"St Johns","NL",47.56038,-52.71147,2018-09-21 01:00:00,28,3,31
"6316",10102,"St Johns","NL",47.56038,-52.71147,2018-09-21 02:00:00,27,3,30
"6317",10102,"St Johns","NL",47.56038,-52.71147,2018-09-21 03:00:00,28,2,30
"6318",10102,"St Johns","NL",47.56038,-52.71147,2018-09-21 04:00:00,27,3,30
"6319",10102,"St Johns","NL",47.56038,-52.71147,2018-09-21 05:00:00,27,3,30
"6320",10102,"St Johns","NL",47.56038,-52.71147,2018-09-21 06:00:00,26,5,31
"6321",10102,"St Johns","NL",47.56038,-52.71147,2018-09-21 07:00:00,24,6,30
"6322",10102,"St Johns","NL",47.56038,-52.71147,2018-09-21 08:00:00,22,7,29
"6323",10102,"St Johns","NL",47.56038,-52.71147,2018-09-21 09:00:00,26,4,30
"6324",10102,"St Johns","NL",47.56038,-52.71147,2018-09-21 10:00:00,26,3,29
"6325",10102,"St Johns","NL",47.56038,-52.71147,2018-09-21 11:00:00,24,5,29
"6326",10102,"St Johns","NL",47.56038,-52.71147,2018-09-21 12:00:00,25,3,28
"6327",10102,"St Johns","NL",47.56038,-52.71147,2018-09-21 13:00:00,25,3,28
"6328",10102,"St Johns","NL",47.56038,-52.71147,2018-09-21 14:00:00,25,4,29
"6329",10102,"St Johns","NL",47.56038,-52.71147,2018-09-21 15:00:00,23,4,27
"6330",10102,"St Johns","NL",47.56038,-52.71147,2018-09-21 16:00:00,23,5,28
"6331",10102,"St Johns","NL",47.56038,-52.71147,2018-09-21 17:00:00,19,9,28
"6332",10102,"St Johns","NL",47.56038,-52.71147,2018-09-21 18:00:00,18,10,28
"6333",10102,"St Johns","NL",47.56038,-52.71147,2018-09-21 19:00:00,18,8,26
"6334",10102,"St Johns","NL",47.56038,-52.71147,2018-09-21 20:00:00,7,15,22
"6335",10102,"St Johns","NL",47.56038,-52.71147,2018-09-21 21:00:00,5,12,17
"6336",10102,"St Johns","NL",47.56038,-52.71147,2018-09-21 22:00:00,3,11,14
"6337",10102,"St Johns","NL",47.56038,-52.71147,2018-09-21 23:00:00,5,8,13
"6338",10102,"St Johns","NL",47.56038,-52.71147,2018-09-22 00:00:00,3,11,14
"6339",10102,"St Johns","NL",47.56038,-52.71147,2018-09-22 01:00:00,3,10,13
"6340",10102,"St Johns","NL",47.56038,-52.71147,2018-09-22 02:00:00,7,6,13
"6341",10102,"St Johns","NL",47.56038,-52.71147,2018-09-22 03:00:00,8,5,13
"6342",10102,"St Johns","NL",47.56038,-52.71147,2018-09-22 04:00:00,7,4,11
"6343",10102,"St Johns","NL",47.56038,-52.71147,2018-09-22 05:00:00,7,5,12
"6344",10102,"St Johns","NL",47.56038,-52.71147,2018-09-22 06:00:00,11,5,16
"6345",10102,"St Johns","NL",47.56038,-52.71147,2018-09-22 07:00:00,17,4,21
"6346",10102,"St Johns","NL",47.56038,-52.71147,2018-09-22 08:00:00,21,3,24
"6347",10102,"St Johns","NL",47.56038,-52.71147,2018-09-22 09:00:00,25,2,27
"6348",10102,"St Johns","NL",47.56038,-52.71147,2018-09-22 10:00:00,27,2,29
"6349",10102,"St Johns","NL",47.56038,-52.71147,2018-09-22 11:00:00,27,2,29
"6350",10102,"St Johns","NL",47.56038,-52.71147,2018-09-22 12:00:00,29,2,31
"6351",10102,"St Johns","NL",47.56038,-52.71147,2018-09-22 13:00:00,30,2,32
"6352",10102,"St Johns","NL",47.56038,-52.71147,2018-09-22 14:00:00,29,2,31
"6353",10102,"St Johns","NL",47.56038,-52.71147,2018-09-22 15:00:00,30,2,32
"6354",10102,"St Johns","NL",47.56038,-52.71147,2018-09-22 16:00:00,31,2,33
"6355",10102,"St Johns","NL",47.56038,-52.71147,2018-09-22 17:00:00,31,2,33
"6356",10102,"St Johns","NL",47.56038,-52.71147,2018-09-22 18:00:00,31,2,33
"6357",10102,"St Johns","NL",47.56038,-52.71147,2018-09-22 19:00:00,32,2,34
"6358",10102,"St Johns","NL",47.56038,-52.71147,2018-09-22 20:00:00,32,2,34
"6359",10102,"St Johns","NL",47.56038,-52.71147,2018-09-22 21:00:00,29,2,31
"6360",10102,"St Johns","NL",47.56038,-52.71147,2018-09-22 22:00:00,20,2,22
"6361",10102,"St Johns","NL",47.56038,-52.71147,2018-09-22 23:00:00,20,2,22
"6362",10102,"St Johns","NL",47.56038,-52.71147,2018-09-23 00:00:00,20,2,22
"6363",10102,"St Johns","NL",47.56038,-52.71147,2018-09-23 01:00:00,20,3,23
"6364",10102,"St Johns","NL",47.56038,-52.71147,2018-09-23 02:00:00,20,4,24
"6365",10102,"St Johns","NL",47.56038,-52.71147,2018-09-23 03:00:00,19,2,21
"6366",10102,"St Johns","NL",47.56038,-52.71147,2018-09-23 04:00:00,18,3,21
"6367",10102,"St Johns","NL",47.56038,-52.71147,2018-09-23 05:00:00,16,4,20
"6368",10102,"St Johns","NL",47.56038,-52.71147,2018-09-23 06:00:00,16,4,20
"6369",10102,"St Johns","NL",47.56038,-52.71147,2018-09-23 07:00:00,14,5,19
"6370",10102,"St Johns","NL",47.56038,-52.71147,2018-09-23 08:00:00,18,5,23
"6371",10102,"St Johns","NL",47.56038,-52.71147,2018-09-23 09:00:00,23,2,25
"6372",10102,"St Johns","NL",47.56038,-52.71147,2018-09-23 10:00:00,24,2,26
"6373",10102,"St Johns","NL",47.56038,-52.71147,2018-09-23 11:00:00,25,2,27
"6374",10102,"St Johns","NL",47.56038,-52.71147,2018-09-23 12:00:00,27,0,27
"6375",10102,"St Johns","NL",47.56038,-52.71147,2018-09-23 13:00:00,25,5,30
"6376",10102,"St Johns","NL",47.56038,-52.71147,2018-09-23 14:00:00,21,6,27
"6377",10102,"St Johns","NL",47.56038,-52.71147,2018-09-23 15:00:00,20,6,26
"6378",10102,"St Johns","NL",47.56038,-52.71147,2018-09-23 16:00:00,21,7,28
"6379",10102,"St Johns","NL",47.56038,-52.71147,2018-09-23 17:00:00,25,3,28
"6380",10102,"St Johns","NL",47.56038,-52.71147,2018-09-23 18:00:00,27,2,29
"6381",10102,"St Johns","NL",47.56038,-52.71147,2018-09-23 19:00:00,25,2,27
"6382",10102,"St Johns","NL",47.56038,-52.71147,2018-09-23 20:00:00,23,2,25
"6383",10102,"St Johns","NL",47.56038,-52.71147,2018-09-23 21:00:00,23,1,24
"6384",10102,"St Johns","NL",47.56038,-52.71147,2018-09-23 22:00:00,24,2,26
"6385",10102,"St Johns","NL",47.56038,-52.71147,2018-09-23 23:00:00,25,2,27
"6386",10102,"St Johns","NL",47.56038,-52.71147,2018-09-24 00:00:00,24,1,25
"6387",10102,"St Johns","NL",47.56038,-52.71147,2018-09-24 01:00:00,24,1,25
"6388",10102,"St Johns","NL",47.56038,-52.71147,2018-09-24 02:00:00,24,1,25
"6389",10102,"St Johns","NL",47.56038,-52.71147,2018-09-24 03:00:00,25,1,26
"6390",10102,"St Johns","NL",47.56038,-52.71147,2018-09-24 04:00:00,27,0,27
"6391",10102,"St Johns","NL",47.56038,-52.71147,2018-09-24 05:00:00,24,1,25
"6392",10102,"St Johns","NL",47.56038,-52.71147,2018-09-24 06:00:00,21,2,23
"6393",10102,"St Johns","NL",47.56038,-52.71147,2018-09-24 07:00:00,23,3,26
"6394",10102,"St Johns","NL",47.56038,-52.71147,2018-09-24 08:00:00,23,3,26
"6395",10102,"St Johns","NL",47.56038,-52.71147,2018-09-24 09:00:00,20,4,24
"6396",10102,"St Johns","NL",47.56038,-52.71147,2018-09-24 10:00:00,20,2,22
"6397",10102,"St Johns","NL",47.56038,-52.71147,2018-09-24 11:00:00,22,1,23
"6398",10102,"St Johns","NL",47.56038,-52.71147,2018-09-24 12:00:00,22,2,24
"6399",10102,"St Johns","NL",47.56038,-52.71147,2018-09-24 13:00:00,24,0,24
"6400",10102,"St Johns","NL",47.56038,-52.71147,2018-09-24 14:00:00,24,1,25
"6401",10102,"St Johns","NL",47.56038,-52.71147,2018-09-24 15:00:00,23,1,24
"6402",10102,"St Johns","NL",47.56038,-52.71147,2018-09-24 16:00:00,24,1,25
"6403",10102,"St Johns","NL",47.56038,-52.71147,2018-09-24 17:00:00,23,1,24
"6404",10102,"St Johns","NL",47.56038,-52.71147,2018-09-24 18:00:00,21,3,24
"6405",10102,"St Johns","NL",47.56038,-52.71147,2018-09-24 19:00:00,20,3,23
"6406",10102,"St Johns","NL",47.56038,-52.71147,2018-09-24 20:00:00,17,5,22
"6407",10102,"St Johns","NL",47.56038,-52.71147,2018-09-24 21:00:00,13,8,21
"6408",10102,"St Johns","NL",47.56038,-52.71147,2018-09-24 22:00:00,11,8,19
"6409",10102,"St Johns","NL",47.56038,-52.71147,2018-09-24 23:00:00,10,8,18
"6410",10102,"St Johns","NL",47.56038,-52.71147,2018-09-25 00:00:00,7,11,18
"6411",10102,"St Johns","NL",47.56038,-52.71147,2018-09-25 01:00:00,9,8,17
"6412",10102,"St Johns","NL",47.56038,-52.71147,2018-09-25 02:00:00,11,6,17
"6413",10102,"St Johns","NL",47.56038,-52.71147,2018-09-25 03:00:00,12,4,16
"6414",10102,"St Johns","NL",47.56038,-52.71147,2018-09-25 04:00:00,10,5,15
"6415",10102,"St Johns","NL",47.56038,-52.71147,2018-09-25 05:00:00,8,5,13
"6416",10102,"St Johns","NL",47.56038,-52.71147,2018-09-25 06:00:00,13,5,18
"6417",10102,"St Johns","NL",47.56038,-52.71147,2018-09-25 07:00:00,11,10,21
"6418",10102,"St Johns","NL",47.56038,-52.71147,2018-09-25 08:00:00,17,3,20
"6419",10102,"St Johns","NL",47.56038,-52.71147,2018-09-25 09:00:00,20,1,21
"6420",10102,"St Johns","NL",47.56038,-52.71147,2018-09-25 10:00:00,21,1,22
"6421",10102,"St Johns","NL",47.56038,-52.71147,2018-09-25 11:00:00,22,2,24
"6422",10102,"St Johns","NL",47.56038,-52.71147,2018-09-25 12:00:00,22,3,25
"6423",10102,"St Johns","NL",47.56038,-52.71147,2018-09-25 13:00:00,22,3,25
"6424",10102,"St Johns","NL",47.56038,-52.71147,2018-09-25 14:00:00,21,4,25
"6425",10102,"St Johns","NL",47.56038,-52.71147,2018-09-25 15:00:00,22,3,25
"6426",10102,"St Johns","NL",47.56038,-52.71147,2018-09-25 16:00:00,22,4,26
"6427",10102,"St Johns","NL",47.56038,-52.71147,2018-09-25 17:00:00,24,3,27
"6428",10102,"St Johns","NL",47.56038,-52.71147,2018-09-25 18:00:00,23,5,28
"6429",10102,"St Johns","NL",47.56038,-52.71147,2018-09-25 19:00:00,11,14,25
"6430",10102,"St Johns","NL",47.56038,-52.71147,2018-09-25 20:00:00,3,17,20
"6431",10102,"St Johns","NL",47.56038,-52.71147,2018-09-25 21:00:00,1,14,15
"6432",10102,"St Johns","NL",47.56038,-52.71147,2018-09-25 22:00:00,3,11,14
"6433",10102,"St Johns","NL",47.56038,-52.71147,2018-09-25 23:00:00,7,8,15
"6434",10102,"St Johns","NL",47.56038,-52.71147,2018-09-26 00:00:00,8,7,15
"6435",10102,"St Johns","NL",47.56038,-52.71147,2018-09-26 01:00:00,11,4,15
"6436",10102,"St Johns","NL",47.56038,-52.71147,2018-09-26 02:00:00,11,3,14
"6437",10102,"St Johns","NL",47.56038,-52.71147,2018-09-26 03:00:00,12,3,15
"6438",10102,"St Johns","NL",47.56038,-52.71147,2018-09-26 04:00:00,14,3,17
"6439",10102,"St Johns","NL",47.56038,-52.71147,2018-09-26 05:00:00,14,4,18
"6440",10102,"St Johns","NL",47.56038,-52.71147,2018-09-26 06:00:00,9,9,18
"6441",10102,"St Johns","NL",47.56038,-52.71147,2018-09-26 07:00:00,9,9,18
"6442",10102,"St Johns","NL",47.56038,-52.71147,2018-09-26 08:00:00,9,12,21
"6443",10102,"St Johns","NL",47.56038,-52.71147,2018-09-26 09:00:00,15,10,25
"6444",10102,"St Johns","NL",47.56038,-52.71147,2018-09-26 10:00:00,23,4,27
"6445",10102,"St Johns","NL",47.56038,-52.71147,2018-09-26 11:00:00,23,3,26
"6446",10102,"St Johns","NL",47.56038,-52.71147,2018-09-26 12:00:00,22,3,25
"6447",10102,"St Johns","NL",47.56038,-52.71147,2018-09-26 13:00:00,23,5,28
"6448",10102,"St Johns","NL",47.56038,-52.71147,2018-09-26 14:00:00,25,4,29
"6449",10102,"St Johns","NL",47.56038,-52.71147,2018-09-26 15:00:00,27,2,29
"6450",10102,"St Johns","NL",47.56038,-52.71147,2018-09-26 16:00:00,26,5,31
"6451",10102,"St Johns","NL",47.56038,-52.71147,2018-09-26 17:00:00,24,4,28
"6452",10102,"St Johns","NL",47.56038,-52.71147,2018-09-26 18:00:00,25,2,27
"6453",10102,"St Johns","NL",47.56038,-52.71147,2018-09-26 19:00:00,25,2,27
"6454",10102,"St Johns","NL",47.56038,-52.71147,2018-09-26 20:00:00,23,3,26
"6455",10102,"St Johns","NL",47.56038,-52.71147,2018-09-26 21:00:00,22,2,24
"6456",10102,"St Johns","NL",47.56038,-52.71147,2018-09-26 22:00:00,24,1,25
"6457",10102,"St Johns","NL",47.56038,-52.71147,2018-09-26 23:00:00,25,1,26
"6458",10102,"St Johns","NL",47.56038,-52.71147,2018-09-27 00:00:00,27,0,27
"6459",10102,"St Johns","NL",47.56038,-52.71147,2018-09-27 01:00:00,25,0,25
"6460",10102,"St Johns","NL",47.56038,-52.71147,2018-09-27 02:00:00,24,0,24
"6461",10102,"St Johns","NL",47.56038,-52.71147,2018-09-27 03:00:00,25,0,25
"6462",10102,"St Johns","NL",47.56038,-52.71147,2018-09-27 04:00:00,24,1,25
"6463",10102,"St Johns","NL",47.56038,-52.71147,2018-09-27 05:00:00,25,1,26
"6464",10102,"St Johns","NL",47.56038,-52.71147,2018-09-27 06:00:00,25,1,26
"6465",10102,"St Johns","NL",47.56038,-52.71147,2018-09-27 07:00:00,23,3,26
"6466",10102,"St Johns","NL",47.56038,-52.71147,2018-09-27 08:00:00,18,10,28
"6467",10102,"St Johns","NL",47.56038,-52.71147,2018-09-27 09:00:00,19,9,28
"6468",10102,"St Johns","NL",47.56038,-52.71147,2018-09-27 10:00:00,23,6,29
"6469",10102,"St Johns","NL",47.56038,-52.71147,2018-09-27 11:00:00,23,5,28
"6470",10102,"St Johns","NL",47.56038,-52.71147,2018-09-27 12:00:00,23,5,28
"6471",10102,"St Johns","NL",47.56038,-52.71147,2018-09-27 13:00:00,24,4,28
"6472",10102,"St Johns","NL",47.56038,-52.71147,2018-09-27 14:00:00,25,3,28
"6473",10102,"St Johns","NL",47.56038,-52.71147,2018-09-27 15:00:00,24,4,28
"6474",10102,"St Johns","NL",47.56038,-52.71147,2018-09-27 16:00:00,21,9,30
"6475",10102,"St Johns","NL",47.56038,-52.71147,2018-09-27 17:00:00,19,11,30
"6476",10102,"St Johns","NL",47.56038,-52.71147,2018-09-27 18:00:00,24,4,28
"6477",10102,"St Johns","NL",47.56038,-52.71147,2018-09-27 19:00:00,26,1,27
"6478",10102,"St Johns","NL",47.56038,-52.71147,2018-09-27 20:00:00,24,2,26
"6479",10102,"St Johns","NL",47.56038,-52.71147,2018-09-27 21:00:00,22,2,24
"6480",10102,"St Johns","NL",47.56038,-52.71147,2018-09-27 22:00:00,19,2,21
"6481",10102,"St Johns","NL",47.56038,-52.71147,2018-09-27 23:00:00,15,5,20
"6482",10102,"St Johns","NL",47.56038,-52.71147,2018-09-28 00:00:00,9,12,21
"6483",10102,"St Johns","NL",47.56038,-52.71147,2018-09-28 01:00:00,12,9,21
"6484",10102,"St Johns","NL",47.56038,-52.71147,2018-09-28 02:00:00,24,1,25
"6485",10102,"St Johns","NL",47.56038,-52.71147,2018-09-28 03:00:00,20,6,26
"6486",10102,"St Johns","NL",47.56038,-52.71147,2018-09-28 04:00:00,20,8,28
"6487",10102,"St Johns","NL",47.56038,-52.71147,2018-09-28 05:00:00,21,6,27
"6488",10102,"St Johns","NL",47.56038,-52.71147,2018-09-28 06:00:00,22,5,27
"6489",10102,"St Johns","NL",47.56038,-52.71147,2018-09-28 07:00:00,16,11,27
"6490",10102,"St Johns","NL",47.56038,-52.71147,2018-09-28 08:00:00,14,15,29
"6491",10102,"St Johns","NL",47.56038,-52.71147,2018-09-28 09:00:00,10,17,27
"6492",10102,"St Johns","NL",47.56038,-52.71147,2018-09-28 10:00:00,13,14,27
"6493",10102,"St Johns","NL",47.56038,-52.71147,2018-09-28 11:00:00,11,17,28
"6494",10102,"St Johns","NL",47.56038,-52.71147,2018-09-28 12:00:00,15,12,27
"6495",10102,"St Johns","NL",47.56038,-52.71147,2018-09-28 13:00:00,16,11,27
"6496",10102,"St Johns","NL",47.56038,-52.71147,2018-09-28 14:00:00,18,10,28
"6497",10102,"St Johns","NL",47.56038,-52.71147,2018-09-28 15:00:00,23,6,29
"6498",10102,"St Johns","NL",47.56038,-52.71147,2018-09-28 16:00:00,21,11,32
"6499",10102,"St Johns","NL",47.56038,-52.71147,2018-09-28 17:00:00,19,14,33
"6500",10102,"St Johns","NL",47.56038,-52.71147,2018-09-28 18:00:00,15,21,36
"6501",10102,"St Johns","NL",47.56038,-52.71147,2018-09-28 19:00:00,29,6,35
"6502",10102,"St Johns","NL",47.56038,-52.71147,2018-09-28 20:00:00,28,6,34
"6503",10102,"St Johns","NL",47.56038,-52.71147,2018-09-28 21:00:00,30,5,35
"6504",10102,"St Johns","NL",47.56038,-52.71147,2018-09-28 22:00:00,29,4,33
"6505",10102,"St Johns","NL",47.56038,-52.71147,2018-09-28 23:00:00,29,2,31
"6506",10102,"St Johns","NL",47.56038,-52.71147,2018-09-29 00:00:00,18,9,27
"6507",10102,"St Johns","NL",47.56038,-52.71147,2018-09-29 01:00:00,5,22,27
"6508",10102,"St Johns","NL",47.56038,-52.71147,2018-09-29 02:00:00,12,14,26
"6509",10102,"St Johns","NL",47.56038,-52.71147,2018-09-29 03:00:00,12,13,25
"6510",10102,"St Johns","NL",47.56038,-52.71147,2018-09-29 04:00:00,10,17,27
"6511",10102,"St Johns","NL",47.56038,-52.71147,2018-09-29 05:00:00,15,9,24
"6512",10102,"St Johns","NL",47.56038,-52.71147,2018-09-29 06:00:00,19,8,27
"6513",10102,"St Johns","NL",47.56038,-52.71147,2018-09-29 07:00:00,18,8,26
"6514",10102,"St Johns","NL",47.56038,-52.71147,2018-09-29 08:00:00,19,10,29
"6515",10102,"St Johns","NL",47.56038,-52.71147,2018-09-29 09:00:00,23,4,27
"6516",10102,"St Johns","NL",47.56038,-52.71147,2018-09-29 10:00:00,24,1,25
"6517",10102,"St Johns","NL",47.56038,-52.71147,2018-09-29 11:00:00,21,5,26
"6518",10102,"St Johns","NL",47.56038,-52.71147,2018-09-29 12:00:00,20,3,23
"6519",10102,"St Johns","NL",47.56038,-52.71147,2018-09-29 13:00:00,23,0,23
"6520",10102,"St Johns","NL",47.56038,-52.71147,2018-09-29 14:00:00,21,3,24
"6521",10102,"St Johns","NL",47.56038,-52.71147,2018-09-29 15:00:00,22,2,24
"6522",10102,"St Johns","NL",47.56038,-52.71147,2018-09-29 16:00:00,20,4,24
"6523",10102,"St Johns","NL",47.56038,-52.71147,2018-09-29 17:00:00,22,4,26
"6524",10102,"St Johns","NL",47.56038,-52.71147,2018-09-29 18:00:00,19,5,24
"6525",10102,"St Johns","NL",47.56038,-52.71147,2018-09-29 19:00:00,21,1,22
"6526",10102,"St Johns","NL",47.56038,-52.71147,2018-09-29 20:00:00,6,15,21
"6527",10102,"St Johns","NL",47.56038,-52.71147,2018-09-29 21:00:00,4,21,25
"6528",10102,"St Johns","NL",47.56038,-52.71147,2018-09-29 22:00:00,19,1,20
"6529",10102,"St Johns","NL",47.56038,-52.71147,2018-09-29 23:00:00,19,1,20
"6530",10102,"St Johns","NL",47.56038,-52.71147,2018-09-30 00:00:00,16,2,18
"6531",10102,"St Johns","NL",47.56038,-52.71147,2018-09-30 01:00:00,18,1,19
"6532",10102,"St Johns","NL",47.56038,-52.71147,2018-09-30 02:00:00,20,1,21
"6533",10102,"St Johns","NL",47.56038,-52.71147,2018-09-30 03:00:00,19,0,19
"6534",10102,"St Johns","NL",47.56038,-52.71147,2018-09-30 04:00:00,18,0,18
"6535",10102,"St Johns","NL",47.56038,-52.71147,2018-09-30 05:00:00,18,0,18
"6536",10102,"St Johns","NL",47.56038,-52.71147,2018-09-30 06:00:00,21,0,21
"6537",10102,"St Johns","NL",47.56038,-52.71147,2018-09-30 07:00:00,23,0,23
"6538",10102,"St Johns","NL",47.56038,-52.71147,2018-09-30 08:00:00,23,1,24
"6539",10102,"St Johns","NL",47.56038,-52.71147,2018-09-30 09:00:00,22,2,24
"6540",10102,"St Johns","NL",47.56038,-52.71147,2018-09-30 10:00:00,19,4,23
"6541",10102,"St Johns","NL",47.56038,-52.71147,2018-09-30 11:00:00,17,4,21
"6542",10102,"St Johns","NL",47.56038,-52.71147,2018-09-30 12:00:00,18,1,19
"6543",10102,"St Johns","NL",47.56038,-52.71147,2018-09-30 13:00:00,19,2,21
"6544",10102,"St Johns","NL",47.56038,-52.71147,2018-09-30 14:00:00,20,2,22
"6545",10102,"St Johns","NL",47.56038,-52.71147,2018-09-30 15:00:00,21,0,21
"6546",10102,"St Johns","NL",47.56038,-52.71147,2018-09-30 16:00:00,22,1,23
"6547",10102,"St Johns","NL",47.56038,-52.71147,2018-09-30 17:00:00,22,1,23
"6548",10102,"St Johns","NL",47.56038,-52.71147,2018-09-30 18:00:00,19,2,21
"6549",10102,"St Johns","NL",47.56038,-52.71147,2018-09-30 19:00:00,16,3,19
"6550",10102,"St Johns","NL",47.56038,-52.71147,2018-09-30 20:00:00,17,3,20
"6551",10102,"St Johns","NL",47.56038,-52.71147,2018-09-30 21:00:00,18,3,21
"6552",10102,"St Johns","NL",47.56038,-52.71147,2018-09-30 22:00:00,18,4,22
"6553",10102,"St Johns","NL",47.56038,-52.71147,2018-09-30 23:00:00,16,6,22
"6554",10102,"St Johns","NL",47.56038,-52.71147,2018-10-01 00:00:00,19,1,20
"6555",10102,"St Johns","NL",47.56038,-52.71147,2018-10-01 01:00:00,15,4,19
"6556",10102,"St Johns","NL",47.56038,-52.71147,2018-10-01 02:00:00,11,9,20
"6557",10102,"St Johns","NL",47.56038,-52.71147,2018-10-01 03:00:00,15,3,18
"6558",10102,"St Johns","NL",47.56038,-52.71147,2018-10-01 04:00:00,9,9,18
"6559",10102,"St Johns","NL",47.56038,-52.71147,2018-10-01 05:00:00,8,12,20
"6560",10102,"St Johns","NL",47.56038,-52.71147,2018-10-01 06:00:00,8,14,22
"6561",10102,"St Johns","NL",47.56038,-52.71147,2018-10-01 07:00:00,11,11,22
"6562",10102,"St Johns","NL",47.56038,-52.71147,2018-10-01 08:00:00,11,10,21
"6563",10102,"St Johns","NL",47.56038,-52.71147,2018-10-01 09:00:00,16,5,21
"6564",10102,"St Johns","NL",47.56038,-52.71147,2018-10-01 10:00:00,14,10,24
"6565",10102,"St Johns","NL",47.56038,-52.71147,2018-10-01 11:00:00,18,3,21
"6566",10102,"St Johns","NL",47.56038,-52.71147,2018-10-01 12:00:00,17,3,20
"6567",10102,"St Johns","NL",47.56038,-52.71147,2018-10-01 13:00:00,18,2,20
"6568",10102,"St Johns","NL",47.56038,-52.71147,2018-10-01 14:00:00,18,3,21
"6569",10102,"St Johns","NL",47.56038,-52.71147,2018-10-01 15:00:00,17,5,22
"6570",10102,"St Johns","NL",47.56038,-52.71147,2018-10-01 16:00:00,13,8,21
"6571",10102,"St Johns","NL",47.56038,-52.71147,2018-10-01 17:00:00,9,13,22
"6572",10102,"St Johns","NL",47.56038,-52.71147,2018-10-01 18:00:00,9,12,21
"6573",10102,"St Johns","NL",47.56038,-52.71147,2018-10-01 19:00:00,12,4,16
"6574",10102,"St Johns","NL",47.56038,-52.71147,2018-10-01 20:00:00,10,4,14
"6575",10102,"St Johns","NL",47.56038,-52.71147,2018-10-01 21:00:00,7,8,15
"6576",10102,"St Johns","NL",47.56038,-52.71147,2018-10-01 22:00:00,15,4,19
"6577",10102,"St Johns","NL",47.56038,-52.71147,2018-10-01 23:00:00,15,3,18
"6578",10102,"St Johns","NL",47.56038,-52.71147,2018-10-02 00:00:00,16,3,19
"6579",10102,"St Johns","NL",47.56038,-52.71147,2018-10-02 01:00:00,19,2,21
"6580",10102,"St Johns","NL",47.56038,-52.71147,2018-10-02 02:00:00,20,2,22
"6581",10102,"St Johns","NL",47.56038,-52.71147,2018-10-02 03:00:00,21,1,22
"6582",10102,"St Johns","NL",47.56038,-52.71147,2018-10-02 04:00:00,18,3,21
"6583",10102,"St Johns","NL",47.56038,-52.71147,2018-10-02 05:00:00,12,6,18
"6584",10102,"St Johns","NL",47.56038,-52.71147,2018-10-02 06:00:00,7,10,17
"6585",10102,"St Johns","NL",47.56038,-52.71147,2018-10-02 07:00:00,5,17,22
"6586",10102,"St Johns","NL",47.56038,-52.71147,2018-10-02 08:00:00,16,6,22
"6587",10102,"St Johns","NL",47.56038,-52.71147,2018-10-02 09:00:00,19,2,21
"6588",10102,"St Johns","NL",47.56038,-52.71147,2018-10-02 10:00:00,20,3,23
"6589",10102,"St Johns","NL",47.56038,-52.71147,2018-10-02 11:00:00,22,4,26
"6590",10102,"St Johns","NL",47.56038,-52.71147,2018-10-02 12:00:00,23,1,24
"6591",10102,"St Johns","NL",47.56038,-52.71147,2018-10-02 13:00:00,22,3,25
"6592",10102,"St Johns","NL",47.56038,-52.71147,2018-10-02 14:00:00,21,4,25
"6593",10102,"St Johns","NL",47.56038,-52.71147,2018-10-02 15:00:00,20,4,24
"6594",10102,"St Johns","NL",47.56038,-52.71147,2018-10-02 16:00:00,19,4,23
"6595",10102,"St Johns","NL",47.56038,-52.71147,2018-10-02 17:00:00,19,5,24
"6596",10102,"St Johns","NL",47.56038,-52.71147,2018-10-02 18:00:00,16,6,22
"6597",10102,"St Johns","NL",47.56038,-52.71147,2018-10-02 19:00:00,14,8,22
"6598",10102,"St Johns","NL",47.56038,-52.71147,2018-10-02 20:00:00,7,15,22
"6599",10102,"St Johns","NL",47.56038,-52.71147,2018-10-02 21:00:00,0,20,20
"6600",10102,"St Johns","NL",47.56038,-52.71147,2018-10-02 22:00:00,0,17,17
"6601",10102,"St Johns","NL",47.56038,-52.71147,2018-10-02 23:00:00,0,16,16
"6602",10102,"St Johns","NL",47.56038,-52.71147,2018-10-03 00:00:00,0,13,13
"6603",10102,"St Johns","NL",47.56038,-52.71147,2018-10-03 01:00:00,0,12,12
"6604",10102,"St Johns","NL",47.56038,-52.71147,2018-10-03 02:00:00,1,10,11
"6605",10102,"St Johns","NL",47.56038,-52.71147,2018-10-03 03:00:00,1,8,9
"6606",10102,"St Johns","NL",47.56038,-52.71147,2018-10-03 04:00:00,0,8,8
"6607",10102,"St Johns","NL",47.56038,-52.71147,2018-10-03 05:00:00,0,8,8
"6608",10102,"St Johns","NL",47.56038,-52.71147,2018-10-03 06:00:00,0,10,10
"6609",10102,"St Johns","NL",47.56038,-52.71147,2018-10-03 07:00:00,0,11,11
"6610",10102,"St Johns","NL",47.56038,-52.71147,2018-10-03 08:00:00,0,14,14
"6611",10102,"St Johns","NL",47.56038,-52.71147,2018-10-03 09:00:00,1,24,25
"6612",10102,"St Johns","NL",47.56038,-52.71147,2018-10-03 10:00:00,21,6,27
"6613",10102,"St Johns","NL",47.56038,-52.71147,2018-10-03 11:00:00,24,3,27
"6614",10102,"St Johns","NL",47.56038,-52.71147,2018-10-03 12:00:00,22,7,29
"6615",10102,"St Johns","NL",47.56038,-52.71147,2018-10-03 13:00:00,25,4,29
"6616",10102,"St Johns","NL",47.56038,-52.71147,2018-10-03 14:00:00,25,4,29
"6617",10102,"St Johns","NL",47.56038,-52.71147,2018-10-03 15:00:00,25,4,29
"6618",10102,"St Johns","NL",47.56038,-52.71147,2018-10-03 16:00:00,24,6,30
"6619",10102,"St Johns","NL",47.56038,-52.71147,2018-10-03 17:00:00,23,5,28
"6620",10102,"St Johns","NL",47.56038,-52.71147,2018-10-03 18:00:00,22,5,27
"6621",10102,"St Johns","NL",47.56038,-52.71147,2018-10-03 19:00:00,20,6,26
"6622",10102,"St Johns","NL",47.56038,-52.71147,2018-10-03 20:00:00,22,5,27
"6623",10102,"St Johns","NL",47.56038,-52.71147,2018-10-03 21:00:00,21,6,27
"6624",10102,"St Johns","NL",47.56038,-52.71147,2018-10-03 22:00:00,24,3,27
"6625",10102,"St Johns","NL",47.56038,-52.71147,2018-10-03 23:00:00,23,3,26
"6626",10102,"St Johns","NL",47.56038,-52.71147,2018-10-04 00:00:00,24,3,27
"6627",10102,"St Johns","NL",47.56038,-52.71147,2018-10-04 01:00:00,24,3,27
"6628",10102,"St Johns","NL",47.56038,-52.71147,2018-10-04 02:00:00,24,2,26
"6629",10102,"St Johns","NL",47.56038,-52.71147,2018-10-04 03:00:00,25,2,27
"6630",10102,"St Johns","NL",47.56038,-52.71147,2018-10-04 04:00:00,25,2,27
"6631",10102,"St Johns","NL",47.56038,-52.71147,2018-10-04 05:00:00,24,2,26
"6632",10102,"St Johns","NL",47.56038,-52.71147,2018-10-04 06:00:00,20,6,26
"6633",10102,"St Johns","NL",47.56038,-52.71147,2018-10-04 07:00:00,4,23,27
"6634",10102,"St Johns","NL",47.56038,-52.71147,2018-10-04 08:00:00,15,13,28
"6635",10102,"St Johns","NL",47.56038,-52.71147,2018-10-04 09:00:00,25,5,30
"6636",10102,"St Johns","NL",47.56038,-52.71147,2018-10-04 10:00:00,25,4,29
"6637",10102,"St Johns","NL",47.56038,-52.71147,2018-10-04 11:00:00,25,5,30
"6638",10102,"St Johns","NL",47.56038,-52.71147,2018-10-04 12:00:00,27,3,30
"6639",10102,"St Johns","NL",47.56038,-52.71147,2018-10-04 13:00:00,26,4,30
"6640",10102,"St Johns","NL",47.56038,-52.71147,2018-10-04 14:00:00,25,5,30
"6641",10102,"St Johns","NL",47.56038,-52.71147,2018-10-04 15:00:00,24,6,30
"6642",10102,"St Johns","NL",47.56038,-52.71147,2018-10-04 16:00:00,23,7,30
"6643",10102,"St Johns","NL",47.56038,-52.71147,2018-10-04 17:00:00,24,5,29
"6644",10102,"St Johns","NL",47.56038,-52.71147,2018-10-04 18:00:00,27,3,30
"6645",10102,"St Johns","NL",47.56038,-52.71147,2018-10-04 19:00:00,28,2,30
"6646",10102,"St Johns","NL",47.56038,-52.71147,2018-10-04 20:00:00,28,3,31
"6647",10102,"St Johns","NL",47.56038,-52.71147,2018-10-04 21:00:00,29,2,31
"6648",10102,"St Johns","NL",47.56038,-52.71147,2018-10-04 22:00:00,30,2,32
"6649",10102,"St Johns","NL",47.56038,-52.71147,2018-10-04 23:00:00,31,2,33
"6650",10102,"St Johns","NL",47.56038,-52.71147,2018-10-05 00:00:00,29,2,31
"6651",10102,"St Johns","NL",47.56038,-52.71147,2018-10-05 01:00:00,26,1,27
"6652",10102,"St Johns","NL",47.56038,-52.71147,2018-10-05 02:00:00,25,1,26
"6653",10102,"St Johns","NL",47.56038,-52.71147,2018-10-05 03:00:00,25,1,26
"6654",10102,"St Johns","NL",47.56038,-52.71147,2018-10-05 04:00:00,24,2,26
"6655",10102,"St Johns","NL",47.56038,-52.71147,2018-10-05 05:00:00,23,1,24
"6656",10102,"St Johns","NL",47.56038,-52.71147,2018-10-05 06:00:00,21,2,23
"6657",10102,"St Johns","NL",47.56038,-52.71147,2018-10-05 07:00:00,18,3,21
"6658",10102,"St Johns","NL",47.56038,-52.71147,2018-10-05 08:00:00,13,8,21
"6659",10102,"St Johns","NL",47.56038,-52.71147,2018-10-05 09:00:00,17,5,22
"6660",10102,"St Johns","NL",47.56038,-52.71147,2018-10-05 10:00:00,18,6,24
"6661",10102,"St Johns","NL",47.56038,-52.71147,2018-10-05 11:00:00,20,6,26
"6662",10102,"St Johns","NL",47.56038,-52.71147,2018-10-05 12:00:00,21,4,25
"6663",10102,"St Johns","NL",47.56038,-52.71147,2018-10-05 13:00:00,23,6,29
"6664",10102,"St Johns","NL",47.56038,-52.71147,2018-10-05 14:00:00,26,3,29
"6665",10102,"St Johns","NL",47.56038,-52.71147,2018-10-05 15:00:00,24,3,27
"6666",10102,"St Johns","NL",47.56038,-52.71147,2018-10-05 16:00:00,21,5,26
"6667",10102,"St Johns","NL",47.56038,-52.71147,2018-10-05 17:00:00,16,7,23
"6668",10102,"St Johns","NL",47.56038,-52.71147,2018-10-05 18:00:00,12,12,24
"6669",10102,"St Johns","NL",47.56038,-52.71147,2018-10-05 19:00:00,13,13,26
"6670",10102,"St Johns","NL",47.56038,-52.71147,2018-10-05 20:00:00,18,7,25
"6671",10102,"St Johns","NL",47.56038,-52.71147,2018-10-05 21:00:00,14,12,26
"6672",10102,"St Johns","NL",47.56038,-52.71147,2018-10-05 22:00:00,16,9,25
"6673",10102,"St Johns","NL",47.56038,-52.71147,2018-10-05 23:00:00,16,8,24
"6674",10102,"St Johns","NL",47.56038,-52.71147,2018-10-06 00:00:00,18,6,24
"6675",10102,"St Johns","NL",47.56038,-52.71147,2018-10-06 01:00:00,20,5,25
"6676",10102,"St Johns","NL",47.56038,-52.71147,2018-10-06 02:00:00,22,3,25
"6677",10102,"St Johns","NL",47.56038,-52.71147,2018-10-06 03:00:00,17,9,26
"6678",10102,"St Johns","NL",47.56038,-52.71147,2018-10-06 04:00:00,15,10,25
"6679",10102,"St Johns","NL",47.56038,-52.71147,2018-10-06 05:00:00,18,7,25
"6680",10102,"St Johns","NL",47.56038,-52.71147,2018-10-06 06:00:00,18,7,25
"6681",10102,"St Johns","NL",47.56038,-52.71147,2018-10-06 07:00:00,15,8,23
"6682",10102,"St Johns","NL",47.56038,-52.71147,2018-10-06 08:00:00,10,10,20
"6683",10102,"St Johns","NL",47.56038,-52.71147,2018-10-06 09:00:00,17,7,24
"6684",10102,"St Johns","NL",47.56038,-52.71147,2018-10-06 10:00:00,21,3,24
"6685",10102,"St Johns","NL",47.56038,-52.71147,2018-10-06 11:00:00,22,4,26
"6686",10102,"St Johns","NL",47.56038,-52.71147,2018-10-06 12:00:00,21,1,22
"6687",10102,"St Johns","NL",47.56038,-52.71147,2018-10-06 13:00:00,21,3,24
"6688",10102,"St Johns","NL",47.56038,-52.71147,2018-10-06 14:00:00,21,2,23
"6689",10102,"St Johns","NL",47.56038,-52.71147,2018-10-06 15:00:00,19,4,23
"6690",10102,"St Johns","NL",47.56038,-52.71147,2018-10-06 16:00:00,20,3,23
"6691",10102,"St Johns","NL",47.56038,-52.71147,2018-10-06 17:00:00,20,4,24
"6692",10102,"St Johns","NL",47.56038,-52.71147,2018-10-06 18:00:00,19,6,25
"6693",10102,"St Johns","NL",47.56038,-52.71147,2018-10-06 19:00:00,10,16,26
"6694",10102,"St Johns","NL",47.56038,-52.71147,2018-10-06 20:00:00,14,12,26
"6695",10102,"St Johns","NL",47.56038,-52.71147,2018-10-06 21:00:00,14,7,21
"6696",10102,"St Johns","NL",47.56038,-52.71147,2018-10-06 22:00:00,6,10,16
"6697",10102,"St Johns","NL",47.56038,-52.71147,2018-10-06 23:00:00,1,11,12
"6698",10102,"St Johns","NL",47.56038,-52.71147,2018-10-07 00:00:00,0,9,9
"6699",10102,"St Johns","NL",47.56038,-52.71147,2018-10-07 01:00:00,1,9,10
"6700",10102,"St Johns","NL",47.56038,-52.71147,2018-10-07 02:00:00,2,8,10
"6701",10102,"St Johns","NL",47.56038,-52.71147,2018-10-07 03:00:00,0,7,7
"6702",10102,"St Johns","NL",47.56038,-52.71147,2018-10-07 04:00:00,0,8,8
"6703",10102,"St Johns","NL",47.56038,-52.71147,2018-10-07 05:00:00,1,7,8
"6704",10102,"St Johns","NL",47.56038,-52.71147,2018-10-07 06:00:00,4,6,10
"6705",10102,"St Johns","NL",47.56038,-52.71147,2018-10-07 07:00:00,6,5,11
"6706",10102,"St Johns","NL",47.56038,-52.71147,2018-10-07 08:00:00,6,7,13
"6707",10102,"St Johns","NL",47.56038,-52.71147,2018-10-07 09:00:00,5,6,11
"6708",10102,"St Johns","NL",47.56038,-52.71147,2018-10-07 10:00:00,11,6,17
"6709",10102,"St Johns","NL",47.56038,-52.71147,2018-10-07 11:00:00,20,1,21
"6710",10102,"St Johns","NL",47.56038,-52.71147,2018-10-07 12:00:00,22,1,23
"6711",10102,"St Johns","NL",47.56038,-52.71147,2018-10-07 13:00:00,23,0,23
"6712",10102,"St Johns","NL",47.56038,-52.71147,2018-10-07 14:00:00,20,1,21
"6713",10102,"St Johns","NL",47.56038,-52.71147,2018-10-07 15:00:00,21,0,21
"6714",10102,"St Johns","NL",47.56038,-52.71147,2018-10-07 16:00:00,29,1,30
"6715",10102,"St Johns","NL",47.56038,-52.71147,2018-10-07 17:00:00,29,1,30
"6716",10102,"St Johns","NL",47.56038,-52.71147,2018-10-07 18:00:00,26,2,28
"6717",10102,"St Johns","NL",47.56038,-52.71147,2018-10-07 19:00:00,24,4,28
"6718",10102,"St Johns","NL",47.56038,-52.71147,2018-10-07 20:00:00,22,3,25
"6719",10102,"St Johns","NL",47.56038,-52.71147,2018-10-07 21:00:00,22,3,25
"6720",10102,"St Johns","NL",47.56038,-52.71147,2018-10-07 22:00:00,22,3,25
"6721",10102,"St Johns","NL",47.56038,-52.71147,2018-10-07 23:00:00,22,1,23
"6722",10102,"St Johns","NL",47.56038,-52.71147,2018-10-08 00:00:00,22,1,23
"6723",10102,"St Johns","NL",47.56038,-52.71147,2018-10-08 01:00:00,22,1,23
"6724",10102,"St Johns","NL",47.56038,-52.71147,2018-10-08 02:00:00,24,0,24
"6725",10102,"St Johns","NL",47.56038,-52.71147,2018-10-08 03:00:00,24,0,24
"6726",10102,"St Johns","NL",47.56038,-52.71147,2018-10-08 04:00:00,23,2,25
"6727",10102,"St Johns","NL",47.56038,-52.71147,2018-10-08 05:00:00,15,6,21
"6728",10102,"St Johns","NL",47.56038,-52.71147,2018-10-08 06:00:00,13,7,20
"6729",10102,"St Johns","NL",47.56038,-52.71147,2018-10-08 07:00:00,8,12,20
"6730",10102,"St Johns","NL",47.56038,-52.71147,2018-10-08 08:00:00,14,10,24
"6731",10102,"St Johns","NL",47.56038,-52.71147,2018-10-08 09:00:00,24,1,25
"6732",10102,"St Johns","NL",47.56038,-52.71147,2018-10-08 10:00:00,25,0,25
"6733",10102,"St Johns","NL",47.56038,-52.71147,2018-10-08 11:00:00,24,1,25
"6734",10102,"St Johns","NL",47.56038,-52.71147,2018-10-08 12:00:00,25,1,26
"6735",10102,"St Johns","NL",47.56038,-52.71147,2018-10-08 13:00:00,26,1,27
"6736",10102,"St Johns","NL",47.56038,-52.71147,2018-10-08 14:00:00,25,1,26
"6737",10102,"St Johns","NL",47.56038,-52.71147,2018-10-08 15:00:00,25,1,26
"6738",10102,"St Johns","NL",47.56038,-52.71147,2018-10-08 16:00:00,25,2,27
"6739",10102,"St Johns","NL",47.56038,-52.71147,2018-10-08 17:00:00,24,2,26
"6740",10102,"St Johns","NL",47.56038,-52.71147,2018-10-08 18:00:00,21,4,25
"6741",10102,"St Johns","NL",47.56038,-52.71147,2018-10-08 19:00:00,11,11,22
"6742",10102,"St Johns","NL",47.56038,-52.71147,2018-10-08 20:00:00,8,12,20
"6743",10102,"St Johns","NL",47.56038,-52.71147,2018-10-08 21:00:00,5,11,16
"6744",10102,"St Johns","NL",47.56038,-52.71147,2018-10-08 22:00:00,7,8,15
"6745",10102,"St Johns","NL",47.56038,-52.71147,2018-10-08 23:00:00,6,8,14
"6746",10102,"St Johns","NL",47.56038,-52.71147,2018-10-09 00:00:00,9,7,16
"6747",10102,"St Johns","NL",47.56038,-52.71147,2018-10-09 01:00:00,11,6,17
"6748",10102,"St Johns","NL",47.56038,-52.71147,2018-10-09 02:00:00,13,5,18
"6749",10102,"St Johns","NL",47.56038,-52.71147,2018-10-09 03:00:00,18,3,21
"6750",10102,"St Johns","NL",47.56038,-52.71147,2018-10-09 04:00:00,18,4,22
"6751",10102,"St Johns","NL",47.56038,-52.71147,2018-10-09 05:00:00,16,4,20
"6752",10102,"St Johns","NL",47.56038,-52.71147,2018-10-09 06:00:00,12,10,22
"6753",10102,"St Johns","NL",47.56038,-52.71147,2018-10-09 07:00:00,6,16,22
"6754",10102,"St Johns","NL",47.56038,-52.71147,2018-10-09 08:00:00,7,17,24
"6755",10102,"St Johns","NL",47.56038,-52.71147,2018-10-09 09:00:00,16,8,24
"6756",10102,"St Johns","NL",47.56038,-52.71147,2018-10-09 10:00:00,23,3,26
"6757",10102,"St Johns","NL",47.56038,-52.71147,2018-10-09 11:00:00,23,3,26
"6758",10102,"St Johns","NL",47.56038,-52.71147,2018-10-09 12:00:00,24,2,26
"6759",10102,"St Johns","NL",47.56038,-52.71147,2018-10-09 13:00:00,25,4,29
"6760",10102,"St Johns","NL",47.56038,-52.71147,2018-10-09 14:00:00,23,6,29
"6761",10102,"St Johns","NL",47.56038,-52.71147,2018-10-09 15:00:00,20,8,28
"6762",10102,"St Johns","NL",47.56038,-52.71147,2018-10-09 16:00:00,21,8,29
"6763",10102,"St Johns","NL",47.56038,-52.71147,2018-10-09 17:00:00,16,13,29
"6764",10102,"St Johns","NL",47.56038,-52.71147,2018-10-09 18:00:00,17,10,27
"6765",10102,"St Johns","NL",47.56038,-52.71147,2018-10-09 19:00:00,16,8,24
"6766",10102,"St Johns","NL",47.56038,-52.71147,2018-10-09 20:00:00,19,5,24
"6767",10102,"St Johns","NL",47.56038,-52.71147,2018-10-09 21:00:00,17,6,23
"6768",10102,"St Johns","NL",47.56038,-52.71147,2018-10-09 22:00:00,16,6,22
"6769",10102,"St Johns","NL",47.56038,-52.71147,2018-10-09 23:00:00,17,5,22
"6770",10102,"St Johns","NL",47.56038,-52.71147,2018-10-10 00:00:00,6,15,21
"6771",10102,"St Johns","NL",47.56038,-52.71147,2018-10-10 01:00:00,7,16,23
"6772",10102,"St Johns","NL",47.56038,-52.71147,2018-10-10 02:00:00,16,10,26
"6773",10102,"St Johns","NL",47.56038,-52.71147,2018-10-10 03:00:00,12,16,28
"6774",10102,"St Johns","NL",47.56038,-52.71147,2018-10-10 04:00:00,24,6,30
"6775",10102,"St Johns","NL",47.56038,-52.71147,2018-10-10 05:00:00,17,15,32
"6776",10102,"St Johns","NL",47.56038,-52.71147,2018-10-10 06:00:00,14,19,33
"6777",10102,"St Johns","NL",47.56038,-52.71147,2018-10-10 07:00:00,10,23,33
"6778",10102,"St Johns","NL",47.56038,-52.71147,2018-10-10 08:00:00,18,13,31
"6779",10102,"St Johns","NL",47.56038,-52.71147,2018-10-10 09:00:00,17,16,33
"6780",10102,"St Johns","NL",47.56038,-52.71147,2018-10-10 10:00:00,23,8,31
"6781",10102,"St Johns","NL",47.56038,-52.71147,2018-10-10 11:00:00,25,5,30
"6782",10102,"St Johns","NL",47.56038,-52.71147,2018-10-10 12:00:00,25,3,28
"6783",10102,"St Johns","NL",47.56038,-52.71147,2018-10-10 13:00:00,25,3,28
"6784",10102,"St Johns","NL",47.56038,-52.71147,2018-10-10 14:00:00,25,3,28
"6785",10102,"St Johns","NL",47.56038,-52.71147,2018-10-10 15:00:00,21,3,24
"6786",10102,"St Johns","NL",47.56038,-52.71147,2018-10-10 16:00:00,22,3,25
"6787",10102,"St Johns","NL",47.56038,-52.71147,2018-10-10 17:00:00,26,2,28
"6788",10102,"St Johns","NL",47.56038,-52.71147,2018-10-10 18:00:00,26,3,29
"6789",10102,"St Johns","NL",47.56038,-52.71147,2018-10-10 19:00:00,23,3,26
"6790",10102,"St Johns","NL",47.56038,-52.71147,2018-10-10 20:00:00,21,2,23
"6791",10102,"St Johns","NL",47.56038,-52.71147,2018-10-10 21:00:00,23,2,25
"6792",10102,"St Johns","NL",47.56038,-52.71147,2018-10-10 22:00:00,26,2,28
"6793",10102,"St Johns","NL",47.56038,-52.71147,2018-10-10 23:00:00,25,3,28
"6794",10102,"St Johns","NL",47.56038,-52.71147,2018-10-11 00:00:00,27,2,29
"6795",10102,"St Johns","NL",47.56038,-52.71147,2018-10-11 01:00:00,27,1,28
"6796",10102,"St Johns","NL",47.56038,-52.71147,2018-10-11 02:00:00,28,1,29
"6797",10102,"St Johns","NL",47.56038,-52.71147,2018-10-11 03:00:00,28,1,29
"6798",10102,"St Johns","NL",47.56038,-52.71147,2018-10-11 04:00:00,29,1,30
"6799",10102,"St Johns","NL",47.56038,-52.71147,2018-10-11 05:00:00,29,1,30
"6800",10102,"St Johns","NL",47.56038,-52.71147,2018-10-11 06:00:00,30,2,32
"6801",10102,"St Johns","NL",47.56038,-52.71147,2018-10-11 07:00:00,28,3,31
"6802",10102,"St Johns","NL",47.56038,-52.71147,2018-10-11 08:00:00,26,5,31
"6803",10102,"St Johns","NL",47.56038,-52.71147,2018-10-11 09:00:00,26,4,30
"6804",10102,"St Johns","NL",47.56038,-52.71147,2018-10-11 10:00:00,27,2,29
"6805",10102,"St Johns","NL",47.56038,-52.71147,2018-10-11 11:00:00,27,3,30
"6806",10102,"St Johns","NL",47.56038,-52.71147,2018-10-11 12:00:00,27,3,30
"6807",10102,"St Johns","NL",47.56038,-52.71147,2018-10-11 13:00:00,28,3,31
"6808",10102,"St Johns","NL",47.56038,-52.71147,2018-10-11 14:00:00,28,3,31
"6809",10102,"St Johns","NL",47.56038,-52.71147,2018-10-11 15:00:00,28,4,32
"6810",10102,"St Johns","NL",47.56038,-52.71147,2018-10-11 16:00:00,27,3,30
"6811",10102,"St Johns","NL",47.56038,-52.71147,2018-10-11 17:00:00,27,3,30
"6812",10102,"St Johns","NL",47.56038,-52.71147,2018-10-11 18:00:00,27,4,31
"6813",10102,"St Johns","NL",47.56038,-52.71147,2018-10-11 19:00:00,25,6,31
"6814",10102,"St Johns","NL",47.56038,-52.71147,2018-10-11 20:00:00,27,5,32
"6815",10102,"St Johns","NL",47.56038,-52.71147,2018-10-11 21:00:00,27,4,31
"6816",10102,"St Johns","NL",47.56038,-52.71147,2018-10-11 22:00:00,26,5,31
"6817",10102,"St Johns","NL",47.56038,-52.71147,2018-10-11 23:00:00,26,4,30
"6818",10102,"St Johns","NL",47.56038,-52.71147,2018-10-12 00:00:00,27,3,30
"6819",10102,"St Johns","NL",47.56038,-52.71147,2018-10-12 01:00:00,28,1,29
"6820",10102,"St Johns","NL",47.56038,-52.71147,2018-10-12 02:00:00,23,5,28
"6821",10102,"St Johns","NL",47.56038,-52.71147,2018-10-12 03:00:00,19,4,23
"6822",10102,"St Johns","NL",47.56038,-52.71147,2018-10-12 04:00:00,19,4,23
"6823",10102,"St Johns","NL",47.56038,-52.71147,2018-10-12 05:00:00,17,5,22
"6824",10102,"St Johns","NL",47.56038,-52.71147,2018-10-12 06:00:00,12,9,21
"6825",10102,"St Johns","NL",47.56038,-52.71147,2018-10-12 07:00:00,4,17,21
"6826",10102,"St Johns","NL",47.56038,-52.71147,2018-10-12 08:00:00,1,22,23
"6827",10102,"St Johns","NL",47.56038,-52.71147,2018-10-12 09:00:00,11,17,28
"6828",10102,"St Johns","NL",47.56038,-52.71147,2018-10-12 10:00:00,22,8,30
"6829",10102,"St Johns","NL",47.56038,-52.71147,2018-10-12 11:00:00,24,9,33
"6830",10102,"St Johns","NL",47.56038,-52.71147,2018-10-12 12:00:00,27,5,32
"6831",10102,"St Johns","NL",47.56038,-52.71147,2018-10-12 13:00:00,27,5,32
"6832",10102,"St Johns","NL",47.56038,-52.71147,2018-10-12 14:00:00,22,11,33
"6833",10102,"St Johns","NL",47.56038,-52.71147,2018-10-12 15:00:00,19,12,31
"6834",10102,"St Johns","NL",47.56038,-52.71147,2018-10-12 16:00:00,23,9,32
"6835",10102,"St Johns","NL",47.56038,-52.71147,2018-10-12 17:00:00,26,6,32
"6836",10102,"St Johns","NL",47.56038,-52.71147,2018-10-12 18:00:00,26,7,33
"6837",10102,"St Johns","NL",47.56038,-52.71147,2018-10-12 19:00:00,29,6,35
"6838",10102,"St Johns","NL",47.56038,-52.71147,2018-10-12 20:00:00,33,2,35
"6839",10102,"St Johns","NL",47.56038,-52.71147,2018-10-12 21:00:00,28,7,35
"6840",10102,"St Johns","NL",47.56038,-52.71147,2018-10-12 22:00:00,35,1,36
"6841",10102,"St Johns","NL",47.56038,-52.71147,2018-10-12 23:00:00,36,1,37
"6842",10102,"St Johns","NL",47.56038,-52.71147,2018-10-13 00:00:00,35,1,36
"6843",10102,"St Johns","NL",47.56038,-52.71147,2018-10-13 01:00:00,36,1,37
"6844",10102,"St Johns","NL",47.56038,-52.71147,2018-10-13 02:00:00,36,1,37
"6845",10102,"St Johns","NL",47.56038,-52.71147,2018-10-13 03:00:00,32,4,36
"6846",10102,"St Johns","NL",47.56038,-52.71147,2018-10-13 04:00:00,25,10,35
"6847",10102,"St Johns","NL",47.56038,-52.71147,2018-10-13 05:00:00,24,10,34
"6848",10102,"St Johns","NL",47.56038,-52.71147,2018-10-13 06:00:00,25,7,32
"6849",10102,"St Johns","NL",47.56038,-52.71147,2018-10-13 07:00:00,28,5,33
"6850",10102,"St Johns","NL",47.56038,-52.71147,2018-10-13 08:00:00,30,1,31
"6851",10102,"St Johns","NL",47.56038,-52.71147,2018-10-13 09:00:00,29,1,30
"6852",10102,"St Johns","NL",47.56038,-52.71147,2018-10-13 10:00:00,28,3,31
"6853",10102,"St Johns","NL",47.56038,-52.71147,2018-10-13 11:00:00,25,6,31
"6854",10102,"St Johns","NL",47.56038,-52.71147,2018-10-13 12:00:00,23,8,31
"6855",10102,"St Johns","NL",47.56038,-52.71147,2018-10-13 13:00:00,20,14,34
"6856",10102,"St Johns","NL",47.56038,-52.71147,2018-10-13 14:00:00,27,6,33
"6857",10102,"St Johns","NL",47.56038,-52.71147,2018-10-13 15:00:00,23,11,34
"6858",10102,"St Johns","NL",47.56038,-52.71147,2018-10-13 16:00:00,28,6,34
"6859",10102,"St Johns","NL",47.56038,-52.71147,2018-10-13 17:00:00,29,5,34
"6860",10102,"St Johns","NL",47.56038,-52.71147,2018-10-13 18:00:00,29,3,32
"6861",10102,"St Johns","NL",47.56038,-52.71147,2018-10-13 19:00:00,27,3,30
"6862",10102,"St Johns","NL",47.56038,-52.71147,2018-10-13 20:00:00,28,4,32
"6863",10102,"St Johns","NL",47.56038,-52.71147,2018-10-13 21:00:00,25,5,30
"6864",10102,"St Johns","NL",47.56038,-52.71147,2018-10-13 22:00:00,26,2,28
"6865",10102,"St Johns","NL",47.56038,-52.71147,2018-10-13 23:00:00,24,3,27
"6866",10102,"St Johns","NL",47.56038,-52.71147,2018-10-14 00:00:00,20,3,23
"6867",10102,"St Johns","NL",47.56038,-52.71147,2018-10-14 01:00:00,20,2,22
"6868",10102,"St Johns","NL",47.56038,-52.71147,2018-10-14 02:00:00,18,3,21
"6869",10102,"St Johns","NL",47.56038,-52.71147,2018-10-14 03:00:00,14,4,18
"6870",10102,"St Johns","NL",47.56038,-52.71147,2018-10-14 04:00:00,13,2,15
"6871",10102,"St Johns","NL",47.56038,-52.71147,2018-10-14 05:00:00,19,0,19
"6872",10102,"St Johns","NL",47.56038,-52.71147,2018-10-14 06:00:00,17,1,18
"6873",10102,"St Johns","NL",47.56038,-52.71147,2018-10-14 07:00:00,14,2,16
"6874",10102,"St Johns","NL",47.56038,-52.71147,2018-10-14 08:00:00,21,1,22
"6875",10102,"St Johns","NL",47.56038,-52.71147,2018-10-14 09:00:00,21,1,22
"6876",10102,"St Johns","NL",47.56038,-52.71147,2018-10-14 10:00:00,18,1,19
"6877",10102,"St Johns","NL",47.56038,-52.71147,2018-10-14 11:00:00,20,0,20
"6878",10102,"St Johns","NL",47.56038,-52.71147,2018-10-14 12:00:00,22,1,23
"6879",10102,"St Johns","NL",47.56038,-52.71147,2018-10-14 13:00:00,23,1,24
"6880",10102,"St Johns","NL",47.56038,-52.71147,2018-10-14 14:00:00,24,1,25
"6881",10102,"St Johns","NL",47.56038,-52.71147,2018-10-14 15:00:00,25,1,26
"6882",10102,"St Johns","NL",47.56038,-52.71147,2018-10-14 16:00:00,25,1,26
"6883",10102,"St Johns","NL",47.56038,-52.71147,2018-10-14 17:00:00,27,1,28
"6884",10102,"St Johns","NL",47.56038,-52.71147,2018-10-14 18:00:00,27,2,29
"6885",10102,"St Johns","NL",47.56038,-52.71147,2018-10-14 19:00:00,26,1,27
"6886",10102,"St Johns","NL",47.56038,-52.71147,2018-10-14 20:00:00,23,1,24
"6887",10102,"St Johns","NL",47.56038,-52.71147,2018-10-14 21:00:00,19,1,20
"6888",10102,"St Johns","NL",47.56038,-52.71147,2018-10-14 22:00:00,19,1,20
"6889",10102,"St Johns","NL",47.56038,-52.71147,2018-10-14 23:00:00,19,1,20
"6890",10102,"St Johns","NL",47.56038,-52.71147,2018-10-15 00:00:00,21,0,21
"6891",10102,"St Johns","NL",47.56038,-52.71147,2018-10-15 01:00:00,22,0,22
"6892",10102,"St Johns","NL",47.56038,-52.71147,2018-10-15 02:00:00,22,1,23
"6893",10102,"St Johns","NL",47.56038,-52.71147,2018-10-15 03:00:00,21,0,21
"6894",10102,"St Johns","NL",47.56038,-52.71147,2018-10-15 04:00:00,21,0,21
"6895",10102,"St Johns","NL",47.56038,-52.71147,2018-10-15 05:00:00,20,0,20
"6896",10102,"St Johns","NL",47.56038,-52.71147,2018-10-15 06:00:00,19,1,20
"6897",10102,"St Johns","NL",47.56038,-52.71147,2018-10-15 07:00:00,17,2,19
"6898",10102,"St Johns","NL",47.56038,-52.71147,2018-10-15 08:00:00,17,2,19
"6899",10102,"St Johns","NL",47.56038,-52.71147,2018-10-15 09:00:00,16,3,19
"6900",10102,"St Johns","NL",47.56038,-52.71147,2018-10-15 10:00:00,17,3,20
"6901",10102,"St Johns","NL",47.56038,-52.71147,2018-10-15 11:00:00,19,2,21
"6902",10102,"St Johns","NL",47.56038,-52.71147,2018-10-15 12:00:00,19,1,20
"6903",10102,"St Johns","NL",47.56038,-52.71147,2018-10-15 13:00:00,19,2,21
"6904",10102,"St Johns","NL",47.56038,-52.71147,2018-10-15 14:00:00,18,2,20
"6905",10102,"St Johns","NL",47.56038,-52.71147,2018-10-15 15:00:00,19,2,21
"6906",10102,"St Johns","NL",47.56038,-52.71147,2018-10-15 16:00:00,19,2,21
"6907",10102,"St Johns","NL",47.56038,-52.71147,2018-10-15 17:00:00,18,4,22
"6908",10102,"St Johns","NL",47.56038,-52.71147,2018-10-15 18:00:00,15,6,21
"6909",10102,"St Johns","NL",47.56038,-52.71147,2018-10-15 19:00:00,10,9,19
"6910",10102,"St Johns","NL",47.56038,-52.71147,2018-10-15 20:00:00,9,7,16
"6911",10102,"St Johns","NL",47.56038,-52.71147,2018-10-15 21:00:00,9,6,15
"6912",10102,"St Johns","NL",47.56038,-52.71147,2018-10-15 22:00:00,14,5,19
"6913",10102,"St Johns","NL",47.56038,-52.71147,2018-10-15 23:00:00,16,6,22
"6914",10102,"St Johns","NL",47.56038,-52.71147,2018-10-16 00:00:00,16,6,22
"6915",10102,"St Johns","NL",47.56038,-52.71147,2018-10-16 01:00:00,16,4,20
"6916",10102,"St Johns","NL",47.56038,-52.71147,2018-10-16 02:00:00,15,3,18
"6917",10102,"St Johns","NL",47.56038,-52.71147,2018-10-16 03:00:00,16,2,18
"6918",10102,"St Johns","NL",47.56038,-52.71147,2018-10-16 04:00:00,15,3,18
"6919",10102,"St Johns","NL",47.56038,-52.71147,2018-10-16 05:00:00,17,3,20
"6920",10102,"St Johns","NL",47.56038,-52.71147,2018-10-16 06:00:00,11,8,19
"6921",10102,"St Johns","NL",47.56038,-52.71147,2018-10-16 07:00:00,23,7,30
"6922",10102,"St Johns","NL",47.56038,-52.71147,2018-10-16 08:00:00,28,5,33
"6923",10102,"St Johns","NL",47.56038,-52.71147,2018-10-16 09:00:00,30,4,34
"6924",10102,"St Johns","NL",47.56038,-52.71147,2018-10-16 10:00:00,31,3,34
"6925",10102,"St Johns","NL",47.56038,-52.71147,2018-10-16 11:00:00,30,3,33
"6926",10102,"St Johns","NL",47.56038,-52.71147,2018-10-16 12:00:00,31,2,33
"6927",10102,"St Johns","NL",47.56038,-52.71147,2018-10-16 13:00:00,33,1,34
"6928",10102,"St Johns","NL",47.56038,-52.71147,2018-10-16 14:00:00,34,1,35
"6929",10102,"St Johns","NL",47.56038,-52.71147,2018-10-16 15:00:00,36,2,38
"6930",10102,"St Johns","NL",47.56038,-52.71147,2018-10-16 16:00:00,34,1,35
"6931",10102,"St Johns","NL",47.56038,-52.71147,2018-10-16 17:00:00,29,2,31
"6932",10102,"St Johns","NL",47.56038,-52.71147,2018-10-16 18:00:00,29,1,30
"6933",10102,"St Johns","NL",47.56038,-52.71147,2018-10-16 19:00:00,22,1,23
"6934",10102,"St Johns","NL",47.56038,-52.71147,2018-10-16 20:00:00,21,0,21
"6935",10102,"St Johns","NL",47.56038,-52.71147,2018-10-16 21:00:00,21,0,21
"6936",10102,"St Johns","NL",47.56038,-52.71147,2018-10-16 22:00:00,22,0,22
"6937",10102,"St Johns","NL",47.56038,-52.71147,2018-10-16 23:00:00,24,0,24
"6938",10102,"St Johns","NL",47.56038,-52.71147,2018-10-17 00:00:00,23,0,23
"6939",10102,"St Johns","NL",47.56038,-52.71147,2018-10-17 01:00:00,24,0,24
"6940",10102,"St Johns","NL",47.56038,-52.71147,2018-10-17 02:00:00,24,0,24
"6941",10102,"St Johns","NL",47.56038,-52.71147,2018-10-17 03:00:00,24,0,24
"6942",10102,"St Johns","NL",47.56038,-52.71147,2018-10-17 04:00:00,24,0,24
"6943",10102,"St Johns","NL",47.56038,-52.71147,2018-10-17 05:00:00,24,0,24
"6944",10102,"St Johns","NL",47.56038,-52.71147,2018-10-17 06:00:00,24,1,25
"6945",10102,"St Johns","NL",47.56038,-52.71147,2018-10-17 07:00:00,22,2,24
"6946",10102,"St Johns","NL",47.56038,-52.71147,2018-10-17 08:00:00,22,3,25
"6947",10102,"St Johns","NL",47.56038,-52.71147,2018-10-17 09:00:00,21,2,23
"6948",10102,"St Johns","NL",47.56038,-52.71147,2018-10-17 10:00:00,23,2,25
"6949",10102,"St Johns","NL",47.56038,-52.71147,2018-10-17 11:00:00,23,2,25
"6950",10102,"St Johns","NL",47.56038,-52.71147,2018-10-17 12:00:00,24,2,26
"6951",10102,"St Johns","NL",47.56038,-52.71147,2018-10-17 13:00:00,25,2,27
"6952",10102,"St Johns","NL",47.56038,-52.71147,2018-10-17 14:00:00,27,2,29
"6953",10102,"St Johns","NL",47.56038,-52.71147,2018-10-17 15:00:00,29,3,32
"6954",10102,"St Johns","NL",47.56038,-52.71147,2018-10-17 16:00:00,29,3,32
"6955",10102,"St Johns","NL",47.56038,-52.71147,2018-10-17 17:00:00,29,4,33
"6956",10102,"St Johns","NL",47.56038,-52.71147,2018-10-17 18:00:00,29,3,32
"6957",10102,"St Johns","NL",47.56038,-52.71147,2018-10-17 19:00:00,24,5,29
"6958",10102,"St Johns","NL",47.56038,-52.71147,2018-10-17 20:00:00,24,4,28
"6959",10102,"St Johns","NL",47.56038,-52.71147,2018-10-17 21:00:00,23,4,27
"6960",10102,"St Johns","NL",47.56038,-52.71147,2018-10-17 22:00:00,25,3,28
"6961",10102,"St Johns","NL",47.56038,-52.71147,2018-10-17 23:00:00,23,3,26
"6962",10102,"St Johns","NL",47.56038,-52.71147,2018-10-18 00:00:00,18,3,21
"6963",10102,"St Johns","NL",47.56038,-52.71147,2018-10-18 01:00:00,17,3,20
"6964",10102,"St Johns","NL",47.56038,-52.71147,2018-10-18 02:00:00,15,5,20
"6965",10102,"St Johns","NL",47.56038,-52.71147,2018-10-18 03:00:00,4,13,17
"6966",10102,"St Johns","NL",47.56038,-52.71147,2018-10-18 04:00:00,5,9,14
"6967",10102,"St Johns","NL",47.56038,-52.71147,2018-10-18 05:00:00,16,8,24
"6968",10102,"St Johns","NL",47.56038,-52.71147,2018-10-18 06:00:00,20,9,29
"6969",10102,"St Johns","NL",47.56038,-52.71147,2018-10-18 07:00:00,30,3,33
"6970",10102,"St Johns","NL",47.56038,-52.71147,2018-10-18 08:00:00,30,4,34
"6971",10102,"St Johns","NL",47.56038,-52.71147,2018-10-18 09:00:00,30,3,33
"6972",10102,"St Johns","NL",47.56038,-52.71147,2018-10-18 10:00:00,29,4,33
"6973",10102,"St Johns","NL",47.56038,-52.71147,2018-10-18 11:00:00,29,3,32
"6974",10102,"St Johns","NL",47.56038,-52.71147,2018-10-18 12:00:00,28,4,32
"6975",10102,"St Johns","NL",47.56038,-52.71147,2018-10-18 13:00:00,29,3,32
"6976",10102,"St Johns","NL",47.56038,-52.71147,2018-10-18 14:00:00,30,3,33
"6977",10102,"St Johns","NL",47.56038,-52.71147,2018-10-18 15:00:00,33,4,37
"6978",10102,"St Johns","NL",47.56038,-52.71147,2018-10-18 16:00:00,32,4,36
"6979",10102,"St Johns","NL",47.56038,-52.71147,2018-10-18 17:00:00,31,5,36
"6980",10102,"St Johns","NL",47.56038,-52.71147,2018-10-18 18:00:00,29,3,32
"6981",10102,"St Johns","NL",47.56038,-52.71147,2018-10-18 19:00:00,26,3,29
"6982",10102,"St Johns","NL",47.56038,-52.71147,2018-10-18 20:00:00,24,3,27
"6983",10102,"St Johns","NL",47.56038,-52.71147,2018-10-18 21:00:00,22,2,24
"6984",10102,"St Johns","NL",47.56038,-52.71147,2018-10-18 22:00:00,22,2,24
"6985",10102,"St Johns","NL",47.56038,-52.71147,2018-10-18 23:00:00,20,2,22
"6986",10102,"St Johns","NL",47.56038,-52.71147,2018-10-19 00:00:00,20,1,21
"6987",10102,"St Johns","NL",47.56038,-52.71147,2018-10-19 01:00:00,23,2,25
"6988",10102,"St Johns","NL",47.56038,-52.71147,2018-10-19 02:00:00,24,1,25
"6989",10102,"St Johns","NL",47.56038,-52.71147,2018-10-19 03:00:00,24,1,25
"6990",10102,"St Johns","NL",47.56038,-52.71147,2018-10-19 04:00:00,25,1,26
"6991",10102,"St Johns","NL",47.56038,-52.71147,2018-10-19 05:00:00,25,1,26
"6992",10102,"St Johns","NL",47.56038,-52.71147,2018-10-19 06:00:00,25,2,27
"6993",10102,"St Johns","NL",47.56038,-52.71147,2018-10-19 07:00:00,23,3,26
"6994",10102,"St Johns","NL",47.56038,-52.71147,2018-10-19 08:00:00,22,3,25
"6995",10102,"St Johns","NL",47.56038,-52.71147,2018-10-19 09:00:00,23,3,26
"6996",10102,"St Johns","NL",47.56038,-52.71147,2018-10-19 10:00:00,25,3,28
"6997",10102,"St Johns","NL",47.56038,-52.71147,2018-10-19 11:00:00,26,3,29
"6998",10102,"St Johns","NL",47.56038,-52.71147,2018-10-19 12:00:00,27,5,32
"6999",10102,"St Johns","NL",47.56038,-52.71147,2018-10-19 13:00:00,28,3,31
"7000",10102,"St Johns","NL",47.56038,-52.71147,2018-10-19 14:00:00,29,3,32
"7001",10102,"St Johns","NL",47.56038,-52.71147,2018-10-19 15:00:00,28,4,32
"7002",10102,"St Johns","NL",47.56038,-52.71147,2018-10-19 16:00:00,28,6,34
"7003",10102,"St Johns","NL",47.56038,-52.71147,2018-10-19 17:00:00,26,7,33
"7004",10102,"St Johns","NL",47.56038,-52.71147,2018-10-19 18:00:00,27,6,33
"7005",10102,"St Johns","NL",47.56038,-52.71147,2018-10-19 19:00:00,24,9,33
"7006",10102,"St Johns","NL",47.56038,-52.71147,2018-10-19 20:00:00,21,7,28
"7007",10102,"St Johns","NL",47.56038,-52.71147,2018-10-19 21:00:00,18,9,27
"7008",10102,"St Johns","NL",47.56038,-52.71147,2018-10-19 22:00:00,19,14,33
"7009",10102,"St Johns","NL",47.56038,-52.71147,2018-10-19 23:00:00,17,6,23
"7010",10102,"St Johns","NL",47.56038,-52.71147,2018-10-20 00:00:00,13,7,20
"7011",10102,"St Johns","NL",47.56038,-52.71147,2018-10-20 01:00:00,15,3,18
"7012",10102,"St Johns","NL",47.56038,-52.71147,2018-10-20 02:00:00,17,2,19
"7013",10102,"St Johns","NL",47.56038,-52.71147,2018-10-20 03:00:00,17,2,19
"7014",10102,"St Johns","NL",47.56038,-52.71147,2018-10-20 04:00:00,17,3,20
"7015",10102,"St Johns","NL",47.56038,-52.71147,2018-10-20 05:00:00,14,3,17
"7016",10102,"St Johns","NL",47.56038,-52.71147,2018-10-20 06:00:00,15,3,18
"7017",10102,"St Johns","NL",47.56038,-52.71147,2018-10-20 07:00:00,19,4,23
"7018",10102,"St Johns","NL",47.56038,-52.71147,2018-10-20 08:00:00,18,6,24
"7019",10102,"St Johns","NL",47.56038,-52.71147,2018-10-20 09:00:00,25,5,30
"7020",10102,"St Johns","NL",47.56038,-52.71147,2018-10-20 10:00:00,28,3,31
"7021",10102,"St Johns","NL",47.56038,-52.71147,2018-10-20 11:00:00,30,2,32
"7022",10102,"St Johns","NL",47.56038,-52.71147,2018-10-20 12:00:00,32,1,33
"7023",10102,"St Johns","NL",47.56038,-52.71147,2018-10-20 13:00:00,33,2,35
"7024",10102,"St Johns","NL",47.56038,-52.71147,2018-10-20 14:00:00,34,2,36
"7025",10102,"St Johns","NL",47.56038,-52.71147,2018-10-20 15:00:00,33,1,34
"7026",10102,"St Johns","NL",47.56038,-52.71147,2018-10-20 16:00:00,32,2,34
"7027",10102,"St Johns","NL",47.56038,-52.71147,2018-10-20 17:00:00,30,3,33
"7028",10102,"St Johns","NL",47.56038,-52.71147,2018-10-20 18:00:00,33,2,35
"7029",10102,"St Johns","NL",47.56038,-52.71147,2018-10-20 19:00:00,33,2,35
"7030",10102,"St Johns","NL",47.56038,-52.71147,2018-10-20 20:00:00,34,1,35
"7031",10102,"St Johns","NL",47.56038,-52.71147,2018-10-20 21:00:00,34,1,35
"7032",10102,"St Johns","NL",47.56038,-52.71147,2018-10-20 22:00:00,33,1,34
"7033",10102,"St Johns","NL",47.56038,-52.71147,2018-10-20 23:00:00,33,1,34
"7034",10102,"St Johns","NL",47.56038,-52.71147,2018-10-21 00:00:00,32,1,33
"7035",10102,"St Johns","NL",47.56038,-52.71147,2018-10-21 01:00:00,33,1,34
"7036",10102,"St Johns","NL",47.56038,-52.71147,2018-10-21 02:00:00,33,0,33
"7037",10102,"St Johns","NL",47.56038,-52.71147,2018-10-21 03:00:00,33,1,34
"7038",10102,"St Johns","NL",47.56038,-52.71147,2018-10-21 04:00:00,33,0,33
"7039",10102,"St Johns","NL",47.56038,-52.71147,2018-10-21 05:00:00,33,0,33
"7040",10102,"St Johns","NL",47.56038,-52.71147,2018-10-21 06:00:00,33,0,33
"7041",10102,"St Johns","NL",47.56038,-52.71147,2018-10-21 07:00:00,32,1,33
"7042",10102,"St Johns","NL",47.56038,-52.71147,2018-10-21 08:00:00,31,2,33
"7043",10102,"St Johns","NL",47.56038,-52.71147,2018-10-21 09:00:00,31,2,33
"7044",10102,"St Johns","NL",47.56038,-52.71147,2018-10-21 10:00:00,31,1,32
"7045",10102,"St Johns","NL",47.56038,-52.71147,2018-10-21 11:00:00,30,1,31
"7046",10102,"St Johns","NL",47.56038,-52.71147,2018-10-21 12:00:00,30,0,30
"7047",10102,"St Johns","NL",47.56038,-52.71147,2018-10-21 13:00:00,31,1,32
"7048",10102,"St Johns","NL",47.56038,-52.71147,2018-10-21 14:00:00,31,0,31
"7049",10102,"St Johns","NL",47.56038,-52.71147,2018-10-21 15:00:00,32,1,33
"7050",10102,"St Johns","NL",47.56038,-52.71147,2018-10-21 16:00:00,32,1,33
"7051",10102,"St Johns","NL",47.56038,-52.71147,2018-10-21 17:00:00,34,1,35
"7052",10102,"St Johns","NL",47.56038,-52.71147,2018-10-21 18:00:00,33,1,34
"7053",10102,"St Johns","NL",47.56038,-52.71147,2018-10-21 19:00:00,34,1,35
"7054",10102,"St Johns","NL",47.56038,-52.71147,2018-10-21 20:00:00,34,1,35
"7055",10102,"St Johns","NL",47.56038,-52.71147,2018-10-21 21:00:00,34,1,35
"7056",10102,"St Johns","NL",47.56038,-52.71147,2018-10-21 22:00:00,33,0,33
"7057",10102,"St Johns","NL",47.56038,-52.71147,2018-10-21 23:00:00,33,0,33
"7058",10102,"St Johns","NL",47.56038,-52.71147,2018-10-22 00:00:00,33,0,33
"7059",10102,"St Johns","NL",47.56038,-52.71147,2018-10-22 01:00:00,33,1,34
"7060",10102,"St Johns","NL",47.56038,-52.71147,2018-10-22 02:00:00,33,0,33
"7061",10102,"St Johns","NL",47.56038,-52.71147,2018-10-22 03:00:00,33,0,33
"7062",10102,"St Johns","NL",47.56038,-52.71147,2018-10-22 04:00:00,33,0,33
"7063",10102,"St Johns","NL",47.56038,-52.71147,2018-10-22 05:00:00,32,1,33
"7064",10102,"St Johns","NL",47.56038,-52.71147,2018-10-22 06:00:00,31,1,32
"7065",10102,"St Johns","NL",47.56038,-52.71147,2018-10-22 07:00:00,28,1,29
"7066",10102,"St Johns","NL",47.56038,-52.71147,2018-10-22 08:00:00,26,3,29
"7067",10102,"St Johns","NL",47.56038,-52.71147,2018-10-22 09:00:00,29,2,31
"7068",10102,"St Johns","NL",47.56038,-52.71147,2018-10-22 10:00:00,28,2,30
"7069",10102,"St Johns","NL",47.56038,-52.71147,2018-10-22 11:00:00,28,2,30
"7070",10102,"St Johns","NL",47.56038,-52.71147,2018-10-22 12:00:00,18,7,25
"7071",10102,"St Johns","NL",47.56038,-52.71147,2018-10-22 13:00:00,20,5,25
"7072",10102,"St Johns","NL",47.56038,-52.71147,2018-10-22 14:00:00,20,5,25
"7073",10102,"St Johns","NL",47.56038,-52.71147,2018-10-22 15:00:00,23,3,26
"7074",10102,"St Johns","NL",47.56038,-52.71147,2018-10-22 16:00:00,21,3,24
"7075",10102,"St Johns","NL",47.56038,-52.71147,2018-10-22 17:00:00,19,3,22
"7076",10102,"St Johns","NL",47.56038,-52.71147,2018-10-22 18:00:00,17,3,20
"7077",10102,"St Johns","NL",47.56038,-52.71147,2018-10-22 19:00:00,13,5,18
"7078",10102,"St Johns","NL",47.56038,-52.71147,2018-10-22 20:00:00,17,4,21
"7079",10102,"St Johns","NL",47.56038,-52.71147,2018-10-22 21:00:00,19,3,22
"7080",10102,"St Johns","NL",47.56038,-52.71147,2018-10-22 22:00:00,21,3,24
"7081",10102,"St Johns","NL",47.56038,-52.71147,2018-10-22 23:00:00,20,3,23
"7082",10102,"St Johns","NL",47.56038,-52.71147,2018-10-23 00:00:00,16,3,19
"7083",10102,"St Johns","NL",47.56038,-52.71147,2018-10-23 01:00:00,15,2,17
"7084",10102,"St Johns","NL",47.56038,-52.71147,2018-10-23 02:00:00,16,2,18
"7085",10102,"St Johns","NL",47.56038,-52.71147,2018-10-23 03:00:00,19,2,21
"7086",10102,"St Johns","NL",47.56038,-52.71147,2018-10-23 04:00:00,25,2,27
"7087",10102,"St Johns","NL",47.56038,-52.71147,2018-10-23 05:00:00,22,2,24
"7088",10102,"St Johns","NL",47.56038,-52.71147,2018-10-23 06:00:00,18,5,23
"7089",10102,"St Johns","NL",47.56038,-52.71147,2018-10-23 07:00:00,16,7,23
"7090",10102,"St Johns","NL",47.56038,-52.71147,2018-10-23 08:00:00,13,12,25
"7091",10102,"St Johns","NL",47.56038,-52.71147,2018-10-23 09:00:00,18,8,26
"7092",10102,"St Johns","NL",47.56038,-52.71147,2018-10-23 10:00:00,20,7,27
"7093",10102,"St Johns","NL",47.56038,-52.71147,2018-10-23 11:00:00,25,5,30
"7094",10102,"St Johns","NL",47.56038,-52.71147,2018-10-23 12:00:00,27,7,34
"7095",10102,"St Johns","NL",47.56038,-52.71147,2018-10-23 13:00:00,28,6,34
"7096",10102,"St Johns","NL",47.56038,-52.71147,2018-10-23 14:00:00,27,5,32
"7097",10102,"St Johns","NL",47.56038,-52.71147,2018-10-23 15:00:00,28,4,32
"7098",10102,"St Johns","NL",47.56038,-52.71147,2018-10-23 16:00:00,26,5,31
"7099",10102,"St Johns","NL",47.56038,-52.71147,2018-10-23 17:00:00,27,5,32
"7100",10102,"St Johns","NL",47.56038,-52.71147,2018-10-23 18:00:00,19,10,29
"7101",10102,"St Johns","NL",47.56038,-52.71147,2018-10-23 19:00:00,11,17,28
"7102",10102,"St Johns","NL",47.56038,-52.71147,2018-10-23 20:00:00,15,9,24
"7103",10102,"St Johns","NL",47.56038,-52.71147,2018-10-23 21:00:00,16,7,23
"7104",10102,"St Johns","NL",47.56038,-52.71147,2018-10-23 22:00:00,16,5,21
"7105",10102,"St Johns","NL",47.56038,-52.71147,2018-10-23 23:00:00,19,3,22
"7106",10102,"St Johns","NL",47.56038,-52.71147,2018-10-24 00:00:00,16,5,21
"7107",10102,"St Johns","NL",47.56038,-52.71147,2018-10-24 01:00:00,4,15,19
"7108",10102,"St Johns","NL",47.56038,-52.71147,2018-10-24 02:00:00,5,12,17
"7109",10102,"St Johns","NL",47.56038,-52.71147,2018-10-24 03:00:00,3,11,14
"7110",10102,"St Johns","NL",47.56038,-52.71147,2018-10-24 04:00:00,2,10,12
"7111",10102,"St Johns","NL",47.56038,-52.71147,2018-10-24 05:00:00,0,10,10
"7112",10102,"St Johns","NL",47.56038,-52.71147,2018-10-24 06:00:00,0,15,15
"7113",10102,"St Johns","NL",47.56038,-52.71147,2018-10-24 07:00:00,0,13,13
"7114",10102,"St Johns","NL",47.56038,-52.71147,2018-10-24 08:00:00,0,17,17
"7115",10102,"St Johns","NL",47.56038,-52.71147,2018-10-24 09:00:00,0,24,24
"7116",10102,"St Johns","NL",47.56038,-52.71147,2018-10-24 10:00:00,15,16,31
"7117",10102,"St Johns","NL",47.56038,-52.71147,2018-10-24 11:00:00,23,11,34
"7118",10102,"St Johns","NL",47.56038,-52.71147,2018-10-24 12:00:00,27,5,32
"7119",10102,"St Johns","NL",47.56038,-52.71147,2018-10-24 13:00:00,27,7,34
"7120",10102,"St Johns","NL",47.56038,-52.71147,2018-10-24 14:00:00,29,8,37
"7121",10102,"St Johns","NL",47.56038,-52.71147,2018-10-24 15:00:00,29,7,36
"7122",10102,"St Johns","NL",47.56038,-52.71147,2018-10-24 16:00:00,27,10,37
"7123",10102,"St Johns","NL",47.56038,-52.71147,2018-10-24 17:00:00,27,9,36
"7124",10102,"St Johns","NL",47.56038,-52.71147,2018-10-24 18:00:00,25,10,35
"7125",10102,"St Johns","NL",47.56038,-52.71147,2018-10-24 19:00:00,29,6,35
"7126",10102,"St Johns","NL",47.56038,-52.71147,2018-10-24 20:00:00,30,5,35
"7127",10102,"St Johns","NL",47.56038,-52.71147,2018-10-24 21:00:00,29,7,36
"7128",10102,"St Johns","NL",47.56038,-52.71147,2018-10-24 22:00:00,32,6,38
"7129",10102,"St Johns","NL",47.56038,-52.71147,2018-10-24 23:00:00,32,5,37
"7130",10102,"St Johns","NL",47.56038,-52.71147,2018-10-25 00:00:00,32,5,37
"7131",10102,"St Johns","NL",47.56038,-52.71147,2018-10-25 01:00:00,32,5,37
"7132",10102,"St Johns","NL",47.56038,-52.71147,2018-10-25 02:00:00,31,5,36
"7133",10102,"St Johns","NL",47.56038,-52.71147,2018-10-25 03:00:00,29,7,36
"7134",10102,"St Johns","NL",47.56038,-52.71147,2018-10-25 04:00:00,28,6,34
"7135",10102,"St Johns","NL",47.56038,-52.71147,2018-10-25 05:00:00,28,6,34
"7136",10102,"St Johns","NL",47.56038,-52.71147,2018-10-25 06:00:00,28,6,34
"7137",10102,"St Johns","NL",47.56038,-52.71147,2018-10-25 07:00:00,27,6,33
"7138",10102,"St Johns","NL",47.56038,-52.71147,2018-10-25 08:00:00,27,6,33
"7139",10102,"St Johns","NL",47.56038,-52.71147,2018-10-25 09:00:00,28,6,34
"7140",10102,"St Johns","NL",47.56038,-52.71147,2018-10-25 10:00:00,27,7,34
"7141",10102,"St Johns","NL",47.56038,-52.71147,2018-10-25 11:00:00,27,6,33
"7142",10102,"St Johns","NL",47.56038,-52.71147,2018-10-25 12:00:00,27,4,31
"7143",10102,"St Johns","NL",47.56038,-52.71147,2018-10-25 13:00:00,27,4,31
"7144",10102,"St Johns","NL",47.56038,-52.71147,2018-10-25 14:00:00,27,4,31
"7145",10102,"St Johns","NL",47.56038,-52.71147,2018-10-25 15:00:00,24,7,31
"7146",10102,"St Johns","NL",47.56038,-52.71147,2018-10-25 16:00:00,19,12,31
"7147",10102,"St Johns","NL",47.56038,-52.71147,2018-10-25 17:00:00,27,3,30
"7148",10102,"St Johns","NL",47.56038,-52.71147,2018-10-25 18:00:00,22,6,28
"7149",10102,"St Johns","NL",47.56038,-52.71147,2018-10-25 19:00:00,22,5,27
"7150",10102,"St Johns","NL",47.56038,-52.71147,2018-10-25 20:00:00,19,3,22
"7151",10102,"St Johns","NL",47.56038,-52.71147,2018-10-25 21:00:00,18,3,21
"7152",10102,"St Johns","NL",47.56038,-52.71147,2018-10-25 22:00:00,27,4,31
"7153",10102,"St Johns","NL",47.56038,-52.71147,2018-10-25 23:00:00,30,2,32
"7154",10102,"St Johns","NL",47.56038,-52.71147,2018-10-26 00:00:00,30,1,31
"7155",10102,"St Johns","NL",47.56038,-52.71147,2018-10-26 01:00:00,27,3,30
"7156",10102,"St Johns","NL",47.56038,-52.71147,2018-10-26 02:00:00,25,2,27
"7157",10102,"St Johns","NL",47.56038,-52.71147,2018-10-26 03:00:00,27,1,28
"7158",10102,"St Johns","NL",47.56038,-52.71147,2018-10-26 04:00:00,28,0,28
"7159",10102,"St Johns","NL",47.56038,-52.71147,2018-10-26 05:00:00,27,0,27
"7160",10102,"St Johns","NL",47.56038,-52.71147,2018-10-26 06:00:00,24,3,27
"7161",10102,"St Johns","NL",47.56038,-52.71147,2018-10-26 07:00:00,21,3,24
"7162",10102,"St Johns","NL",47.56038,-52.71147,2018-10-26 08:00:00,18,4,22
"7163",10102,"St Johns","NL",47.56038,-52.71147,2018-10-26 09:00:00,19,2,21
"7164",10102,"St Johns","NL",47.56038,-52.71147,2018-10-26 10:00:00,20,2,22
"7165",10102,"St Johns","NL",47.56038,-52.71147,2018-10-26 11:00:00,21,2,23
"7166",10102,"St Johns","NL",47.56038,-52.71147,2018-10-26 12:00:00,25,1,26
"7167",10102,"St Johns","NL",47.56038,-52.71147,2018-10-26 13:00:00,29,1,30
"7168",10102,"St Johns","NL",47.56038,-52.71147,2018-10-26 14:00:00,30,1,31
"7169",10102,"St Johns","NL",47.56038,-52.71147,2018-10-26 15:00:00,31,2,33
"7170",10102,"St Johns","NL",47.56038,-52.71147,2018-10-26 16:00:00,30,2,32
"7171",10102,"St Johns","NL",47.56038,-52.71147,2018-10-26 17:00:00,27,4,31
"7172",10102,"St Johns","NL",47.56038,-52.71147,2018-10-26 18:00:00,26,2,28
"7173",10102,"St Johns","NL",47.56038,-52.71147,2018-10-26 19:00:00,26,2,28
"7174",10102,"St Johns","NL",47.56038,-52.71147,2018-10-26 20:00:00,23,4,27
"7175",10102,"St Johns","NL",47.56038,-52.71147,2018-10-26 21:00:00,29,2,31
"7176",10102,"St Johns","NL",47.56038,-52.71147,2018-10-26 22:00:00,29,2,31
"7177",10102,"St Johns","NL",47.56038,-52.71147,2018-10-26 23:00:00,26,3,29
"7178",10102,"St Johns","NL",47.56038,-52.71147,2018-10-27 00:00:00,25,2,27
"7179",10102,"St Johns","NL",47.56038,-52.71147,2018-10-27 01:00:00,24,2,26
"7180",10102,"St Johns","NL",47.56038,-52.71147,2018-10-27 02:00:00,26,2,28
"7181",10102,"St Johns","NL",47.56038,-52.71147,2018-10-27 03:00:00,28,1,29
"7182",10102,"St Johns","NL",47.56038,-52.71147,2018-10-27 04:00:00,29,1,30
"7183",10102,"St Johns","NL",47.56038,-52.71147,2018-10-27 05:00:00,26,1,27
"7184",10102,"St Johns","NL",47.56038,-52.71147,2018-10-27 06:00:00,24,3,27
"7185",10102,"St Johns","NL",47.56038,-52.71147,2018-10-27 07:00:00,26,4,30
"7186",10102,"St Johns","NL",47.56038,-52.71147,2018-10-27 08:00:00,28,3,31
"7187",10102,"St Johns","NL",47.56038,-52.71147,2018-10-27 09:00:00,29,3,32
"7188",10102,"St Johns","NL",47.56038,-52.71147,2018-10-27 10:00:00,30,2,32
"7189",10102,"St Johns","NL",47.56038,-52.71147,2018-10-27 11:00:00,32,1,33
"7190",10102,"St Johns","NL",47.56038,-52.71147,2018-10-27 12:00:00,33,2,35
"7191",10102,"St Johns","NL",47.56038,-52.71147,2018-10-27 13:00:00,33,3,36
"7192",10102,"St Johns","NL",47.56038,-52.71147,2018-10-27 14:00:00,34,3,37
"7193",10102,"St Johns","NL",47.56038,-52.71147,2018-10-27 15:00:00,33,3,36
"7194",10102,"St Johns","NL",47.56038,-52.71147,2018-10-27 16:00:00,33,3,36
"7195",10102,"St Johns","NL",47.56038,-52.71147,2018-10-27 17:00:00,32,4,36
"7196",10102,"St Johns","NL",47.56038,-52.71147,2018-10-27 18:00:00,29,6,35
"7197",10102,"St Johns","NL",47.56038,-52.71147,2018-10-27 19:00:00,29,5,34
"7198",10102,"St Johns","NL",47.56038,-52.71147,2018-10-27 20:00:00,26,7,33
"7199",10102,"St Johns","NL",47.56038,-52.71147,2018-10-27 21:00:00,22,9,31
"7200",10102,"St Johns","NL",47.56038,-52.71147,2018-10-27 22:00:00,20,8,28
"7201",10102,"St Johns","NL",47.56038,-52.71147,2018-10-27 23:00:00,19,5,24
"7202",10102,"St Johns","NL",47.56038,-52.71147,2018-10-28 00:00:00,16,7,23
"7203",10102,"St Johns","NL",47.56038,-52.71147,2018-10-28 01:00:00,12,10,22
"7204",10102,"St Johns","NL",47.56038,-52.71147,2018-10-28 02:00:00,9,10,19
"7205",10102,"St Johns","NL",47.56038,-52.71147,2018-10-28 03:00:00,6,12,18
"7206",10102,"St Johns","NL",47.56038,-52.71147,2018-10-28 04:00:00,3,12,15
"7207",10102,"St Johns","NL",47.56038,-52.71147,2018-10-28 05:00:00,0,12,12
"7208",10102,"St Johns","NL",47.56038,-52.71147,2018-10-28 06:00:00,1,12,13
"7209",10102,"St Johns","NL",47.56038,-52.71147,2018-10-28 07:00:00,0,14,14
"7210",10102,"St Johns","NL",47.56038,-52.71147,2018-10-28 08:00:00,1,15,16
"7211",10102,"St Johns","NL",47.56038,-52.71147,2018-10-28 09:00:00,8,20,28
"7212",10102,"St Johns","NL",47.56038,-52.71147,2018-10-28 10:00:00,24,10,34
"7213",10102,"St Johns","NL",47.56038,-52.71147,2018-10-28 11:00:00,23,12,35
"7214",10102,"St Johns","NL",47.56038,-52.71147,2018-10-28 12:00:00,28,5,33
"7215",10102,"St Johns","NL",47.56038,-52.71147,2018-10-28 13:00:00,23,11,34
"7216",10102,"St Johns","NL",47.56038,-52.71147,2018-10-28 14:00:00,25,9,34
"7217",10102,"St Johns","NL",47.56038,-52.71147,2018-10-28 15:00:00,30,3,33
"7218",10102,"St Johns","NL",47.56038,-52.71147,2018-10-28 16:00:00,29,4,33
"7219",10102,"St Johns","NL",47.56038,-52.71147,2018-10-28 17:00:00,24,10,34
"7220",10102,"St Johns","NL",47.56038,-52.71147,2018-10-28 18:00:00,27,8,35
"7221",10102,"St Johns","NL",47.56038,-52.71147,2018-10-28 19:00:00,30,5,35
"7222",10102,"St Johns","NL",47.56038,-52.71147,2018-10-28 20:00:00,28,8,36
"7223",10102,"St Johns","NL",47.56038,-52.71147,2018-10-28 21:00:00,28,7,35
"7224",10102,"St Johns","NL",47.56038,-52.71147,2018-10-28 22:00:00,27,10,37
"7225",10102,"St Johns","NL",47.56038,-52.71147,2018-10-28 23:00:00,30,7,37
"7226",10102,"St Johns","NL",47.56038,-52.71147,2018-10-29 00:00:00,28,8,36
"7227",10102,"St Johns","NL",47.56038,-52.71147,2018-10-29 01:00:00,27,9,36
"7228",10102,"St Johns","NL",47.56038,-52.71147,2018-10-29 02:00:00,25,11,36
"7229",10102,"St Johns","NL",47.56038,-52.71147,2018-10-29 03:00:00,30,6,36
"7230",10102,"St Johns","NL",47.56038,-52.71147,2018-10-29 04:00:00,24,11,35
"7231",10102,"St Johns","NL",47.56038,-52.71147,2018-10-29 05:00:00,28,8,36
"7232",10102,"St Johns","NL",47.56038,-52.71147,2018-10-29 06:00:00,33,3,36
"7233",10102,"St Johns","NL",47.56038,-52.71147,2018-10-29 07:00:00,29,4,33
"7234",10102,"St Johns","NL",47.56038,-52.71147,2018-10-29 08:00:00,16,17,33
"7235",10102,"St Johns","NL",47.56038,-52.71147,2018-10-29 09:00:00,24,4,28
"7236",10102,"St Johns","NL",47.56038,-52.71147,2018-10-29 10:00:00,19,10,29
"7237",10102,"St Johns","NL",47.56038,-52.71147,2018-10-29 11:00:00,NA,8,NA
"7238",10102,"St Johns","NL",47.56038,-52.71147,2018-10-29 12:00:00,12,3,15
"7239",10102,"St Johns","NL",47.56038,-52.71147,2018-10-29 13:00:00,13,NA,NA
"7240",10102,"St Johns","NL",47.56038,-52.71147,2018-10-29 14:00:00,20,3,23
"7241",10102,"St Johns","NL",47.56038,-52.71147,2018-10-29 15:00:00,24,1,25
"7242",10102,"St Johns","NL",47.56038,-52.71147,2018-10-29 16:00:00,24,2,26
"7243",10102,"St Johns","NL",47.56038,-52.71147,2018-10-29 17:00:00,23,3,26
"7244",10102,"St Johns","NL",47.56038,-52.71147,2018-10-29 18:00:00,24,3,27
"7245",10102,"St Johns","NL",47.56038,-52.71147,2018-10-29 19:00:00,22,2,24
"7246",10102,"St Johns","NL",47.56038,-52.71147,2018-10-29 20:00:00,23,2,25
"7247",10102,"St Johns","NL",47.56038,-52.71147,2018-10-29 21:00:00,22,2,24
"7248",10102,"St Johns","NL",47.56038,-52.71147,2018-10-29 22:00:00,20,1,21
"7249",10102,"St Johns","NL",47.56038,-52.71147,2018-10-29 23:00:00,16,2,18
"7250",10102,"St Johns","NL",47.56038,-52.71147,2018-10-30 00:00:00,15,2,17
"7251",10102,"St Johns","NL",47.56038,-52.71147,2018-10-30 01:00:00,16,1,17
"7252",10102,"St Johns","NL",47.56038,-52.71147,2018-10-30 02:00:00,15,0,15
"7253",10102,"St Johns","NL",47.56038,-52.71147,2018-10-30 03:00:00,15,1,16
"7254",10102,"St Johns","NL",47.56038,-52.71147,2018-10-30 04:00:00,15,2,17
"7255",10102,"St Johns","NL",47.56038,-52.71147,2018-10-30 05:00:00,7,7,14
"7256",10102,"St Johns","NL",47.56038,-52.71147,2018-10-30 06:00:00,0,22,22
"7257",10102,"St Johns","NL",47.56038,-52.71147,2018-10-30 07:00:00,0,24,24
"7258",10102,"St Johns","NL",47.56038,-52.71147,2018-10-30 08:00:00,0,26,26
"7259",10102,"St Johns","NL",47.56038,-52.71147,2018-10-30 09:00:00,0,24,24
"7260",10102,"St Johns","NL",47.56038,-52.71147,2018-10-30 10:00:00,0,25,25
"7261",10102,"St Johns","NL",47.56038,-52.71147,2018-10-30 11:00:00,0,26,26
"7262",10102,"St Johns","NL",47.56038,-52.71147,2018-10-30 12:00:00,3,25,28
"7263",10102,"St Johns","NL",47.56038,-52.71147,2018-10-30 13:00:00,11,13,24
"7264",10102,"St Johns","NL",47.56038,-52.71147,2018-10-30 14:00:00,18,5,23
"7265",10102,"St Johns","NL",47.56038,-52.71147,2018-10-30 15:00:00,14,7,21
"7266",10102,"St Johns","NL",47.56038,-52.71147,2018-10-30 16:00:00,13,10,23
"7267",10102,"St Johns","NL",47.56038,-52.71147,2018-10-30 17:00:00,23,3,26
"7268",10102,"St Johns","NL",47.56038,-52.71147,2018-10-30 18:00:00,28,2,30
"7269",10102,"St Johns","NL",47.56038,-52.71147,2018-10-30 19:00:00,33,2,35
"7270",10102,"St Johns","NL",47.56038,-52.71147,2018-10-30 20:00:00,31,2,33
"7271",10102,"St Johns","NL",47.56038,-52.71147,2018-10-30 21:00:00,29,4,33
"7272",10102,"St Johns","NL",47.56038,-52.71147,2018-10-30 22:00:00,24,3,27
"7273",10102,"St Johns","NL",47.56038,-52.71147,2018-10-30 23:00:00,25,2,27
"7274",10102,"St Johns","NL",47.56038,-52.71147,2018-10-31 00:00:00,23,3,26
"7275",10102,"St Johns","NL",47.56038,-52.71147,2018-10-31 01:00:00,24,1,25
"7276",10102,"St Johns","NL",47.56038,-52.71147,2018-10-31 02:00:00,20,0,20
"7277",10102,"St Johns","NL",47.56038,-52.71147,2018-10-31 03:00:00,17,1,18
"7278",10102,"St Johns","NL",47.56038,-52.71147,2018-10-31 04:00:00,15,1,16
"7279",10102,"St Johns","NL",47.56038,-52.71147,2018-10-31 05:00:00,15,1,16
"7280",10102,"St Johns","NL",47.56038,-52.71147,2018-10-31 06:00:00,15,1,16
"7281",10102,"St Johns","NL",47.56038,-52.71147,2018-10-31 07:00:00,12,2,14
"7282",10102,"St Johns","NL",47.56038,-52.71147,2018-10-31 08:00:00,14,3,17
"7283",10102,"St Johns","NL",47.56038,-52.71147,2018-10-31 09:00:00,16,4,20
"7284",10102,"St Johns","NL",47.56038,-52.71147,2018-10-31 10:00:00,19,4,23
"7285",10102,"St Johns","NL",47.56038,-52.71147,2018-10-31 11:00:00,23,2,25
"7286",10102,"St Johns","NL",47.56038,-52.71147,2018-10-31 12:00:00,24,1,25
"7287",10102,"St Johns","NL",47.56038,-52.71147,2018-10-31 13:00:00,26,2,28
"7288",10102,"St Johns","NL",47.56038,-52.71147,2018-10-31 14:00:00,27,3,30
"7289",10102,"St Johns","NL",47.56038,-52.71147,2018-10-31 15:00:00,30,2,32
"7290",10102,"St Johns","NL",47.56038,-52.71147,2018-10-31 16:00:00,31,2,33
"7291",10102,"St Johns","NL",47.56038,-52.71147,2018-10-31 17:00:00,33,2,35
"7292",10102,"St Johns","NL",47.56038,-52.71147,2018-10-31 18:00:00,35,1,36
"7293",10102,"St Johns","NL",47.56038,-52.71147,2018-10-31 19:00:00,35,1,36
"7294",10102,"St Johns","NL",47.56038,-52.71147,2018-10-31 20:00:00,35,0,35
"7295",10102,"St Johns","NL",47.56038,-52.71147,2018-10-31 21:00:00,35,1,36
"7296",10102,"St Johns","NL",47.56038,-52.71147,2018-10-31 22:00:00,35,1,36
"7297",10102,"St Johns","NL",47.56038,-52.71147,2018-10-31 23:00:00,36,0,36
"7298",10102,"St Johns","NL",47.56038,-52.71147,2018-11-01 00:00:00,35,0,35
"7299",10102,"St Johns","NL",47.56038,-52.71147,2018-11-01 01:00:00,35,1,36
"7300",10102,"St Johns","NL",47.56038,-52.71147,2018-11-01 02:00:00,36,0,36
"7301",10102,"St Johns","NL",47.56038,-52.71147,2018-11-01 03:00:00,36,0,36
"7302",10102,"St Johns","NL",47.56038,-52.71147,2018-11-01 04:00:00,36,0,36
"7303",10102,"St Johns","NL",47.56038,-52.71147,2018-11-01 05:00:00,36,0,36
"7304",10102,"St Johns","NL",47.56038,-52.71147,2018-11-01 06:00:00,36,1,37
"7305",10102,"St Johns","NL",47.56038,-52.71147,2018-11-01 07:00:00,35,0,35
"7306",10102,"St Johns","NL",47.56038,-52.71147,2018-11-01 08:00:00,33,2,35
"7307",10102,"St Johns","NL",47.56038,-52.71147,2018-11-01 09:00:00,33,2,35
"7308",10102,"St Johns","NL",47.56038,-52.71147,2018-11-01 10:00:00,34,1,35
"7309",10102,"St Johns","NL",47.56038,-52.71147,2018-11-01 11:00:00,32,3,35
"7310",10102,"St Johns","NL",47.56038,-52.71147,2018-11-01 12:00:00,33,2,35
"7311",10102,"St Johns","NL",47.56038,-52.71147,2018-11-01 13:00:00,34,2,36
"7312",10102,"St Johns","NL",47.56038,-52.71147,2018-11-01 14:00:00,35,1,36
"7313",10102,"St Johns","NL",47.56038,-52.71147,2018-11-01 15:00:00,34,2,36
"7314",10102,"St Johns","NL",47.56038,-52.71147,2018-11-01 16:00:00,33,3,36
"7315",10102,"St Johns","NL",47.56038,-52.71147,2018-11-01 17:00:00,31,3,34
"7316",10102,"St Johns","NL",47.56038,-52.71147,2018-11-01 18:00:00,30,2,32
"7317",10102,"St Johns","NL",47.56038,-52.71147,2018-11-01 19:00:00,28,4,32
"7318",10102,"St Johns","NL",47.56038,-52.71147,2018-11-01 20:00:00,25,4,29
"7319",10102,"St Johns","NL",47.56038,-52.71147,2018-11-01 21:00:00,21,3,24
"7320",10102,"St Johns","NL",47.56038,-52.71147,2018-11-01 22:00:00,20,1,21
"7321",10102,"St Johns","NL",47.56038,-52.71147,2018-11-01 23:00:00,23,1,24
"7322",10102,"St Johns","NL",47.56038,-52.71147,2018-11-02 00:00:00,23,0,23
"7323",10102,"St Johns","NL",47.56038,-52.71147,2018-11-02 01:00:00,23,0,23
"7324",10102,"St Johns","NL",47.56038,-52.71147,2018-11-02 02:00:00,20,1,21
"7325",10102,"St Johns","NL",47.56038,-52.71147,2018-11-02 03:00:00,16,1,17
"7326",10102,"St Johns","NL",47.56038,-52.71147,2018-11-02 04:00:00,14,1,15
"7327",10102,"St Johns","NL",47.56038,-52.71147,2018-11-02 05:00:00,12,1,13
"7328",10102,"St Johns","NL",47.56038,-52.71147,2018-11-02 06:00:00,8,4,12
"7329",10102,"St Johns","NL",47.56038,-52.71147,2018-11-02 07:00:00,14,4,18
"7330",10102,"St Johns","NL",47.56038,-52.71147,2018-11-02 08:00:00,13,5,18
"7331",10102,"St Johns","NL",47.56038,-52.71147,2018-11-02 09:00:00,17,1,18
"7332",10102,"St Johns","NL",47.56038,-52.71147,2018-11-02 10:00:00,21,1,22
"7333",10102,"St Johns","NL",47.56038,-52.71147,2018-11-02 11:00:00,22,1,23
"7334",10102,"St Johns","NL",47.56038,-52.71147,2018-11-02 12:00:00,21,1,22
"7335",10102,"St Johns","NL",47.56038,-52.71147,2018-11-02 13:00:00,21,1,22
"7336",10102,"St Johns","NL",47.56038,-52.71147,2018-11-02 14:00:00,21,1,22
"7337",10102,"St Johns","NL",47.56038,-52.71147,2018-11-02 15:00:00,19,2,21
"7338",10102,"St Johns","NL",47.56038,-52.71147,2018-11-02 16:00:00,19,3,22
"7339",10102,"St Johns","NL",47.56038,-52.71147,2018-11-02 17:00:00,17,4,21
"7340",10102,"St Johns","NL",47.56038,-52.71147,2018-11-02 18:00:00,16,3,19
"7341",10102,"St Johns","NL",47.56038,-52.71147,2018-11-02 19:00:00,16,3,19
"7342",10102,"St Johns","NL",47.56038,-52.71147,2018-11-02 20:00:00,15,2,17
"7343",10102,"St Johns","NL",47.56038,-52.71147,2018-11-02 21:00:00,16,3,19
"7344",10102,"St Johns","NL",47.56038,-52.71147,2018-11-02 22:00:00,12,4,16
"7345",10102,"St Johns","NL",47.56038,-52.71147,2018-11-02 23:00:00,13,4,17
"7346",10102,"St Johns","NL",47.56038,-52.71147,2018-11-03 00:00:00,15,3,18
"7347",10102,"St Johns","NL",47.56038,-52.71147,2018-11-03 01:00:00,16,1,17
"7348",10102,"St Johns","NL",47.56038,-52.71147,2018-11-03 02:00:00,15,8,23
"7349",10102,"St Johns","NL",47.56038,-52.71147,2018-11-03 03:00:00,20,8,28
"7350",10102,"St Johns","NL",47.56038,-52.71147,2018-11-03 04:00:00,25,9,34
"7351",10102,"St Johns","NL",47.56038,-52.71147,2018-11-03 05:00:00,13,12,25
"7352",10102,"St Johns","NL",47.56038,-52.71147,2018-11-03 06:00:00,8,17,25
"7353",10102,"St Johns","NL",47.56038,-52.71147,2018-11-03 07:00:00,9,15,24
"7354",10102,"St Johns","NL",47.56038,-52.71147,2018-11-03 08:00:00,4,18,22
"7355",10102,"St Johns","NL",47.56038,-52.71147,2018-11-03 09:00:00,8,13,21
"7356",10102,"St Johns","NL",47.56038,-52.71147,2018-11-03 10:00:00,15,7,22
"7357",10102,"St Johns","NL",47.56038,-52.71147,2018-11-03 11:00:00,17,7,24
"7358",10102,"St Johns","NL",47.56038,-52.71147,2018-11-03 12:00:00,19,8,27
"7359",10102,"St Johns","NL",47.56038,-52.71147,2018-11-03 13:00:00,22,7,29
"7360",10102,"St Johns","NL",47.56038,-52.71147,2018-11-03 14:00:00,21,9,30
"7361",10102,"St Johns","NL",47.56038,-52.71147,2018-11-03 15:00:00,17,10,27
"7362",10102,"St Johns","NL",47.56038,-52.71147,2018-11-03 16:00:00,16,12,28
"7363",10102,"St Johns","NL",47.56038,-52.71147,2018-11-03 17:00:00,21,6,27
"7364",10102,"St Johns","NL",47.56038,-52.71147,2018-11-03 18:00:00,19,10,29
"7365",10102,"St Johns","NL",47.56038,-52.71147,2018-11-03 19:00:00,13,13,26
"7366",10102,"St Johns","NL",47.56038,-52.71147,2018-11-03 20:00:00,9,17,26
"7367",10102,"St Johns","NL",47.56038,-52.71147,2018-11-03 21:00:00,15,16,31
"7368",10102,"St Johns","NL",47.56038,-52.71147,2018-11-03 22:00:00,31,1,32
"7369",10102,"St Johns","NL",47.56038,-52.71147,2018-11-03 23:00:00,31,0,31
"7370",10102,"St Johns","NL",47.56038,-52.71147,2018-11-04 00:00:00,30,1,31
"7371",10102,"St Johns","NL",47.56038,-52.71147,2018-11-04 01:00:00,30,0,30
"7372",10102,"St Johns","NL",47.56038,-52.71147,2018-11-04 02:00:00,30,1,31
"7373",10102,"St Johns","NL",47.56038,-52.71147,2018-11-04 03:00:00,31,1,32
"7374",10102,"St Johns","NL",47.56038,-52.71147,2018-11-04 04:00:00,32,1,33
"7375",10102,"St Johns","NL",47.56038,-52.71147,2018-11-04 05:00:00,34,1,35
"7376",10102,"St Johns","NL",47.56038,-52.71147,2018-11-04 06:00:00,40,1,41
"7377",10102,"St Johns","NL",47.56038,-52.71147,2018-11-04 07:00:00,37,1,38
"7378",10102,"St Johns","NL",47.56038,-52.71147,2018-11-04 08:00:00,33,1,34
"7379",10102,"St Johns","NL",47.56038,-52.71147,2018-11-04 09:00:00,25,1,26
"7380",10102,"St Johns","NL",47.56038,-52.71147,2018-11-04 10:00:00,22,1,23
"7381",10102,"St Johns","NL",47.56038,-52.71147,2018-11-04 11:00:00,19,1,20
"7382",10102,"St Johns","NL",47.56038,-52.71147,2018-11-04 12:00:00,17,0,17
"7383",10102,"St Johns","NL",47.56038,-52.71147,2018-11-04 13:00:00,15,1,16
"7384",10102,"St Johns","NL",47.56038,-52.71147,2018-11-04 14:00:00,14,1,15
"7385",10102,"St Johns","NL",47.56038,-52.71147,2018-11-04 15:00:00,15,0,15
"7386",10102,"St Johns","NL",47.56038,-52.71147,2018-11-04 16:00:00,17,0,17
"7387",10102,"St Johns","NL",47.56038,-52.71147,2018-11-04 17:00:00,19,0,19
"7388",10102,"St Johns","NL",47.56038,-52.71147,2018-11-04 18:00:00,20,1,21
"7389",10102,"St Johns","NL",47.56038,-52.71147,2018-11-04 19:00:00,21,0,21
"7390",10102,"St Johns","NL",47.56038,-52.71147,2018-11-04 20:00:00,20,1,21
"7391",10102,"St Johns","NL",47.56038,-52.71147,2018-11-04 21:00:00,23,1,24
"7392",10102,"St Johns","NL",47.56038,-52.71147,2018-11-04 22:00:00,24,0,24
"7393",10102,"St Johns","NL",47.56038,-52.71147,2018-11-04 23:00:00,25,0,25
"7394",10102,"St Johns","NL",47.56038,-52.71147,2018-11-05 00:00:00,25,0,25
"7395",10102,"St Johns","NL",47.56038,-52.71147,2018-11-05 01:00:00,24,0,24
"7396",10102,"St Johns","NL",47.56038,-52.71147,2018-11-05 02:00:00,24,0,24
"7397",10102,"St Johns","NL",47.56038,-52.71147,2018-11-05 03:00:00,23,0,23
"7398",10102,"St Johns","NL",47.56038,-52.71147,2018-11-05 04:00:00,25,0,25
"7399",10102,"St Johns","NL",47.56038,-52.71147,2018-11-05 05:00:00,29,0,29
"7400",10102,"St Johns","NL",47.56038,-52.71147,2018-11-05 06:00:00,30,0,30
"7401",10102,"St Johns","NL",47.56038,-52.71147,2018-11-05 07:00:00,29,1,30
"7402",10102,"St Johns","NL",47.56038,-52.71147,2018-11-05 08:00:00,28,1,29
"7403",10102,"St Johns","NL",47.56038,-52.71147,2018-11-05 09:00:00,28,1,29
"7404",10102,"St Johns","NL",47.56038,-52.71147,2018-11-05 10:00:00,29,1,30
"7405",10102,"St Johns","NL",47.56038,-52.71147,2018-11-05 11:00:00,30,1,31
"7406",10102,"St Johns","NL",47.56038,-52.71147,2018-11-05 12:00:00,28,2,30
"7407",10102,"St Johns","NL",47.56038,-52.71147,2018-11-05 13:00:00,28,2,30
"7408",10102,"St Johns","NL",47.56038,-52.71147,2018-11-05 14:00:00,29,3,32
"7409",10102,"St Johns","NL",47.56038,-52.71147,2018-11-05 15:00:00,28,3,31
"7410",10102,"St Johns","NL",47.56038,-52.71147,2018-11-05 16:00:00,27,3,30
"7411",10102,"St Johns","NL",47.56038,-52.71147,2018-11-05 17:00:00,23,7,30
"7412",10102,"St Johns","NL",47.56038,-52.71147,2018-11-05 18:00:00,15,14,29
"7413",10102,"St Johns","NL",47.56038,-52.71147,2018-11-05 19:00:00,9,19,28
"7414",10102,"St Johns","NL",47.56038,-52.71147,2018-11-05 20:00:00,9,20,29
"7415",10102,"St Johns","NL",47.56038,-52.71147,2018-11-05 21:00:00,11,13,24
"7416",10102,"St Johns","NL",47.56038,-52.71147,2018-11-05 22:00:00,9,12,21
"7417",10102,"St Johns","NL",47.56038,-52.71147,2018-11-05 23:00:00,10,11,21
"7418",10102,"St Johns","NL",47.56038,-52.71147,2018-11-06 00:00:00,9,11,20
"7419",10102,"St Johns","NL",47.56038,-52.71147,2018-11-06 01:00:00,12,7,19
"7420",10102,"St Johns","NL",47.56038,-52.71147,2018-11-06 02:00:00,11,8,19
"7421",10102,"St Johns","NL",47.56038,-52.71147,2018-11-06 03:00:00,10,8,18
"7422",10102,"St Johns","NL",47.56038,-52.71147,2018-11-06 04:00:00,10,7,17
"7423",10102,"St Johns","NL",47.56038,-52.71147,2018-11-06 05:00:00,8,7,15
"7424",10102,"St Johns","NL",47.56038,-52.71147,2018-11-06 06:00:00,6,9,15
"7425",10102,"St Johns","NL",47.56038,-52.71147,2018-11-06 07:00:00,4,12,16
"7426",10102,"St Johns","NL",47.56038,-52.71147,2018-11-06 08:00:00,4,14,18
"7427",10102,"St Johns","NL",47.56038,-52.71147,2018-11-06 09:00:00,5,20,25
"7428",10102,"St Johns","NL",47.56038,-52.71147,2018-11-06 10:00:00,23,5,28
"7429",10102,"St Johns","NL",47.56038,-52.71147,2018-11-06 11:00:00,22,6,28
"7430",10102,"St Johns","NL",47.56038,-52.71147,2018-11-06 12:00:00,23,5,28
"7431",10102,"St Johns","NL",47.56038,-52.71147,2018-11-06 13:00:00,24,6,30
"7432",10102,"St Johns","NL",47.56038,-52.71147,2018-11-06 14:00:00,24,5,29
"7433",10102,"St Johns","NL",47.56038,-52.71147,2018-11-06 15:00:00,25,3,28
"7434",10102,"St Johns","NL",47.56038,-52.71147,2018-11-06 16:00:00,23,6,29
"7435",10102,"St Johns","NL",47.56038,-52.71147,2018-11-06 17:00:00,17,10,27
"7436",10102,"St Johns","NL",47.56038,-52.71147,2018-11-06 18:00:00,13,14,27
"7437",10102,"St Johns","NL",47.56038,-52.71147,2018-11-06 19:00:00,17,13,30
"7438",10102,"St Johns","NL",47.56038,-52.71147,2018-11-06 20:00:00,11,21,32
"7439",10102,"St Johns","NL",47.56038,-52.71147,2018-11-06 21:00:00,11,19,30
"7440",10102,"St Johns","NL",47.56038,-52.71147,2018-11-06 22:00:00,13,16,29
"7441",10102,"St Johns","NL",47.56038,-52.71147,2018-11-06 23:00:00,19,10,29
"7442",10102,"St Johns","NL",47.56038,-52.71147,2018-11-07 00:00:00,23,5,28
"7443",10102,"St Johns","NL",47.56038,-52.71147,2018-11-07 01:00:00,27,5,32
"7444",10102,"St Johns","NL",47.56038,-52.71147,2018-11-07 02:00:00,29,4,33
"7445",10102,"St Johns","NL",47.56038,-52.71147,2018-11-07 03:00:00,30,4,34
"7446",10102,"St Johns","NL",47.56038,-52.71147,2018-11-07 04:00:00,31,3,34
"7447",10102,"St Johns","NL",47.56038,-52.71147,2018-11-07 05:00:00,32,2,34
"7448",10102,"St Johns","NL",47.56038,-52.71147,2018-11-07 06:00:00,31,2,33
"7449",10102,"St Johns","NL",47.56038,-52.71147,2018-11-07 07:00:00,31,2,33
"7450",10102,"St Johns","NL",47.56038,-52.71147,2018-11-07 08:00:00,30,4,34
"7451",10102,"St Johns","NL",47.56038,-52.71147,2018-11-07 09:00:00,30,4,34
"7452",10102,"St Johns","NL",47.56038,-52.71147,2018-11-07 10:00:00,31,3,34
"7453",10102,"St Johns","NL",47.56038,-52.71147,2018-11-07 11:00:00,27,6,33
"7454",10102,"St Johns","NL",47.56038,-52.71147,2018-11-07 12:00:00,23,4,27
"7455",10102,"St Johns","NL",47.56038,-52.71147,2018-11-07 13:00:00,29,1,30
"7456",10102,"St Johns","NL",47.56038,-52.71147,2018-11-07 14:00:00,29,1,30
"7457",10102,"St Johns","NL",47.56038,-52.71147,2018-11-07 15:00:00,29,1,30
"7458",10102,"St Johns","NL",47.56038,-52.71147,2018-11-07 16:00:00,30,2,32
"7459",10102,"St Johns","NL",47.56038,-52.71147,2018-11-07 17:00:00,30,2,32
"7460",10102,"St Johns","NL",47.56038,-52.71147,2018-11-07 18:00:00,30,3,33
"7461",10102,"St Johns","NL",47.56038,-52.71147,2018-11-07 19:00:00,30,1,31
"7462",10102,"St Johns","NL",47.56038,-52.71147,2018-11-07 20:00:00,30,0,30
"7463",10102,"St Johns","NL",47.56038,-52.71147,2018-11-07 21:00:00,30,1,31
"7464",10102,"St Johns","NL",47.56038,-52.71147,2018-11-07 22:00:00,27,2,29
"7465",10102,"St Johns","NL",47.56038,-52.71147,2018-11-07 23:00:00,27,1,28
"7466",10102,"St Johns","NL",47.56038,-52.71147,2018-11-08 00:00:00,28,1,29
"7467",10102,"St Johns","NL",47.56038,-52.71147,2018-11-08 01:00:00,31,0,31
"7468",10102,"St Johns","NL",47.56038,-52.71147,2018-11-08 02:00:00,30,0,30
"7469",10102,"St Johns","NL",47.56038,-52.71147,2018-11-08 03:00:00,28,0,28
"7470",10102,"St Johns","NL",47.56038,-52.71147,2018-11-08 04:00:00,27,0,27
"7471",10102,"St Johns","NL",47.56038,-52.71147,2018-11-08 05:00:00,25,0,25
"7472",10102,"St Johns","NL",47.56038,-52.71147,2018-11-08 06:00:00,25,1,26
"7473",10102,"St Johns","NL",47.56038,-52.71147,2018-11-08 07:00:00,24,1,25
"7474",10102,"St Johns","NL",47.56038,-52.71147,2018-11-08 08:00:00,22,2,24
"7475",10102,"St Johns","NL",47.56038,-52.71147,2018-11-08 09:00:00,20,3,23
"7476",10102,"St Johns","NL",47.56038,-52.71147,2018-11-08 10:00:00,20,2,22
"7477",10102,"St Johns","NL",47.56038,-52.71147,2018-11-08 11:00:00,21,1,22
"7478",10102,"St Johns","NL",47.56038,-52.71147,2018-11-08 12:00:00,21,3,24
"7479",10102,"St Johns","NL",47.56038,-52.71147,2018-11-08 13:00:00,21,2,23
"7480",10102,"St Johns","NL",47.56038,-52.71147,2018-11-08 14:00:00,21,2,23
"7481",10102,"St Johns","NL",47.56038,-52.71147,2018-11-08 15:00:00,22,2,24
"7482",10102,"St Johns","NL",47.56038,-52.71147,2018-11-08 16:00:00,20,3,23
"7483",10102,"St Johns","NL",47.56038,-52.71147,2018-11-08 17:00:00,20,2,22
"7484",10102,"St Johns","NL",47.56038,-52.71147,2018-11-08 18:00:00,19,2,21
"7485",10102,"St Johns","NL",47.56038,-52.71147,2018-11-08 19:00:00,18,2,20
"7486",10102,"St Johns","NL",47.56038,-52.71147,2018-11-08 20:00:00,17,2,19
"7487",10102,"St Johns","NL",47.56038,-52.71147,2018-11-08 21:00:00,17,2,19
"7488",10102,"St Johns","NL",47.56038,-52.71147,2018-11-08 22:00:00,17,1,18
"7489",10102,"St Johns","NL",47.56038,-52.71147,2018-11-08 23:00:00,16,1,17
"7490",10102,"St Johns","NL",47.56038,-52.71147,2018-11-09 00:00:00,16,0,16
"7491",10102,"St Johns","NL",47.56038,-52.71147,2018-11-09 01:00:00,15,1,16
"7492",10102,"St Johns","NL",47.56038,-52.71147,2018-11-09 02:00:00,15,1,16
"7493",10102,"St Johns","NL",47.56038,-52.71147,2018-11-09 03:00:00,14,1,15
"7494",10102,"St Johns","NL",47.56038,-52.71147,2018-11-09 04:00:00,14,1,15
"7495",10102,"St Johns","NL",47.56038,-52.71147,2018-11-09 05:00:00,14,1,15
"7496",10102,"St Johns","NL",47.56038,-52.71147,2018-11-09 06:00:00,13,3,16
"7497",10102,"St Johns","NL",47.56038,-52.71147,2018-11-09 07:00:00,13,3,16
"7498",10102,"St Johns","NL",47.56038,-52.71147,2018-11-09 08:00:00,11,7,18
"7499",10102,"St Johns","NL",47.56038,-52.71147,2018-11-09 09:00:00,13,4,17
"7500",10102,"St Johns","NL",47.56038,-52.71147,2018-11-09 10:00:00,15,2,17
"7501",10102,"St Johns","NL",47.56038,-52.71147,2018-11-09 11:00:00,16,1,17
"7502",10102,"St Johns","NL",47.56038,-52.71147,2018-11-09 12:00:00,15,3,18
"7503",10102,"St Johns","NL",47.56038,-52.71147,2018-11-09 13:00:00,17,3,20
"7504",10102,"St Johns","NL",47.56038,-52.71147,2018-11-09 14:00:00,18,2,20
"7505",10102,"St Johns","NL",47.56038,-52.71147,2018-11-09 15:00:00,19,2,21
"7506",10102,"St Johns","NL",47.56038,-52.71147,2018-11-09 16:00:00,19,2,21
"7507",10102,"St Johns","NL",47.56038,-52.71147,2018-11-09 17:00:00,18,3,21
"7508",10102,"St Johns","NL",47.56038,-52.71147,2018-11-09 18:00:00,17,3,20
"7509",10102,"St Johns","NL",47.56038,-52.71147,2018-11-09 19:00:00,16,3,19
"7510",10102,"St Johns","NL",47.56038,-52.71147,2018-11-09 20:00:00,18,2,20
"7511",10102,"St Johns","NL",47.56038,-52.71147,2018-11-09 21:00:00,19,3,22
"7512",10102,"St Johns","NL",47.56038,-52.71147,2018-11-09 22:00:00,22,5,27
"7513",10102,"St Johns","NL",47.56038,-52.71147,2018-11-09 23:00:00,26,4,30
"7514",10102,"St Johns","NL",47.56038,-52.71147,2018-11-10 00:00:00,27,5,32
"7515",10102,"St Johns","NL",47.56038,-52.71147,2018-11-10 01:00:00,29,3,32
"7516",10102,"St Johns","NL",47.56038,-52.71147,2018-11-10 02:00:00,29,2,31
"7517",10102,"St Johns","NL",47.56038,-52.71147,2018-11-10 03:00:00,27,4,31
"7518",10102,"St Johns","NL",47.56038,-52.71147,2018-11-10 04:00:00,24,4,28
"7519",10102,"St Johns","NL",47.56038,-52.71147,2018-11-10 05:00:00,22,5,27
"7520",10102,"St Johns","NL",47.56038,-52.71147,2018-11-10 06:00:00,26,3,29
"7521",10102,"St Johns","NL",47.56038,-52.71147,2018-11-10 07:00:00,21,6,27
"7522",10102,"St Johns","NL",47.56038,-52.71147,2018-11-10 08:00:00,16,12,28
"7523",10102,"St Johns","NL",47.56038,-52.71147,2018-11-10 09:00:00,13,15,28
"7524",10102,"St Johns","NL",47.56038,-52.71147,2018-11-10 10:00:00,21,9,30
"7525",10102,"St Johns","NL",47.56038,-52.71147,2018-11-10 11:00:00,27,5,32
"7526",10102,"St Johns","NL",47.56038,-52.71147,2018-11-10 12:00:00,27,4,31
"7527",10102,"St Johns","NL",47.56038,-52.71147,2018-11-10 13:00:00,25,6,31
"7528",10102,"St Johns","NL",47.56038,-52.71147,2018-11-10 14:00:00,23,8,31
"7529",10102,"St Johns","NL",47.56038,-52.71147,2018-11-10 15:00:00,26,4,30
"7530",10102,"St Johns","NL",47.56038,-52.71147,2018-11-10 16:00:00,21,10,31
"7531",10102,"St Johns","NL",47.56038,-52.71147,2018-11-10 17:00:00,22,11,33
"7532",10102,"St Johns","NL",47.56038,-52.71147,2018-11-10 18:00:00,23,14,37
"7533",10102,"St Johns","NL",47.56038,-52.71147,2018-11-10 19:00:00,27,7,34
"7534",10102,"St Johns","NL",47.56038,-52.71147,2018-11-10 20:00:00,32,3,35
"7535",10102,"St Johns","NL",47.56038,-52.71147,2018-11-10 21:00:00,32,5,37
"7536",10102,"St Johns","NL",47.56038,-52.71147,2018-11-10 22:00:00,35,1,36
"7537",10102,"St Johns","NL",47.56038,-52.71147,2018-11-10 23:00:00,35,0,35
"7538",10102,"St Johns","NL",47.56038,-52.71147,2018-11-11 00:00:00,33,0,33
"7539",10102,"St Johns","NL",47.56038,-52.71147,2018-11-11 01:00:00,31,1,32
"7540",10102,"St Johns","NL",47.56038,-52.71147,2018-11-11 02:00:00,29,1,30
"7541",10102,"St Johns","NL",47.56038,-52.71147,2018-11-11 03:00:00,28,0,28
"7542",10102,"St Johns","NL",47.56038,-52.71147,2018-11-11 04:00:00,25,2,27
"7543",10102,"St Johns","NL",47.56038,-52.71147,2018-11-11 05:00:00,25,1,26
"7544",10102,"St Johns","NL",47.56038,-52.71147,2018-11-11 06:00:00,25,1,26
"7545",10102,"St Johns","NL",47.56038,-52.71147,2018-11-11 07:00:00,30,0,30
"7546",10102,"St Johns","NL",47.56038,-52.71147,2018-11-11 08:00:00,28,1,29
"7547",10102,"St Johns","NL",47.56038,-52.71147,2018-11-11 09:00:00,28,0,28
"7548",10102,"St Johns","NL",47.56038,-52.71147,2018-11-11 10:00:00,30,0,30
"7549",10102,"St Johns","NL",47.56038,-52.71147,2018-11-11 11:00:00,29,0,29
"7550",10102,"St Johns","NL",47.56038,-52.71147,2018-11-11 12:00:00,23,1,24
"7551",10102,"St Johns","NL",47.56038,-52.71147,2018-11-11 13:00:00,24,1,25
"7552",10102,"St Johns","NL",47.56038,-52.71147,2018-11-11 14:00:00,23,1,24
"7553",10102,"St Johns","NL",47.56038,-52.71147,2018-11-11 15:00:00,22,1,23
"7554",10102,"St Johns","NL",47.56038,-52.71147,2018-11-11 16:00:00,22,1,23
"7555",10102,"St Johns","NL",47.56038,-52.71147,2018-11-11 17:00:00,22,0,22
"7556",10102,"St Johns","NL",47.56038,-52.71147,2018-11-11 18:00:00,23,1,24
"7557",10102,"St Johns","NL",47.56038,-52.71147,2018-11-11 19:00:00,22,1,23
"7558",10102,"St Johns","NL",47.56038,-52.71147,2018-11-11 20:00:00,21,1,22
"7559",10102,"St Johns","NL",47.56038,-52.71147,2018-11-11 21:00:00,22,0,22
"7560",10102,"St Johns","NL",47.56038,-52.71147,2018-11-11 22:00:00,23,1,24
"7561",10102,"St Johns","NL",47.56038,-52.71147,2018-11-11 23:00:00,24,1,25
"7562",10102,"St Johns","NL",47.56038,-52.71147,2018-11-12 00:00:00,26,0,26
"7563",10102,"St Johns","NL",47.56038,-52.71147,2018-11-12 01:00:00,28,1,29
"7564",10102,"St Johns","NL",47.56038,-52.71147,2018-11-12 02:00:00,30,0,30
"7565",10102,"St Johns","NL",47.56038,-52.71147,2018-11-12 03:00:00,31,0,31
"7566",10102,"St Johns","NL",47.56038,-52.71147,2018-11-12 04:00:00,31,0,31
"7567",10102,"St Johns","NL",47.56038,-52.71147,2018-11-12 05:00:00,30,0,30
"7568",10102,"St Johns","NL",47.56038,-52.71147,2018-11-12 06:00:00,31,0,31
"7569",10102,"St Johns","NL",47.56038,-52.71147,2018-11-12 07:00:00,31,1,32
"7570",10102,"St Johns","NL",47.56038,-52.71147,2018-11-12 08:00:00,31,2,33
"7571",10102,"St Johns","NL",47.56038,-52.71147,2018-11-12 09:00:00,30,1,31
"7572",10102,"St Johns","NL",47.56038,-52.71147,2018-11-12 10:00:00,30,1,31
"7573",10102,"St Johns","NL",47.56038,-52.71147,2018-11-12 11:00:00,31,1,32
"7574",10102,"St Johns","NL",47.56038,-52.71147,2018-11-12 12:00:00,31,1,32
"7575",10102,"St Johns","NL",47.56038,-52.71147,2018-11-12 13:00:00,31,1,32
"7576",10102,"St Johns","NL",47.56038,-52.71147,2018-11-12 14:00:00,31,1,32
"7577",10102,"St Johns","NL",47.56038,-52.71147,2018-11-12 15:00:00,30,2,32
"7578",10102,"St Johns","NL",47.56038,-52.71147,2018-11-12 16:00:00,30,1,31
"7579",10102,"St Johns","NL",47.56038,-52.71147,2018-11-12 17:00:00,33,1,34
"7580",10102,"St Johns","NL",47.56038,-52.71147,2018-11-12 18:00:00,33,1,34
"7581",10102,"St Johns","NL",47.56038,-52.71147,2018-11-12 19:00:00,34,1,35
"7582",10102,"St Johns","NL",47.56038,-52.71147,2018-11-12 20:00:00,34,1,35
"7583",10102,"St Johns","NL",47.56038,-52.71147,2018-11-12 21:00:00,34,0,34
"7584",10102,"St Johns","NL",47.56038,-52.71147,2018-11-12 22:00:00,35,0,35
"7585",10102,"St Johns","NL",47.56038,-52.71147,2018-11-12 23:00:00,34,0,34
"7586",10102,"St Johns","NL",47.56038,-52.71147,2018-11-13 00:00:00,33,0,33
"7587",10102,"St Johns","NL",47.56038,-52.71147,2018-11-13 01:00:00,32,1,33
"7588",10102,"St Johns","NL",47.56038,-52.71147,2018-11-13 02:00:00,32,0,32
"7589",10102,"St Johns","NL",47.56038,-52.71147,2018-11-13 03:00:00,31,0,31
"7590",10102,"St Johns","NL",47.56038,-52.71147,2018-11-13 04:00:00,31,0,31
"7591",10102,"St Johns","NL",47.56038,-52.71147,2018-11-13 05:00:00,30,0,30
"7592",10102,"St Johns","NL",47.56038,-52.71147,2018-11-13 06:00:00,30,0,30
"7593",10102,"St Johns","NL",47.56038,-52.71147,2018-11-13 07:00:00,30,1,31
"7594",10102,"St Johns","NL",47.56038,-52.71147,2018-11-13 08:00:00,29,1,30
"7595",10102,"St Johns","NL",47.56038,-52.71147,2018-11-13 09:00:00,29,1,30
"7596",10102,"St Johns","NL",47.56038,-52.71147,2018-11-13 10:00:00,30,1,31
"7597",10102,"St Johns","NL",47.56038,-52.71147,2018-11-13 11:00:00,30,0,30
"7598",10102,"St Johns","NL",47.56038,-52.71147,2018-11-13 12:00:00,30,1,31
"7599",10102,"St Johns","NL",47.56038,-52.71147,2018-11-13 13:00:00,29,1,30
"7600",10102,"St Johns","NL",47.56038,-52.71147,2018-11-13 14:00:00,30,1,31
"7601",10102,"St Johns","NL",47.56038,-52.71147,2018-11-13 15:00:00,29,2,31
"7602",10102,"St Johns","NL",47.56038,-52.71147,2018-11-13 16:00:00,29,3,32
"7603",10102,"St Johns","NL",47.56038,-52.71147,2018-11-13 17:00:00,28,3,31
"7604",10102,"St Johns","NL",47.56038,-52.71147,2018-11-13 18:00:00,28,3,31
"7605",10102,"St Johns","NL",47.56038,-52.71147,2018-11-13 19:00:00,28,3,31
"7606",10102,"St Johns","NL",47.56038,-52.71147,2018-11-13 20:00:00,27,4,31
"7607",10102,"St Johns","NL",47.56038,-52.71147,2018-11-13 21:00:00,26,4,30
"7608",10102,"St Johns","NL",47.56038,-52.71147,2018-11-13 22:00:00,25,4,29
"7609",10102,"St Johns","NL",47.56038,-52.71147,2018-11-13 23:00:00,23,4,27
"7610",10102,"St Johns","NL",47.56038,-52.71147,2018-11-14 00:00:00,23,3,26
"7611",10102,"St Johns","NL",47.56038,-52.71147,2018-11-14 01:00:00,24,1,25
"7612",10102,"St Johns","NL",47.56038,-52.71147,2018-11-14 02:00:00,25,2,27
"7613",10102,"St Johns","NL",47.56038,-52.71147,2018-11-14 03:00:00,28,3,31
"7614",10102,"St Johns","NL",47.56038,-52.71147,2018-11-14 04:00:00,26,3,29
"7615",10102,"St Johns","NL",47.56038,-52.71147,2018-11-14 05:00:00,31,1,32
"7616",10102,"St Johns","NL",47.56038,-52.71147,2018-11-14 06:00:00,34,1,35
"7617",10102,"St Johns","NL",47.56038,-52.71147,2018-11-14 07:00:00,34,1,35
"7618",10102,"St Johns","NL",47.56038,-52.71147,2018-11-14 08:00:00,34,3,37
"7619",10102,"St Johns","NL",47.56038,-52.71147,2018-11-14 09:00:00,33,4,37
"7620",10102,"St Johns","NL",47.56038,-52.71147,2018-11-14 10:00:00,33,4,37
"7621",10102,"St Johns","NL",47.56038,-52.71147,2018-11-14 11:00:00,33,2,35
"7622",10102,"St Johns","NL",47.56038,-52.71147,2018-11-14 12:00:00,33,4,37
"7623",10102,"St Johns","NL",47.56038,-52.71147,2018-11-14 13:00:00,32,4,36
"7624",10102,"St Johns","NL",47.56038,-52.71147,2018-11-14 14:00:00,29,3,32
"7625",10102,"St Johns","NL",47.56038,-52.71147,2018-11-14 15:00:00,27,4,31
"7626",10102,"St Johns","NL",47.56038,-52.71147,2018-11-14 16:00:00,24,4,28
"7627",10102,"St Johns","NL",47.56038,-52.71147,2018-11-14 17:00:00,25,4,29
"7628",10102,"St Johns","NL",47.56038,-52.71147,2018-11-14 18:00:00,26,3,29
"7629",10102,"St Johns","NL",47.56038,-52.71147,2018-11-14 19:00:00,26,3,29
"7630",10102,"St Johns","NL",47.56038,-52.71147,2018-11-14 20:00:00,26,4,30
"7631",10102,"St Johns","NL",47.56038,-52.71147,2018-11-14 21:00:00,27,3,30
"7632",10102,"St Johns","NL",47.56038,-52.71147,2018-11-14 22:00:00,29,3,32
"7633",10102,"St Johns","NL",47.56038,-52.71147,2018-11-14 23:00:00,30,2,32
"7634",10102,"St Johns","NL",47.56038,-52.71147,2018-11-15 00:00:00,30,3,33
"7635",10102,"St Johns","NL",47.56038,-52.71147,2018-11-15 01:00:00,32,2,34
"7636",10102,"St Johns","NL",47.56038,-52.71147,2018-11-15 02:00:00,33,2,35
"7637",10102,"St Johns","NL",47.56038,-52.71147,2018-11-15 03:00:00,34,2,36
"7638",10102,"St Johns","NL",47.56038,-52.71147,2018-11-15 04:00:00,35,2,37
"7639",10102,"St Johns","NL",47.56038,-52.71147,2018-11-15 05:00:00,35,2,37
"7640",10102,"St Johns","NL",47.56038,-52.71147,2018-11-15 06:00:00,35,2,37
"7641",10102,"St Johns","NL",47.56038,-52.71147,2018-11-15 07:00:00,35,2,37
"7642",10102,"St Johns","NL",47.56038,-52.71147,2018-11-15 08:00:00,34,2,36
"7643",10102,"St Johns","NL",47.56038,-52.71147,2018-11-15 09:00:00,34,2,36
"7644",10102,"St Johns","NL",47.56038,-52.71147,2018-11-15 10:00:00,34,2,36
"7645",10102,"St Johns","NL",47.56038,-52.71147,2018-11-15 11:00:00,34,3,37
"7646",10102,"St Johns","NL",47.56038,-52.71147,2018-11-15 12:00:00,34,1,35
"7647",10102,"St Johns","NL",47.56038,-52.71147,2018-11-15 13:00:00,34,2,36
"7648",10102,"St Johns","NL",47.56038,-52.71147,2018-11-15 14:00:00,33,3,36
"7649",10102,"St Johns","NL",47.56038,-52.71147,2018-11-15 15:00:00,33,2,35
"7650",10102,"St Johns","NL",47.56038,-52.71147,2018-11-15 16:00:00,34,1,35
"7651",10102,"St Johns","NL",47.56038,-52.71147,2018-11-15 17:00:00,34,2,36
"7652",10102,"St Johns","NL",47.56038,-52.71147,2018-11-15 18:00:00,34,1,35
"7653",10102,"St Johns","NL",47.56038,-52.71147,2018-11-15 19:00:00,33,1,34
"7654",10102,"St Johns","NL",47.56038,-52.71147,2018-11-15 20:00:00,34,1,35
"7655",10102,"St Johns","NL",47.56038,-52.71147,2018-11-15 21:00:00,33,2,35
"7656",10102,"St Johns","NL",47.56038,-52.71147,2018-11-15 22:00:00,34,1,35
"7657",10102,"St Johns","NL",47.56038,-52.71147,2018-11-15 23:00:00,34,1,35
"7658",10102,"St Johns","NL",47.56038,-52.71147,2018-11-16 00:00:00,33,2,35
"7659",10102,"St Johns","NL",47.56038,-52.71147,2018-11-16 01:00:00,34,1,35
"7660",10102,"St Johns","NL",47.56038,-52.71147,2018-11-16 02:00:00,35,1,36
"7661",10102,"St Johns","NL",47.56038,-52.71147,2018-11-16 03:00:00,34,1,35
"7662",10102,"St Johns","NL",47.56038,-52.71147,2018-11-16 04:00:00,35,1,36
"7663",10102,"St Johns","NL",47.56038,-52.71147,2018-11-16 05:00:00,35,1,36
"7664",10102,"St Johns","NL",47.56038,-52.71147,2018-11-16 06:00:00,35,2,37
"7665",10102,"St Johns","NL",47.56038,-52.71147,2018-11-16 07:00:00,33,3,36
"7666",10102,"St Johns","NL",47.56038,-52.71147,2018-11-16 08:00:00,33,3,36
"7667",10102,"St Johns","NL",47.56038,-52.71147,2018-11-16 09:00:00,32,5,37
"7668",10102,"St Johns","NL",47.56038,-52.71147,2018-11-16 10:00:00,33,3,36
"7669",10102,"St Johns","NL",47.56038,-52.71147,2018-11-16 11:00:00,33,3,36
"7670",10102,"St Johns","NL",47.56038,-52.71147,2018-11-16 12:00:00,32,3,35
"7671",10102,"St Johns","NL",47.56038,-52.71147,2018-11-16 13:00:00,32,5,37
"7672",10102,"St Johns","NL",47.56038,-52.71147,2018-11-16 14:00:00,31,5,36
"7673",10102,"St Johns","NL",47.56038,-52.71147,2018-11-16 15:00:00,32,5,37
"7674",10102,"St Johns","NL",47.56038,-52.71147,2018-11-16 16:00:00,28,11,39
"7675",10102,"St Johns","NL",47.56038,-52.71147,2018-11-16 17:00:00,26,10,36
"7676",10102,"St Johns","NL",47.56038,-52.71147,2018-11-16 18:00:00,14,22,36
"7677",10102,"St Johns","NL",47.56038,-52.71147,2018-11-16 19:00:00,13,25,38
"7678",10102,"St Johns","NL",47.56038,-52.71147,2018-11-16 20:00:00,20,16,36
"7679",10102,"St Johns","NL",47.56038,-52.71147,2018-11-16 21:00:00,24,12,36
"7680",10102,"St Johns","NL",47.56038,-52.71147,2018-11-16 22:00:00,26,12,38
"7681",10102,"St Johns","NL",47.56038,-52.71147,2018-11-16 23:00:00,33,5,38
"7682",10102,"St Johns","NL",47.56038,-52.71147,2018-11-17 00:00:00,35,3,38
"7683",10102,"St Johns","NL",47.56038,-52.71147,2018-11-17 01:00:00,34,5,39
"7684",10102,"St Johns","NL",47.56038,-52.71147,2018-11-17 02:00:00,36,3,39
"7685",10102,"St Johns","NL",47.56038,-52.71147,2018-11-17 03:00:00,37,2,39
"7686",10102,"St Johns","NL",47.56038,-52.71147,2018-11-17 04:00:00,36,3,39
"7687",10102,"St Johns","NL",47.56038,-52.71147,2018-11-17 05:00:00,34,6,40
"7688",10102,"St Johns","NL",47.56038,-52.71147,2018-11-17 06:00:00,35,4,39
"7689",10102,"St Johns","NL",47.56038,-52.71147,2018-11-17 07:00:00,35,3,38
"7690",10102,"St Johns","NL",47.56038,-52.71147,2018-11-17 08:00:00,33,7,40
"7691",10102,"St Johns","NL",47.56038,-52.71147,2018-11-17 09:00:00,33,6,39
"7692",10102,"St Johns","NL",47.56038,-52.71147,2018-11-17 10:00:00,33,3,36
"7693",10102,"St Johns","NL",47.56038,-52.71147,2018-11-17 11:00:00,33,3,36
"7694",10102,"St Johns","NL",47.56038,-52.71147,2018-11-17 12:00:00,32,2,34
"7695",10102,"St Johns","NL",47.56038,-52.71147,2018-11-17 13:00:00,30,3,33
"7696",10102,"St Johns","NL",47.56038,-52.71147,2018-11-17 14:00:00,28,3,31
"7697",10102,"St Johns","NL",47.56038,-52.71147,2018-11-17 15:00:00,31,1,32
"7698",10102,"St Johns","NL",47.56038,-52.71147,2018-11-17 16:00:00,35,1,36
"7699",10102,"St Johns","NL",47.56038,-52.71147,2018-11-17 17:00:00,34,2,36
"7700",10102,"St Johns","NL",47.56038,-52.71147,2018-11-17 18:00:00,35,1,36
"7701",10102,"St Johns","NL",47.56038,-52.71147,2018-11-17 19:00:00,34,1,35
"7702",10102,"St Johns","NL",47.56038,-52.71147,2018-11-17 20:00:00,33,1,34
"7703",10102,"St Johns","NL",47.56038,-52.71147,2018-11-17 21:00:00,32,1,33
"7704",10102,"St Johns","NL",47.56038,-52.71147,2018-11-17 22:00:00,30,2,32
"7705",10102,"St Johns","NL",47.56038,-52.71147,2018-11-17 23:00:00,30,1,31
"7706",10102,"St Johns","NL",47.56038,-52.71147,2018-11-18 00:00:00,30,1,31
"7707",10102,"St Johns","NL",47.56038,-52.71147,2018-11-18 01:00:00,30,2,32
"7708",10102,"St Johns","NL",47.56038,-52.71147,2018-11-18 02:00:00,30,1,31
"7709",10102,"St Johns","NL",47.56038,-52.71147,2018-11-18 03:00:00,30,1,31
"7710",10102,"St Johns","NL",47.56038,-52.71147,2018-11-18 04:00:00,30,2,32
"7711",10102,"St Johns","NL",47.56038,-52.71147,2018-11-18 05:00:00,30,1,31
"7712",10102,"St Johns","NL",47.56038,-52.71147,2018-11-18 06:00:00,30,1,31
"7713",10102,"St Johns","NL",47.56038,-52.71147,2018-11-18 07:00:00,31,2,33
"7714",10102,"St Johns","NL",47.56038,-52.71147,2018-11-18 08:00:00,30,2,32
"7715",10102,"St Johns","NL",47.56038,-52.71147,2018-11-18 09:00:00,30,2,32
"7716",10102,"St Johns","NL",47.56038,-52.71147,2018-11-18 10:00:00,32,1,33
"7717",10102,"St Johns","NL",47.56038,-52.71147,2018-11-18 11:00:00,33,1,34
"7718",10102,"St Johns","NL",47.56038,-52.71147,2018-11-18 12:00:00,32,1,33
"7719",10102,"St Johns","NL",47.56038,-52.71147,2018-11-18 13:00:00,32,2,34
"7720",10102,"St Johns","NL",47.56038,-52.71147,2018-11-18 14:00:00,31,1,32
"7721",10102,"St Johns","NL",47.56038,-52.71147,2018-11-18 15:00:00,29,1,30
"7722",10102,"St Johns","NL",47.56038,-52.71147,2018-11-18 16:00:00,27,1,28
"7723",10102,"St Johns","NL",47.56038,-52.71147,2018-11-18 17:00:00,25,2,27
"7724",10102,"St Johns","NL",47.56038,-52.71147,2018-11-18 18:00:00,25,1,26
"7725",10102,"St Johns","NL",47.56038,-52.71147,2018-11-18 19:00:00,25,1,26
"7726",10102,"St Johns","NL",47.56038,-52.71147,2018-11-18 20:00:00,27,1,28
"7727",10102,"St Johns","NL",47.56038,-52.71147,2018-11-18 21:00:00,27,1,28
"7728",10102,"St Johns","NL",47.56038,-52.71147,2018-11-18 22:00:00,28,1,29
"7729",10102,"St Johns","NL",47.56038,-52.71147,2018-11-18 23:00:00,30,0,30
"7730",10102,"St Johns","NL",47.56038,-52.71147,2018-11-19 00:00:00,31,1,32
"7731",10102,"St Johns","NL",47.56038,-52.71147,2018-11-19 01:00:00,32,0,32
"7732",10102,"St Johns","NL",47.56038,-52.71147,2018-11-19 02:00:00,33,0,33
"7733",10102,"St Johns","NL",47.56038,-52.71147,2018-11-19 03:00:00,33,1,34
"7734",10102,"St Johns","NL",47.56038,-52.71147,2018-11-19 04:00:00,33,0,33
"7735",10102,"St Johns","NL",47.56038,-52.71147,2018-11-19 05:00:00,33,0,33
"7736",10102,"St Johns","NL",47.56038,-52.71147,2018-11-19 06:00:00,33,1,34
"7737",10102,"St Johns","NL",47.56038,-52.71147,2018-11-19 07:00:00,24,9,33
"7738",10102,"St Johns","NL",47.56038,-52.71147,2018-11-19 08:00:00,16,17,33
"7739",10102,"St Johns","NL",47.56038,-52.71147,2018-11-19 09:00:00,15,18,33
"7740",10102,"St Johns","NL",47.56038,-52.71147,2018-11-19 10:00:00,25,11,36
"7741",10102,"St Johns","NL",47.56038,-52.71147,2018-11-19 11:00:00,27,7,34
"7742",10102,"St Johns","NL",47.56038,-52.71147,2018-11-19 12:00:00,31,5,36
"7743",10102,"St Johns","NL",47.56038,-52.71147,2018-11-19 13:00:00,31,5,36
"7744",10102,"St Johns","NL",47.56038,-52.71147,2018-11-19 14:00:00,29,8,37
"7745",10102,"St Johns","NL",47.56038,-52.71147,2018-11-19 15:00:00,30,7,37
"7746",10102,"St Johns","NL",47.56038,-52.71147,2018-11-19 16:00:00,31,7,38
"7747",10102,"St Johns","NL",47.56038,-52.71147,2018-11-19 17:00:00,29,8,37
"7748",10102,"St Johns","NL",47.56038,-52.71147,2018-11-19 18:00:00,27,9,36
"7749",10102,"St Johns","NL",47.56038,-52.71147,2018-11-19 19:00:00,30,4,34
"7750",10102,"St Johns","NL",47.56038,-52.71147,2018-11-19 20:00:00,30,3,33
"7751",10102,"St Johns","NL",47.56038,-52.71147,2018-11-19 21:00:00,30,3,33
"7752",10102,"St Johns","NL",47.56038,-52.71147,2018-11-19 22:00:00,33,2,35
"7753",10102,"St Johns","NL",47.56038,-52.71147,2018-11-19 23:00:00,34,2,36
"7754",10102,"St Johns","NL",47.56038,-52.71147,2018-11-20 00:00:00,34,1,35
"7755",10102,"St Johns","NL",47.56038,-52.71147,2018-11-20 01:00:00,35,1,36
"7756",10102,"St Johns","NL",47.56038,-52.71147,2018-11-20 02:00:00,36,1,37
"7757",10102,"St Johns","NL",47.56038,-52.71147,2018-11-20 03:00:00,33,1,34
"7758",10102,"St Johns","NL",47.56038,-52.71147,2018-11-20 04:00:00,31,2,33
"7759",10102,"St Johns","NL",47.56038,-52.71147,2018-11-20 05:00:00,33,1,34
"7760",10102,"St Johns","NL",47.56038,-52.71147,2018-11-20 06:00:00,34,1,35
"7761",10102,"St Johns","NL",47.56038,-52.71147,2018-11-20 07:00:00,34,2,36
"7762",10102,"St Johns","NL",47.56038,-52.71147,2018-11-20 08:00:00,25,11,36
"7763",10102,"St Johns","NL",47.56038,-52.71147,2018-11-20 09:00:00,19,17,36
"7764",10102,"St Johns","NL",47.56038,-52.71147,2018-11-20 10:00:00,17,20,37
"7765",10102,"St Johns","NL",47.56038,-52.71147,2018-11-20 11:00:00,25,14,39
"7766",10102,"St Johns","NL",47.56038,-52.71147,2018-11-20 12:00:00,32,2,34
"7767",10102,"St Johns","NL",47.56038,-52.71147,2018-11-20 13:00:00,30,2,32
"7768",10102,"St Johns","NL",47.56038,-52.71147,2018-11-20 14:00:00,24,7,31
"7769",10102,"St Johns","NL",47.56038,-52.71147,2018-11-20 15:00:00,22,9,31
"7770",10102,"St Johns","NL",47.56038,-52.71147,2018-11-20 16:00:00,27,3,30
"7771",10102,"St Johns","NL",47.56038,-52.71147,2018-11-20 17:00:00,18,12,30
"7772",10102,"St Johns","NL",47.56038,-52.71147,2018-11-20 18:00:00,9,20,29
"7773",10102,"St Johns","NL",47.56038,-52.71147,2018-11-20 19:00:00,9,21,30
"7774",10102,"St Johns","NL",47.56038,-52.71147,2018-11-20 20:00:00,14,16,30
"7775",10102,"St Johns","NL",47.56038,-52.71147,2018-11-20 21:00:00,9,19,28
"7776",10102,"St Johns","NL",47.56038,-52.71147,2018-11-20 22:00:00,3,24,27
"7777",10102,"St Johns","NL",47.56038,-52.71147,2018-11-20 23:00:00,12,9,21
"7778",10102,"St Johns","NL",47.56038,-52.71147,2018-11-21 00:00:00,14,7,21
"7779",10102,"St Johns","NL",47.56038,-52.71147,2018-11-21 01:00:00,3,20,23
"7780",10102,"St Johns","NL",47.56038,-52.71147,2018-11-21 02:00:00,6,19,25
"7781",10102,"St Johns","NL",47.56038,-52.71147,2018-11-21 03:00:00,7,19,26
"7782",10102,"St Johns","NL",47.56038,-52.71147,2018-11-21 04:00:00,19,11,30
"7783",10102,"St Johns","NL",47.56038,-52.71147,2018-11-21 05:00:00,20,11,31
"7784",10102,"St Johns","NL",47.56038,-52.71147,2018-11-21 06:00:00,25,6,31
"7785",10102,"St Johns","NL",47.56038,-52.71147,2018-11-21 07:00:00,24,8,32
"7786",10102,"St Johns","NL",47.56038,-52.71147,2018-11-21 08:00:00,32,5,37
"7787",10102,"St Johns","NL",47.56038,-52.71147,2018-11-21 09:00:00,32,5,37
"7788",10102,"St Johns","NL",47.56038,-52.71147,2018-11-21 10:00:00,34,4,38
"7789",10102,"St Johns","NL",47.56038,-52.71147,2018-11-21 11:00:00,34,3,37
"7790",10102,"St Johns","NL",47.56038,-52.71147,2018-11-21 12:00:00,32,3,35
"7791",10102,"St Johns","NL",47.56038,-52.71147,2018-11-21 13:00:00,30,4,34
"7792",10102,"St Johns","NL",47.56038,-52.71147,2018-11-21 14:00:00,32,4,36
"7793",10102,"St Johns","NL",47.56038,-52.71147,2018-11-21 15:00:00,34,2,36
"7794",10102,"St Johns","NL",47.56038,-52.71147,2018-11-21 16:00:00,34,4,38
"7795",10102,"St Johns","NL",47.56038,-52.71147,2018-11-21 17:00:00,32,4,36
"7796",10102,"St Johns","NL",47.56038,-52.71147,2018-11-21 18:00:00,27,3,30
"7797",10102,"St Johns","NL",47.56038,-52.71147,2018-11-21 19:00:00,26,3,29
"7798",10102,"St Johns","NL",47.56038,-52.71147,2018-11-21 20:00:00,28,2,30
"7799",10102,"St Johns","NL",47.56038,-52.71147,2018-11-21 21:00:00,29,1,30
"7800",10102,"St Johns","NL",47.56038,-52.71147,2018-11-21 22:00:00,30,1,31
"7801",10102,"St Johns","NL",47.56038,-52.71147,2018-11-21 23:00:00,29,2,31
"7802",10102,"St Johns","NL",47.56038,-52.71147,2018-11-22 00:00:00,28,2,30
"7803",10102,"St Johns","NL",47.56038,-52.71147,2018-11-22 01:00:00,29,1,30
"7804",10102,"St Johns","NL",47.56038,-52.71147,2018-11-22 02:00:00,30,1,31
"7805",10102,"St Johns","NL",47.56038,-52.71147,2018-11-22 03:00:00,30,1,31
"7806",10102,"St Johns","NL",47.56038,-52.71147,2018-11-22 04:00:00,29,2,31
"7807",10102,"St Johns","NL",47.56038,-52.71147,2018-11-22 05:00:00,25,5,30
"7808",10102,"St Johns","NL",47.56038,-52.71147,2018-11-22 06:00:00,25,3,28
"7809",10102,"St Johns","NL",47.56038,-52.71147,2018-11-22 07:00:00,23,6,29
"7810",10102,"St Johns","NL",47.56038,-52.71147,2018-11-22 08:00:00,24,7,31
"7811",10102,"St Johns","NL",47.56038,-52.71147,2018-11-22 09:00:00,26,7,33
"7812",10102,"St Johns","NL",47.56038,-52.71147,2018-11-22 10:00:00,27,6,33
"7813",10102,"St Johns","NL",47.56038,-52.71147,2018-11-22 11:00:00,28,5,33
"7814",10102,"St Johns","NL",47.56038,-52.71147,2018-11-22 12:00:00,27,5,32
"7815",10102,"St Johns","NL",47.56038,-52.71147,2018-11-22 13:00:00,29,4,33
"7816",10102,"St Johns","NL",47.56038,-52.71147,2018-11-22 14:00:00,30,3,33
"7817",10102,"St Johns","NL",47.56038,-52.71147,2018-11-22 15:00:00,30,4,34
"7818",10102,"St Johns","NL",47.56038,-52.71147,2018-11-22 16:00:00,26,5,31
"7819",10102,"St Johns","NL",47.56038,-52.71147,2018-11-22 17:00:00,24,7,31
"7820",10102,"St Johns","NL",47.56038,-52.71147,2018-11-22 18:00:00,22,8,30
"7821",10102,"St Johns","NL",47.56038,-52.71147,2018-11-22 19:00:00,25,4,29
"7822",10102,"St Johns","NL",47.56038,-52.71147,2018-11-22 20:00:00,29,2,31
"7823",10102,"St Johns","NL",47.56038,-52.71147,2018-11-22 21:00:00,28,3,31
"7824",10102,"St Johns","NL",47.56038,-52.71147,2018-11-22 22:00:00,28,3,31
"7825",10102,"St Johns","NL",47.56038,-52.71147,2018-11-22 23:00:00,30,2,32
"7826",10102,"St Johns","NL",47.56038,-52.71147,2018-11-23 00:00:00,31,2,33
"7827",10102,"St Johns","NL",47.56038,-52.71147,2018-11-23 01:00:00,31,1,32
"7828",10102,"St Johns","NL",47.56038,-52.71147,2018-11-23 02:00:00,30,1,31
"7829",10102,"St Johns","NL",47.56038,-52.71147,2018-11-23 03:00:00,31,1,32
"7830",10102,"St Johns","NL",47.56038,-52.71147,2018-11-23 04:00:00,32,2,34
"7831",10102,"St Johns","NL",47.56038,-52.71147,2018-11-23 05:00:00,30,1,31
"7832",10102,"St Johns","NL",47.56038,-52.71147,2018-11-23 06:00:00,28,2,30
"7833",10102,"St Johns","NL",47.56038,-52.71147,2018-11-23 07:00:00,28,3,31
"7834",10102,"St Johns","NL",47.56038,-52.71147,2018-11-23 08:00:00,22,6,28
"7835",10102,"St Johns","NL",47.56038,-52.71147,2018-11-23 09:00:00,22,8,30
"7836",10102,"St Johns","NL",47.56038,-52.71147,2018-11-23 10:00:00,27,3,30
"7837",10102,"St Johns","NL",47.56038,-52.71147,2018-11-23 11:00:00,28,4,32
"7838",10102,"St Johns","NL",47.56038,-52.71147,2018-11-23 12:00:00,29,1,30
"7839",10102,"St Johns","NL",47.56038,-52.71147,2018-11-23 13:00:00,30,2,32
"7840",10102,"St Johns","NL",47.56038,-52.71147,2018-11-23 14:00:00,31,2,33
"7841",10102,"St Johns","NL",47.56038,-52.71147,2018-11-23 15:00:00,31,2,33
"7842",10102,"St Johns","NL",47.56038,-52.71147,2018-11-23 16:00:00,30,2,32
"7843",10102,"St Johns","NL",47.56038,-52.71147,2018-11-23 17:00:00,26,5,31
"7844",10102,"St Johns","NL",47.56038,-52.71147,2018-11-23 18:00:00,26,5,31
"7845",10102,"St Johns","NL",47.56038,-52.71147,2018-11-23 19:00:00,23,7,30
"7846",10102,"St Johns","NL",47.56038,-52.71147,2018-11-23 20:00:00,30,2,32
"7847",10102,"St Johns","NL",47.56038,-52.71147,2018-11-23 21:00:00,30,3,33
"7848",10102,"St Johns","NL",47.56038,-52.71147,2018-11-23 22:00:00,29,2,31
"7849",10102,"St Johns","NL",47.56038,-52.71147,2018-11-23 23:00:00,29,3,32
"7850",10102,"St Johns","NL",47.56038,-52.71147,2018-11-24 00:00:00,30,1,31
"7851",10102,"St Johns","NL",47.56038,-52.71147,2018-11-24 01:00:00,30,1,31
"7852",10102,"St Johns","NL",47.56038,-52.71147,2018-11-24 02:00:00,31,0,31
"7853",10102,"St Johns","NL",47.56038,-52.71147,2018-11-24 03:00:00,30,0,30
"7854",10102,"St Johns","NL",47.56038,-52.71147,2018-11-24 04:00:00,32,0,32
"7855",10102,"St Johns","NL",47.56038,-52.71147,2018-11-24 05:00:00,32,1,33
"7856",10102,"St Johns","NL",47.56038,-52.71147,2018-11-24 06:00:00,32,0,32
"7857",10102,"St Johns","NL",47.56038,-52.71147,2018-11-24 07:00:00,33,0,33
"7858",10102,"St Johns","NL",47.56038,-52.71147,2018-11-24 08:00:00,34,0,34
"7859",10102,"St Johns","NL",47.56038,-52.71147,2018-11-24 09:00:00,35,1,36
"7860",10102,"St Johns","NL",47.56038,-52.71147,2018-11-24 10:00:00,36,0,36
"7861",10102,"St Johns","NL",47.56038,-52.71147,2018-11-24 11:00:00,36,0,36
"7862",10102,"St Johns","NL",47.56038,-52.71147,2018-11-24 12:00:00,35,2,37
"7863",10102,"St Johns","NL",47.56038,-52.71147,2018-11-24 13:00:00,35,2,37
"7864",10102,"St Johns","NL",47.56038,-52.71147,2018-11-24 14:00:00,35,3,38
"7865",10102,"St Johns","NL",47.56038,-52.71147,2018-11-24 15:00:00,35,2,37
"7866",10102,"St Johns","NL",47.56038,-52.71147,2018-11-24 16:00:00,34,2,36
"7867",10102,"St Johns","NL",47.56038,-52.71147,2018-11-24 17:00:00,34,2,36
"7868",10102,"St Johns","NL",47.56038,-52.71147,2018-11-24 18:00:00,33,3,36
"7869",10102,"St Johns","NL",47.56038,-52.71147,2018-11-24 19:00:00,32,2,34
"7870",10102,"St Johns","NL",47.56038,-52.71147,2018-11-24 20:00:00,32,2,34
"7871",10102,"St Johns","NL",47.56038,-52.71147,2018-11-24 21:00:00,32,2,34
"7872",10102,"St Johns","NL",47.56038,-52.71147,2018-11-24 22:00:00,31,2,33
"7873",10102,"St Johns","NL",47.56038,-52.71147,2018-11-24 23:00:00,31,2,33
"7874",10102,"St Johns","NL",47.56038,-52.71147,2018-11-25 00:00:00,32,2,34
"7875",10102,"St Johns","NL",47.56038,-52.71147,2018-11-25 01:00:00,31,2,33
"7876",10102,"St Johns","NL",47.56038,-52.71147,2018-11-25 02:00:00,31,2,33
"7877",10102,"St Johns","NL",47.56038,-52.71147,2018-11-25 03:00:00,31,2,33
"7878",10102,"St Johns","NL",47.56038,-52.71147,2018-11-25 04:00:00,31,2,33
"7879",10102,"St Johns","NL",47.56038,-52.71147,2018-11-25 05:00:00,31,2,33
"7880",10102,"St Johns","NL",47.56038,-52.71147,2018-11-25 06:00:00,31,2,33
"7881",10102,"St Johns","NL",47.56038,-52.71147,2018-11-25 07:00:00,30,3,33
"7882",10102,"St Johns","NL",47.56038,-52.71147,2018-11-25 08:00:00,30,2,32
"7883",10102,"St Johns","NL",47.56038,-52.71147,2018-11-25 09:00:00,30,2,32
"7884",10102,"St Johns","NL",47.56038,-52.71147,2018-11-25 10:00:00,30,2,32
"7885",10102,"St Johns","NL",47.56038,-52.71147,2018-11-25 11:00:00,30,2,32
"7886",10102,"St Johns","NL",47.56038,-52.71147,2018-11-25 12:00:00,30,1,31
"7887",10102,"St Johns","NL",47.56038,-52.71147,2018-11-25 13:00:00,30,1,31
"7888",10102,"St Johns","NL",47.56038,-52.71147,2018-11-25 14:00:00,31,1,32
"7889",10102,"St Johns","NL",47.56038,-52.71147,2018-11-25 15:00:00,30,1,31
"7890",10102,"St Johns","NL",47.56038,-52.71147,2018-11-25 16:00:00,30,2,32
"7891",10102,"St Johns","NL",47.56038,-52.71147,2018-11-25 17:00:00,30,2,32
"7892",10102,"St Johns","NL",47.56038,-52.71147,2018-11-25 18:00:00,30,2,32
"7893",10102,"St Johns","NL",47.56038,-52.71147,2018-11-25 19:00:00,31,2,33
"7894",10102,"St Johns","NL",47.56038,-52.71147,2018-11-25 20:00:00,31,1,32
"7895",10102,"St Johns","NL",47.56038,-52.71147,2018-11-25 21:00:00,31,1,32
"7896",10102,"St Johns","NL",47.56038,-52.71147,2018-11-25 22:00:00,30,1,31
"7897",10102,"St Johns","NL",47.56038,-52.71147,2018-11-25 23:00:00,31,0,31
"7898",10102,"St Johns","NL",47.56038,-52.71147,2018-11-26 00:00:00,30,1,31
"7899",10102,"St Johns","NL",47.56038,-52.71147,2018-11-26 01:00:00,31,1,32
"7900",10102,"St Johns","NL",47.56038,-52.71147,2018-11-26 02:00:00,30,1,31
"7901",10102,"St Johns","NL",47.56038,-52.71147,2018-11-26 03:00:00,31,1,32
"7902",10102,"St Johns","NL",47.56038,-52.71147,2018-11-26 04:00:00,32,1,33
"7903",10102,"St Johns","NL",47.56038,-52.71147,2018-11-26 05:00:00,32,1,33
"7904",10102,"St Johns","NL",47.56038,-52.71147,2018-11-26 06:00:00,31,1,32
"7905",10102,"St Johns","NL",47.56038,-52.71147,2018-11-26 07:00:00,30,3,33
"7906",10102,"St Johns","NL",47.56038,-52.71147,2018-11-26 08:00:00,30,3,33
"7907",10102,"St Johns","NL",47.56038,-52.71147,2018-11-26 09:00:00,28,5,33
"7908",10102,"St Johns","NL",47.56038,-52.71147,2018-11-26 10:00:00,26,7,33
"7909",10102,"St Johns","NL",47.56038,-52.71147,2018-11-26 11:00:00,27,7,34
"7910",10102,"St Johns","NL",47.56038,-52.71147,2018-11-26 12:00:00,30,3,33
"7911",10102,"St Johns","NL",47.56038,-52.71147,2018-11-26 13:00:00,29,4,33
"7912",10102,"St Johns","NL",47.56038,-52.71147,2018-11-26 14:00:00,30,4,34
"7913",10102,"St Johns","NL",47.56038,-52.71147,2018-11-26 15:00:00,30,3,33
"7914",10102,"St Johns","NL",47.56038,-52.71147,2018-11-26 16:00:00,30,2,32
"7915",10102,"St Johns","NL",47.56038,-52.71147,2018-11-26 17:00:00,30,2,32
"7916",10102,"St Johns","NL",47.56038,-52.71147,2018-11-26 18:00:00,31,1,32
"7917",10102,"St Johns","NL",47.56038,-52.71147,2018-11-26 19:00:00,32,2,34
"7918",10102,"St Johns","NL",47.56038,-52.71147,2018-11-26 20:00:00,32,1,33
"7919",10102,"St Johns","NL",47.56038,-52.71147,2018-11-26 21:00:00,30,1,31
"7920",10102,"St Johns","NL",47.56038,-52.71147,2018-11-26 22:00:00,30,2,32
"7921",10102,"St Johns","NL",47.56038,-52.71147,2018-11-26 23:00:00,28,3,31
"7922",10102,"St Johns","NL",47.56038,-52.71147,2018-11-27 00:00:00,30,3,33
"7923",10102,"St Johns","NL",47.56038,-52.71147,2018-11-27 01:00:00,30,3,33
"7924",10102,"St Johns","NL",47.56038,-52.71147,2018-11-27 02:00:00,33,1,34
"7925",10102,"St Johns","NL",47.56038,-52.71147,2018-11-27 03:00:00,33,1,34
"7926",10102,"St Johns","NL",47.56038,-52.71147,2018-11-27 04:00:00,33,1,34
"7927",10102,"St Johns","NL",47.56038,-52.71147,2018-11-27 05:00:00,33,0,33
"7928",10102,"St Johns","NL",47.56038,-52.71147,2018-11-27 06:00:00,33,1,34
"7929",10102,"St Johns","NL",47.56038,-52.71147,2018-11-27 07:00:00,32,1,33
"7930",10102,"St Johns","NL",47.56038,-52.71147,2018-11-27 08:00:00,31,0,31
"7931",10102,"St Johns","NL",47.56038,-52.71147,2018-11-27 09:00:00,30,3,33
"7932",10102,"St Johns","NL",47.56038,-52.71147,2018-11-27 10:00:00,30,3,33
"7933",10102,"St Johns","NL",47.56038,-52.71147,2018-11-27 11:00:00,30,2,32
"7934",10102,"St Johns","NL",47.56038,-52.71147,2018-11-27 12:00:00,29,4,33
"7935",10102,"St Johns","NL",47.56038,-52.71147,2018-11-27 13:00:00,29,4,33
"7936",10102,"St Johns","NL",47.56038,-52.71147,2018-11-27 14:00:00,28,5,33
"7937",10102,"St Johns","NL",47.56038,-52.71147,2018-11-27 15:00:00,28,4,32
"7938",10102,"St Johns","NL",47.56038,-52.71147,2018-11-27 16:00:00,26,7,33
"7939",10102,"St Johns","NL",47.56038,-52.71147,2018-11-27 17:00:00,26,6,32
"7940",10102,"St Johns","NL",47.56038,-52.71147,2018-11-27 18:00:00,27,6,33
"7941",10102,"St Johns","NL",47.56038,-52.71147,2018-11-27 19:00:00,27,5,32
"7942",10102,"St Johns","NL",47.56038,-52.71147,2018-11-27 20:00:00,28,3,31
"7943",10102,"St Johns","NL",47.56038,-52.71147,2018-11-27 21:00:00,29,3,32
"7944",10102,"St Johns","NL",47.56038,-52.71147,2018-11-27 22:00:00,29,4,33
"7945",10102,"St Johns","NL",47.56038,-52.71147,2018-11-27 23:00:00,30,3,33
"7946",10102,"St Johns","NL",47.56038,-52.71147,2018-11-28 00:00:00,29,4,33
"7947",10102,"St Johns","NL",47.56038,-52.71147,2018-11-28 01:00:00,29,4,33
"7948",10102,"St Johns","NL",47.56038,-52.71147,2018-11-28 02:00:00,29,4,33
"7949",10102,"St Johns","NL",47.56038,-52.71147,2018-11-28 03:00:00,28,4,32
"7950",10102,"St Johns","NL",47.56038,-52.71147,2018-11-28 04:00:00,29,3,32
"7951",10102,"St Johns","NL",47.56038,-52.71147,2018-11-28 05:00:00,28,5,33
"7952",10102,"St Johns","NL",47.56038,-52.71147,2018-11-28 06:00:00,27,6,33
"7953",10102,"St Johns","NL",47.56038,-52.71147,2018-11-28 07:00:00,28,7,35
"7954",10102,"St Johns","NL",47.56038,-52.71147,2018-11-28 08:00:00,27,7,34
"7955",10102,"St Johns","NL",47.56038,-52.71147,2018-11-28 09:00:00,26,9,35
"7956",10102,"St Johns","NL",47.56038,-52.71147,2018-11-28 10:00:00,23,15,38
"7957",10102,"St Johns","NL",47.56038,-52.71147,2018-11-28 11:00:00,23,16,39
"7958",10102,"St Johns","NL",47.56038,-52.71147,2018-11-28 12:00:00,26,7,33
"7959",10102,"St Johns","NL",47.56038,-52.71147,2018-11-28 13:00:00,24,9,33
"7960",10102,"St Johns","NL",47.56038,-52.71147,2018-11-28 14:00:00,27,6,33
"7961",10102,"St Johns","NL",47.56038,-52.71147,2018-11-28 15:00:00,28,6,34
"7962",10102,"St Johns","NL",47.56038,-52.71147,2018-11-28 16:00:00,29,6,35
"7963",10102,"St Johns","NL",47.56038,-52.71147,2018-11-28 17:00:00,28,8,36
"7964",10102,"St Johns","NL",47.56038,-52.71147,2018-11-28 18:00:00,30,5,35
"7965",10102,"St Johns","NL",47.56038,-52.71147,2018-11-28 19:00:00,32,3,35
"7966",10102,"St Johns","NL",47.56038,-52.71147,2018-11-28 20:00:00,31,5,36
"7967",10102,"St Johns","NL",47.56038,-52.71147,2018-11-28 21:00:00,32,2,34
"7968",10102,"St Johns","NL",47.56038,-52.71147,2018-11-28 22:00:00,32,3,35
"7969",10102,"St Johns","NL",47.56038,-52.71147,2018-11-28 23:00:00,32,2,34
"7970",10102,"St Johns","NL",47.56038,-52.71147,2018-11-29 00:00:00,31,4,35
"7971",10102,"St Johns","NL",47.56038,-52.71147,2018-11-29 01:00:00,32,6,38
"7972",10102,"St Johns","NL",47.56038,-52.71147,2018-11-29 02:00:00,33,5,38
"7973",10102,"St Johns","NL",47.56038,-52.71147,2018-11-29 03:00:00,32,7,39
"7974",10102,"St Johns","NL",47.56038,-52.71147,2018-11-29 04:00:00,32,6,38
"7975",10102,"St Johns","NL",47.56038,-52.71147,2018-11-29 05:00:00,34,5,39
"7976",10102,"St Johns","NL",47.56038,-52.71147,2018-11-29 06:00:00,28,10,38
"7977",10102,"St Johns","NL",47.56038,-52.71147,2018-11-29 07:00:00,26,12,38
"7978",10102,"St Johns","NL",47.56038,-52.71147,2018-11-29 08:00:00,27,11,38
"7979",10102,"St Johns","NL",47.56038,-52.71147,2018-11-29 09:00:00,23,13,36
"7980",10102,"St Johns","NL",47.56038,-52.71147,2018-11-29 10:00:00,19,20,39
"7981",10102,"St Johns","NL",47.56038,-52.71147,2018-11-29 11:00:00,23,15,38
"7982",10102,"St Johns","NL",47.56038,-52.71147,2018-11-29 12:00:00,15,23,38
"7983",10102,"St Johns","NL",47.56038,-52.71147,2018-11-29 13:00:00,16,19,35
"7984",10102,"St Johns","NL",47.56038,-52.71147,2018-11-29 14:00:00,8,32,40
"7985",10102,"St Johns","NL",47.56038,-52.71147,2018-11-29 15:00:00,8,33,41
"7986",10102,"St Johns","NL",47.56038,-52.71147,2018-11-29 16:00:00,2,34,36
"7987",10102,"St Johns","NL",47.56038,-52.71147,2018-11-29 17:00:00,6,27,33
"7988",10102,"St Johns","NL",47.56038,-52.71147,2018-11-29 18:00:00,19,13,32
"7989",10102,"St Johns","NL",47.56038,-52.71147,2018-11-29 19:00:00,23,8,31
"7990",10102,"St Johns","NL",47.56038,-52.71147,2018-11-29 20:00:00,25,6,31
"7991",10102,"St Johns","NL",47.56038,-52.71147,2018-11-29 21:00:00,27,7,34
"7992",10102,"St Johns","NL",47.56038,-52.71147,2018-11-29 22:00:00,18,17,35
"7993",10102,"St Johns","NL",47.56038,-52.71147,2018-11-29 23:00:00,22,12,34
"7994",10102,"St Johns","NL",47.56038,-52.71147,2018-11-30 00:00:00,21,16,37
"7995",10102,"St Johns","NL",47.56038,-52.71147,2018-11-30 01:00:00,16,24,40
"7996",10102,"St Johns","NL",47.56038,-52.71147,2018-11-30 02:00:00,22,18,40
"7997",10102,"St Johns","NL",47.56038,-52.71147,2018-11-30 03:00:00,37,0,37
"7998",10102,"St Johns","NL",47.56038,-52.71147,2018-11-30 04:00:00,37,0,37
"7999",10102,"St Johns","NL",47.56038,-52.71147,2018-11-30 05:00:00,36,0,36
"8000",10102,"St Johns","NL",47.56038,-52.71147,2018-11-30 06:00:00,36,0,36
"8001",10102,"St Johns","NL",47.56038,-52.71147,2018-11-30 07:00:00,36,1,37
"8002",10102,"St Johns","NL",47.56038,-52.71147,2018-11-30 08:00:00,36,1,37
"8003",10102,"St Johns","NL",47.56038,-52.71147,2018-11-30 09:00:00,35,2,37
"8004",10102,"St Johns","NL",47.56038,-52.71147,2018-11-30 10:00:00,34,1,35
"8005",10102,"St Johns","NL",47.56038,-52.71147,2018-11-30 11:00:00,34,1,35
"8006",10102,"St Johns","NL",47.56038,-52.71147,2018-11-30 12:00:00,33,2,35
"8007",10102,"St Johns","NL",47.56038,-52.71147,2018-11-30 13:00:00,34,1,35
"8008",10102,"St Johns","NL",47.56038,-52.71147,2018-11-30 14:00:00,35,1,36
"8009",10102,"St Johns","NL",47.56038,-52.71147,2018-11-30 15:00:00,35,0,35
"8010",10102,"St Johns","NL",47.56038,-52.71147,2018-11-30 16:00:00,35,1,36
"8011",10102,"St Johns","NL",47.56038,-52.71147,2018-11-30 17:00:00,36,1,37
"8012",10102,"St Johns","NL",47.56038,-52.71147,2018-11-30 18:00:00,36,1,37
"8013",10102,"St Johns","NL",47.56038,-52.71147,2018-11-30 19:00:00,35,2,37
"8014",10102,"St Johns","NL",47.56038,-52.71147,2018-11-30 20:00:00,34,4,38
"8015",10102,"St Johns","NL",47.56038,-52.71147,2018-11-30 21:00:00,36,1,37
"8016",10102,"St Johns","NL",47.56038,-52.71147,2018-11-30 22:00:00,37,1,38
"8017",10102,"St Johns","NL",47.56038,-52.71147,2018-11-30 23:00:00,37,1,38
"8018",10102,"St Johns","NL",47.56038,-52.71147,2018-12-01 00:00:00,36,0,36
"8019",10102,"St Johns","NL",47.56038,-52.71147,2018-12-01 01:00:00,35,2,37
"8020",10102,"St Johns","NL",47.56038,-52.71147,2018-12-01 02:00:00,36,1,37
"8021",10102,"St Johns","NL",47.56038,-52.71147,2018-12-01 03:00:00,35,0,35
"8022",10102,"St Johns","NL",47.56038,-52.71147,2018-12-01 04:00:00,35,1,36
"8023",10102,"St Johns","NL",47.56038,-52.71147,2018-12-01 05:00:00,36,0,36
"8024",10102,"St Johns","NL",47.56038,-52.71147,2018-12-01 06:00:00,36,0,36
"8025",10102,"St Johns","NL",47.56038,-52.71147,2018-12-01 07:00:00,35,0,35
"8026",10102,"St Johns","NL",47.56038,-52.71147,2018-12-01 08:00:00,35,1,36
"8027",10102,"St Johns","NL",47.56038,-52.71147,2018-12-01 09:00:00,34,3,37
"8028",10102,"St Johns","NL",47.56038,-52.71147,2018-12-01 10:00:00,34,3,37
"8029",10102,"St Johns","NL",47.56038,-52.71147,2018-12-01 11:00:00,34,3,37
"8030",10102,"St Johns","NL",47.56038,-52.71147,2018-12-01 12:00:00,33,4,37
"8031",10102,"St Johns","NL",47.56038,-52.71147,2018-12-01 13:00:00,33,4,37
"8032",10102,"St Johns","NL",47.56038,-52.71147,2018-12-01 14:00:00,31,7,38
"8033",10102,"St Johns","NL",47.56038,-52.71147,2018-12-01 15:00:00,31,7,38
"8034",10102,"St Johns","NL",47.56038,-52.71147,2018-12-01 16:00:00,31,5,36
"8035",10102,"St Johns","NL",47.56038,-52.71147,2018-12-01 17:00:00,32,4,36
"8036",10102,"St Johns","NL",47.56038,-52.71147,2018-12-01 18:00:00,32,4,36
"8037",10102,"St Johns","NL",47.56038,-52.71147,2018-12-01 19:00:00,31,4,35
"8038",10102,"St Johns","NL",47.56038,-52.71147,2018-12-01 20:00:00,31,4,35
"8039",10102,"St Johns","NL",47.56038,-52.71147,2018-12-01 21:00:00,29,5,34
"8040",10102,"St Johns","NL",47.56038,-52.71147,2018-12-01 22:00:00,31,3,34
"8041",10102,"St Johns","NL",47.56038,-52.71147,2018-12-01 23:00:00,30,4,34
"8042",10102,"St Johns","NL",47.56038,-52.71147,2018-12-02 00:00:00,28,7,35
"8043",10102,"St Johns","NL",47.56038,-52.71147,2018-12-02 01:00:00,30,4,34
"8044",10102,"St Johns","NL",47.56038,-52.71147,2018-12-02 02:00:00,31,4,35
"8045",10102,"St Johns","NL",47.56038,-52.71147,2018-12-02 03:00:00,30,4,34
"8046",10102,"St Johns","NL",47.56038,-52.71147,2018-12-02 04:00:00,29,5,34
"8047",10102,"St Johns","NL",47.56038,-52.71147,2018-12-02 05:00:00,30,4,34
"8048",10102,"St Johns","NL",47.56038,-52.71147,2018-12-02 06:00:00,31,2,33
"8049",10102,"St Johns","NL",47.56038,-52.71147,2018-12-02 07:00:00,29,3,32
"8050",10102,"St Johns","NL",47.56038,-52.71147,2018-12-02 08:00:00,29,4,33
"8051",10102,"St Johns","NL",47.56038,-52.71147,2018-12-02 09:00:00,31,3,34
"8052",10102,"St Johns","NL",47.56038,-52.71147,2018-12-02 10:00:00,31,3,34
"8053",10102,"St Johns","NL",47.56038,-52.71147,2018-12-02 11:00:00,32,2,34
"8054",10102,"St Johns","NL",47.56038,-52.71147,2018-12-02 12:00:00,34,3,37
"8055",10102,"St Johns","NL",47.56038,-52.71147,2018-12-02 13:00:00,33,3,36
"8056",10102,"St Johns","NL",47.56038,-52.71147,2018-12-02 14:00:00,34,3,37
"8057",10102,"St Johns","NL",47.56038,-52.71147,2018-12-02 15:00:00,32,6,38
"8058",10102,"St Johns","NL",47.56038,-52.71147,2018-12-02 16:00:00,28,9,37
"8059",10102,"St Johns","NL",47.56038,-52.71147,2018-12-02 17:00:00,25,12,37
"8060",10102,"St Johns","NL",47.56038,-52.71147,2018-12-02 18:00:00,30,6,36
"8061",10102,"St Johns","NL",47.56038,-52.71147,2018-12-02 19:00:00,19,17,36
"8062",10102,"St Johns","NL",47.56038,-52.71147,2018-12-02 20:00:00,21,14,35
"8063",10102,"St Johns","NL",47.56038,-52.71147,2018-12-02 21:00:00,30,6,36
"8064",10102,"St Johns","NL",47.56038,-52.71147,2018-12-02 22:00:00,19,14,33
"8065",10102,"St Johns","NL",47.56038,-52.71147,2018-12-02 23:00:00,24,10,34
"8066",10102,"St Johns","NL",47.56038,-52.71147,2018-12-03 00:00:00,30,3,33
"8067",10102,"St Johns","NL",47.56038,-52.71147,2018-12-03 01:00:00,26,7,33
"8068",10102,"St Johns","NL",47.56038,-52.71147,2018-12-03 02:00:00,28,6,34
"8069",10102,"St Johns","NL",47.56038,-52.71147,2018-12-03 03:00:00,26,4,30
"8070",10102,"St Johns","NL",47.56038,-52.71147,2018-12-03 04:00:00,27,6,33
"8071",10102,"St Johns","NL",47.56038,-52.71147,2018-12-03 05:00:00,29,2,31
"8072",10102,"St Johns","NL",47.56038,-52.71147,2018-12-03 06:00:00,29,5,34
"8073",10102,"St Johns","NL",47.56038,-52.71147,2018-12-03 07:00:00,29,6,35
"8074",10102,"St Johns","NL",47.56038,-52.71147,2018-12-03 08:00:00,29,10,39
"8075",10102,"St Johns","NL",47.56038,-52.71147,2018-12-03 09:00:00,31,8,39
"8076",10102,"St Johns","NL",47.56038,-52.71147,2018-12-03 10:00:00,26,12,38
"8077",10102,"St Johns","NL",47.56038,-52.71147,2018-12-03 11:00:00,28,11,39
"8078",10102,"St Johns","NL",47.56038,-52.71147,2018-12-03 12:00:00,29,8,37
"8079",10102,"St Johns","NL",47.56038,-52.71147,2018-12-03 13:00:00,33,7,40
"8080",10102,"St Johns","NL",47.56038,-52.71147,2018-12-03 14:00:00,34,5,39
"8081",10102,"St Johns","NL",47.56038,-52.71147,2018-12-03 15:00:00,34,5,39
"8082",10102,"St Johns","NL",47.56038,-52.71147,2018-12-03 16:00:00,35,4,39
"8083",10102,"St Johns","NL",47.56038,-52.71147,2018-12-03 17:00:00,36,3,39
"8084",10102,"St Johns","NL",47.56038,-52.71147,2018-12-03 18:00:00,36,3,39
"8085",10102,"St Johns","NL",47.56038,-52.71147,2018-12-03 19:00:00,34,2,36
"8086",10102,"St Johns","NL",47.56038,-52.71147,2018-12-03 20:00:00,32,3,35
"8087",10102,"St Johns","NL",47.56038,-52.71147,2018-12-03 21:00:00,31,4,35
"8088",10102,"St Johns","NL",47.56038,-52.71147,2018-12-03 22:00:00,31,3,34
"8089",10102,"St Johns","NL",47.56038,-52.71147,2018-12-03 23:00:00,29,3,32
"8090",10102,"St Johns","NL",47.56038,-52.71147,2018-12-04 00:00:00,29,3,32
"8091",10102,"St Johns","NL",47.56038,-52.71147,2018-12-04 01:00:00,28,3,31
"8092",10102,"St Johns","NL",47.56038,-52.71147,2018-12-04 02:00:00,28,2,30
"8093",10102,"St Johns","NL",47.56038,-52.71147,2018-12-04 03:00:00,28,3,31
"8094",10102,"St Johns","NL",47.56038,-52.71147,2018-12-04 04:00:00,25,4,29
"8095",10102,"St Johns","NL",47.56038,-52.71147,2018-12-04 05:00:00,24,5,29
"8096",10102,"St Johns","NL",47.56038,-52.71147,2018-12-04 06:00:00,23,4,27
"8097",10102,"St Johns","NL",47.56038,-52.71147,2018-12-04 07:00:00,16,10,26
"8098",10102,"St Johns","NL",47.56038,-52.71147,2018-12-04 08:00:00,9,18,27
"8099",10102,"St Johns","NL",47.56038,-52.71147,2018-12-04 09:00:00,4,22,26
"8100",10102,"St Johns","NL",47.56038,-52.71147,2018-12-04 10:00:00,9,16,25
"8101",10102,"St Johns","NL",47.56038,-52.71147,2018-12-04 11:00:00,7,20,27
"8102",10102,"St Johns","NL",47.56038,-52.71147,2018-12-04 12:00:00,19,6,25
"8103",10102,"St Johns","NL",47.56038,-52.71147,2018-12-04 13:00:00,24,3,27
"8104",10102,"St Johns","NL",47.56038,-52.71147,2018-12-04 14:00:00,26,1,27
"8105",10102,"St Johns","NL",47.56038,-52.71147,2018-12-04 15:00:00,24,3,27
"8106",10102,"St Johns","NL",47.56038,-52.71147,2018-12-04 16:00:00,26,1,27
"8107",10102,"St Johns","NL",47.56038,-52.71147,2018-12-04 17:00:00,23,4,27
"8108",10102,"St Johns","NL",47.56038,-52.71147,2018-12-04 18:00:00,19,7,26
"8109",10102,"St Johns","NL",47.56038,-52.71147,2018-12-04 19:00:00,25,3,28
"8110",10102,"St Johns","NL",47.56038,-52.71147,2018-12-04 20:00:00,27,1,28
"8111",10102,"St Johns","NL",47.56038,-52.71147,2018-12-04 21:00:00,29,0,29
"8112",10102,"St Johns","NL",47.56038,-52.71147,2018-12-04 22:00:00,28,0,28
"8113",10102,"St Johns","NL",47.56038,-52.71147,2018-12-04 23:00:00,24,3,27
"8114",10102,"St Johns","NL",47.56038,-52.71147,2018-12-05 00:00:00,22,5,27
"8115",10102,"St Johns","NL",47.56038,-52.71147,2018-12-05 01:00:00,26,1,27
"8116",10102,"St Johns","NL",47.56038,-52.71147,2018-12-05 02:00:00,27,1,28
"8117",10102,"St Johns","NL",47.56038,-52.71147,2018-12-05 03:00:00,27,1,28
"8118",10102,"St Johns","NL",47.56038,-52.71147,2018-12-05 04:00:00,27,0,27
"8119",10102,"St Johns","NL",47.56038,-52.71147,2018-12-05 05:00:00,29,0,29
"8120",10102,"St Johns","NL",47.56038,-52.71147,2018-12-05 06:00:00,32,0,32
"8121",10102,"St Johns","NL",47.56038,-52.71147,2018-12-05 07:00:00,30,1,31
"8122",10102,"St Johns","NL",47.56038,-52.71147,2018-12-05 08:00:00,30,1,31
"8123",10102,"St Johns","NL",47.56038,-52.71147,2018-12-05 09:00:00,30,1,31
"8124",10102,"St Johns","NL",47.56038,-52.71147,2018-12-05 10:00:00,30,1,31
"8125",10102,"St Johns","NL",47.56038,-52.71147,2018-12-05 11:00:00,30,2,32
"8126",10102,"St Johns","NL",47.56038,-52.71147,2018-12-05 12:00:00,30,2,32
"8127",10102,"St Johns","NL",47.56038,-52.71147,2018-12-05 13:00:00,31,2,33
"8128",10102,"St Johns","NL",47.56038,-52.71147,2018-12-05 14:00:00,30,3,33
"8129",10102,"St Johns","NL",47.56038,-52.71147,2018-12-05 15:00:00,30,2,32
"8130",10102,"St Johns","NL",47.56038,-52.71147,2018-12-05 16:00:00,31,2,33
"8131",10102,"St Johns","NL",47.56038,-52.71147,2018-12-05 17:00:00,31,2,33
"8132",10102,"St Johns","NL",47.56038,-52.71147,2018-12-05 18:00:00,31,2,33
"8133",10102,"St Johns","NL",47.56038,-52.71147,2018-12-05 19:00:00,31,1,32
"8134",10102,"St Johns","NL",47.56038,-52.71147,2018-12-05 20:00:00,31,2,33
"8135",10102,"St Johns","NL",47.56038,-52.71147,2018-12-05 21:00:00,32,1,33
"8136",10102,"St Johns","NL",47.56038,-52.71147,2018-12-05 22:00:00,34,1,35
"8137",10102,"St Johns","NL",47.56038,-52.71147,2018-12-05 23:00:00,35,1,36
"8138",10102,"St Johns","NL",47.56038,-52.71147,2018-12-06 00:00:00,35,1,36
"8139",10102,"St Johns","NL",47.56038,-52.71147,2018-12-06 01:00:00,35,0,35
"8140",10102,"St Johns","NL",47.56038,-52.71147,2018-12-06 02:00:00,35,1,36
"8141",10102,"St Johns","NL",47.56038,-52.71147,2018-12-06 03:00:00,33,1,34
"8142",10102,"St Johns","NL",47.56038,-52.71147,2018-12-06 04:00:00,33,0,33
"8143",10102,"St Johns","NL",47.56038,-52.71147,2018-12-06 05:00:00,32,2,34
"8144",10102,"St Johns","NL",47.56038,-52.71147,2018-12-06 06:00:00,30,4,34
"8145",10102,"St Johns","NL",47.56038,-52.71147,2018-12-06 07:00:00,28,4,32
"8146",10102,"St Johns","NL",47.56038,-52.71147,2018-12-06 08:00:00,18,11,29
"8147",10102,"St Johns","NL",47.56038,-52.71147,2018-12-06 09:00:00,11,23,34
"8148",10102,"St Johns","NL",47.56038,-52.71147,2018-12-06 10:00:00,14,20,34
"8149",10102,"St Johns","NL",47.56038,-52.71147,2018-12-06 11:00:00,17,15,32
"8150",10102,"St Johns","NL",47.56038,-52.71147,2018-12-06 12:00:00,9,30,39
"8151",10102,"St Johns","NL",47.56038,-52.71147,2018-12-06 13:00:00,25,13,38
"8152",10102,"St Johns","NL",47.56038,-52.71147,2018-12-06 14:00:00,28,10,38
"8153",10102,"St Johns","NL",47.56038,-52.71147,2018-12-06 15:00:00,30,9,39
"8154",10102,"St Johns","NL",47.56038,-52.71147,2018-12-06 16:00:00,31,9,40
"8155",10102,"St Johns","NL",47.56038,-52.71147,2018-12-06 17:00:00,27,13,40
"8156",10102,"St Johns","NL",47.56038,-52.71147,2018-12-06 18:00:00,21,20,41
"8157",10102,"St Johns","NL",47.56038,-52.71147,2018-12-06 19:00:00,26,14,40
"8158",10102,"St Johns","NL",47.56038,-52.71147,2018-12-06 20:00:00,25,15,40
"8159",10102,"St Johns","NL",47.56038,-52.71147,2018-12-06 21:00:00,28,11,39
"8160",10102,"St Johns","NL",47.56038,-52.71147,2018-12-06 22:00:00,31,8,39
"8161",10102,"St Johns","NL",47.56038,-52.71147,2018-12-06 23:00:00,32,6,38
"8162",10102,"St Johns","NL",47.56038,-52.71147,2018-12-07 00:00:00,33,6,39
"8163",10102,"St Johns","NL",47.56038,-52.71147,2018-12-07 01:00:00,33,4,37
"8164",10102,"St Johns","NL",47.56038,-52.71147,2018-12-07 02:00:00,30,4,34
"8165",10102,"St Johns","NL",47.56038,-52.71147,2018-12-07 03:00:00,27,4,31
"8166",10102,"St Johns","NL",47.56038,-52.71147,2018-12-07 04:00:00,27,4,31
"8167",10102,"St Johns","NL",47.56038,-52.71147,2018-12-07 05:00:00,25,6,31
"8168",10102,"St Johns","NL",47.56038,-52.71147,2018-12-07 06:00:00,26,5,31
"8169",10102,"St Johns","NL",47.56038,-52.71147,2018-12-07 07:00:00,24,4,28
"8170",10102,"St Johns","NL",47.56038,-52.71147,2018-12-07 08:00:00,23,5,28
"8171",10102,"St Johns","NL",47.56038,-52.71147,2018-12-07 09:00:00,23,7,30
"8172",10102,"St Johns","NL",47.56038,-52.71147,2018-12-07 10:00:00,23,7,30
"8173",10102,"St Johns","NL",47.56038,-52.71147,2018-12-07 11:00:00,23,7,30
"8174",10102,"St Johns","NL",47.56038,-52.71147,2018-12-07 12:00:00,22,3,25
"8175",10102,"St Johns","NL",47.56038,-52.71147,2018-12-07 13:00:00,24,2,26
"8176",10102,"St Johns","NL",47.56038,-52.71147,2018-12-07 14:00:00,24,3,27
"8177",10102,"St Johns","NL",47.56038,-52.71147,2018-12-07 15:00:00,28,3,31
"8178",10102,"St Johns","NL",47.56038,-52.71147,2018-12-07 16:00:00,29,3,32
"8179",10102,"St Johns","NL",47.56038,-52.71147,2018-12-07 17:00:00,29,3,32
"8180",10102,"St Johns","NL",47.56038,-52.71147,2018-12-07 18:00:00,28,5,33
"8181",10102,"St Johns","NL",47.56038,-52.71147,2018-12-07 19:00:00,20,12,32
"8182",10102,"St Johns","NL",47.56038,-52.71147,2018-12-07 20:00:00,24,6,30
"8183",10102,"St Johns","NL",47.56038,-52.71147,2018-12-07 21:00:00,19,11,30
"8184",10102,"St Johns","NL",47.56038,-52.71147,2018-12-07 22:00:00,21,9,30
"8185",10102,"St Johns","NL",47.56038,-52.71147,2018-12-07 23:00:00,21,8,29
"8186",10102,"St Johns","NL",47.56038,-52.71147,2018-12-08 00:00:00,22,6,28
"8187",10102,"St Johns","NL",47.56038,-52.71147,2018-12-08 01:00:00,23,5,28
"8188",10102,"St Johns","NL",47.56038,-52.71147,2018-12-08 02:00:00,24,4,28
"8189",10102,"St Johns","NL",47.56038,-52.71147,2018-12-08 03:00:00,22,7,29
"8190",10102,"St Johns","NL",47.56038,-52.71147,2018-12-08 04:00:00,18,9,27
"8191",10102,"St Johns","NL",47.56038,-52.71147,2018-12-08 05:00:00,16,12,28
"8192",10102,"St Johns","NL",47.56038,-52.71147,2018-12-08 06:00:00,14,11,25
"8193",10102,"St Johns","NL",47.56038,-52.71147,2018-12-08 07:00:00,14,11,25
"8194",10102,"St Johns","NL",47.56038,-52.71147,2018-12-08 08:00:00,4,23,27
"8195",10102,"St Johns","NL",47.56038,-52.71147,2018-12-08 09:00:00,3,28,31
"8196",10102,"St Johns","NL",47.56038,-52.71147,2018-12-08 10:00:00,4,27,31
"8197",10102,"St Johns","NL",47.56038,-52.71147,2018-12-08 11:00:00,4,31,35
"8198",10102,"St Johns","NL",47.56038,-52.71147,2018-12-08 12:00:00,3,35,38
"8199",10102,"St Johns","NL",47.56038,-52.71147,2018-12-08 13:00:00,9,30,39
"8200",10102,"St Johns","NL",47.56038,-52.71147,2018-12-08 14:00:00,29,10,39
"8201",10102,"St Johns","NL",47.56038,-52.71147,2018-12-08 15:00:00,32,4,36
"8202",10102,"St Johns","NL",47.56038,-52.71147,2018-12-08 16:00:00,32,5,37
"8203",10102,"St Johns","NL",47.56038,-52.71147,2018-12-08 17:00:00,27,9,36
"8204",10102,"St Johns","NL",47.56038,-52.71147,2018-12-08 18:00:00,21,17,38
"8205",10102,"St Johns","NL",47.56038,-52.71147,2018-12-08 19:00:00,24,17,41
"8206",10102,"St Johns","NL",47.56038,-52.71147,2018-12-08 20:00:00,15,24,39
"8207",10102,"St Johns","NL",47.56038,-52.71147,2018-12-08 21:00:00,23,15,38
"8208",10102,"St Johns","NL",47.56038,-52.71147,2018-12-08 22:00:00,30,7,37
"8209",10102,"St Johns","NL",47.56038,-52.71147,2018-12-08 23:00:00,31,4,35
"8210",10102,"St Johns","NL",47.56038,-52.71147,2018-12-09 00:00:00,32,3,35
"8211",10102,"St Johns","NL",47.56038,-52.71147,2018-12-09 01:00:00,32,3,35
"8212",10102,"St Johns","NL",47.56038,-52.71147,2018-12-09 02:00:00,31,3,34
"8213",10102,"St Johns","NL",47.56038,-52.71147,2018-12-09 03:00:00,31,3,34
"8214",10102,"St Johns","NL",47.56038,-52.71147,2018-12-09 04:00:00,31,2,33
"8215",10102,"St Johns","NL",47.56038,-52.71147,2018-12-09 05:00:00,30,2,32
"8216",10102,"St Johns","NL",47.56038,-52.71147,2018-12-09 06:00:00,28,5,33
"8217",10102,"St Johns","NL",47.56038,-52.71147,2018-12-09 07:00:00,28,2,30
"8218",10102,"St Johns","NL",47.56038,-52.71147,2018-12-09 08:00:00,24,2,26
"8219",10102,"St Johns","NL",47.56038,-52.71147,2018-12-09 09:00:00,24,1,25
"8220",10102,"St Johns","NL",47.56038,-52.71147,2018-12-09 10:00:00,25,1,26
"8221",10102,"St Johns","NL",47.56038,-52.71147,2018-12-09 11:00:00,27,0,27
"8222",10102,"St Johns","NL",47.56038,-52.71147,2018-12-09 12:00:00,27,1,28
"8223",10102,"St Johns","NL",47.56038,-52.71147,2018-12-09 13:00:00,29,0,29
"8224",10102,"St Johns","NL",47.56038,-52.71147,2018-12-09 14:00:00,28,0,28
"8225",10102,"St Johns","NL",47.56038,-52.71147,2018-12-09 15:00:00,29,2,31
"8226",10102,"St Johns","NL",47.56038,-52.71147,2018-12-09 16:00:00,29,3,32
"8227",10102,"St Johns","NL",47.56038,-52.71147,2018-12-09 17:00:00,30,1,31
"8228",10102,"St Johns","NL",47.56038,-52.71147,2018-12-09 18:00:00,30,1,31
"8229",10102,"St Johns","NL",47.56038,-52.71147,2018-12-09 19:00:00,30,2,32
"8230",10102,"St Johns","NL",47.56038,-52.71147,2018-12-09 20:00:00,31,2,33
"8231",10102,"St Johns","NL",47.56038,-52.71147,2018-12-09 21:00:00,32,1,33
"8232",10102,"St Johns","NL",47.56038,-52.71147,2018-12-09 22:00:00,33,1,34
"8233",10102,"St Johns","NL",47.56038,-52.71147,2018-12-09 23:00:00,33,0,33
"8234",10102,"St Johns","NL",47.56038,-52.71147,2018-12-10 00:00:00,34,0,34
"8235",10102,"St Johns","NL",47.56038,-52.71147,2018-12-10 01:00:00,34,0,34
"8236",10102,"St Johns","NL",47.56038,-52.71147,2018-12-10 02:00:00,34,1,35
"8237",10102,"St Johns","NL",47.56038,-52.71147,2018-12-10 03:00:00,34,0,34
"8238",10102,"St Johns","NL",47.56038,-52.71147,2018-12-10 04:00:00,35,1,36
"8239",10102,"St Johns","NL",47.56038,-52.71147,2018-12-10 05:00:00,35,1,36
"8240",10102,"St Johns","NL",47.56038,-52.71147,2018-12-10 06:00:00,29,8,37
"8241",10102,"St Johns","NL",47.56038,-52.71147,2018-12-10 07:00:00,33,2,35
"8242",10102,"St Johns","NL",47.56038,-52.71147,2018-12-10 08:00:00,32,2,34
"8243",10102,"St Johns","NL",47.56038,-52.71147,2018-12-10 09:00:00,27,7,34
"8244",10102,"St Johns","NL",47.56038,-52.71147,2018-12-10 10:00:00,25,9,34
"8245",10102,"St Johns","NL",47.56038,-52.71147,2018-12-10 11:00:00,27,6,33
"8246",10102,"St Johns","NL",47.56038,-52.71147,2018-12-10 12:00:00,26,8,34
"8247",10102,"St Johns","NL",47.56038,-52.71147,2018-12-10 13:00:00,29,7,36
"8248",10102,"St Johns","NL",47.56038,-52.71147,2018-12-10 14:00:00,32,5,37
"8249",10102,"St Johns","NL",47.56038,-52.71147,2018-12-10 15:00:00,29,7,36
"8250",10102,"St Johns","NL",47.56038,-52.71147,2018-12-10 16:00:00,24,13,37
"8251",10102,"St Johns","NL",47.56038,-52.71147,2018-12-10 17:00:00,23,12,35
"8252",10102,"St Johns","NL",47.56038,-52.71147,2018-12-10 18:00:00,19,15,34
"8253",10102,"St Johns","NL",47.56038,-52.71147,2018-12-10 19:00:00,22,11,33
"8254",10102,"St Johns","NL",47.56038,-52.71147,2018-12-10 20:00:00,25,8,33
"8255",10102,"St Johns","NL",47.56038,-52.71147,2018-12-10 21:00:00,21,10,31
"8256",10102,"St Johns","NL",47.56038,-52.71147,2018-12-10 22:00:00,16,16,32
"8257",10102,"St Johns","NL",47.56038,-52.71147,2018-12-10 23:00:00,17,13,30
"8258",10102,"St Johns","NL",47.56038,-52.71147,2018-12-11 00:00:00,12,19,31
"8259",10102,"St Johns","NL",47.56038,-52.71147,2018-12-11 01:00:00,10,21,31
"8260",10102,"St Johns","NL",47.56038,-52.71147,2018-12-11 02:00:00,7,25,32
"8261",10102,"St Johns","NL",47.56038,-52.71147,2018-12-11 03:00:00,20,11,31
"8262",10102,"St Johns","NL",47.56038,-52.71147,2018-12-11 04:00:00,21,12,33
"8263",10102,"St Johns","NL",47.56038,-52.71147,2018-12-11 05:00:00,15,30,45
"8264",10102,"St Johns","NL",47.56038,-52.71147,2018-12-11 06:00:00,22,15,37
"8265",10102,"St Johns","NL",47.56038,-52.71147,2018-12-11 07:00:00,20,11,31
"8266",10102,"St Johns","NL",47.56038,-52.71147,2018-12-11 08:00:00,21,12,33
"8267",10102,"St Johns","NL",47.56038,-52.71147,2018-12-11 09:00:00,20,11,31
"8268",10102,"St Johns","NL",47.56038,-52.71147,2018-12-11 10:00:00,25,8,33
"8269",10102,"St Johns","NL",47.56038,-52.71147,2018-12-11 11:00:00,30,4,34
"8270",10102,"St Johns","NL",47.56038,-52.71147,2018-12-11 12:00:00,31,2,33
"8271",10102,"St Johns","NL",47.56038,-52.71147,2018-12-11 13:00:00,30,3,33
"8272",10102,"St Johns","NL",47.56038,-52.71147,2018-12-11 14:00:00,33,3,36
"8273",10102,"St Johns","NL",47.56038,-52.71147,2018-12-11 15:00:00,34,3,37
"8274",10102,"St Johns","NL",47.56038,-52.71147,2018-12-11 16:00:00,33,4,37
"8275",10102,"St Johns","NL",47.56038,-52.71147,2018-12-11 17:00:00,31,5,36
"8276",10102,"St Johns","NL",47.56038,-52.71147,2018-12-11 18:00:00,29,7,36
"8277",10102,"St Johns","NL",47.56038,-52.71147,2018-12-11 19:00:00,32,4,36
"8278",10102,"St Johns","NL",47.56038,-52.71147,2018-12-11 20:00:00,32,4,36
"8279",10102,"St Johns","NL",47.56038,-52.71147,2018-12-11 21:00:00,30,6,36
"8280",10102,"St Johns","NL",47.56038,-52.71147,2018-12-11 22:00:00,23,12,35
"8281",10102,"St Johns","NL",47.56038,-52.71147,2018-12-11 23:00:00,26,8,34
"8282",10102,"St Johns","NL",47.56038,-52.71147,2018-12-12 00:00:00,16,16,32
"8283",10102,"St Johns","NL",47.56038,-52.71147,2018-12-12 01:00:00,15,13,28
"8284",10102,"St Johns","NL",47.56038,-52.71147,2018-12-12 02:00:00,16,12,28
"8285",10102,"St Johns","NL",47.56038,-52.71147,2018-12-12 03:00:00,10,19,29
"8286",10102,"St Johns","NL",47.56038,-52.71147,2018-12-12 04:00:00,11,21,32
"8287",10102,"St Johns","NL",47.56038,-52.71147,2018-12-12 05:00:00,2,32,34
"8288",10102,"St Johns","NL",47.56038,-52.71147,2018-12-12 06:00:00,1,33,34
"8289",10102,"St Johns","NL",47.56038,-52.71147,2018-12-12 07:00:00,1,36,37
"8290",10102,"St Johns","NL",47.56038,-52.71147,2018-12-12 08:00:00,4,38,42
"8291",10102,"St Johns","NL",47.56038,-52.71147,2018-12-12 09:00:00,25,13,38
"8292",10102,"St Johns","NL",47.56038,-52.71147,2018-12-12 10:00:00,30,7,37
"8293",10102,"St Johns","NL",47.56038,-52.71147,2018-12-12 11:00:00,31,6,37
"8294",10102,"St Johns","NL",47.56038,-52.71147,2018-12-12 12:00:00,32,9,41
"8295",10102,"St Johns","NL",47.56038,-52.71147,2018-12-12 13:00:00,34,5,39
"8296",10102,"St Johns","NL",47.56038,-52.71147,2018-12-12 14:00:00,35,4,39
"8297",10102,"St Johns","NL",47.56038,-52.71147,2018-12-12 15:00:00,33,6,39
"8298",10102,"St Johns","NL",47.56038,-52.71147,2018-12-12 16:00:00,28,11,39
"8299",10102,"St Johns","NL",47.56038,-52.71147,2018-12-12 17:00:00,23,16,39
"8300",10102,"St Johns","NL",47.56038,-52.71147,2018-12-12 18:00:00,26,14,40
"8301",10102,"St Johns","NL",47.56038,-52.71147,2018-12-12 19:00:00,30,10,40
"8302",10102,"St Johns","NL",47.56038,-52.71147,2018-12-12 20:00:00,35,4,39
"8303",10102,"St Johns","NL",47.56038,-52.71147,2018-12-12 21:00:00,35,4,39
"8304",10102,"St Johns","NL",47.56038,-52.71147,2018-12-12 22:00:00,34,3,37
"8305",10102,"St Johns","NL",47.56038,-52.71147,2018-12-12 23:00:00,35,3,38
"8306",10102,"St Johns","NL",47.56038,-52.71147,2018-12-13 00:00:00,34,3,37
"8307",10102,"St Johns","NL",47.56038,-52.71147,2018-12-13 01:00:00,33,3,36
"8308",10102,"St Johns","NL",47.56038,-52.71147,2018-12-13 02:00:00,34,3,37
"8309",10102,"St Johns","NL",47.56038,-52.71147,2018-12-13 03:00:00,33,4,37
"8310",10102,"St Johns","NL",47.56038,-52.71147,2018-12-13 04:00:00,34,4,38
"8311",10102,"St Johns","NL",47.56038,-52.71147,2018-12-13 05:00:00,31,6,37
"8312",10102,"St Johns","NL",47.56038,-52.71147,2018-12-13 06:00:00,33,3,36
"8313",10102,"St Johns","NL",47.56038,-52.71147,2018-12-13 07:00:00,32,4,36
"8314",10102,"St Johns","NL",47.56038,-52.71147,2018-12-13 08:00:00,31,6,37
"8315",10102,"St Johns","NL",47.56038,-52.71147,2018-12-13 09:00:00,31,6,37
"8316",10102,"St Johns","NL",47.56038,-52.71147,2018-12-13 10:00:00,32,4,36
"8317",10102,"St Johns","NL",47.56038,-52.71147,2018-12-13 11:00:00,32,7,39
"8318",10102,"St Johns","NL",47.56038,-52.71147,2018-12-13 12:00:00,32,3,35
"8319",10102,"St Johns","NL",47.56038,-52.71147,2018-12-13 13:00:00,33,1,34
"8320",10102,"St Johns","NL",47.56038,-52.71147,2018-12-13 14:00:00,33,2,35
"8321",10102,"St Johns","NL",47.56038,-52.71147,2018-12-13 15:00:00,31,4,35
"8322",10102,"St Johns","NL",47.56038,-52.71147,2018-12-13 16:00:00,32,2,34
"8323",10102,"St Johns","NL",47.56038,-52.71147,2018-12-13 17:00:00,32,3,35
"8324",10102,"St Johns","NL",47.56038,-52.71147,2018-12-13 18:00:00,30,5,35
"8325",10102,"St Johns","NL",47.56038,-52.71147,2018-12-13 19:00:00,28,7,35
"8326",10102,"St Johns","NL",47.56038,-52.71147,2018-12-13 20:00:00,30,4,34
"8327",10102,"St Johns","NL",47.56038,-52.71147,2018-12-13 21:00:00,31,3,34
"8328",10102,"St Johns","NL",47.56038,-52.71147,2018-12-13 22:00:00,32,2,34
"8329",10102,"St Johns","NL",47.56038,-52.71147,2018-12-13 23:00:00,30,4,34
"8330",10102,"St Johns","NL",47.56038,-52.71147,2018-12-14 00:00:00,31,4,35
"8331",10102,"St Johns","NL",47.56038,-52.71147,2018-12-14 01:00:00,34,2,36
"8332",10102,"St Johns","NL",47.56038,-52.71147,2018-12-14 02:00:00,34,1,35
"8333",10102,"St Johns","NL",47.56038,-52.71147,2018-12-14 03:00:00,34,2,36
"8334",10102,"St Johns","NL",47.56038,-52.71147,2018-12-14 04:00:00,34,2,36
"8335",10102,"St Johns","NL",47.56038,-52.71147,2018-12-14 05:00:00,36,0,36
"8336",10102,"St Johns","NL",47.56038,-52.71147,2018-12-14 06:00:00,36,0,36
"8337",10102,"St Johns","NL",47.56038,-52.71147,2018-12-14 07:00:00,35,2,37
"8338",10102,"St Johns","NL",47.56038,-52.71147,2018-12-14 08:00:00,34,2,36
"8339",10102,"St Johns","NL",47.56038,-52.71147,2018-12-14 09:00:00,33,3,36
"8340",10102,"St Johns","NL",47.56038,-52.71147,2018-12-14 10:00:00,33,4,37
"8341",10102,"St Johns","NL",47.56038,-52.71147,2018-12-14 11:00:00,35,1,36
"8342",10102,"St Johns","NL",47.56038,-52.71147,2018-12-14 12:00:00,36,2,38
"8343",10102,"St Johns","NL",47.56038,-52.71147,2018-12-14 13:00:00,35,2,37
"8344",10102,"St Johns","NL",47.56038,-52.71147,2018-12-14 14:00:00,36,2,38
"8345",10102,"St Johns","NL",47.56038,-52.71147,2018-12-14 15:00:00,36,3,39
"8346",10102,"St Johns","NL",47.56038,-52.71147,2018-12-14 16:00:00,36,2,38
"8347",10102,"St Johns","NL",47.56038,-52.71147,2018-12-14 17:00:00,33,5,38
"8348",10102,"St Johns","NL",47.56038,-52.71147,2018-12-14 18:00:00,33,6,39
"8349",10102,"St Johns","NL",47.56038,-52.71147,2018-12-14 19:00:00,35,4,39
"8350",10102,"St Johns","NL",47.56038,-52.71147,2018-12-14 20:00:00,35,4,39
"8351",10102,"St Johns","NL",47.56038,-52.71147,2018-12-14 21:00:00,36,3,39
"8352",10102,"St Johns","NL",47.56038,-52.71147,2018-12-14 22:00:00,34,4,38
"8353",10102,"St Johns","NL",47.56038,-52.71147,2018-12-14 23:00:00,31,8,39
"8354",10102,"St Johns","NL",47.56038,-52.71147,2018-12-15 00:00:00,30,8,38
"8355",10102,"St Johns","NL",47.56038,-52.71147,2018-12-15 01:00:00,29,8,37
"8356",10102,"St Johns","NL",47.56038,-52.71147,2018-12-15 02:00:00,30,5,35
"8357",10102,"St Johns","NL",47.56038,-52.71147,2018-12-15 03:00:00,30,6,36
"8358",10102,"St Johns","NL",47.56038,-52.71147,2018-12-15 04:00:00,33,3,36
"8359",10102,"St Johns","NL",47.56038,-52.71147,2018-12-15 05:00:00,33,2,35
"8360",10102,"St Johns","NL",47.56038,-52.71147,2018-12-15 06:00:00,32,2,34
"8361",10102,"St Johns","NL",47.56038,-52.71147,2018-12-15 07:00:00,33,2,35
"8362",10102,"St Johns","NL",47.56038,-52.71147,2018-12-15 08:00:00,32,2,34
"8363",10102,"St Johns","NL",47.56038,-52.71147,2018-12-15 09:00:00,30,4,34
"8364",10102,"St Johns","NL",47.56038,-52.71147,2018-12-15 10:00:00,31,4,35
"8365",10102,"St Johns","NL",47.56038,-52.71147,2018-12-15 11:00:00,30,4,34
"8366",10102,"St Johns","NL",47.56038,-52.71147,2018-12-15 12:00:00,32,1,33
"8367",10102,"St Johns","NL",47.56038,-52.71147,2018-12-15 13:00:00,35,1,36
"8368",10102,"St Johns","NL",47.56038,-52.71147,2018-12-15 14:00:00,35,1,36
"8369",10102,"St Johns","NL",47.56038,-52.71147,2018-12-15 15:00:00,34,1,35
"8370",10102,"St Johns","NL",47.56038,-52.71147,2018-12-15 16:00:00,34,2,36
"8371",10102,"St Johns","NL",47.56038,-52.71147,2018-12-15 17:00:00,34,2,36
"8372",10102,"St Johns","NL",47.56038,-52.71147,2018-12-15 18:00:00,33,3,36
"8373",10102,"St Johns","NL",47.56038,-52.71147,2018-12-15 19:00:00,32,2,34
"8374",10102,"St Johns","NL",47.56038,-52.71147,2018-12-15 20:00:00,31,1,32
"8375",10102,"St Johns","NL",47.56038,-52.71147,2018-12-15 21:00:00,29,1,30
"8376",10102,"St Johns","NL",47.56038,-52.71147,2018-12-15 22:00:00,26,0,26
"8377",10102,"St Johns","NL",47.56038,-52.71147,2018-12-15 23:00:00,27,0,27
"8378",10102,"St Johns","NL",47.56038,-52.71147,2018-12-16 00:00:00,25,1,26
"8379",10102,"St Johns","NL",47.56038,-52.71147,2018-12-16 01:00:00,25,0,25
"8380",10102,"St Johns","NL",47.56038,-52.71147,2018-12-16 02:00:00,26,0,26
"8381",10102,"St Johns","NL",47.56038,-52.71147,2018-12-16 03:00:00,25,0,25
"8382",10102,"St Johns","NL",47.56038,-52.71147,2018-12-16 04:00:00,25,0,25
"8383",10102,"St Johns","NL",47.56038,-52.71147,2018-12-16 05:00:00,25,0,25
"8384",10102,"St Johns","NL",47.56038,-52.71147,2018-12-16 06:00:00,25,0,25
"8385",10102,"St Johns","NL",47.56038,-52.71147,2018-12-16 07:00:00,25,0,25
"8386",10102,"St Johns","NL",47.56038,-52.71147,2018-12-16 08:00:00,24,0,24
"8387",10102,"St Johns","NL",47.56038,-52.71147,2018-12-16 09:00:00,23,0,23
"8388",10102,"St Johns","NL",47.56038,-52.71147,2018-12-16 10:00:00,23,1,24
"8389",10102,"St Johns","NL",47.56038,-52.71147,2018-12-16 11:00:00,23,1,24
"8390",10102,"St Johns","NL",47.56038,-52.71147,2018-12-16 12:00:00,24,3,27
"8391",10102,"St Johns","NL",47.56038,-52.71147,2018-12-16 13:00:00,25,4,29
"8392",10102,"St Johns","NL",47.56038,-52.71147,2018-12-16 14:00:00,26,3,29
"8393",10102,"St Johns","NL",47.56038,-52.71147,2018-12-16 15:00:00,27,4,31
"8394",10102,"St Johns","NL",47.56038,-52.71147,2018-12-16 16:00:00,28,5,33
"8395",10102,"St Johns","NL",47.56038,-52.71147,2018-12-16 17:00:00,28,4,32
"8396",10102,"St Johns","NL",47.56038,-52.71147,2018-12-16 18:00:00,30,4,34
"8397",10102,"St Johns","NL",47.56038,-52.71147,2018-12-16 19:00:00,30,3,33
"8398",10102,"St Johns","NL",47.56038,-52.71147,2018-12-16 20:00:00,30,3,33
"8399",10102,"St Johns","NL",47.56038,-52.71147,2018-12-16 21:00:00,29,3,32
"8400",10102,"St Johns","NL",47.56038,-52.71147,2018-12-16 22:00:00,30,3,33
"8401",10102,"St Johns","NL",47.56038,-52.71147,2018-12-16 23:00:00,30,3,33
"8402",10102,"St Johns","NL",47.56038,-52.71147,2018-12-17 00:00:00,30,5,35
"8403",10102,"St Johns","NL",47.56038,-52.71147,2018-12-17 01:00:00,29,6,35
"8404",10102,"St Johns","NL",47.56038,-52.71147,2018-12-17 02:00:00,27,6,33
"8405",10102,"St Johns","NL",47.56038,-52.71147,2018-12-17 03:00:00,29,4,33
"8406",10102,"St Johns","NL",47.56038,-52.71147,2018-12-17 04:00:00,27,6,33
"8407",10102,"St Johns","NL",47.56038,-52.71147,2018-12-17 05:00:00,24,8,32
"8408",10102,"St Johns","NL",47.56038,-52.71147,2018-12-17 06:00:00,25,7,32
"8409",10102,"St Johns","NL",47.56038,-52.71147,2018-12-17 07:00:00,22,8,30
"8410",10102,"St Johns","NL",47.56038,-52.71147,2018-12-17 08:00:00,11,17,28
"8411",10102,"St Johns","NL",47.56038,-52.71147,2018-12-17 09:00:00,3,25,28
"8412",10102,"St Johns","NL",47.56038,-52.71147,2018-12-17 10:00:00,7,20,27
"8413",10102,"St Johns","NL",47.56038,-52.71147,2018-12-17 11:00:00,20,11,31
"8414",10102,"St Johns","NL",47.56038,-52.71147,2018-12-17 12:00:00,28,4,32
"8415",10102,"St Johns","NL",47.56038,-52.71147,2018-12-17 13:00:00,28,3,31
"8416",10102,"St Johns","NL",47.56038,-52.71147,2018-12-17 14:00:00,26,5,31
"8417",10102,"St Johns","NL",47.56038,-52.71147,2018-12-17 15:00:00,26,6,32
"8418",10102,"St Johns","NL",47.56038,-52.71147,2018-12-17 16:00:00,25,6,31
"8419",10102,"St Johns","NL",47.56038,-52.71147,2018-12-17 17:00:00,25,6,31
"8420",10102,"St Johns","NL",47.56038,-52.71147,2018-12-17 18:00:00,28,6,34
"8421",10102,"St Johns","NL",47.56038,-52.71147,2018-12-17 19:00:00,31,2,33
"8422",10102,"St Johns","NL",47.56038,-52.71147,2018-12-17 20:00:00,32,1,33
"8423",10102,"St Johns","NL",47.56038,-52.71147,2018-12-17 21:00:00,33,2,35
"8424",10102,"St Johns","NL",47.56038,-52.71147,2018-12-17 22:00:00,32,2,34
"8425",10102,"St Johns","NL",47.56038,-52.71147,2018-12-17 23:00:00,31,3,34
"8426",10102,"St Johns","NL",47.56038,-52.71147,2018-12-18 00:00:00,23,10,33
"8427",10102,"St Johns","NL",47.56038,-52.71147,2018-12-18 01:00:00,32,3,35
"8428",10102,"St Johns","NL",47.56038,-52.71147,2018-12-18 02:00:00,32,3,35
"8429",10102,"St Johns","NL",47.56038,-52.71147,2018-12-18 03:00:00,35,0,35
"8430",10102,"St Johns","NL",47.56038,-52.71147,2018-12-18 04:00:00,34,1,35
"8431",10102,"St Johns","NL",47.56038,-52.71147,2018-12-18 05:00:00,33,3,36
"8432",10102,"St Johns","NL",47.56038,-52.71147,2018-12-18 06:00:00,35,1,36
"8433",10102,"St Johns","NL",47.56038,-52.71147,2018-12-18 07:00:00,34,3,37
"8434",10102,"St Johns","NL",47.56038,-52.71147,2018-12-18 08:00:00,30,8,38
"8435",10102,"St Johns","NL",47.56038,-52.71147,2018-12-18 09:00:00,29,9,38
"8436",10102,"St Johns","NL",47.56038,-52.71147,2018-12-18 10:00:00,30,7,37
"8437",10102,"St Johns","NL",47.56038,-52.71147,2018-12-18 11:00:00,27,8,35
"8438",10102,"St Johns","NL",47.56038,-52.71147,2018-12-18 12:00:00,26,9,35
"8439",10102,"St Johns","NL",47.56038,-52.71147,2018-12-18 13:00:00,30,3,33
"8440",10102,"St Johns","NL",47.56038,-52.71147,2018-12-18 14:00:00,31,3,34
"8441",10102,"St Johns","NL",47.56038,-52.71147,2018-12-18 15:00:00,30,3,33
"8442",10102,"St Johns","NL",47.56038,-52.71147,2018-12-18 16:00:00,25,6,31
"8443",10102,"St Johns","NL",47.56038,-52.71147,2018-12-18 17:00:00,22,8,30
"8444",10102,"St Johns","NL",47.56038,-52.71147,2018-12-18 18:00:00,26,4,30
"8445",10102,"St Johns","NL",47.56038,-52.71147,2018-12-18 19:00:00,22,7,29
"8446",10102,"St Johns","NL",47.56038,-52.71147,2018-12-18 20:00:00,23,5,28
"8447",10102,"St Johns","NL",47.56038,-52.71147,2018-12-18 21:00:00,27,5,32
"8448",10102,"St Johns","NL",47.56038,-52.71147,2018-12-18 22:00:00,30,2,32
"8449",10102,"St Johns","NL",47.56038,-52.71147,2018-12-18 23:00:00,29,3,32
"8450",10102,"St Johns","NL",47.56038,-52.71147,2018-12-19 00:00:00,29,4,33
"8451",10102,"St Johns","NL",47.56038,-52.71147,2018-12-19 01:00:00,27,4,31
"8452",10102,"St Johns","NL",47.56038,-52.71147,2018-12-19 02:00:00,27,3,30
"8453",10102,"St Johns","NL",47.56038,-52.71147,2018-12-19 03:00:00,29,1,30
"8454",10102,"St Johns","NL",47.56038,-52.71147,2018-12-19 04:00:00,30,0,30
"8455",10102,"St Johns","NL",47.56038,-52.71147,2018-12-19 05:00:00,29,1,30
"8456",10102,"St Johns","NL",47.56038,-52.71147,2018-12-19 06:00:00,29,1,30
"8457",10102,"St Johns","NL",47.56038,-52.71147,2018-12-19 07:00:00,29,1,30
"8458",10102,"St Johns","NL",47.56038,-52.71147,2018-12-19 08:00:00,26,2,28
"8459",10102,"St Johns","NL",47.56038,-52.71147,2018-12-19 09:00:00,26,2,28
"8460",10102,"St Johns","NL",47.56038,-52.71147,2018-12-19 10:00:00,25,2,27
"8461",10102,"St Johns","NL",47.56038,-52.71147,2018-12-19 11:00:00,26,3,29
"8462",10102,"St Johns","NL",47.56038,-52.71147,2018-12-19 12:00:00,25,1,26
"8463",10102,"St Johns","NL",47.56038,-52.71147,2018-12-19 13:00:00,25,2,27
"8464",10102,"St Johns","NL",47.56038,-52.71147,2018-12-19 14:00:00,24,3,27
"8465",10102,"St Johns","NL",47.56038,-52.71147,2018-12-19 15:00:00,24,3,27
"8466",10102,"St Johns","NL",47.56038,-52.71147,2018-12-19 16:00:00,25,3,28
"8467",10102,"St Johns","NL",47.56038,-52.71147,2018-12-19 17:00:00,25,3,28
"8468",10102,"St Johns","NL",47.56038,-52.71147,2018-12-19 18:00:00,26,3,29
"8469",10102,"St Johns","NL",47.56038,-52.71147,2018-12-19 19:00:00,26,2,28
"8470",10102,"St Johns","NL",47.56038,-52.71147,2018-12-19 20:00:00,27,2,29
"8471",10102,"St Johns","NL",47.56038,-52.71147,2018-12-19 21:00:00,29,1,30
"8472",10102,"St Johns","NL",47.56038,-52.71147,2018-12-19 22:00:00,29,1,30
"8473",10102,"St Johns","NL",47.56038,-52.71147,2018-12-19 23:00:00,30,2,32
"8474",10102,"St Johns","NL",47.56038,-52.71147,2018-12-20 00:00:00,30,1,31
"8475",10102,"St Johns","NL",47.56038,-52.71147,2018-12-20 01:00:00,31,0,31
"8476",10102,"St Johns","NL",47.56038,-52.71147,2018-12-20 02:00:00,31,1,32
"8477",10102,"St Johns","NL",47.56038,-52.71147,2018-12-20 03:00:00,31,1,32
"8478",10102,"St Johns","NL",47.56038,-52.71147,2018-12-20 04:00:00,30,1,31
"8479",10102,"St Johns","NL",47.56038,-52.71147,2018-12-20 05:00:00,30,1,31
"8480",10102,"St Johns","NL",47.56038,-52.71147,2018-12-20 06:00:00,30,1,31
"8481",10102,"St Johns","NL",47.56038,-52.71147,2018-12-20 07:00:00,29,1,30
"8482",10102,"St Johns","NL",47.56038,-52.71147,2018-12-20 08:00:00,28,2,30
"8483",10102,"St Johns","NL",47.56038,-52.71147,2018-12-20 09:00:00,27,3,30
"8484",10102,"St Johns","NL",47.56038,-52.71147,2018-12-20 10:00:00,28,2,30
"8485",10102,"St Johns","NL",47.56038,-52.71147,2018-12-20 11:00:00,29,1,30
"8486",10102,"St Johns","NL",47.56038,-52.71147,2018-12-20 12:00:00,30,3,33
"8487",10102,"St Johns","NL",47.56038,-52.71147,2018-12-20 13:00:00,33,3,36
"8488",10102,"St Johns","NL",47.56038,-52.71147,2018-12-20 14:00:00,35,3,38
"8489",10102,"St Johns","NL",47.56038,-52.71147,2018-12-20 15:00:00,35,3,38
"8490",10102,"St Johns","NL",47.56038,-52.71147,2018-12-20 16:00:00,34,3,37
"8491",10102,"St Johns","NL",47.56038,-52.71147,2018-12-20 17:00:00,36,3,39
"8492",10102,"St Johns","NL",47.56038,-52.71147,2018-12-20 18:00:00,37,2,39
"8493",10102,"St Johns","NL",47.56038,-52.71147,2018-12-20 19:00:00,37,2,39
"8494",10102,"St Johns","NL",47.56038,-52.71147,2018-12-20 20:00:00,37,2,39
"8495",10102,"St Johns","NL",47.56038,-52.71147,2018-12-20 21:00:00,37,1,38
"8496",10102,"St Johns","NL",47.56038,-52.71147,2018-12-20 22:00:00,37,2,39
"8497",10102,"St Johns","NL",47.56038,-52.71147,2018-12-20 23:00:00,36,2,38
"8498",10102,"St Johns","NL",47.56038,-52.71147,2018-12-21 00:00:00,36,2,38
"8499",10102,"St Johns","NL",47.56038,-52.71147,2018-12-21 01:00:00,36,2,38
"8500",10102,"St Johns","NL",47.56038,-52.71147,2018-12-21 02:00:00,35,2,37
"8501",10102,"St Johns","NL",47.56038,-52.71147,2018-12-21 03:00:00,35,2,37
"8502",10102,"St Johns","NL",47.56038,-52.71147,2018-12-21 04:00:00,35,2,37
"8503",10102,"St Johns","NL",47.56038,-52.71147,2018-12-21 05:00:00,35,1,36
"8504",10102,"St Johns","NL",47.56038,-52.71147,2018-12-21 06:00:00,35,1,36
"8505",10102,"St Johns","NL",47.56038,-52.71147,2018-12-21 07:00:00,34,2,36
"8506",10102,"St Johns","NL",47.56038,-52.71147,2018-12-21 08:00:00,31,5,36
"8507",10102,"St Johns","NL",47.56038,-52.71147,2018-12-21 09:00:00,27,8,35
"8508",10102,"St Johns","NL",47.56038,-52.71147,2018-12-21 10:00:00,23,13,36
"8509",10102,"St Johns","NL",47.56038,-52.71147,2018-12-21 11:00:00,26,10,36
"8510",10102,"St Johns","NL",47.56038,-52.71147,2018-12-21 12:00:00,28,6,34
"8511",10102,"St Johns","NL",47.56038,-52.71147,2018-12-21 13:00:00,30,3,33
"8512",10102,"St Johns","NL",47.56038,-52.71147,2018-12-21 14:00:00,30,3,33
"8513",10102,"St Johns","NL",47.56038,-52.71147,2018-12-21 15:00:00,30,3,33
"8514",10102,"St Johns","NL",47.56038,-52.71147,2018-12-21 16:00:00,28,5,33
"8515",10102,"St Johns","NL",47.56038,-52.71147,2018-12-21 17:00:00,26,6,32
"8516",10102,"St Johns","NL",47.56038,-52.71147,2018-12-21 18:00:00,19,13,32
"8517",10102,"St Johns","NL",47.56038,-52.71147,2018-12-21 19:00:00,19,12,31
"8518",10102,"St Johns","NL",47.56038,-52.71147,2018-12-21 20:00:00,18,13,31
"8519",10102,"St Johns","NL",47.56038,-52.71147,2018-12-21 21:00:00,13,17,30
"8520",10102,"St Johns","NL",47.56038,-52.71147,2018-12-21 22:00:00,17,13,30
"8521",10102,"St Johns","NL",47.56038,-52.71147,2018-12-21 23:00:00,15,15,30
"8522",10102,"St Johns","NL",47.56038,-52.71147,2018-12-22 00:00:00,9,21,30
"8523",10102,"St Johns","NL",47.56038,-52.71147,2018-12-22 01:00:00,10,18,28
"8524",10102,"St Johns","NL",47.56038,-52.71147,2018-12-22 02:00:00,10,15,25
"8525",10102,"St Johns","NL",47.56038,-52.71147,2018-12-22 03:00:00,9,15,24
"8526",10102,"St Johns","NL",47.56038,-52.71147,2018-12-22 04:00:00,5,17,22
"8527",10102,"St Johns","NL",47.56038,-52.71147,2018-12-22 05:00:00,7,13,20
"8528",10102,"St Johns","NL",47.56038,-52.71147,2018-12-22 06:00:00,10,10,20
"8529",10102,"St Johns","NL",47.56038,-52.71147,2018-12-22 07:00:00,5,14,19
"8530",10102,"St Johns","NL",47.56038,-52.71147,2018-12-22 08:00:00,10,12,22
"8531",10102,"St Johns","NL",47.56038,-52.71147,2018-12-22 09:00:00,11,13,24
"8532",10102,"St Johns","NL",47.56038,-52.71147,2018-12-22 10:00:00,6,20,26
"8533",10102,"St Johns","NL",47.56038,-52.71147,2018-12-22 11:00:00,8,19,27
"8534",10102,"St Johns","NL",47.56038,-52.71147,2018-12-22 12:00:00,24,4,28
"8535",10102,"St Johns","NL",47.56038,-52.71147,2018-12-22 13:00:00,28,2,30
"8536",10102,"St Johns","NL",47.56038,-52.71147,2018-12-22 14:00:00,28,2,30
"8537",10102,"St Johns","NL",47.56038,-52.71147,2018-12-22 15:00:00,27,3,30
"8538",10102,"St Johns","NL",47.56038,-52.71147,2018-12-22 16:00:00,28,2,30
"8539",10102,"St Johns","NL",47.56038,-52.71147,2018-12-22 17:00:00,28,2,30
"8540",10102,"St Johns","NL",47.56038,-52.71147,2018-12-22 18:00:00,28,2,30
"8541",10102,"St Johns","NL",47.56038,-52.71147,2018-12-22 19:00:00,29,1,30
"8542",10102,"St Johns","NL",47.56038,-52.71147,2018-12-22 20:00:00,29,1,30
"8543",10102,"St Johns","NL",47.56038,-52.71147,2018-12-22 21:00:00,29,1,30
"8544",10102,"St Johns","NL",47.56038,-52.71147,2018-12-22 22:00:00,30,2,32
"8545",10102,"St Johns","NL",47.56038,-52.71147,2018-12-22 23:00:00,31,1,32
"8546",10102,"St Johns","NL",47.56038,-52.71147,2018-12-23 00:00:00,33,1,34
"8547",10102,"St Johns","NL",47.56038,-52.71147,2018-12-23 01:00:00,33,1,34
"8548",10102,"St Johns","NL",47.56038,-52.71147,2018-12-23 02:00:00,33,0,33
"8549",10102,"St Johns","NL",47.56038,-52.71147,2018-12-23 03:00:00,33,1,34
"8550",10102,"St Johns","NL",47.56038,-52.71147,2018-12-23 04:00:00,33,0,33
"8551",10102,"St Johns","NL",47.56038,-52.71147,2018-12-23 05:00:00,34,1,35
"8552",10102,"St Johns","NL",47.56038,-52.71147,2018-12-23 06:00:00,35,0,35
"8553",10102,"St Johns","NL",47.56038,-52.71147,2018-12-23 07:00:00,36,0,36
"8554",10102,"St Johns","NL",47.56038,-52.71147,2018-12-23 08:00:00,36,2,38
"8555",10102,"St Johns","NL",47.56038,-52.71147,2018-12-23 09:00:00,36,2,38
"8556",10102,"St Johns","NL",47.56038,-52.71147,2018-12-23 10:00:00,35,1,36
"8557",10102,"St Johns","NL",47.56038,-52.71147,2018-12-23 11:00:00,36,1,37
"8558",10102,"St Johns","NL",47.56038,-52.71147,2018-12-23 12:00:00,36,2,38
"8559",10102,"St Johns","NL",47.56038,-52.71147,2018-12-23 13:00:00,33,2,35
"8560",10102,"St Johns","NL",47.56038,-52.71147,2018-12-23 14:00:00,25,2,27
"8561",10102,"St Johns","NL",47.56038,-52.71147,2018-12-23 15:00:00,21,2,23
"8562",10102,"St Johns","NL",47.56038,-52.71147,2018-12-23 16:00:00,18,2,20
"8563",10102,"St Johns","NL",47.56038,-52.71147,2018-12-23 17:00:00,17,2,19
"8564",10102,"St Johns","NL",47.56038,-52.71147,2018-12-23 18:00:00,16,2,18
"8565",10102,"St Johns","NL",47.56038,-52.71147,2018-12-23 19:00:00,15,3,18
"8566",10102,"St Johns","NL",47.56038,-52.71147,2018-12-23 20:00:00,17,3,20
"8567",10102,"St Johns","NL",47.56038,-52.71147,2018-12-23 21:00:00,21,3,24
"8568",10102,"St Johns","NL",47.56038,-52.71147,2018-12-23 22:00:00,24,3,27
"8569",10102,"St Johns","NL",47.56038,-52.71147,2018-12-23 23:00:00,25,2,27
"8570",10102,"St Johns","NL",47.56038,-52.71147,2018-12-24 00:00:00,26,2,28
"8571",10102,"St Johns","NL",47.56038,-52.71147,2018-12-24 01:00:00,28,2,30
"8572",10102,"St Johns","NL",47.56038,-52.71147,2018-12-24 02:00:00,30,2,32
"8573",10102,"St Johns","NL",47.56038,-52.71147,2018-12-24 03:00:00,31,2,33
"8574",10102,"St Johns","NL",47.56038,-52.71147,2018-12-24 04:00:00,31,2,33
"8575",10102,"St Johns","NL",47.56038,-52.71147,2018-12-24 05:00:00,31,2,33
"8576",10102,"St Johns","NL",47.56038,-52.71147,2018-12-24 06:00:00,33,2,35
"8577",10102,"St Johns","NL",47.56038,-52.71147,2018-12-24 07:00:00,32,2,34
"8578",10102,"St Johns","NL",47.56038,-52.71147,2018-12-24 08:00:00,31,4,35
"8579",10102,"St Johns","NL",47.56038,-52.71147,2018-12-24 09:00:00,32,4,36
"8580",10102,"St Johns","NL",47.56038,-52.71147,2018-12-24 10:00:00,33,2,35
"8581",10102,"St Johns","NL",47.56038,-52.71147,2018-12-24 11:00:00,33,3,36
"8582",10102,"St Johns","NL",47.56038,-52.71147,2018-12-24 12:00:00,33,3,36
"8583",10102,"St Johns","NL",47.56038,-52.71147,2018-12-24 13:00:00,34,2,36
"8584",10102,"St Johns","NL",47.56038,-52.71147,2018-12-24 14:00:00,33,3,36
"8585",10102,"St Johns","NL",47.56038,-52.71147,2018-12-24 15:00:00,33,3,36
"8586",10102,"St Johns","NL",47.56038,-52.71147,2018-12-24 16:00:00,34,2,36
"8587",10102,"St Johns","NL",47.56038,-52.71147,2018-12-24 17:00:00,33,3,36
"8588",10102,"St Johns","NL",47.56038,-52.71147,2018-12-24 18:00:00,33,5,38
"8589",10102,"St Johns","NL",47.56038,-52.71147,2018-12-24 19:00:00,34,3,37
"8590",10102,"St Johns","NL",47.56038,-52.71147,2018-12-24 20:00:00,36,3,39
"8591",10102,"St Johns","NL",47.56038,-52.71147,2018-12-24 21:00:00,36,2,38
"8592",10102,"St Johns","NL",47.56038,-52.71147,2018-12-24 22:00:00,36,2,38
"8593",10102,"St Johns","NL",47.56038,-52.71147,2018-12-24 23:00:00,37,2,39
"8594",10102,"St Johns","NL",47.56038,-52.71147,2018-12-25 00:00:00,36,2,38
"8595",10102,"St Johns","NL",47.56038,-52.71147,2018-12-25 01:00:00,37,2,39
"8596",10102,"St Johns","NL",47.56038,-52.71147,2018-12-25 02:00:00,37,2,39
"8597",10102,"St Johns","NL",47.56038,-52.71147,2018-12-25 03:00:00,36,2,38
"8598",10102,"St Johns","NL",47.56038,-52.71147,2018-12-25 04:00:00,35,2,37
"8599",10102,"St Johns","NL",47.56038,-52.71147,2018-12-25 05:00:00,31,4,35
"8600",10102,"St Johns","NL",47.56038,-52.71147,2018-12-25 06:00:00,33,2,35
"8601",10102,"St Johns","NL",47.56038,-52.71147,2018-12-25 07:00:00,32,2,34
"8602",10102,"St Johns","NL",47.56038,-52.71147,2018-12-25 08:00:00,29,5,34
"8603",10102,"St Johns","NL",47.56038,-52.71147,2018-12-25 09:00:00,28,4,32
"8604",10102,"St Johns","NL",47.56038,-52.71147,2018-12-25 10:00:00,31,3,34
"8605",10102,"St Johns","NL",47.56038,-52.71147,2018-12-25 11:00:00,33,3,36
"8606",10102,"St Johns","NL",47.56038,-52.71147,2018-12-25 12:00:00,33,1,34
"8607",10102,"St Johns","NL",47.56038,-52.71147,2018-12-25 13:00:00,31,2,33
"8608",10102,"St Johns","NL",47.56038,-52.71147,2018-12-25 14:00:00,34,1,35
"8609",10102,"St Johns","NL",47.56038,-52.71147,2018-12-25 15:00:00,34,1,35
"8610",10102,"St Johns","NL",47.56038,-52.71147,2018-12-25 16:00:00,34,1,35
"8611",10102,"St Johns","NL",47.56038,-52.71147,2018-12-25 17:00:00,32,2,34
"8612",10102,"St Johns","NL",47.56038,-52.71147,2018-12-25 18:00:00,28,4,32
"8613",10102,"St Johns","NL",47.56038,-52.71147,2018-12-25 19:00:00,31,3,34
"8614",10102,"St Johns","NL",47.56038,-52.71147,2018-12-25 20:00:00,35,0,35
"8615",10102,"St Johns","NL",47.56038,-52.71147,2018-12-25 21:00:00,34,1,35
"8616",10102,"St Johns","NL",47.56038,-52.71147,2018-12-25 22:00:00,35,2,37
"8617",10102,"St Johns","NL",47.56038,-52.71147,2018-12-25 23:00:00,33,2,35
"8618",10102,"St Johns","NL",47.56038,-52.71147,2018-12-26 00:00:00,35,1,36
"8619",10102,"St Johns","NL",47.56038,-52.71147,2018-12-26 01:00:00,36,0,36
"8620",10102,"St Johns","NL",47.56038,-52.71147,2018-12-26 02:00:00,37,0,37
"8621",10102,"St Johns","NL",47.56038,-52.71147,2018-12-26 03:00:00,37,1,38
"8622",10102,"St Johns","NL",47.56038,-52.71147,2018-12-26 04:00:00,38,0,38
"8623",10102,"St Johns","NL",47.56038,-52.71147,2018-12-26 05:00:00,39,0,39
"8624",10102,"St Johns","NL",47.56038,-52.71147,2018-12-26 06:00:00,39,0,39
"8625",10102,"St Johns","NL",47.56038,-52.71147,2018-12-26 07:00:00,39,0,39
"8626",10102,"St Johns","NL",47.56038,-52.71147,2018-12-26 08:00:00,39,1,40
"8627",10102,"St Johns","NL",47.56038,-52.71147,2018-12-26 09:00:00,39,0,39
"8628",10102,"St Johns","NL",47.56038,-52.71147,2018-12-26 10:00:00,41,1,42
"8629",10102,"St Johns","NL",47.56038,-52.71147,2018-12-26 11:00:00,41,0,41
"8630",10102,"St Johns","NL",47.56038,-52.71147,2018-12-26 12:00:00,39,1,40
"8631",10102,"St Johns","NL",47.56038,-52.71147,2018-12-26 13:00:00,39,0,39
"8632",10102,"St Johns","NL",47.56038,-52.71147,2018-12-26 14:00:00,39,0,39
"8633",10102,"St Johns","NL",47.56038,-52.71147,2018-12-26 15:00:00,38,0,38
"8634",10102,"St Johns","NL",47.56038,-52.71147,2018-12-26 16:00:00,38,1,39
"8635",10102,"St Johns","NL",47.56038,-52.71147,2018-12-26 17:00:00,38,1,39
"8636",10102,"St Johns","NL",47.56038,-52.71147,2018-12-26 18:00:00,38,1,39
"8637",10102,"St Johns","NL",47.56038,-52.71147,2018-12-26 19:00:00,39,1,40
"8638",10102,"St Johns","NL",47.56038,-52.71147,2018-12-26 20:00:00,39,1,40
"8639",10102,"St Johns","NL",47.56038,-52.71147,2018-12-26 21:00:00,39,1,40
"8640",10102,"St Johns","NL",47.56038,-52.71147,2018-12-26 22:00:00,39,0,39
"8641",10102,"St Johns","NL",47.56038,-52.71147,2018-12-26 23:00:00,38,0,38
"8642",10102,"St Johns","NL",47.56038,-52.71147,2018-12-27 00:00:00,38,1,39
"8643",10102,"St Johns","NL",47.56038,-52.71147,2018-12-27 01:00:00,38,1,39
"8644",10102,"St Johns","NL",47.56038,-52.71147,2018-12-27 02:00:00,38,1,39
"8645",10102,"St Johns","NL",47.56038,-52.71147,2018-12-27 03:00:00,38,0,38
"8646",10102,"St Johns","NL",47.56038,-52.71147,2018-12-27 04:00:00,36,2,38
"8647",10102,"St Johns","NL",47.56038,-52.71147,2018-12-27 05:00:00,31,7,38
"8648",10102,"St Johns","NL",47.56038,-52.71147,2018-12-27 06:00:00,30,7,37
"8649",10102,"St Johns","NL",47.56038,-52.71147,2018-12-27 07:00:00,28,8,36
"8650",10102,"St Johns","NL",47.56038,-52.71147,2018-12-27 08:00:00,16,20,36
"8651",10102,"St Johns","NL",47.56038,-52.71147,2018-12-27 09:00:00,17,19,36
"8652",10102,"St Johns","NL",47.56038,-52.71147,2018-12-27 10:00:00,24,12,36
"8653",10102,"St Johns","NL",47.56038,-52.71147,2018-12-27 11:00:00,23,13,36
"8654",10102,"St Johns","NL",47.56038,-52.71147,2018-12-27 12:00:00,34,5,39
"8655",10102,"St Johns","NL",47.56038,-52.71147,2018-12-27 13:00:00,36,3,39
"8656",10102,"St Johns","NL",47.56038,-52.71147,2018-12-27 14:00:00,35,4,39
"8657",10102,"St Johns","NL",47.56038,-52.71147,2018-12-27 15:00:00,35,5,40
"8658",10102,"St Johns","NL",47.56038,-52.71147,2018-12-27 16:00:00,34,6,40
"8659",10102,"St Johns","NL",47.56038,-52.71147,2018-12-27 17:00:00,35,5,40
"8660",10102,"St Johns","NL",47.56038,-52.71147,2018-12-27 18:00:00,35,5,40
"8661",10102,"St Johns","NL",47.56038,-52.71147,2018-12-27 19:00:00,33,6,39
"8662",10102,"St Johns","NL",47.56038,-52.71147,2018-12-27 20:00:00,31,7,38
"8663",10102,"St Johns","NL",47.56038,-52.71147,2018-12-27 21:00:00,33,5,38
"8664",10102,"St Johns","NL",47.56038,-52.71147,2018-12-27 22:00:00,36,3,39
"8665",10102,"St Johns","NL",47.56038,-52.71147,2018-12-27 23:00:00,36,2,38
"8666",10102,"St Johns","NL",47.56038,-52.71147,2018-12-28 00:00:00,36,2,38
"8667",10102,"St Johns","NL",47.56038,-52.71147,2018-12-28 01:00:00,35,3,38
"8668",10102,"St Johns","NL",47.56038,-52.71147,2018-12-28 02:00:00,35,3,38
"8669",10102,"St Johns","NL",47.56038,-52.71147,2018-12-28 03:00:00,33,3,36
"8670",10102,"St Johns","NL",47.56038,-52.71147,2018-12-28 04:00:00,34,2,36
"8671",10102,"St Johns","NL",47.56038,-52.71147,2018-12-28 05:00:00,34,2,36
"8672",10102,"St Johns","NL",47.56038,-52.71147,2018-12-28 06:00:00,33,2,35
"8673",10102,"St Johns","NL",47.56038,-52.71147,2018-12-28 07:00:00,31,2,33
"8674",10102,"St Johns","NL",47.56038,-52.71147,2018-12-28 08:00:00,31,2,33
"8675",10102,"St Johns","NL",47.56038,-52.71147,2018-12-28 09:00:00,31,3,34
"8676",10102,"St Johns","NL",47.56038,-52.71147,2018-12-28 10:00:00,30,4,34
"8677",10102,"St Johns","NL",47.56038,-52.71147,2018-12-28 11:00:00,31,2,33
"8678",10102,"St Johns","NL",47.56038,-52.71147,2018-12-28 12:00:00,30,4,34
"8679",10102,"St Johns","NL",47.56038,-52.71147,2018-12-28 13:00:00,31,3,34
"8680",10102,"St Johns","NL",47.56038,-52.71147,2018-12-28 14:00:00,31,5,36
"8681",10102,"St Johns","NL",47.56038,-52.71147,2018-12-28 15:00:00,31,3,34
"8682",10102,"St Johns","NL",47.56038,-52.71147,2018-12-28 16:00:00,30,5,35
"8683",10102,"St Johns","NL",47.56038,-52.71147,2018-12-28 17:00:00,29,5,34
"8684",10102,"St Johns","NL",47.56038,-52.71147,2018-12-28 18:00:00,24,10,34
"8685",10102,"St Johns","NL",47.56038,-52.71147,2018-12-28 19:00:00,23,10,33
"8686",10102,"St Johns","NL",47.56038,-52.71147,2018-12-28 20:00:00,25,9,34
"8687",10102,"St Johns","NL",47.56038,-52.71147,2018-12-28 21:00:00,29,6,35
"8688",10102,"St Johns","NL",47.56038,-52.71147,2018-12-28 22:00:00,19,14,33
"8689",10102,"St Johns","NL",47.56038,-52.71147,2018-12-28 23:00:00,14,19,33
"8690",10102,"St Johns","NL",47.56038,-52.71147,2018-12-29 00:00:00,17,15,32
"8691",10102,"St Johns","NL",47.56038,-52.71147,2018-12-29 01:00:00,18,14,32
"8692",10102,"St Johns","NL",47.56038,-52.71147,2018-12-29 02:00:00,18,10,28
"8693",10102,"St Johns","NL",47.56038,-52.71147,2018-12-29 03:00:00,16,10,26
"8694",10102,"St Johns","NL",47.56038,-52.71147,2018-12-29 04:00:00,15,12,27
"8695",10102,"St Johns","NL",47.56038,-52.71147,2018-12-29 05:00:00,16,11,27
"8696",10102,"St Johns","NL",47.56038,-52.71147,2018-12-29 06:00:00,13,13,26
"8697",10102,"St Johns","NL",47.56038,-52.71147,2018-12-29 07:00:00,15,11,26
"8698",10102,"St Johns","NL",47.56038,-52.71147,2018-12-29 08:00:00,16,12,28
"8699",10102,"St Johns","NL",47.56038,-52.71147,2018-12-29 09:00:00,13,16,29
"8700",10102,"St Johns","NL",47.56038,-52.71147,2018-12-29 10:00:00,10,22,32
"8701",10102,"St Johns","NL",47.56038,-52.71147,2018-12-29 11:00:00,24,14,38
"8702",10102,"St Johns","NL",47.56038,-52.71147,2018-12-29 12:00:00,33,3,36
"8703",10102,"St Johns","NL",47.56038,-52.71147,2018-12-29 13:00:00,31,4,35
"8704",10102,"St Johns","NL",47.56038,-52.71147,2018-12-29 14:00:00,32,4,36
"8705",10102,"St Johns","NL",47.56038,-52.71147,2018-12-29 15:00:00,32,5,37
"8706",10102,"St Johns","NL",47.56038,-52.71147,2018-12-29 16:00:00,33,4,37
"8707",10102,"St Johns","NL",47.56038,-52.71147,2018-12-29 17:00:00,31,6,37
"8708",10102,"St Johns","NL",47.56038,-52.71147,2018-12-29 18:00:00,29,8,37
"8709",10102,"St Johns","NL",47.56038,-52.71147,2018-12-29 19:00:00,31,6,37
"8710",10102,"St Johns","NL",47.56038,-52.71147,2018-12-29 20:00:00,32,4,36
"8711",10102,"St Johns","NL",47.56038,-52.71147,2018-12-29 21:00:00,33,4,37
"8712",10102,"St Johns","NL",47.56038,-52.71147,2018-12-29 22:00:00,32,4,36
"8713",10102,"St Johns","NL",47.56038,-52.71147,2018-12-29 23:00:00,34,2,36
"8714",10102,"St Johns","NL",47.56038,-52.71147,2018-12-30 00:00:00,35,1,36
"8715",10102,"St Johns","NL",47.56038,-52.71147,2018-12-30 01:00:00,34,2,36
"8716",10102,"St Johns","NL",47.56038,-52.71147,2018-12-30 02:00:00,28,8,36
"8717",10102,"St Johns","NL",47.56038,-52.71147,2018-12-30 03:00:00,17,20,37
"8718",10102,"St Johns","NL",47.56038,-52.71147,2018-12-30 04:00:00,28,9,37
"8719",10102,"St Johns","NL",47.56038,-52.71147,2018-12-30 05:00:00,32,4,36
"8720",10102,"St Johns","NL",47.56038,-52.71147,2018-12-30 06:00:00,32,2,34
"8721",10102,"St Johns","NL",47.56038,-52.71147,2018-12-30 07:00:00,32,3,35
"8722",10102,"St Johns","NL",47.56038,-52.71147,2018-12-30 08:00:00,33,2,35
"8723",10102,"St Johns","NL",47.56038,-52.71147,2018-12-30 09:00:00,34,1,35
"8724",10102,"St Johns","NL",47.56038,-52.71147,2018-12-30 10:00:00,33,4,37
"8725",10102,"St Johns","NL",47.56038,-52.71147,2018-12-30 11:00:00,31,5,36
"8726",10102,"St Johns","NL",47.56038,-52.71147,2018-12-30 12:00:00,34,3,37
"8727",10102,"St Johns","NL",47.56038,-52.71147,2018-12-30 13:00:00,34,3,37
"8728",10102,"St Johns","NL",47.56038,-52.71147,2018-12-30 14:00:00,32,7,39
"8729",10102,"St Johns","NL",47.56038,-52.71147,2018-12-30 15:00:00,34,4,38
"8730",10102,"St Johns","NL",47.56038,-52.71147,2018-12-30 16:00:00,33,4,37
"8731",10102,"St Johns","NL",47.56038,-52.71147,2018-12-30 17:00:00,34,3,37
"8732",10102,"St Johns","NL",47.56038,-52.71147,2018-12-30 18:00:00,33,4,37
"8733",10102,"St Johns","NL",47.56038,-52.71147,2018-12-30 19:00:00,34,3,37
"8734",10102,"St Johns","NL",47.56038,-52.71147,2018-12-30 20:00:00,34,2,36
"8735",10102,"St Johns","NL",47.56038,-52.71147,2018-12-30 21:00:00,33,3,36
"8736",10102,"St Johns","NL",47.56038,-52.71147,2018-12-30 22:00:00,33,2,35
"8737",10102,"St Johns","NL",47.56038,-52.71147,2018-12-30 23:00:00,34,3,37
"8738",10102,"St Johns","NL",47.56038,-52.71147,2018-12-31 00:00:00,34,2,36
"8739",10102,"St Johns","NL",47.56038,-52.71147,2018-12-31 01:00:00,33,5,38
"8740",10102,"St Johns","NL",47.56038,-52.71147,2018-12-31 02:00:00,33,2,35
"8741",10102,"St Johns","NL",47.56038,-52.71147,2018-12-31 03:00:00,33,3,36
"8742",10102,"St Johns","NL",47.56038,-52.71147,2018-12-31 04:00:00,33,2,35
"8743",10102,"St Johns","NL",47.56038,-52.71147,2018-12-31 05:00:00,33,2,35
"8744",10102,"St Johns","NL",47.56038,-52.71147,2018-12-31 06:00:00,33,2,35
"8745",10102,"St Johns","NL",47.56038,-52.71147,2018-12-31 07:00:00,33,3,36
"8746",10102,"St Johns","NL",47.56038,-52.71147,2018-12-31 08:00:00,34,4,38
"8747",10102,"St Johns","NL",47.56038,-52.71147,2018-12-31 09:00:00,33,5,38
"8748",10102,"St Johns","NL",47.56038,-52.71147,2018-12-31 10:00:00,33,4,37
"8749",10102,"St Johns","NL",47.56038,-52.71147,2018-12-31 11:00:00,33,6,39
"8750",10102,"St Johns","NL",47.56038,-52.71147,2018-12-31 12:00:00,33,4,37
"8751",10102,"St Johns","NL",47.56038,-52.71147,2018-12-31 13:00:00,34,5,39
"8752",10102,"St Johns","NL",47.56038,-52.71147,2018-12-31 14:00:00,35,6,41
"8753",10102,"St Johns","NL",47.56038,-52.71147,2018-12-31 15:00:00,36,5,41
"8754",10102,"St Johns","NL",47.56038,-52.71147,2018-12-31 16:00:00,37,5,42
"8755",10102,"St Johns","NL",47.56038,-52.71147,2018-12-31 17:00:00,35,8,43
"8756",10102,"St Johns","NL",47.56038,-52.71147,2018-12-31 18:00:00,37,4,41
"8757",10102,"St Johns","NL",47.56038,-52.71147,2018-12-31 19:00:00,36,5,41
"8758",10102,"St Johns","NL",47.56038,-52.71147,2018-12-31 20:00:00,36,5,41
"8759",10102,"St Johns","NL",47.56038,-52.71147,2018-12-31 21:00:00,35,5,40
"8760",10102,"St Johns","NL",47.56038,-52.71147,2018-12-31 22:00:00,35,5,40
"8761",10102,"St Johns","NL",47.56038,-52.71147,2018-12-31 23:00:00,35,5,40
"8762",10102,"St Johns","NL",47.56038,-52.71147,2019-01-01 00:00:00,35,5,40
"8763",10401,"Mount Pearl","NL",47.50513,-52.79476,2018-01-01 01:00:00,35,1,36
"8764",10401,"Mount Pearl","NL",47.50513,-52.79476,2018-01-01 02:00:00,31,4,35
"8765",10401,"Mount Pearl","NL",47.50513,-52.79476,2018-01-01 03:00:00,30,5,35
"8766",10401,"Mount Pearl","NL",47.50513,-52.79476,2018-01-01 04:00:00,32,3,35
"8767",10401,"Mount Pearl","NL",47.50513,-52.79476,2018-01-01 05:00:00,34,1,35
"8768",10401,"Mount Pearl","NL",47.50513,-52.79476,2018-01-01 06:00:00,34,0,34
"8769",10401,"Mount Pearl","NL",47.50513,-52.79476,2018-01-01 07:00:00,34,1,35
"8770",10401,"Mount Pearl","NL",47.50513,-52.79476,2018-01-01 08:00:00,36,0,36
"8771",10401,"Mount Pearl","NL",47.50513,-52.79476,2018-01-01 09:00:00,36,0,36
"8772",10401,"Mount Pearl","NL",47.50513,-52.79476,2018-01-01 10:00:00,35,0,35
"8773",10401,"Mount Pearl","NL",47.50513,-52.79476,2018-01-01 11:00:00,33,1,34
"8774",10401,"Mount Pearl","NL",47.50513,-52.79476,2018-01-01 12:00:00,32,1,33
"8775",10401,"Mount Pearl","NL",47.50513,-52.79476,2018-01-01 13:00:00,29,3,32
"8776",10401,"Mount Pearl","NL",47.50513,-52.79476,2018-01-01 14:00:00,31,3,34
"8777",10401,"Mount Pearl","NL",47.50513,-52.79476,2018-01-01 15:00:00,33,4,37
"8778",10401,"Mount Pearl","NL",47.50513,-52.79476,2018-01-01 16:00:00,34,3,37
"8779",10401,"Mount Pearl","NL",47.50513,-52.79476,2018-01-01 17:00:00,32,5,37
"8780",10401,"Mount Pearl","NL",47.50513,-52.79476,2018-01-01 18:00:00,35,1,36
"8781",10401,"Mount Pearl","NL",47.50513,-52.79476,2018-01-01 19:00:00,36,1,37
"8782",10401,"Mount Pearl","NL",47.50513,-52.79476,2018-01-01 20:00:00,36,1,37
"8783",10401,"Mount Pearl","NL",47.50513,-52.79476,2018-01-01 21:00:00,36,1,37
"8784",10401,"Mount Pearl","NL",47.50513,-52.79476,2018-01-01 22:00:00,36,1,37
"8785",10401,"Mount Pearl","NL",47.50513,-52.79476,2018-01-01 23:00:00,35,1,36
"8786",10401,"Mount Pearl","NL",47.50513,-52.79476,2018-01-02 00:00:00,34,2,36
"8787",10401,"Mount Pearl","NL",47.50513,-52.79476,2018-01-02 01:00:00,34,2,36
"8788",10401,"Mount Pearl","NL",47.50513,-52.79476,2018-01-02 02:00:00,34,2,36
"8789",10401,"Mount Pearl","NL",47.50513,-52.79476,2018-01-02 03:00:00,35,1,36
"8790",10401,"Mount Pearl","NL",47.50513,-52.79476,2018-01-02 04:00:00,34,1,35
"8791",10401,"Mount Pearl","NL",47.50513,-52.79476,2018-01-02 05:00:00,34,1,35
"8792",10401,"Mount Pearl","NL",47.50513,-52.79476,2018-01-02 06:00:00,33,1,34
"8793",10401,"Mount Pearl","NL",47.50513,-52.79476,2018-01-02 07:00:00,34,1,35
"8794",10401,"Mount Pearl","NL",47.50513,-52.79476,2018-01-02 08:00:00,33,2,35
"8795",10401,"Mount Pearl","NL",47.50513,-52.79476,2018-01-02 09:00:00,28,5,33
"8796",10401,"Mount Pearl","NL",47.50513,-52.79476,2018-01-02 10:00:00,27,4,31
"8797",10401,"Mount Pearl","NL",47.50513,-52.79476,2018-01-02 11:00:00,30,2,32
"8798",10401,"Mount Pearl","NL",47.50513,-52.79476,2018-01-02 12:00:00,31,1,32
"8799",10401,"Mount Pearl","NL",47.50513,-52.79476,2018-01-02 13:00:00,32,0,32
"8800",10401,"Mount Pearl","NL",47.50513,-52.79476,2018-01-02 14:00:00,33,1,34
"8801",10401,"Mount Pearl","NL",47.50513,-52.79476,2018-01-02 15:00:00,33,3,36
"8802",10401,"Mount Pearl","NL",47.50513,-52.79476,2018-01-02 16:00:00,34,1,35
"8803",10401,"Mount Pearl","NL",47.50513,-52.79476,2018-01-02 17:00:00,29,4,33
"8804",10401,"Mount Pearl","NL",47.50513,-52.79476,2018-01-02 18:00:00,30,3,33
"8805",10401,"Mount Pearl","NL",47.50513,-52.79476,2018-01-02 19:00:00,32,2,34
"8806",10401,"Mount Pearl","NL",47.50513,-52.79476,2018-01-02 20:00:00,31,2,33
"8807",10401,"Mount Pearl","NL",47.50513,-52.79476,2018-01-02 21:00:00,32,1,33
"8808",10401,"Mount Pearl","NL",47.50513,-52.79476,2018-01-02 22:00:00,33,1,34
"8809",10401,"Mount Pearl","NL",47.50513,-52.79476,2018-01-02 23:00:00,35,0,35
"8810",10401,"Mount Pearl","NL",47.50513,-52.79476,2018-01-03 00:00:00,35,1,36
"8811",10401,"Mount Pearl","NL",47.50513,-52.79476,2018-01-03 01:00:00,36,0,36
"8812",10401,"Mount Pearl","NL",47.50513,-52.79476,2018-01-03 02:00:00,37,0,37
"8813",10401,"Mount Pearl","NL",47.50513,-52.79476,2018-01-03 03:00:00,37,0,37
"8814",10401,"Mount Pearl","NL",47.50513,-52.79476,2018-01-03 04:00:00,36,1,37
"8815",10401,"Mount Pearl","NL",47.50513,-52.79476,2018-01-03 05:00:00,32,2,34
"8816",10401,"Mount Pearl","NL",47.50513,-52.79476,2018-01-03 06:00:00,34,1,35
"8817",10401,"Mount Pearl","NL",47.50513,-52.79476,2018-01-03 07:00:00,35,0,35
"8818",10401,"Mount Pearl","NL",47.50513,-52.79476,2018-01-03 08:00:00,32,3,35
"8819",10401,"Mount Pearl","NL",47.50513,-52.79476,2018-01-03 09:00:00,28,5,33
"8820",10401,"Mount Pearl","NL",47.50513,-52.79476,2018-01-03 10:00:00,32,2,34
"8821",10401,"Mount Pearl","NL",47.50513,-52.79476,2018-01-03 11:00:00,33,0,33
"8822",10401,"Mount Pearl","NL",47.50513,-52.79476,2018-01-03 12:00:00,31,3,34
"8823",10401,"Mount Pearl","NL",47.50513,-52.79476,2018-01-03 13:00:00,32,3,35
"8824",10401,"Mount Pearl","NL",47.50513,-52.79476,2018-01-03 14:00:00,32,2,34
"8825",10401,"Mount Pearl","NL",47.50513,-52.79476,2018-01-03 15:00:00,35,1,36
"8826",10401,"Mount Pearl","NL",47.50513,-52.79476,2018-01-03 16:00:00,35,2,37
"8827",10401,"Mount Pearl","NL",47.50513,-52.79476,2018-01-03 17:00:00,37,1,38
"8828",10401,"Mount Pearl","NL",47.50513,-52.79476,2018-01-03 18:00:00,37,1,38
"8829",10401,"Mount Pearl","NL",47.50513,-52.79476,2018-01-03 19:00:00,38,0,38
"8830",10401,"Mount Pearl","NL",47.50513,-52.79476,2018-01-03 20:00:00,37,0,37
"8831",10401,"Mount Pearl","NL",47.50513,-52.79476,2018-01-03 21:00:00,34,1,35
"8832",10401,"Mount Pearl","NL",47.50513,-52.79476,2018-01-03 22:00:00,35,1,36
"8833",10401,"Mount Pearl","NL",47.50513,-52.79476,2018-01-03 23:00:00,37,0,37
"8834",10401,"Mount Pearl","NL",47.50513,-52.79476,2018-01-04 00:00:00,37,0,37
"8835",10401,"Mount Pearl","NL",47.50513,-52.79476,2018-01-04 01:00:00,36,0,36
"8836",10401,"Mount Pearl","NL",47.50513,-52.79476,2018-01-04 02:00:00,36,0,36
"8837",10401,"Mount Pearl","NL",47.50513,-52.79476,2018-01-04 03:00:00,36,0,36
"8838",10401,"Mount Pearl","NL",47.50513,-52.79476,2018-01-04 04:00:00,35,1,36
"8839",10401,"Mount Pearl","NL",47.50513,-52.79476,2018-01-04 05:00:00,34,1,35
"8840",10401,"Mount Pearl","NL",47.50513,-52.79476,2018-01-04 06:00:00,29,2,31
"8841",10401,"Mount Pearl","NL",47.50513,-52.79476,2018-01-04 07:00:00,22,4,26
"8842",10401,"Mount Pearl","NL",47.50513,-52.79476,2018-01-04 08:00:00,16,6,22
"8843",10401,"Mount Pearl","NL",47.50513,-52.79476,2018-01-04 09:00:00,26,3,29
"8844",10401,"Mount Pearl","NL",47.50513,-52.79476,2018-01-04 10:00:00,26,3,29
"8845",10401,"Mount Pearl","NL",47.50513,-52.79476,2018-01-04 11:00:00,25,3,28
"8846",10401,"Mount Pearl","NL",47.50513,-52.79476,2018-01-04 12:00:00,27,3,30
"8847",10401,"Mount Pearl","NL",47.50513,-52.79476,2018-01-04 13:00:00,26,3,29
"8848",10401,"Mount Pearl","NL",47.50513,-52.79476,2018-01-04 14:00:00,31,2,33
"8849",10401,"Mount Pearl","NL",47.50513,-52.79476,2018-01-04 15:00:00,31,3,34
"8850",10401,"Mount Pearl","NL",47.50513,-52.79476,2018-01-04 16:00:00,35,2,37
"8851",10401,"Mount Pearl","NL",47.50513,-52.79476,2018-01-04 17:00:00,37,1,38
"8852",10401,"Mount Pearl","NL",47.50513,-52.79476,2018-01-04 18:00:00,39,0,39
"8853",10401,"Mount Pearl","NL",47.50513,-52.79476,2018-01-04 19:00:00,40,0,40
"8854",10401,"Mount Pearl","NL",47.50513,-52.79476,2018-01-04 20:00:00,41,0,41
"8855",10401,"Mount Pearl","NL",47.50513,-52.79476,2018-01-04 21:00:00,41,0,41
"8856",10401,"Mount Pearl","NL",47.50513,-52.79476,2018-01-04 22:00:00,40,0,40
"8857",10401,"Mount Pearl","NL",47.50513,-52.79476,2018-01-04 23:00:00,41,0,41
"8858",10401,"Mount Pearl","NL",47.50513,-52.79476,2018-01-05 00:00:00,41,0,41
"8859",10401,"Mount Pearl","NL",47.50513,-52.79476,2018-01-05 01:00:00,41,0,41
"8860",10401,"Mount Pearl","NL",47.50513,-52.79476,2018-01-05 02:00:00,41,1,42
"8861",10401,"Mount Pearl","NL",47.50513,-52.79476,2018-01-05 03:00:00,41,1,42
"8862",10401,"Mount Pearl","NL",47.50513,-52.79476,2018-01-05 04:00:00,40,1,41
"8863",10401,"Mount Pearl","NL",47.50513,-52.79476,2018-01-05 05:00:00,41,1,42
"8864",10401,"Mount Pearl","NL",47.50513,-52.79476,2018-01-05 06:00:00,41,1,42
"8865",10401,"Mount Pearl","NL",47.50513,-52.79476,2018-01-05 07:00:00,40,2,42
"8866",10401,"Mount Pearl","NL",47.50513,-52.79476,2018-01-05 08:00:00,38,2,40
"8867",10401,"Mount Pearl","NL",47.50513,-52.79476,2018-01-05 09:00:00,33,4,37
"8868",10401,"Mount Pearl","NL",47.50513,-52.79476,2018-01-05 10:00:00,33,2,35
"8869",10401,"Mount Pearl","NL",47.50513,-52.79476,2018-01-05 11:00:00,31,2,33
"8870",10401,"Mount Pearl","NL",47.50513,-52.79476,2018-01-05 12:00:00,32,2,34
"8871",10401,"Mount Pearl","NL",47.50513,-52.79476,2018-01-05 13:00:00,31,1,32
"8872",10401,"Mount Pearl","NL",47.50513,-52.79476,2018-01-05 14:00:00,31,1,32
"8873",10401,"Mount Pearl","NL",47.50513,-52.79476,2018-01-05 15:00:00,30,2,32
"8874",10401,"Mount Pearl","NL",47.50513,-52.79476,2018-01-05 16:00:00,30,2,32
"8875",10401,"Mount Pearl","NL",47.50513,-52.79476,2018-01-05 17:00:00,32,2,34
"8876",10401,"Mount Pearl","NL",47.50513,-52.79476,2018-01-05 18:00:00,32,2,34
"8877",10401,"Mount Pearl","NL",47.50513,-52.79476,2018-01-05 19:00:00,31,2,33
"8878",10401,"Mount Pearl","NL",47.50513,-52.79476,2018-01-05 20:00:00,31,3,34
"8879",10401,"Mount Pearl","NL",47.50513,-52.79476,2018-01-05 21:00:00,28,4,32
"8880",10401,"Mount Pearl","NL",47.50513,-52.79476,2018-01-05 22:00:00,33,2,35
"8881",10401,"Mount Pearl","NL",47.50513,-52.79476,2018-01-05 23:00:00,34,2,36
"8882",10401,"Mount Pearl","NL",47.50513,-52.79476,2018-01-06 00:00:00,35,2,37
"8883",10401,"Mount Pearl","NL",47.50513,-52.79476,2018-01-06 01:00:00,33,2,35
"8884",10401,"Mount Pearl","NL",47.50513,-52.79476,2018-01-06 02:00:00,36,1,37
"8885",10401,"Mount Pearl","NL",47.50513,-52.79476,2018-01-06 03:00:00,36,1,37
"8886",10401,"Mount Pearl","NL",47.50513,-52.79476,2018-01-06 04:00:00,34,1,35
"8887",10401,"Mount Pearl","NL",47.50513,-52.79476,2018-01-06 05:00:00,32,2,34
"8888",10401,"Mount Pearl","NL",47.50513,-52.79476,2018-01-06 06:00:00,33,1,34
"8889",10401,"Mount Pearl","NL",47.50513,-52.79476,2018-01-06 07:00:00,32,2,34
"8890",10401,"Mount Pearl","NL",47.50513,-52.79476,2018-01-06 08:00:00,32,2,34
"8891",10401,"Mount Pearl","NL",47.50513,-52.79476,2018-01-06 09:00:00,35,1,36
"8892",10401,"Mount Pearl","NL",47.50513,-52.79476,2018-01-06 10:00:00,36,2,38
"8893",10401,"Mount Pearl","NL",47.50513,-52.79476,2018-01-06 11:00:00,35,1,36
"8894",10401,"Mount Pearl","NL",47.50513,-52.79476,2018-01-06 12:00:00,38,0,38
"8895",10401,"Mount Pearl","NL",47.50513,-52.79476,2018-01-06 13:00:00,37,1,38
"8896",10401,"Mount Pearl","NL",47.50513,-52.79476,2018-01-06 14:00:00,37,1,38
"8897",10401,"Mount Pearl","NL",47.50513,-52.79476,2018-01-06 15:00:00,35,0,35
"8898",10401,"Mount Pearl","NL",47.50513,-52.79476,2018-01-06 16:00:00,35,1,36
"8899",10401,"Mount Pearl","NL",47.50513,-52.79476,2018-01-06 17:00:00,35,1,36
"8900",10401,"Mount Pearl","NL",47.50513,-52.79476,2018-01-06 18:00:00,35,1,36
"8901",10401,"Mount Pearl","NL",47.50513,-52.79476,2018-01-06 19:00:00,36,0,36
"8902",10401,"Mount Pearl","NL",47.50513,-52.79476,2018-01-06 20:00:00,36,0,36
"8903",10401,"Mount Pearl","NL",47.50513,-52.79476,2018-01-06 21:00:00,37,0,37
"8904",10401,"Mount Pearl","NL",47.50513,-52.79476,2018-01-06 22:00:00,37,0,37
"8905",10401,"Mount Pearl","NL",47.50513,-52.79476,2018-01-06 23:00:00,37,0,37
"8906",10401,"Mount Pearl","NL",47.50513,-52.79476,2018-01-07 00:00:00,34,1,35
"8907",10401,"Mount Pearl","NL",47.50513,-52.79476,2018-01-07 01:00:00,34,1,35
"8908",10401,"Mount Pearl","NL",47.50513,-52.79476,2018-01-07 02:00:00,34,0,34
"8909",10401,"Mount Pearl","NL",47.50513,-52.79476,2018-01-07 03:00:00,34,0,34
"8910",10401,"Mount Pearl","NL",47.50513,-52.79476,2018-01-07 04:00:00,34,0,34
"8911",10401,"Mount Pearl","NL",47.50513,-52.79476,2018-01-07 05:00:00,33,0,33
"8912",10401,"Mount Pearl","NL",47.50513,-52.79476,2018-01-07 06:00:00,33,1,34
"8913",10401,"Mount Pearl","NL",47.50513,-52.79476,2018-01-07 07:00:00,32,1,33
"8914",10401,"Mount Pearl","NL",47.50513,-52.79476,2018-01-07 08:00:00,33,1,34
"8915",10401,"Mount Pearl","NL",47.50513,-52.79476,2018-01-07 09:00:00,34,0,34
"8916",10401,"Mount Pearl","NL",47.50513,-52.79476,2018-01-07 10:00:00,33,0,33
"8917",10401,"Mount Pearl","NL",47.50513,-52.79476,2018-01-07 11:00:00,34,0,34
"8918",10401,"Mount Pearl","NL",47.50513,-52.79476,2018-01-07 12:00:00,35,1,36
"8919",10401,"Mount Pearl","NL",47.50513,-52.79476,2018-01-07 13:00:00,36,1,37
"8920",10401,"Mount Pearl","NL",47.50513,-52.79476,2018-01-07 14:00:00,34,4,38
"8921",10401,"Mount Pearl","NL",47.50513,-52.79476,2018-01-07 15:00:00,35,3,38
"8922",10401,"Mount Pearl","NL",47.50513,-52.79476,2018-01-07 16:00:00,36,3,39
"8923",10401,"Mount Pearl","NL",47.50513,-52.79476,2018-01-07 17:00:00,35,4,39
"8924",10401,"Mount Pearl","NL",47.50513,-52.79476,2018-01-07 18:00:00,32,6,38
"8925",10401,"Mount Pearl","NL",47.50513,-52.79476,2018-01-07 19:00:00,37,2,39
"8926",10401,"Mount Pearl","NL",47.50513,-52.79476,2018-01-07 20:00:00,37,1,38
"8927",10401,"Mount Pearl","NL",47.50513,-52.79476,2018-01-07 21:00:00,37,2,39
"8928",10401,"Mount Pearl","NL",47.50513,-52.79476,2018-01-07 22:00:00,37,1,38
"8929",10401,"Mount Pearl","NL",47.50513,-52.79476,2018-01-07 23:00:00,37,1,38
"8930",10401,"Mount Pearl","NL",47.50513,-52.79476,2018-01-08 00:00:00,38,1,39
"8931",10401,"Mount Pearl","NL",47.50513,-52.79476,2018-01-08 01:00:00,39,1,40
"8932",10401,"Mount Pearl","NL",47.50513,-52.79476,2018-01-08 02:00:00,39,1,40
"8933",10401,"Mount Pearl","NL",47.50513,-52.79476,2018-01-08 03:00:00,39,1,40
"8934",10401,"Mount Pearl","NL",47.50513,-52.79476,2018-01-08 04:00:00,40,1,41
"8935",10401,"Mount Pearl","NL",47.50513,-52.79476,2018-01-08 05:00:00,41,1,42
"8936",10401,"Mount Pearl","NL",47.50513,-52.79476,2018-01-08 06:00:00,41,1,42
"8937",10401,"Mount Pearl","NL",47.50513,-52.79476,2018-01-08 07:00:00,41,1,42
"8938",10401,"Mount Pearl","NL",47.50513,-52.79476,2018-01-08 08:00:00,40,2,42
"8939",10401,"Mount Pearl","NL",47.50513,-52.79476,2018-01-08 09:00:00,40,1,41
"8940",10401,"Mount Pearl","NL",47.50513,-52.79476,2018-01-08 10:00:00,40,1,41
"8941",10401,"Mount Pearl","NL",47.50513,-52.79476,2018-01-08 11:00:00,40,1,41
"8942",10401,"Mount Pearl","NL",47.50513,-52.79476,2018-01-08 12:00:00,39,2,41
"8943",10401,"Mount Pearl","NL",47.50513,-52.79476,2018-01-08 13:00:00,39,2,41
"8944",10401,"Mount Pearl","NL",47.50513,-52.79476,2018-01-08 14:00:00,40,2,42
"8945",10401,"Mount Pearl","NL",47.50513,-52.79476,2018-01-08 15:00:00,40,2,42
"8946",10401,"Mount Pearl","NL",47.50513,-52.79476,2018-01-08 16:00:00,39,4,43
"8947",10401,"Mount Pearl","NL",47.50513,-52.79476,2018-01-08 17:00:00,40,4,44
"8948",10401,"Mount Pearl","NL",47.50513,-52.79476,2018-01-08 18:00:00,40,3,43
"8949",10401,"Mount Pearl","NL",47.50513,-52.79476,2018-01-08 19:00:00,40,3,43
"8950",10401,"Mount Pearl","NL",47.50513,-52.79476,2018-01-08 20:00:00,40,2,42
"8951",10401,"Mount Pearl","NL",47.50513,-52.79476,2018-01-08 21:00:00,39,3,42
"8952",10401,"Mount Pearl","NL",47.50513,-52.79476,2018-01-08 22:00:00,39,2,41
"8953",10401,"Mount Pearl","NL",47.50513,-52.79476,2018-01-08 23:00:00,39,3,42
"8954",10401,"Mount Pearl","NL",47.50513,-52.79476,2018-01-09 00:00:00,39,2,41
"8955",10401,"Mount Pearl","NL",47.50513,-52.79476,2018-01-09 01:00:00,39,3,42
"8956",10401,"Mount Pearl","NL",47.50513,-52.79476,2018-01-09 02:00:00,39,3,42
"8957",10401,"Mount Pearl","NL",47.50513,-52.79476,2018-01-09 03:00:00,39,3,42
"8958",10401,"Mount Pearl","NL",47.50513,-52.79476,2018-01-09 04:00:00,38,3,41
"8959",10401,"Mount Pearl","NL",47.50513,-52.79476,2018-01-09 05:00:00,38,3,41
"8960",10401,"Mount Pearl","NL",47.50513,-52.79476,2018-01-09 06:00:00,38,3,41
"8961",10401,"Mount Pearl","NL",47.50513,-52.79476,2018-01-09 07:00:00,19,16,35
"8962",10401,"Mount Pearl","NL",47.50513,-52.79476,2018-01-09 08:00:00,26,10,36
"8963",10401,"Mount Pearl","NL",47.50513,-52.79476,2018-01-09 09:00:00,31,6,37
"8964",10401,"Mount Pearl","NL",47.50513,-52.79476,2018-01-09 10:00:00,32,5,37
"8965",10401,"Mount Pearl","NL",47.50513,-52.79476,2018-01-09 11:00:00,30,7,37
"8966",10401,"Mount Pearl","NL",47.50513,-52.79476,2018-01-09 12:00:00,35,3,38
"8967",10401,"Mount Pearl","NL",47.50513,-52.79476,2018-01-09 13:00:00,36,3,39
"8968",10401,"Mount Pearl","NL",47.50513,-52.79476,2018-01-09 14:00:00,36,3,39
"8969",10401,"Mount Pearl","NL",47.50513,-52.79476,2018-01-09 15:00:00,36,2,38
"8970",10401,"Mount Pearl","NL",47.50513,-52.79476,2018-01-09 16:00:00,37,2,39
"8971",10401,"Mount Pearl","NL",47.50513,-52.79476,2018-01-09 17:00:00,36,3,39
"8972",10401,"Mount Pearl","NL",47.50513,-52.79476,2018-01-09 18:00:00,35,3,38
"8973",10401,"Mount Pearl","NL",47.50513,-52.79476,2018-01-09 19:00:00,37,4,41
"8974",10401,"Mount Pearl","NL",47.50513,-52.79476,2018-01-09 20:00:00,38,2,40
"8975",10401,"Mount Pearl","NL",47.50513,-52.79476,2018-01-09 21:00:00,36,2,38
"8976",10401,"Mount Pearl","NL",47.50513,-52.79476,2018-01-09 22:00:00,34,2,36
"8977",10401,"Mount Pearl","NL",47.50513,-52.79476,2018-01-09 23:00:00,33,3,36
"8978",10401,"Mount Pearl","NL",47.50513,-52.79476,2018-01-10 00:00:00,34,3,37
"8979",10401,"Mount Pearl","NL",47.50513,-52.79476,2018-01-10 01:00:00,34,2,36
"8980",10401,"Mount Pearl","NL",47.50513,-52.79476,2018-01-10 02:00:00,29,5,34
"8981",10401,"Mount Pearl","NL",47.50513,-52.79476,2018-01-10 03:00:00,28,5,33
"8982",10401,"Mount Pearl","NL",47.50513,-52.79476,2018-01-10 04:00:00,33,2,35
"8983",10401,"Mount Pearl","NL",47.50513,-52.79476,2018-01-10 05:00:00,29,5,34
"8984",10401,"Mount Pearl","NL",47.50513,-52.79476,2018-01-10 06:00:00,33,3,36
"8985",10401,"Mount Pearl","NL",47.50513,-52.79476,2018-01-10 07:00:00,37,2,39
"8986",10401,"Mount Pearl","NL",47.50513,-52.79476,2018-01-10 08:00:00,38,3,41
"8987",10401,"Mount Pearl","NL",47.50513,-52.79476,2018-01-10 09:00:00,36,3,39
"8988",10401,"Mount Pearl","NL",47.50513,-52.79476,2018-01-10 10:00:00,35,3,38
"8989",10401,"Mount Pearl","NL",47.50513,-52.79476,2018-01-10 11:00:00,35,3,38
"8990",10401,"Mount Pearl","NL",47.50513,-52.79476,2018-01-10 12:00:00,36,1,37
"8991",10401,"Mount Pearl","NL",47.50513,-52.79476,2018-01-10 13:00:00,37,0,37
"8992",10401,"Mount Pearl","NL",47.50513,-52.79476,2018-01-10 14:00:00,36,1,37
"8993",10401,"Mount Pearl","NL",47.50513,-52.79476,2018-01-10 15:00:00,36,1,37
"8994",10401,"Mount Pearl","NL",47.50513,-52.79476,2018-01-10 16:00:00,38,1,39
"8995",10401,"Mount Pearl","NL",47.50513,-52.79476,2018-01-10 17:00:00,40,2,42
"8996",10401,"Mount Pearl","NL",47.50513,-52.79476,2018-01-10 18:00:00,41,0,41
"8997",10401,"Mount Pearl","NL",47.50513,-52.79476,2018-01-10 19:00:00,40,1,41
"8998",10401,"Mount Pearl","NL",47.50513,-52.79476,2018-01-10 20:00:00,39,1,40
"8999",10401,"Mount Pearl","NL",47.50513,-52.79476,2018-01-10 21:00:00,39,0,39
"9000",10401,"Mount Pearl","NL",47.50513,-52.79476,2018-01-10 22:00:00,39,0,39
"9001",10401,"Mount Pearl","NL",47.50513,-52.79476,2018-01-10 23:00:00,39,0,39
"9002",10401,"Mount Pearl","NL",47.50513,-52.79476,2018-01-11 00:00:00,39,0,39
"9003",10401,"Mount Pearl","NL",47.50513,-52.79476,2018-01-11 01:00:00,39,0,39
"9004",10401,"Mount Pearl","NL",47.50513,-52.79476,2018-01-11 02:00:00,39,0,39
"9005",10401,"Mount Pearl","NL",47.50513,-52.79476,2018-01-11 03:00:00,38,0,38
"9006",10401,"Mount Pearl","NL",47.50513,-52.79476,2018-01-11 04:00:00,37,0,37
"9007",10401,"Mount Pearl","NL",47.50513,-52.79476,2018-01-11 05:00:00,36,0,36
"9008",10401,"Mount Pearl","NL",47.50513,-52.79476,2018-01-11 06:00:00,33,0,33
"9009",10401,"Mount Pearl","NL",47.50513,-52.79476,2018-01-11 07:00:00,29,2,31
"9010",10401,"Mount Pearl","NL",47.50513,-52.79476,2018-01-11 08:00:00,30,2,32
"9011",10401,"Mount Pearl","NL",47.50513,-52.79476,2018-01-11 09:00:00,32,1,33
"9012",10401,"Mount Pearl","NL",47.50513,-52.79476,2018-01-11 10:00:00,35,0,35
"9013",10401,"Mount Pearl","NL",47.50513,-52.79476,2018-01-11 11:00:00,33,0,33
"9014",10401,"Mount Pearl","NL",47.50513,-52.79476,2018-01-11 12:00:00,34,1,35
"9015",10401,"Mount Pearl","NL",47.50513,-52.79476,2018-01-11 13:00:00,34,1,35
"9016",10401,"Mount Pearl","NL",47.50513,-52.79476,2018-01-11 14:00:00,36,1,37
"9017",10401,"Mount Pearl","NL",47.50513,-52.79476,2018-01-11 15:00:00,37,1,38
"9018",10401,"Mount Pearl","NL",47.50513,-52.79476,2018-01-11 16:00:00,38,0,38
"9019",10401,"Mount Pearl","NL",47.50513,-52.79476,2018-01-11 17:00:00,38,0,38
"9020",10401,"Mount Pearl","NL",47.50513,-52.79476,2018-01-11 18:00:00,37,0,37
"9021",10401,"Mount Pearl","NL",47.50513,-52.79476,2018-01-11 19:00:00,36,0,36
"9022",10401,"Mount Pearl","NL",47.50513,-52.79476,2018-01-11 20:00:00,35,0,35
"9023",10401,"Mount Pearl","NL",47.50513,-52.79476,2018-01-11 21:00:00,36,0,36
"9024",10401,"Mount Pearl","NL",47.50513,-52.79476,2018-01-11 22:00:00,36,0,36
"9025",10401,"Mount Pearl","NL",47.50513,-52.79476,2018-01-11 23:00:00,35,1,36
"9026",10401,"Mount Pearl","NL",47.50513,-52.79476,2018-01-12 00:00:00,35,0,35
"9027",10401,"Mount Pearl","NL",47.50513,-52.79476,2018-01-12 01:00:00,30,3,33
"9028",10401,"Mount Pearl","NL",47.50513,-52.79476,2018-01-12 02:00:00,30,3,33
"9029",10401,"Mount Pearl","NL",47.50513,-52.79476,2018-01-12 03:00:00,33,1,34
"9030",10401,"Mount Pearl","NL",47.50513,-52.79476,2018-01-12 04:00:00,30,2,32
"9031",10401,"Mount Pearl","NL",47.50513,-52.79476,2018-01-12 05:00:00,31,1,32
"9032",10401,"Mount Pearl","NL",47.50513,-52.79476,2018-01-12 06:00:00,30,3,33
"9033",10401,"Mount Pearl","NL",47.50513,-52.79476,2018-01-12 07:00:00,32,1,33
"9034",10401,"Mount Pearl","NL",47.50513,-52.79476,2018-01-12 08:00:00,31,2,33
"9035",10401,"Mount Pearl","NL",47.50513,-52.79476,2018-01-12 09:00:00,30,2,32
"9036",10401,"Mount Pearl","NL",47.50513,-52.79476,2018-01-12 10:00:00,32,1,33
"9037",10401,"Mount Pearl","NL",47.50513,-52.79476,2018-01-12 11:00:00,31,1,32
"9038",10401,"Mount Pearl","NL",47.50513,-52.79476,2018-01-12 12:00:00,31,1,32
"9039",10401,"Mount Pearl","NL",47.50513,-52.79476,2018-01-12 13:00:00,32,1,33
"9040",10401,"Mount Pearl","NL",47.50513,-52.79476,2018-01-12 14:00:00,34,1,35
"9041",10401,"Mount Pearl","NL",47.50513,-52.79476,2018-01-12 15:00:00,36,1,37
"9042",10401,"Mount Pearl","NL",47.50513,-52.79476,2018-01-12 16:00:00,37,1,38
"9043",10401,"Mount Pearl","NL",47.50513,-52.79476,2018-01-12 17:00:00,38,1,39
"9044",10401,"Mount Pearl","NL",47.50513,-52.79476,2018-01-12 18:00:00,38,1,39
"9045",10401,"Mount Pearl","NL",47.50513,-52.79476,2018-01-12 19:00:00,38,1,39
"9046",10401,"Mount Pearl","NL",47.50513,-52.79476,2018-01-12 20:00:00,38,0,38
"9047",10401,"Mount Pearl","NL",47.50513,-52.79476,2018-01-12 21:00:00,37,1,38
"9048",10401,"Mount Pearl","NL",47.50513,-52.79476,2018-01-12 22:00:00,37,0,37
"9049",10401,"Mount Pearl","NL",47.50513,-52.79476,2018-01-12 23:00:00,37,0,37
"9050",10401,"Mount Pearl","NL",47.50513,-52.79476,2018-01-13 00:00:00,37,0,37
"9051",10401,"Mount Pearl","NL",47.50513,-52.79476,2018-01-13 01:00:00,37,0,37
"9052",10401,"Mount Pearl","NL",47.50513,-52.79476,2018-01-13 02:00:00,37,0,37
"9053",10401,"Mount Pearl","NL",47.50513,-52.79476,2018-01-13 03:00:00,37,0,37
"9054",10401,"Mount Pearl","NL",47.50513,-52.79476,2018-01-13 04:00:00,38,0,38
"9055",10401,"Mount Pearl","NL",47.50513,-52.79476,2018-01-13 05:00:00,38,0,38
"9056",10401,"Mount Pearl","NL",47.50513,-52.79476,2018-01-13 06:00:00,39,0,39
"9057",10401,"Mount Pearl","NL",47.50513,-52.79476,2018-01-13 07:00:00,40,1,41
"9058",10401,"Mount Pearl","NL",47.50513,-52.79476,2018-01-13 08:00:00,40,0,40
"9059",10401,"Mount Pearl","NL",47.50513,-52.79476,2018-01-13 09:00:00,NA,NA,NA
"9060",10401,"Mount Pearl","NL",47.50513,-52.79476,2018-01-13 10:00:00,NA,NA,NA
"9061",10401,"Mount Pearl","NL",47.50513,-52.79476,2018-01-13 11:00:00,NA,NA,NA
"9062",10401,"Mount Pearl","NL",47.50513,-52.79476,2018-01-13 12:00:00,NA,NA,NA
"9063",10401,"Mount Pearl","NL",47.50513,-52.79476,2018-01-13 13:00:00,39,1,40
"9064",10401,"Mount Pearl","NL",47.50513,-52.79476,2018-01-13 14:00:00,39,0,39
"9065",10401,"Mount Pearl","NL",47.50513,-52.79476,2018-01-13 15:00:00,39,1,40
"9066",10401,"Mount Pearl","NL",47.50513,-52.79476,2018-01-13 16:00:00,39,0,39
"9067",10401,"Mount Pearl","NL",47.50513,-52.79476,2018-01-13 17:00:00,39,1,40
"9068",10401,"Mount Pearl","NL",47.50513,-52.79476,2018-01-13 18:00:00,39,0,39
"9069",10401,"Mount Pearl","NL",47.50513,-52.79476,2018-01-13 19:00:00,39,0,39
"9070",10401,"Mount Pearl","NL",47.50513,-52.79476,2018-01-13 20:00:00,39,0,39
"9071",10401,"Mount Pearl","NL",47.50513,-52.79476,2018-01-13 21:00:00,39,0,39
"9072",10401,"Mount Pearl","NL",47.50513,-52.79476,2018-01-13 22:00:00,38,0,38
"9073",10401,"Mount Pearl","NL",47.50513,-52.79476,2018-01-13 23:00:00,38,0,38
"9074",10401,"Mount Pearl","NL",47.50513,-52.79476,2018-01-14 00:00:00,38,0,38
"9075",10401,"Mount Pearl","NL",47.50513,-52.79476,2018-01-14 01:00:00,38,1,39
"9076",10401,"Mount Pearl","NL",47.50513,-52.79476,2018-01-14 02:00:00,38,1,39
"9077",10401,"Mount Pearl","NL",47.50513,-52.79476,2018-01-14 03:00:00,39,1,40
"9078",10401,"Mount Pearl","NL",47.50513,-52.79476,2018-01-14 04:00:00,39,0,39
"9079",10401,"Mount Pearl","NL",47.50513,-52.79476,2018-01-14 05:00:00,38,1,39
"9080",10401,"Mount Pearl","NL",47.50513,-52.79476,2018-01-14 06:00:00,38,0,38
"9081",10401,"Mount Pearl","NL",47.50513,-52.79476,2018-01-14 07:00:00,38,0,38
"9082",10401,"Mount Pearl","NL",47.50513,-52.79476,2018-01-14 08:00:00,37,0,37
"9083",10401,"Mount Pearl","NL",47.50513,-52.79476,2018-01-14 09:00:00,36,0,36
"9084",10401,"Mount Pearl","NL",47.50513,-52.79476,2018-01-14 10:00:00,36,1,37
"9085",10401,"Mount Pearl","NL",47.50513,-52.79476,2018-01-14 11:00:00,35,1,36
"9086",10401,"Mount Pearl","NL",47.50513,-52.79476,2018-01-14 12:00:00,33,1,34
"9087",10401,"Mount Pearl","NL",47.50513,-52.79476,2018-01-14 13:00:00,33,1,34
"9088",10401,"Mount Pearl","NL",47.50513,-52.79476,2018-01-14 14:00:00,32,1,33
"9089",10401,"Mount Pearl","NL",47.50513,-52.79476,2018-01-14 15:00:00,29,2,31
"9090",10401,"Mount Pearl","NL",47.50513,-52.79476,2018-01-14 16:00:00,29,1,30
"9091",10401,"Mount Pearl","NL",47.50513,-52.79476,2018-01-14 17:00:00,27,2,29
"9092",10401,"Mount Pearl","NL",47.50513,-52.79476,2018-01-14 18:00:00,29,1,30
"9093",10401,"Mount Pearl","NL",47.50513,-52.79476,2018-01-14 19:00:00,28,1,29
"9094",10401,"Mount Pearl","NL",47.50513,-52.79476,2018-01-14 20:00:00,27,1,28
"9095",10401,"Mount Pearl","NL",47.50513,-52.79476,2018-01-14 21:00:00,31,1,32
"9096",10401,"Mount Pearl","NL",47.50513,-52.79476,2018-01-14 22:00:00,31,1,32
"9097",10401,"Mount Pearl","NL",47.50513,-52.79476,2018-01-14 23:00:00,31,1,32
"9098",10401,"Mount Pearl","NL",47.50513,-52.79476,2018-01-15 00:00:00,33,0,33
"9099",10401,"Mount Pearl","NL",47.50513,-52.79476,2018-01-15 01:00:00,34,0,34
"9100",10401,"Mount Pearl","NL",47.50513,-52.79476,2018-01-15 02:00:00,35,0,35
"9101",10401,"Mount Pearl","NL",47.50513,-52.79476,2018-01-15 03:00:00,35,0,35
"9102",10401,"Mount Pearl","NL",47.50513,-52.79476,2018-01-15 04:00:00,34,0,34
"9103",10401,"Mount Pearl","NL",47.50513,-52.79476,2018-01-15 05:00:00,33,0,33
"9104",10401,"Mount Pearl","NL",47.50513,-52.79476,2018-01-15 06:00:00,34,0,34
"9105",10401,"Mount Pearl","NL",47.50513,-52.79476,2018-01-15 07:00:00,36,0,36
"9106",10401,"Mount Pearl","NL",47.50513,-52.79476,2018-01-15 08:00:00,35,1,36
"9107",10401,"Mount Pearl","NL",47.50513,-52.79476,2018-01-15 09:00:00,35,1,36
"9108",10401,"Mount Pearl","NL",47.50513,-52.79476,2018-01-15 10:00:00,36,1,37
"9109",10401,"Mount Pearl","NL",47.50513,-52.79476,2018-01-15 11:00:00,36,1,37
"9110",10401,"Mount Pearl","NL",47.50513,-52.79476,2018-01-15 12:00:00,35,0,35
"9111",10401,"Mount Pearl","NL",47.50513,-52.79476,2018-01-15 13:00:00,35,1,36
"9112",10401,"Mount Pearl","NL",47.50513,-52.79476,2018-01-15 14:00:00,35,1,36
"9113",10401,"Mount Pearl","NL",47.50513,-52.79476,2018-01-15 15:00:00,36,0,36
"9114",10401,"Mount Pearl","NL",47.50513,-52.79476,2018-01-15 16:00:00,35,1,36
"9115",10401,"Mount Pearl","NL",47.50513,-52.79476,2018-01-15 17:00:00,36,1,37
"9116",10401,"Mount Pearl","NL",47.50513,-52.79476,2018-01-15 18:00:00,36,1,37
"9117",10401,"Mount Pearl","NL",47.50513,-52.79476,2018-01-15 19:00:00,36,1,37
"9118",10401,"Mount Pearl","NL",47.50513,-52.79476,2018-01-15 20:00:00,36,1,37
"9119",10401,"Mount Pearl","NL",47.50513,-52.79476,2018-01-15 21:00:00,36,1,37
"9120",10401,"Mount Pearl","NL",47.50513,-52.79476,2018-01-15 22:00:00,36,0,36
"9121",10401,"Mount Pearl","NL",47.50513,-52.79476,2018-01-15 23:00:00,37,0,37
"9122",10401,"Mount Pearl","NL",47.50513,-52.79476,2018-01-16 00:00:00,37,0,37
"9123",10401,"Mount Pearl","NL",47.50513,-52.79476,2018-01-16 01:00:00,38,0,38
"9124",10401,"Mount Pearl","NL",47.50513,-52.79476,2018-01-16 02:00:00,37,0,37
"9125",10401,"Mount Pearl","NL",47.50513,-52.79476,2018-01-16 03:00:00,38,0,38
"9126",10401,"Mount Pearl","NL",47.50513,-52.79476,2018-01-16 04:00:00,39,0,39
"9127",10401,"Mount Pearl","NL",47.50513,-52.79476,2018-01-16 05:00:00,38,0,38
"9128",10401,"Mount Pearl","NL",47.50513,-52.79476,2018-01-16 06:00:00,38,1,39
"9129",10401,"Mount Pearl","NL",47.50513,-52.79476,2018-01-16 07:00:00,39,0,39
"9130",10401,"Mount Pearl","NL",47.50513,-52.79476,2018-01-16 08:00:00,38,0,38
"9131",10401,"Mount Pearl","NL",47.50513,-52.79476,2018-01-16 09:00:00,37,1,38
"9132",10401,"Mount Pearl","NL",47.50513,-52.79476,2018-01-16 10:00:00,39,0,39
"9133",10401,"Mount Pearl","NL",47.50513,-52.79476,2018-01-16 11:00:00,39,0,39
"9134",10401,"Mount Pearl","NL",47.50513,-52.79476,2018-01-16 12:00:00,38,1,39
"9135",10401,"Mount Pearl","NL",47.50513,-52.79476,2018-01-16 13:00:00,37,1,38
"9136",10401,"Mount Pearl","NL",47.50513,-52.79476,2018-01-16 14:00:00,37,1,38
"9137",10401,"Mount Pearl","NL",47.50513,-52.79476,2018-01-16 15:00:00,38,1,39
"9138",10401,"Mount Pearl","NL",47.50513,-52.79476,2018-01-16 16:00:00,37,1,38
"9139",10401,"Mount Pearl","NL",47.50513,-52.79476,2018-01-16 17:00:00,37,1,38
"9140",10401,"Mount Pearl","NL",47.50513,-52.79476,2018-01-16 18:00:00,39,0,39
"9141",10401,"Mount Pearl","NL",47.50513,-52.79476,2018-01-16 19:00:00,39,1,40
"9142",10401,"Mount Pearl","NL",47.50513,-52.79476,2018-01-16 20:00:00,37,1,38
"9143",10401,"Mount Pearl","NL",47.50513,-52.79476,2018-01-16 21:00:00,39,0,39
"9144",10401,"Mount Pearl","NL",47.50513,-52.79476,2018-01-16 22:00:00,39,0,39
"9145",10401,"Mount Pearl","NL",47.50513,-52.79476,2018-01-16 23:00:00,39,0,39
"9146",10401,"Mount Pearl","NL",47.50513,-52.79476,2018-01-17 00:00:00,39,0,39
"9147",10401,"Mount Pearl","NL",47.50513,-52.79476,2018-01-17 01:00:00,39,1,40
"9148",10401,"Mount Pearl","NL",47.50513,-52.79476,2018-01-17 02:00:00,38,0,38
"9149",10401,"Mount Pearl","NL",47.50513,-52.79476,2018-01-17 03:00:00,38,0,38
"9150",10401,"Mount Pearl","NL",47.50513,-52.79476,2018-01-17 04:00:00,38,0,38
"9151",10401,"Mount Pearl","NL",47.50513,-52.79476,2018-01-17 05:00:00,39,1,40
"9152",10401,"Mount Pearl","NL",47.50513,-52.79476,2018-01-17 06:00:00,39,0,39
"9153",10401,"Mount Pearl","NL",47.50513,-52.79476,2018-01-17 07:00:00,39,1,40
"9154",10401,"Mount Pearl","NL",47.50513,-52.79476,2018-01-17 08:00:00,37,1,38
"9155",10401,"Mount Pearl","NL",47.50513,-52.79476,2018-01-17 09:00:00,34,2,36
"9156",10401,"Mount Pearl","NL",47.50513,-52.79476,2018-01-17 10:00:00,33,1,34
"9157",10401,"Mount Pearl","NL",47.50513,-52.79476,2018-01-17 11:00:00,35,1,36
"9158",10401,"Mount Pearl","NL",47.50513,-52.79476,2018-01-17 12:00:00,35,1,36
"9159",10401,"Mount Pearl","NL",47.50513,-52.79476,2018-01-17 13:00:00,37,0,37
"9160",10401,"Mount Pearl","NL",47.50513,-52.79476,2018-01-17 14:00:00,37,0,37
"9161",10401,"Mount Pearl","NL",47.50513,-52.79476,2018-01-17 15:00:00,37,1,38
"9162",10401,"Mount Pearl","NL",47.50513,-52.79476,2018-01-17 16:00:00,37,1,38
"9163",10401,"Mount Pearl","NL",47.50513,-52.79476,2018-01-17 17:00:00,38,1,39
"9164",10401,"Mount Pearl","NL",47.50513,-52.79476,2018-01-17 18:00:00,38,1,39
"9165",10401,"Mount Pearl","NL",47.50513,-52.79476,2018-01-17 19:00:00,38,1,39
"9166",10401,"Mount Pearl","NL",47.50513,-52.79476,2018-01-17 20:00:00,34,1,35
"9167",10401,"Mount Pearl","NL",47.50513,-52.79476,2018-01-17 21:00:00,31,2,33
"9168",10401,"Mount Pearl","NL",47.50513,-52.79476,2018-01-17 22:00:00,26,3,29
"9169",10401,"Mount Pearl","NL",47.50513,-52.79476,2018-01-17 23:00:00,25,3,28
"9170",10401,"Mount Pearl","NL",47.50513,-52.79476,2018-01-18 00:00:00,27,2,29
"9171",10401,"Mount Pearl","NL",47.50513,-52.79476,2018-01-18 01:00:00,30,1,31
"9172",10401,"Mount Pearl","NL",47.50513,-52.79476,2018-01-18 02:00:00,28,1,29
"9173",10401,"Mount Pearl","NL",47.50513,-52.79476,2018-01-18 03:00:00,35,1,36
"9174",10401,"Mount Pearl","NL",47.50513,-52.79476,2018-01-18 04:00:00,36,1,37
"9175",10401,"Mount Pearl","NL",47.50513,-52.79476,2018-01-18 05:00:00,39,0,39
"9176",10401,"Mount Pearl","NL",47.50513,-52.79476,2018-01-18 06:00:00,40,0,40
"9177",10401,"Mount Pearl","NL",47.50513,-52.79476,2018-01-18 07:00:00,41,1,42
"9178",10401,"Mount Pearl","NL",47.50513,-52.79476,2018-01-18 08:00:00,40,1,41
"9179",10401,"Mount Pearl","NL",47.50513,-52.79476,2018-01-18 09:00:00,40,1,41
"9180",10401,"Mount Pearl","NL",47.50513,-52.79476,2018-01-18 10:00:00,39,2,41
"9181",10401,"Mount Pearl","NL",47.50513,-52.79476,2018-01-18 11:00:00,38,1,39
"9182",10401,"Mount Pearl","NL",47.50513,-52.79476,2018-01-18 12:00:00,37,1,38
"9183",10401,"Mount Pearl","NL",47.50513,-52.79476,2018-01-18 13:00:00,37,1,38
"9184",10401,"Mount Pearl","NL",47.50513,-52.79476,2018-01-18 14:00:00,36,1,37
"9185",10401,"Mount Pearl","NL",47.50513,-52.79476,2018-01-18 15:00:00,36,1,37
"9186",10401,"Mount Pearl","NL",47.50513,-52.79476,2018-01-18 16:00:00,34,1,35
"9187",10401,"Mount Pearl","NL",47.50513,-52.79476,2018-01-18 17:00:00,34,1,35
"9188",10401,"Mount Pearl","NL",47.50513,-52.79476,2018-01-18 18:00:00,36,1,37
"9189",10401,"Mount Pearl","NL",47.50513,-52.79476,2018-01-18 19:00:00,36,1,37
"9190",10401,"Mount Pearl","NL",47.50513,-52.79476,2018-01-18 20:00:00,36,0,36
"9191",10401,"Mount Pearl","NL",47.50513,-52.79476,2018-01-18 21:00:00,35,2,37
"9192",10401,"Mount Pearl","NL",47.50513,-52.79476,2018-01-18 22:00:00,38,1,39
"9193",10401,"Mount Pearl","NL",47.50513,-52.79476,2018-01-18 23:00:00,37,0,37
"9194",10401,"Mount Pearl","NL",47.50513,-52.79476,2018-01-19 00:00:00,37,0,37
"9195",10401,"Mount Pearl","NL",47.50513,-52.79476,2018-01-19 01:00:00,34,0,34
"9196",10401,"Mount Pearl","NL",47.50513,-52.79476,2018-01-19 02:00:00,34,0,34
"9197",10401,"Mount Pearl","NL",47.50513,-52.79476,2018-01-19 03:00:00,36,0,36
"9198",10401,"Mount Pearl","NL",47.50513,-52.79476,2018-01-19 04:00:00,36,0,36
"9199",10401,"Mount Pearl","NL",47.50513,-52.79476,2018-01-19 05:00:00,34,1,35
"9200",10401,"Mount Pearl","NL",47.50513,-52.79476,2018-01-19 06:00:00,31,2,33
"9201",10401,"Mount Pearl","NL",47.50513,-52.79476,2018-01-19 07:00:00,30,3,33
"9202",10401,"Mount Pearl","NL",47.50513,-52.79476,2018-01-19 08:00:00,29,4,33
"9203",10401,"Mount Pearl","NL",47.50513,-52.79476,2018-01-19 09:00:00,20,11,31
"9204",10401,"Mount Pearl","NL",47.50513,-52.79476,2018-01-19 10:00:00,25,7,32
"9205",10401,"Mount Pearl","NL",47.50513,-52.79476,2018-01-19 11:00:00,32,1,33
"9206",10401,"Mount Pearl","NL",47.50513,-52.79476,2018-01-19 12:00:00,32,1,33
"9207",10401,"Mount Pearl","NL",47.50513,-52.79476,2018-01-19 13:00:00,33,1,34
"9208",10401,"Mount Pearl","NL",47.50513,-52.79476,2018-01-19 14:00:00,33,1,34
"9209",10401,"Mount Pearl","NL",47.50513,-52.79476,2018-01-19 15:00:00,32,2,34
"9210",10401,"Mount Pearl","NL",47.50513,-52.79476,2018-01-19 16:00:00,33,2,35
"9211",10401,"Mount Pearl","NL",47.50513,-52.79476,2018-01-19 17:00:00,33,2,35
"9212",10401,"Mount Pearl","NL",47.50513,-52.79476,2018-01-19 18:00:00,32,2,34
"9213",10401,"Mount Pearl","NL",47.50513,-52.79476,2018-01-19 19:00:00,32,1,33
"9214",10401,"Mount Pearl","NL",47.50513,-52.79476,2018-01-19 20:00:00,32,1,33
"9215",10401,"Mount Pearl","NL",47.50513,-52.79476,2018-01-19 21:00:00,32,1,33
"9216",10401,"Mount Pearl","NL",47.50513,-52.79476,2018-01-19 22:00:00,32,1,33
"9217",10401,"Mount Pearl","NL",47.50513,-52.79476,2018-01-19 23:00:00,33,1,34
"9218",10401,"Mount Pearl","NL",47.50513,-52.79476,2018-01-20 00:00:00,33,1,34
"9219",10401,"Mount Pearl","NL",47.50513,-52.79476,2018-01-20 01:00:00,33,1,34
"9220",10401,"Mount Pearl","NL",47.50513,-52.79476,2018-01-20 02:00:00,33,1,34
"9221",10401,"Mount Pearl","NL",47.50513,-52.79476,2018-01-20 03:00:00,33,1,34
"9222",10401,"Mount Pearl","NL",47.50513,-52.79476,2018-01-20 04:00:00,32,1,33
"9223",10401,"Mount Pearl","NL",47.50513,-52.79476,2018-01-20 05:00:00,32,1,33
"9224",10401,"Mount Pearl","NL",47.50513,-52.79476,2018-01-20 06:00:00,32,1,33
"9225",10401,"Mount Pearl","NL",47.50513,-52.79476,2018-01-20 07:00:00,32,1,33
"9226",10401,"Mount Pearl","NL",47.50513,-52.79476,2018-01-20 08:00:00,30,2,32
"9227",10401,"Mount Pearl","NL",47.50513,-52.79476,2018-01-20 09:00:00,29,2,31
"9228",10401,"Mount Pearl","NL",47.50513,-52.79476,2018-01-20 10:00:00,30,1,31
"9229",10401,"Mount Pearl","NL",47.50513,-52.79476,2018-01-20 11:00:00,32,1,33
"9230",10401,"Mount Pearl","NL",47.50513,-52.79476,2018-01-20 12:00:00,33,1,34
"9231",10401,"Mount Pearl","NL",47.50513,-52.79476,2018-01-20 13:00:00,35,1,36
"9232",10401,"Mount Pearl","NL",47.50513,-52.79476,2018-01-20 14:00:00,35,1,36
"9233",10401,"Mount Pearl","NL",47.50513,-52.79476,2018-01-20 15:00:00,36,1,37
"9234",10401,"Mount Pearl","NL",47.50513,-52.79476,2018-01-20 16:00:00,38,1,39
"9235",10401,"Mount Pearl","NL",47.50513,-52.79476,2018-01-20 17:00:00,40,1,41
"9236",10401,"Mount Pearl","NL",47.50513,-52.79476,2018-01-20 18:00:00,38,1,39
"9237",10401,"Mount Pearl","NL",47.50513,-52.79476,2018-01-20 19:00:00,37,1,38
"9238",10401,"Mount Pearl","NL",47.50513,-52.79476,2018-01-20 20:00:00,37,1,38
"9239",10401,"Mount Pearl","NL",47.50513,-52.79476,2018-01-20 21:00:00,38,0,38
"9240",10401,"Mount Pearl","NL",47.50513,-52.79476,2018-01-20 22:00:00,37,2,39
"9241",10401,"Mount Pearl","NL",47.50513,-52.79476,2018-01-20 23:00:00,38,2,40
"9242",10401,"Mount Pearl","NL",47.50513,-52.79476,2018-01-21 00:00:00,39,2,41
"9243",10401,"Mount Pearl","NL",47.50513,-52.79476,2018-01-21 01:00:00,37,2,39
"9244",10401,"Mount Pearl","NL",47.50513,-52.79476,2018-01-21 02:00:00,35,3,38
"9245",10401,"Mount Pearl","NL",47.50513,-52.79476,2018-01-21 03:00:00,33,4,37
"9246",10401,"Mount Pearl","NL",47.50513,-52.79476,2018-01-21 04:00:00,33,2,35
"9247",10401,"Mount Pearl","NL",47.50513,-52.79476,2018-01-21 05:00:00,32,2,34
"9248",10401,"Mount Pearl","NL",47.50513,-52.79476,2018-01-21 06:00:00,28,4,32
"9249",10401,"Mount Pearl","NL",47.50513,-52.79476,2018-01-21 07:00:00,28,3,31
"9250",10401,"Mount Pearl","NL",47.50513,-52.79476,2018-01-21 08:00:00,26,4,30
"9251",10401,"Mount Pearl","NL",47.50513,-52.79476,2018-01-21 09:00:00,25,3,28
"9252",10401,"Mount Pearl","NL",47.50513,-52.79476,2018-01-21 10:00:00,25,2,27
"9253",10401,"Mount Pearl","NL",47.50513,-52.79476,2018-01-21 11:00:00,25,1,26
"9254",10401,"Mount Pearl","NL",47.50513,-52.79476,2018-01-21 12:00:00,24,1,25
"9255",10401,"Mount Pearl","NL",47.50513,-52.79476,2018-01-21 13:00:00,27,1,28
"9256",10401,"Mount Pearl","NL",47.50513,-52.79476,2018-01-21 14:00:00,28,1,29
"9257",10401,"Mount Pearl","NL",47.50513,-52.79476,2018-01-21 15:00:00,29,1,30
"9258",10401,"Mount Pearl","NL",47.50513,-52.79476,2018-01-21 16:00:00,32,0,32
"9259",10401,"Mount Pearl","NL",47.50513,-52.79476,2018-01-21 17:00:00,34,1,35
"9260",10401,"Mount Pearl","NL",47.50513,-52.79476,2018-01-21 18:00:00,35,1,36
"9261",10401,"Mount Pearl","NL",47.50513,-52.79476,2018-01-21 19:00:00,35,2,37
"9262",10401,"Mount Pearl","NL",47.50513,-52.79476,2018-01-21 20:00:00,39,1,40
"9263",10401,"Mount Pearl","NL",47.50513,-52.79476,2018-01-21 21:00:00,39,0,39
"9264",10401,"Mount Pearl","NL",47.50513,-52.79476,2018-01-21 22:00:00,39,0,39
"9265",10401,"Mount Pearl","NL",47.50513,-52.79476,2018-01-21 23:00:00,39,0,39
"9266",10401,"Mount Pearl","NL",47.50513,-52.79476,2018-01-22 00:00:00,40,0,40
"9267",10401,"Mount Pearl","NL",47.50513,-52.79476,2018-01-22 01:00:00,39,1,40
"9268",10401,"Mount Pearl","NL",47.50513,-52.79476,2018-01-22 02:00:00,38,0,38
"9269",10401,"Mount Pearl","NL",47.50513,-52.79476,2018-01-22 03:00:00,38,1,39
"9270",10401,"Mount Pearl","NL",47.50513,-52.79476,2018-01-22 04:00:00,37,0,37
"9271",10401,"Mount Pearl","NL",47.50513,-52.79476,2018-01-22 05:00:00,37,0,37
"9272",10401,"Mount Pearl","NL",47.50513,-52.79476,2018-01-22 06:00:00,37,0,37
"9273",10401,"Mount Pearl","NL",47.50513,-52.79476,2018-01-22 07:00:00,37,0,37
"9274",10401,"Mount Pearl","NL",47.50513,-52.79476,2018-01-22 08:00:00,36,1,37
"9275",10401,"Mount Pearl","NL",47.50513,-52.79476,2018-01-22 09:00:00,36,1,37
"9276",10401,"Mount Pearl","NL",47.50513,-52.79476,2018-01-22 10:00:00,37,1,38
"9277",10401,"Mount Pearl","NL",47.50513,-52.79476,2018-01-22 11:00:00,37,0,37
"9278",10401,"Mount Pearl","NL",47.50513,-52.79476,2018-01-22 12:00:00,37,2,39
"9279",10401,"Mount Pearl","NL",47.50513,-52.79476,2018-01-22 13:00:00,38,3,41
"9280",10401,"Mount Pearl","NL",47.50513,-52.79476,2018-01-22 14:00:00,38,2,40
"9281",10401,"Mount Pearl","NL",47.50513,-52.79476,2018-01-22 15:00:00,37,3,40
"9282",10401,"Mount Pearl","NL",47.50513,-52.79476,2018-01-22 16:00:00,37,3,40
"9283",10401,"Mount Pearl","NL",47.50513,-52.79476,2018-01-22 17:00:00,37,3,40
"9284",10401,"Mount Pearl","NL",47.50513,-52.79476,2018-01-22 18:00:00,37,2,39
"9285",10401,"Mount Pearl","NL",47.50513,-52.79476,2018-01-22 19:00:00,38,2,40
"9286",10401,"Mount Pearl","NL",47.50513,-52.79476,2018-01-22 20:00:00,37,2,39
"9287",10401,"Mount Pearl","NL",47.50513,-52.79476,2018-01-22 21:00:00,37,2,39
"9288",10401,"Mount Pearl","NL",47.50513,-52.79476,2018-01-22 22:00:00,37,2,39
"9289",10401,"Mount Pearl","NL",47.50513,-52.79476,2018-01-22 23:00:00,37,2,39
"9290",10401,"Mount Pearl","NL",47.50513,-52.79476,2018-01-23 00:00:00,37,2,39
"9291",10401,"Mount Pearl","NL",47.50513,-52.79476,2018-01-23 01:00:00,37,2,39
"9292",10401,"Mount Pearl","NL",47.50513,-52.79476,2018-01-23 02:00:00,38,2,40
"9293",10401,"Mount Pearl","NL",47.50513,-52.79476,2018-01-23 03:00:00,36,2,38
"9294",10401,"Mount Pearl","NL",47.50513,-52.79476,2018-01-23 04:00:00,36,2,38
"9295",10401,"Mount Pearl","NL",47.50513,-52.79476,2018-01-23 05:00:00,34,3,37
"9296",10401,"Mount Pearl","NL",47.50513,-52.79476,2018-01-23 06:00:00,31,4,35
"9297",10401,"Mount Pearl","NL",47.50513,-52.79476,2018-01-23 07:00:00,34,3,37
"9298",10401,"Mount Pearl","NL",47.50513,-52.79476,2018-01-23 08:00:00,35,3,38
"9299",10401,"Mount Pearl","NL",47.50513,-52.79476,2018-01-23 09:00:00,33,3,36
"9300",10401,"Mount Pearl","NL",47.50513,-52.79476,2018-01-23 10:00:00,34,3,37
"9301",10401,"Mount Pearl","NL",47.50513,-52.79476,2018-01-23 11:00:00,34,3,37
"9302",10401,"Mount Pearl","NL",47.50513,-52.79476,2018-01-23 12:00:00,37,1,38
"9303",10401,"Mount Pearl","NL",47.50513,-52.79476,2018-01-23 13:00:00,39,1,40
"9304",10401,"Mount Pearl","NL",47.50513,-52.79476,2018-01-23 14:00:00,39,1,40
"9305",10401,"Mount Pearl","NL",47.50513,-52.79476,2018-01-23 15:00:00,35,2,37
"9306",10401,"Mount Pearl","NL",47.50513,-52.79476,2018-01-23 16:00:00,37,1,38
"9307",10401,"Mount Pearl","NL",47.50513,-52.79476,2018-01-23 17:00:00,34,2,36
"9308",10401,"Mount Pearl","NL",47.50513,-52.79476,2018-01-23 18:00:00,32,2,34
"9309",10401,"Mount Pearl","NL",47.50513,-52.79476,2018-01-23 19:00:00,30,3,33
"9310",10401,"Mount Pearl","NL",47.50513,-52.79476,2018-01-23 20:00:00,24,5,29
"9311",10401,"Mount Pearl","NL",47.50513,-52.79476,2018-01-23 21:00:00,26,3,29
"9312",10401,"Mount Pearl","NL",47.50513,-52.79476,2018-01-23 22:00:00,28,2,30
"9313",10401,"Mount Pearl","NL",47.50513,-52.79476,2018-01-23 23:00:00,32,1,33
"9314",10401,"Mount Pearl","NL",47.50513,-52.79476,2018-01-24 00:00:00,34,1,35
"9315",10401,"Mount Pearl","NL",47.50513,-52.79476,2018-01-24 01:00:00,36,0,36
"9316",10401,"Mount Pearl","NL",47.50513,-52.79476,2018-01-24 02:00:00,37,1,38
"9317",10401,"Mount Pearl","NL",47.50513,-52.79476,2018-01-24 03:00:00,37,1,38
"9318",10401,"Mount Pearl","NL",47.50513,-52.79476,2018-01-24 04:00:00,38,1,39
"9319",10401,"Mount Pearl","NL",47.50513,-52.79476,2018-01-24 05:00:00,38,0,38
"9320",10401,"Mount Pearl","NL",47.50513,-52.79476,2018-01-24 06:00:00,38,0,38
"9321",10401,"Mount Pearl","NL",47.50513,-52.79476,2018-01-24 07:00:00,38,0,38
"9322",10401,"Mount Pearl","NL",47.50513,-52.79476,2018-01-24 08:00:00,37,1,38
"9323",10401,"Mount Pearl","NL",47.50513,-52.79476,2018-01-24 09:00:00,37,0,37
"9324",10401,"Mount Pearl","NL",47.50513,-52.79476,2018-01-24 10:00:00,37,1,38
"9325",10401,"Mount Pearl","NL",47.50513,-52.79476,2018-01-24 11:00:00,38,1,39
"9326",10401,"Mount Pearl","NL",47.50513,-52.79476,2018-01-24 12:00:00,37,2,39
"9327",10401,"Mount Pearl","NL",47.50513,-52.79476,2018-01-24 13:00:00,37,2,39
"9328",10401,"Mount Pearl","NL",47.50513,-52.79476,2018-01-24 14:00:00,37,3,40
"9329",10401,"Mount Pearl","NL",47.50513,-52.79476,2018-01-24 15:00:00,38,3,41
"9330",10401,"Mount Pearl","NL",47.50513,-52.79476,2018-01-24 16:00:00,39,2,41
"9331",10401,"Mount Pearl","NL",47.50513,-52.79476,2018-01-24 17:00:00,39,3,42
"9332",10401,"Mount Pearl","NL",47.50513,-52.79476,2018-01-24 18:00:00,39,2,41
"9333",10401,"Mount Pearl","NL",47.50513,-52.79476,2018-01-24 19:00:00,39,2,41
"9334",10401,"Mount Pearl","NL",47.50513,-52.79476,2018-01-24 20:00:00,39,2,41
"9335",10401,"Mount Pearl","NL",47.50513,-52.79476,2018-01-24 21:00:00,38,2,40
"9336",10401,"Mount Pearl","NL",47.50513,-52.79476,2018-01-24 22:00:00,38,3,41
"9337",10401,"Mount Pearl","NL",47.50513,-52.79476,2018-01-24 23:00:00,37,2,39
"9338",10401,"Mount Pearl","NL",47.50513,-52.79476,2018-01-25 00:00:00,36,2,38
"9339",10401,"Mount Pearl","NL",47.50513,-52.79476,2018-01-25 01:00:00,34,2,36
"9340",10401,"Mount Pearl","NL",47.50513,-52.79476,2018-01-25 02:00:00,33,2,35
"9341",10401,"Mount Pearl","NL",47.50513,-52.79476,2018-01-25 03:00:00,32,3,35
"9342",10401,"Mount Pearl","NL",47.50513,-52.79476,2018-01-25 04:00:00,30,2,32
"9343",10401,"Mount Pearl","NL",47.50513,-52.79476,2018-01-25 05:00:00,26,3,29
"9344",10401,"Mount Pearl","NL",47.50513,-52.79476,2018-01-25 06:00:00,24,3,27
"9345",10401,"Mount Pearl","NL",47.50513,-52.79476,2018-01-25 07:00:00,24,3,27
"9346",10401,"Mount Pearl","NL",47.50513,-52.79476,2018-01-25 08:00:00,29,3,32
"9347",10401,"Mount Pearl","NL",47.50513,-52.79476,2018-01-25 09:00:00,30,3,33
"9348",10401,"Mount Pearl","NL",47.50513,-52.79476,2018-01-25 10:00:00,17,3,20
"9349",10401,"Mount Pearl","NL",47.50513,-52.79476,2018-01-25 11:00:00,NA,NA,NA
"9350",10401,"Mount Pearl","NL",47.50513,-52.79476,2018-01-25 12:00:00,26,1,27
"9351",10401,"Mount Pearl","NL",47.50513,-52.79476,2018-01-25 13:00:00,25,NA,NA
"9352",10401,"Mount Pearl","NL",47.50513,-52.79476,2018-01-25 14:00:00,21,1,22
"9353",10401,"Mount Pearl","NL",47.50513,-52.79476,2018-01-25 15:00:00,23,1,24
"9354",10401,"Mount Pearl","NL",47.50513,-52.79476,2018-01-25 16:00:00,37,1,38
"9355",10401,"Mount Pearl","NL",47.50513,-52.79476,2018-01-25 17:00:00,37,2,39
"9356",10401,"Mount Pearl","NL",47.50513,-52.79476,2018-01-25 18:00:00,38,2,40
"9357",10401,"Mount Pearl","NL",47.50513,-52.79476,2018-01-25 19:00:00,38,3,41
"9358",10401,"Mount Pearl","NL",47.50513,-52.79476,2018-01-25 20:00:00,39,1,40
"9359",10401,"Mount Pearl","NL",47.50513,-52.79476,2018-01-25 21:00:00,40,1,41
"9360",10401,"Mount Pearl","NL",47.50513,-52.79476,2018-01-25 22:00:00,39,2,41
"9361",10401,"Mount Pearl","NL",47.50513,-52.79476,2018-01-25 23:00:00,39,3,42
"9362",10401,"Mount Pearl","NL",47.50513,-52.79476,2018-01-26 00:00:00,39,1,40
"9363",10401,"Mount Pearl","NL",47.50513,-52.79476,2018-01-26 01:00:00,39,1,40
"9364",10401,"Mount Pearl","NL",47.50513,-52.79476,2018-01-26 02:00:00,38,1,39
"9365",10401,"Mount Pearl","NL",47.50513,-52.79476,2018-01-26 03:00:00,37,1,38
"9366",10401,"Mount Pearl","NL",47.50513,-52.79476,2018-01-26 04:00:00,38,0,38
"9367",10401,"Mount Pearl","NL",47.50513,-52.79476,2018-01-26 05:00:00,36,1,37
"9368",10401,"Mount Pearl","NL",47.50513,-52.79476,2018-01-26 06:00:00,35,1,36
"9369",10401,"Mount Pearl","NL",47.50513,-52.79476,2018-01-26 07:00:00,31,4,35
"9370",10401,"Mount Pearl","NL",47.50513,-52.79476,2018-01-26 08:00:00,29,5,34
"9371",10401,"Mount Pearl","NL",47.50513,-52.79476,2018-01-26 09:00:00,28,5,33
"9372",10401,"Mount Pearl","NL",47.50513,-52.79476,2018-01-26 10:00:00,30,3,33
"9373",10401,"Mount Pearl","NL",47.50513,-52.79476,2018-01-26 11:00:00,32,1,33
"9374",10401,"Mount Pearl","NL",47.50513,-52.79476,2018-01-26 12:00:00,30,1,31
"9375",10401,"Mount Pearl","NL",47.50513,-52.79476,2018-01-26 13:00:00,30,1,31
"9376",10401,"Mount Pearl","NL",47.50513,-52.79476,2018-01-26 14:00:00,31,1,32
"9377",10401,"Mount Pearl","NL",47.50513,-52.79476,2018-01-26 15:00:00,31,1,32
"9378",10401,"Mount Pearl","NL",47.50513,-52.79476,2018-01-26 16:00:00,31,1,32
"9379",10401,"Mount Pearl","NL",47.50513,-52.79476,2018-01-26 17:00:00,31,1,32
"9380",10401,"Mount Pearl","NL",47.50513,-52.79476,2018-01-26 18:00:00,32,1,33
"9381",10401,"Mount Pearl","NL",47.50513,-52.79476,2018-01-26 19:00:00,32,1,33
"9382",10401,"Mount Pearl","NL",47.50513,-52.79476,2018-01-26 20:00:00,33,1,34
"9383",10401,"Mount Pearl","NL",47.50513,-52.79476,2018-01-26 21:00:00,33,1,34
"9384",10401,"Mount Pearl","NL",47.50513,-52.79476,2018-01-26 22:00:00,33,1,34
"9385",10401,"Mount Pearl","NL",47.50513,-52.79476,2018-01-26 23:00:00,33,1,34
"9386",10401,"Mount Pearl","NL",47.50513,-52.79476,2018-01-27 00:00:00,33,1,34
"9387",10401,"Mount Pearl","NL",47.50513,-52.79476,2018-01-27 01:00:00,33,1,34
"9388",10401,"Mount Pearl","NL",47.50513,-52.79476,2018-01-27 02:00:00,33,0,33
"9389",10401,"Mount Pearl","NL",47.50513,-52.79476,2018-01-27 03:00:00,34,1,35
"9390",10401,"Mount Pearl","NL",47.50513,-52.79476,2018-01-27 04:00:00,35,0,35
"9391",10401,"Mount Pearl","NL",47.50513,-52.79476,2018-01-27 05:00:00,35,0,35
"9392",10401,"Mount Pearl","NL",47.50513,-52.79476,2018-01-27 06:00:00,35,0,35
"9393",10401,"Mount Pearl","NL",47.50513,-52.79476,2018-01-27 07:00:00,35,0,35
"9394",10401,"Mount Pearl","NL",47.50513,-52.79476,2018-01-27 08:00:00,36,0,36
"9395",10401,"Mount Pearl","NL",47.50513,-52.79476,2018-01-27 09:00:00,35,1,36
"9396",10401,"Mount Pearl","NL",47.50513,-52.79476,2018-01-27 10:00:00,36,1,37
"9397",10401,"Mount Pearl","NL",47.50513,-52.79476,2018-01-27 11:00:00,36,1,37
"9398",10401,"Mount Pearl","NL",47.50513,-52.79476,2018-01-27 12:00:00,36,1,37
"9399",10401,"Mount Pearl","NL",47.50513,-52.79476,2018-01-27 13:00:00,36,0,36
"9400",10401,"Mount Pearl","NL",47.50513,-52.79476,2018-01-27 14:00:00,36,0,36
"9401",10401,"Mount Pearl","NL",47.50513,-52.79476,2018-01-27 15:00:00,36,1,37
"9402",10401,"Mount Pearl","NL",47.50513,-52.79476,2018-01-27 16:00:00,36,0,36
"9403",10401,"Mount Pearl","NL",47.50513,-52.79476,2018-01-27 17:00:00,35,1,36
"9404",10401,"Mount Pearl","NL",47.50513,-52.79476,2018-01-27 18:00:00,33,2,35
"9405",10401,"Mount Pearl","NL",47.50513,-52.79476,2018-01-27 19:00:00,32,2,34
"9406",10401,"Mount Pearl","NL",47.50513,-52.79476,2018-01-27 20:00:00,32,1,33
"9407",10401,"Mount Pearl","NL",47.50513,-52.79476,2018-01-27 21:00:00,32,1,33
"9408",10401,"Mount Pearl","NL",47.50513,-52.79476,2018-01-27 22:00:00,32,1,33
"9409",10401,"Mount Pearl","NL",47.50513,-52.79476,2018-01-27 23:00:00,33,1,34
"9410",10401,"Mount Pearl","NL",47.50513,-52.79476,2018-01-28 00:00:00,35,1,36
"9411",10401,"Mount Pearl","NL",47.50513,-52.79476,2018-01-28 01:00:00,37,0,37
"9412",10401,"Mount Pearl","NL",47.50513,-52.79476,2018-01-28 02:00:00,38,0,38
"9413",10401,"Mount Pearl","NL",47.50513,-52.79476,2018-01-28 03:00:00,39,0,39
"9414",10401,"Mount Pearl","NL",47.50513,-52.79476,2018-01-28 04:00:00,40,0,40
"9415",10401,"Mount Pearl","NL",47.50513,-52.79476,2018-01-28 05:00:00,39,0,39
"9416",10401,"Mount Pearl","NL",47.50513,-52.79476,2018-01-28 06:00:00,39,0,39
"9417",10401,"Mount Pearl","NL",47.50513,-52.79476,2018-01-28 07:00:00,39,0,39
"9418",10401,"Mount Pearl","NL",47.50513,-52.79476,2018-01-28 08:00:00,39,0,39
"9419",10401,"Mount Pearl","NL",47.50513,-52.79476,2018-01-28 09:00:00,38,0,38
"9420",10401,"Mount Pearl","NL",47.50513,-52.79476,2018-01-28 10:00:00,37,0,37
"9421",10401,"Mount Pearl","NL",47.50513,-52.79476,2018-01-28 11:00:00,38,0,38
"9422",10401,"Mount Pearl","NL",47.50513,-52.79476,2018-01-28 12:00:00,40,1,41
"9423",10401,"Mount Pearl","NL",47.50513,-52.79476,2018-01-28 13:00:00,41,0,41
"9424",10401,"Mount Pearl","NL",47.50513,-52.79476,2018-01-28 14:00:00,41,0,41
"9425",10401,"Mount Pearl","NL",47.50513,-52.79476,2018-01-28 15:00:00,41,0,41
"9426",10401,"Mount Pearl","NL",47.50513,-52.79476,2018-01-28 16:00:00,41,1,42
"9427",10401,"Mount Pearl","NL",47.50513,-52.79476,2018-01-28 17:00:00,41,1,42
"9428",10401,"Mount Pearl","NL",47.50513,-52.79476,2018-01-28 18:00:00,40,1,41
"9429",10401,"Mount Pearl","NL",47.50513,-52.79476,2018-01-28 19:00:00,40,0,40
"9430",10401,"Mount Pearl","NL",47.50513,-52.79476,2018-01-28 20:00:00,40,1,41
"9431",10401,"Mount Pearl","NL",47.50513,-52.79476,2018-01-28 21:00:00,39,1,40
"9432",10401,"Mount Pearl","NL",47.50513,-52.79476,2018-01-28 22:00:00,38,1,39
"9433",10401,"Mount Pearl","NL",47.50513,-52.79476,2018-01-28 23:00:00,38,0,38
"9434",10401,"Mount Pearl","NL",47.50513,-52.79476,2018-01-29 00:00:00,38,1,39
"9435",10401,"Mount Pearl","NL",47.50513,-52.79476,2018-01-29 01:00:00,37,1,38
"9436",10401,"Mount Pearl","NL",47.50513,-52.79476,2018-01-29 02:00:00,35,1,36
"9437",10401,"Mount Pearl","NL",47.50513,-52.79476,2018-01-29 03:00:00,33,1,34
"9438",10401,"Mount Pearl","NL",47.50513,-52.79476,2018-01-29 04:00:00,31,2,33
"9439",10401,"Mount Pearl","NL",47.50513,-52.79476,2018-01-29 05:00:00,32,1,33
"9440",10401,"Mount Pearl","NL",47.50513,-52.79476,2018-01-29 06:00:00,31,1,32
"9441",10401,"Mount Pearl","NL",47.50513,-52.79476,2018-01-29 07:00:00,31,1,32
"9442",10401,"Mount Pearl","NL",47.50513,-52.79476,2018-01-29 08:00:00,28,1,29
"9443",10401,"Mount Pearl","NL",47.50513,-52.79476,2018-01-29 09:00:00,29,2,31
"9444",10401,"Mount Pearl","NL",47.50513,-52.79476,2018-01-29 10:00:00,28,2,30
"9445",10401,"Mount Pearl","NL",47.50513,-52.79476,2018-01-29 11:00:00,25,2,27
"9446",10401,"Mount Pearl","NL",47.50513,-52.79476,2018-01-29 12:00:00,24,2,26
"9447",10401,"Mount Pearl","NL",47.50513,-52.79476,2018-01-29 13:00:00,27,1,28
"9448",10401,"Mount Pearl","NL",47.50513,-52.79476,2018-01-29 14:00:00,28,1,29
"9449",10401,"Mount Pearl","NL",47.50513,-52.79476,2018-01-29 15:00:00,28,1,29
"9450",10401,"Mount Pearl","NL",47.50513,-52.79476,2018-01-29 16:00:00,29,1,30
"9451",10401,"Mount Pearl","NL",47.50513,-52.79476,2018-01-29 17:00:00,31,1,32
"9452",10401,"Mount Pearl","NL",47.50513,-52.79476,2018-01-29 18:00:00,31,1,32
"9453",10401,"Mount Pearl","NL",47.50513,-52.79476,2018-01-29 19:00:00,32,1,33
"9454",10401,"Mount Pearl","NL",47.50513,-52.79476,2018-01-29 20:00:00,34,1,35
"9455",10401,"Mount Pearl","NL",47.50513,-52.79476,2018-01-29 21:00:00,34,1,35
"9456",10401,"Mount Pearl","NL",47.50513,-52.79476,2018-01-29 22:00:00,35,1,36
"9457",10401,"Mount Pearl","NL",47.50513,-52.79476,2018-01-29 23:00:00,35,1,36
"9458",10401,"Mount Pearl","NL",47.50513,-52.79476,2018-01-30 00:00:00,36,1,37
"9459",10401,"Mount Pearl","NL",47.50513,-52.79476,2018-01-30 01:00:00,38,1,39
"9460",10401,"Mount Pearl","NL",47.50513,-52.79476,2018-01-30 02:00:00,37,1,38
"9461",10401,"Mount Pearl","NL",47.50513,-52.79476,2018-01-30 03:00:00,37,1,38
"9462",10401,"Mount Pearl","NL",47.50513,-52.79476,2018-01-30 04:00:00,36,1,37
"9463",10401,"Mount Pearl","NL",47.50513,-52.79476,2018-01-30 05:00:00,36,1,37
"9464",10401,"Mount Pearl","NL",47.50513,-52.79476,2018-01-30 06:00:00,37,1,38
"9465",10401,"Mount Pearl","NL",47.50513,-52.79476,2018-01-30 07:00:00,36,1,37
"9466",10401,"Mount Pearl","NL",47.50513,-52.79476,2018-01-30 08:00:00,35,1,36
"9467",10401,"Mount Pearl","NL",47.50513,-52.79476,2018-01-30 09:00:00,36,1,37
"9468",10401,"Mount Pearl","NL",47.50513,-52.79476,2018-01-30 10:00:00,36,1,37
"9469",10401,"Mount Pearl","NL",47.50513,-52.79476,2018-01-30 11:00:00,37,1,38
"9470",10401,"Mount Pearl","NL",47.50513,-52.79476,2018-01-30 12:00:00,37,0,37
"9471",10401,"Mount Pearl","NL",47.50513,-52.79476,2018-01-30 13:00:00,36,1,37
"9472",10401,"Mount Pearl","NL",47.50513,-52.79476,2018-01-30 14:00:00,36,0,36
"9473",10401,"Mount Pearl","NL",47.50513,-52.79476,2018-01-30 15:00:00,35,1,36
"9474",10401,"Mount Pearl","NL",47.50513,-52.79476,2018-01-30 16:00:00,36,1,37
"9475",10401,"Mount Pearl","NL",47.50513,-52.79476,2018-01-30 17:00:00,33,2,35
"9476",10401,"Mount Pearl","NL",47.50513,-52.79476,2018-01-30 18:00:00,24,5,29
"9477",10401,"Mount Pearl","NL",47.50513,-52.79476,2018-01-30 19:00:00,35,1,36
"9478",10401,"Mount Pearl","NL",47.50513,-52.79476,2018-01-30 20:00:00,38,0,38
"9479",10401,"Mount Pearl","NL",47.50513,-52.79476,2018-01-30 21:00:00,41,0,41
"9480",10401,"Mount Pearl","NL",47.50513,-52.79476,2018-01-30 22:00:00,42,1,43
"9481",10401,"Mount Pearl","NL",47.50513,-52.79476,2018-01-30 23:00:00,41,0,41
"9482",10401,"Mount Pearl","NL",47.50513,-52.79476,2018-01-31 00:00:00,39,0,39
"9483",10401,"Mount Pearl","NL",47.50513,-52.79476,2018-01-31 01:00:00,39,0,39
"9484",10401,"Mount Pearl","NL",47.50513,-52.79476,2018-01-31 02:00:00,38,0,38
"9485",10401,"Mount Pearl","NL",47.50513,-52.79476,2018-01-31 03:00:00,37,0,37
"9486",10401,"Mount Pearl","NL",47.50513,-52.79476,2018-01-31 04:00:00,37,0,37
"9487",10401,"Mount Pearl","NL",47.50513,-52.79476,2018-01-31 05:00:00,37,0,37
"9488",10401,"Mount Pearl","NL",47.50513,-52.79476,2018-01-31 06:00:00,36,1,37
"9489",10401,"Mount Pearl","NL",47.50513,-52.79476,2018-01-31 07:00:00,36,0,36
"9490",10401,"Mount Pearl","NL",47.50513,-52.79476,2018-01-31 08:00:00,36,1,37
"9491",10401,"Mount Pearl","NL",47.50513,-52.79476,2018-01-31 09:00:00,37,0,37
"9492",10401,"Mount Pearl","NL",47.50513,-52.79476,2018-01-31 10:00:00,40,0,40
"9493",10401,"Mount Pearl","NL",47.50513,-52.79476,2018-01-31 11:00:00,42,0,42
"9494",10401,"Mount Pearl","NL",47.50513,-52.79476,2018-01-31 12:00:00,30,1,31
"9495",10401,"Mount Pearl","NL",47.50513,-52.79476,2018-01-31 13:00:00,22,2,24
"9496",10401,"Mount Pearl","NL",47.50513,-52.79476,2018-01-31 14:00:00,32,2,34
"9497",10401,"Mount Pearl","NL",47.50513,-52.79476,2018-01-31 15:00:00,33,1,34
"9498",10401,"Mount Pearl","NL",47.50513,-52.79476,2018-01-31 16:00:00,33,2,35
"9499",10401,"Mount Pearl","NL",47.50513,-52.79476,2018-01-31 17:00:00,34,1,35
"9500",10401,"Mount Pearl","NL",47.50513,-52.79476,2018-01-31 18:00:00,34,2,36
"9501",10401,"Mount Pearl","NL",47.50513,-52.79476,2018-01-31 19:00:00,35,1,36
"9502",10401,"Mount Pearl","NL",47.50513,-52.79476,2018-01-31 20:00:00,35,1,36
"9503",10401,"Mount Pearl","NL",47.50513,-52.79476,2018-01-31 21:00:00,35,1,36
"9504",10401,"Mount Pearl","NL",47.50513,-52.79476,2018-01-31 22:00:00,35,2,37
"9505",10401,"Mount Pearl","NL",47.50513,-52.79476,2018-01-31 23:00:00,35,2,37
"9506",10401,"Mount Pearl","NL",47.50513,-52.79476,2018-02-01 00:00:00,36,1,37
"9507",10401,"Mount Pearl","NL",47.50513,-52.79476,2018-02-01 01:00:00,37,1,38
"9508",10401,"Mount Pearl","NL",47.50513,-52.79476,2018-02-01 02:00:00,37,1,38
"9509",10401,"Mount Pearl","NL",47.50513,-52.79476,2018-02-01 03:00:00,35,1,36
"9510",10401,"Mount Pearl","NL",47.50513,-52.79476,2018-02-01 04:00:00,34,1,35
"9511",10401,"Mount Pearl","NL",47.50513,-52.79476,2018-02-01 05:00:00,36,1,37
"9512",10401,"Mount Pearl","NL",47.50513,-52.79476,2018-02-01 06:00:00,35,1,36
"9513",10401,"Mount Pearl","NL",47.50513,-52.79476,2018-02-01 07:00:00,33,2,35
"9514",10401,"Mount Pearl","NL",47.50513,-52.79476,2018-02-01 08:00:00,32,2,34
"9515",10401,"Mount Pearl","NL",47.50513,-52.79476,2018-02-01 09:00:00,33,1,34
"9516",10401,"Mount Pearl","NL",47.50513,-52.79476,2018-02-01 10:00:00,34,1,35
"9517",10401,"Mount Pearl","NL",47.50513,-52.79476,2018-02-01 11:00:00,34,1,35
"9518",10401,"Mount Pearl","NL",47.50513,-52.79476,2018-02-01 12:00:00,34,0,34
"9519",10401,"Mount Pearl","NL",47.50513,-52.79476,2018-02-01 13:00:00,34,0,34
"9520",10401,"Mount Pearl","NL",47.50513,-52.79476,2018-02-01 14:00:00,34,0,34
"9521",10401,"Mount Pearl","NL",47.50513,-52.79476,2018-02-01 15:00:00,35,0,35
"9522",10401,"Mount Pearl","NL",47.50513,-52.79476,2018-02-01 16:00:00,36,0,36
"9523",10401,"Mount Pearl","NL",47.50513,-52.79476,2018-02-01 17:00:00,38,0,38
"9524",10401,"Mount Pearl","NL",47.50513,-52.79476,2018-02-01 18:00:00,38,0,38
"9525",10401,"Mount Pearl","NL",47.50513,-52.79476,2018-02-01 19:00:00,39,0,39
"9526",10401,"Mount Pearl","NL",47.50513,-52.79476,2018-02-01 20:00:00,37,0,37
"9527",10401,"Mount Pearl","NL",47.50513,-52.79476,2018-02-01 21:00:00,36,0,36
"9528",10401,"Mount Pearl","NL",47.50513,-52.79476,2018-02-01 22:00:00,36,0,36
"9529",10401,"Mount Pearl","NL",47.50513,-52.79476,2018-02-01 23:00:00,37,0,37
"9530",10401,"Mount Pearl","NL",47.50513,-52.79476,2018-02-02 00:00:00,38,0,38
"9531",10401,"Mount Pearl","NL",47.50513,-52.79476,2018-02-02 01:00:00,38,0,38
"9532",10401,"Mount Pearl","NL",47.50513,-52.79476,2018-02-02 02:00:00,37,0,37
"9533",10401,"Mount Pearl","NL",47.50513,-52.79476,2018-02-02 03:00:00,38,0,38
"9534",10401,"Mount Pearl","NL",47.50513,-52.79476,2018-02-02 04:00:00,38,0,38
"9535",10401,"Mount Pearl","NL",47.50513,-52.79476,2018-02-02 05:00:00,40,0,40
"9536",10401,"Mount Pearl","NL",47.50513,-52.79476,2018-02-02 06:00:00,40,0,40
"9537",10401,"Mount Pearl","NL",47.50513,-52.79476,2018-02-02 07:00:00,40,0,40
"9538",10401,"Mount Pearl","NL",47.50513,-52.79476,2018-02-02 08:00:00,39,0,39
"9539",10401,"Mount Pearl","NL",47.50513,-52.79476,2018-02-02 09:00:00,37,0,37
"9540",10401,"Mount Pearl","NL",47.50513,-52.79476,2018-02-02 10:00:00,37,0,37
"9541",10401,"Mount Pearl","NL",47.50513,-52.79476,2018-02-02 11:00:00,37,0,37
"9542",10401,"Mount Pearl","NL",47.50513,-52.79476,2018-02-02 12:00:00,38,0,38
"9543",10401,"Mount Pearl","NL",47.50513,-52.79476,2018-02-02 13:00:00,38,0,38
"9544",10401,"Mount Pearl","NL",47.50513,-52.79476,2018-02-02 14:00:00,38,0,38
"9545",10401,"Mount Pearl","NL",47.50513,-52.79476,2018-02-02 15:00:00,39,0,39
"9546",10401,"Mount Pearl","NL",47.50513,-52.79476,2018-02-02 16:00:00,38,0,38
"9547",10401,"Mount Pearl","NL",47.50513,-52.79476,2018-02-02 17:00:00,38,0,38
"9548",10401,"Mount Pearl","NL",47.50513,-52.79476,2018-02-02 18:00:00,38,0,38
"9549",10401,"Mount Pearl","NL",47.50513,-52.79476,2018-02-02 19:00:00,38,0,38
"9550",10401,"Mount Pearl","NL",47.50513,-52.79476,2018-02-02 20:00:00,39,0,39
"9551",10401,"Mount Pearl","NL",47.50513,-52.79476,2018-02-02 21:00:00,40,1,41
"9552",10401,"Mount Pearl","NL",47.50513,-52.79476,2018-02-02 22:00:00,41,1,42
"9553",10401,"Mount Pearl","NL",47.50513,-52.79476,2018-02-02 23:00:00,41,1,42
"9554",10401,"Mount Pearl","NL",47.50513,-52.79476,2018-02-03 00:00:00,40,1,41
"9555",10401,"Mount Pearl","NL",47.50513,-52.79476,2018-02-03 01:00:00,40,1,41
"9556",10401,"Mount Pearl","NL",47.50513,-52.79476,2018-02-03 02:00:00,40,1,41
"9557",10401,"Mount Pearl","NL",47.50513,-52.79476,2018-02-03 03:00:00,41,0,41
"9558",10401,"Mount Pearl","NL",47.50513,-52.79476,2018-02-03 04:00:00,42,0,42
"9559",10401,"Mount Pearl","NL",47.50513,-52.79476,2018-02-03 05:00:00,45,0,45
"9560",10401,"Mount Pearl","NL",47.50513,-52.79476,2018-02-03 06:00:00,41,1,42
"9561",10401,"Mount Pearl","NL",47.50513,-52.79476,2018-02-03 07:00:00,35,1,36
"9562",10401,"Mount Pearl","NL",47.50513,-52.79476,2018-02-03 08:00:00,34,1,35
"9563",10401,"Mount Pearl","NL",47.50513,-52.79476,2018-02-03 09:00:00,32,0,32
"9564",10401,"Mount Pearl","NL",47.50513,-52.79476,2018-02-03 10:00:00,32,1,33
"9565",10401,"Mount Pearl","NL",47.50513,-52.79476,2018-02-03 11:00:00,29,1,30
"9566",10401,"Mount Pearl","NL",47.50513,-52.79476,2018-02-03 12:00:00,28,2,30
"9567",10401,"Mount Pearl","NL",47.50513,-52.79476,2018-02-03 13:00:00,29,1,30
"9568",10401,"Mount Pearl","NL",47.50513,-52.79476,2018-02-03 14:00:00,30,1,31
"9569",10401,"Mount Pearl","NL",47.50513,-52.79476,2018-02-03 15:00:00,31,1,32
"9570",10401,"Mount Pearl","NL",47.50513,-52.79476,2018-02-03 16:00:00,32,1,33
"9571",10401,"Mount Pearl","NL",47.50513,-52.79476,2018-02-03 17:00:00,32,1,33
"9572",10401,"Mount Pearl","NL",47.50513,-52.79476,2018-02-03 18:00:00,34,1,35
"9573",10401,"Mount Pearl","NL",47.50513,-52.79476,2018-02-03 19:00:00,34,1,35
"9574",10401,"Mount Pearl","NL",47.50513,-52.79476,2018-02-03 20:00:00,35,1,36
"9575",10401,"Mount Pearl","NL",47.50513,-52.79476,2018-02-03 21:00:00,38,0,38
"9576",10401,"Mount Pearl","NL",47.50513,-52.79476,2018-02-03 22:00:00,38,1,39
"9577",10401,"Mount Pearl","NL",47.50513,-52.79476,2018-02-03 23:00:00,38,0,38
"9578",10401,"Mount Pearl","NL",47.50513,-52.79476,2018-02-04 00:00:00,36,1,37
"9579",10401,"Mount Pearl","NL",47.50513,-52.79476,2018-02-04 01:00:00,37,0,37
"9580",10401,"Mount Pearl","NL",47.50513,-52.79476,2018-02-04 02:00:00,37,0,37
"9581",10401,"Mount Pearl","NL",47.50513,-52.79476,2018-02-04 03:00:00,37,1,38
"9582",10401,"Mount Pearl","NL",47.50513,-52.79476,2018-02-04 04:00:00,38,0,38
"9583",10401,"Mount Pearl","NL",47.50513,-52.79476,2018-02-04 05:00:00,38,0,38
"9584",10401,"Mount Pearl","NL",47.50513,-52.79476,2018-02-04 06:00:00,37,0,37
"9585",10401,"Mount Pearl","NL",47.50513,-52.79476,2018-02-04 07:00:00,37,1,38
"9586",10401,"Mount Pearl","NL",47.50513,-52.79476,2018-02-04 08:00:00,36,0,36
"9587",10401,"Mount Pearl","NL",47.50513,-52.79476,2018-02-04 09:00:00,34,0,34
"9588",10401,"Mount Pearl","NL",47.50513,-52.79476,2018-02-04 10:00:00,33,0,33
"9589",10401,"Mount Pearl","NL",47.50513,-52.79476,2018-02-04 11:00:00,32,1,33
"9590",10401,"Mount Pearl","NL",47.50513,-52.79476,2018-02-04 12:00:00,33,1,34
"9591",10401,"Mount Pearl","NL",47.50513,-52.79476,2018-02-04 13:00:00,35,1,36
"9592",10401,"Mount Pearl","NL",47.50513,-52.79476,2018-02-04 14:00:00,37,1,38
"9593",10401,"Mount Pearl","NL",47.50513,-52.79476,2018-02-04 15:00:00,38,1,39
"9594",10401,"Mount Pearl","NL",47.50513,-52.79476,2018-02-04 16:00:00,39,1,40
"9595",10401,"Mount Pearl","NL",47.50513,-52.79476,2018-02-04 17:00:00,39,1,40
"9596",10401,"Mount Pearl","NL",47.50513,-52.79476,2018-02-04 18:00:00,37,1,38
"9597",10401,"Mount Pearl","NL",47.50513,-52.79476,2018-02-04 19:00:00,36,2,38
"9598",10401,"Mount Pearl","NL",47.50513,-52.79476,2018-02-04 20:00:00,38,1,39
"9599",10401,"Mount Pearl","NL",47.50513,-52.79476,2018-02-04 21:00:00,38,1,39
"9600",10401,"Mount Pearl","NL",47.50513,-52.79476,2018-02-04 22:00:00,39,1,40
"9601",10401,"Mount Pearl","NL",47.50513,-52.79476,2018-02-04 23:00:00,39,1,40
"9602",10401,"Mount Pearl","NL",47.50513,-52.79476,2018-02-05 00:00:00,38,1,39
"9603",10401,"Mount Pearl","NL",47.50513,-52.79476,2018-02-05 01:00:00,39,1,40
"9604",10401,"Mount Pearl","NL",47.50513,-52.79476,2018-02-05 02:00:00,39,1,40
"9605",10401,"Mount Pearl","NL",47.50513,-52.79476,2018-02-05 03:00:00,39,1,40
"9606",10401,"Mount Pearl","NL",47.50513,-52.79476,2018-02-05 04:00:00,39,1,40
"9607",10401,"Mount Pearl","NL",47.50513,-52.79476,2018-02-05 05:00:00,39,1,40
"9608",10401,"Mount Pearl","NL",47.50513,-52.79476,2018-02-05 06:00:00,40,1,41
"9609",10401,"Mount Pearl","NL",47.50513,-52.79476,2018-02-05 07:00:00,36,4,40
"9610",10401,"Mount Pearl","NL",47.50513,-52.79476,2018-02-05 08:00:00,40,1,41
"9611",10401,"Mount Pearl","NL",47.50513,-52.79476,2018-02-05 09:00:00,40,1,41
"9612",10401,"Mount Pearl","NL",47.50513,-52.79476,2018-02-05 10:00:00,40,1,41
"9613",10401,"Mount Pearl","NL",47.50513,-52.79476,2018-02-05 11:00:00,40,1,41
"9614",10401,"Mount Pearl","NL",47.50513,-52.79476,2018-02-05 12:00:00,39,0,39
"9615",10401,"Mount Pearl","NL",47.50513,-52.79476,2018-02-05 13:00:00,40,0,40
"9616",10401,"Mount Pearl","NL",47.50513,-52.79476,2018-02-05 14:00:00,39,0,39
"9617",10401,"Mount Pearl","NL",47.50513,-52.79476,2018-02-05 15:00:00,39,0,39
"9618",10401,"Mount Pearl","NL",47.50513,-52.79476,2018-02-05 16:00:00,39,0,39
"9619",10401,"Mount Pearl","NL",47.50513,-52.79476,2018-02-05 17:00:00,39,0,39
"9620",10401,"Mount Pearl","NL",47.50513,-52.79476,2018-02-05 18:00:00,40,0,40
"9621",10401,"Mount Pearl","NL",47.50513,-52.79476,2018-02-05 19:00:00,41,0,41
"9622",10401,"Mount Pearl","NL",47.50513,-52.79476,2018-02-05 20:00:00,42,0,42
"9623",10401,"Mount Pearl","NL",47.50513,-52.79476,2018-02-05 21:00:00,42,0,42
"9624",10401,"Mount Pearl","NL",47.50513,-52.79476,2018-02-05 22:00:00,42,1,43
"9625",10401,"Mount Pearl","NL",47.50513,-52.79476,2018-02-05 23:00:00,40,0,40
"9626",10401,"Mount Pearl","NL",47.50513,-52.79476,2018-02-06 00:00:00,38,0,38
"9627",10401,"Mount Pearl","NL",47.50513,-52.79476,2018-02-06 01:00:00,37,0,37
"9628",10401,"Mount Pearl","NL",47.50513,-52.79476,2018-02-06 02:00:00,38,1,39
"9629",10401,"Mount Pearl","NL",47.50513,-52.79476,2018-02-06 03:00:00,38,1,39
"9630",10401,"Mount Pearl","NL",47.50513,-52.79476,2018-02-06 04:00:00,37,1,38
"9631",10401,"Mount Pearl","NL",47.50513,-52.79476,2018-02-06 05:00:00,36,1,37
"9632",10401,"Mount Pearl","NL",47.50513,-52.79476,2018-02-06 06:00:00,34,0,34
"9633",10401,"Mount Pearl","NL",47.50513,-52.79476,2018-02-06 07:00:00,30,1,31
"9634",10401,"Mount Pearl","NL",47.50513,-52.79476,2018-02-06 08:00:00,27,2,29
"9635",10401,"Mount Pearl","NL",47.50513,-52.79476,2018-02-06 09:00:00,29,1,30
"9636",10401,"Mount Pearl","NL",47.50513,-52.79476,2018-02-06 10:00:00,29,0,29
"9637",10401,"Mount Pearl","NL",47.50513,-52.79476,2018-02-06 11:00:00,32,0,32
"9638",10401,"Mount Pearl","NL",47.50513,-52.79476,2018-02-06 12:00:00,32,0,32
"9639",10401,"Mount Pearl","NL",47.50513,-52.79476,2018-02-06 13:00:00,34,0,34
"9640",10401,"Mount Pearl","NL",47.50513,-52.79476,2018-02-06 14:00:00,35,1,36
"9641",10401,"Mount Pearl","NL",47.50513,-52.79476,2018-02-06 15:00:00,34,1,35
"9642",10401,"Mount Pearl","NL",47.50513,-52.79476,2018-02-06 16:00:00,34,1,35
"9643",10401,"Mount Pearl","NL",47.50513,-52.79476,2018-02-06 17:00:00,35,1,36
"9644",10401,"Mount Pearl","NL",47.50513,-52.79476,2018-02-06 18:00:00,36,1,37
"9645",10401,"Mount Pearl","NL",47.50513,-52.79476,2018-02-06 19:00:00,35,1,36
"9646",10401,"Mount Pearl","NL",47.50513,-52.79476,2018-02-06 20:00:00,35,1,36
"9647",10401,"Mount Pearl","NL",47.50513,-52.79476,2018-02-06 21:00:00,33,1,34
"9648",10401,"Mount Pearl","NL",47.50513,-52.79476,2018-02-06 22:00:00,36,1,37
"9649",10401,"Mount Pearl","NL",47.50513,-52.79476,2018-02-06 23:00:00,36,0,36
"9650",10401,"Mount Pearl","NL",47.50513,-52.79476,2018-02-07 00:00:00,37,0,37
"9651",10401,"Mount Pearl","NL",47.50513,-52.79476,2018-02-07 01:00:00,37,0,37
"9652",10401,"Mount Pearl","NL",47.50513,-52.79476,2018-02-07 02:00:00,37,0,37
"9653",10401,"Mount Pearl","NL",47.50513,-52.79476,2018-02-07 03:00:00,37,0,37
"9654",10401,"Mount Pearl","NL",47.50513,-52.79476,2018-02-07 04:00:00,37,0,37
"9655",10401,"Mount Pearl","NL",47.50513,-52.79476,2018-02-07 05:00:00,37,0,37
"9656",10401,"Mount Pearl","NL",47.50513,-52.79476,2018-02-07 06:00:00,36,1,37
"9657",10401,"Mount Pearl","NL",47.50513,-52.79476,2018-02-07 07:00:00,34,1,35
"9658",10401,"Mount Pearl","NL",47.50513,-52.79476,2018-02-07 08:00:00,32,2,34
"9659",10401,"Mount Pearl","NL",47.50513,-52.79476,2018-02-07 09:00:00,27,3,30
"9660",10401,"Mount Pearl","NL",47.50513,-52.79476,2018-02-07 10:00:00,30,3,33
"9661",10401,"Mount Pearl","NL",47.50513,-52.79476,2018-02-07 11:00:00,33,1,34
"9662",10401,"Mount Pearl","NL",47.50513,-52.79476,2018-02-07 12:00:00,35,1,36
"9663",10401,"Mount Pearl","NL",47.50513,-52.79476,2018-02-07 13:00:00,37,1,38
"9664",10401,"Mount Pearl","NL",47.50513,-52.79476,2018-02-07 14:00:00,35,1,36
"9665",10401,"Mount Pearl","NL",47.50513,-52.79476,2018-02-07 15:00:00,35,1,36
"9666",10401,"Mount Pearl","NL",47.50513,-52.79476,2018-02-07 16:00:00,34,2,36
"9667",10401,"Mount Pearl","NL",47.50513,-52.79476,2018-02-07 17:00:00,33,2,35
"9668",10401,"Mount Pearl","NL",47.50513,-52.79476,2018-02-07 18:00:00,34,1,35
"9669",10401,"Mount Pearl","NL",47.50513,-52.79476,2018-02-07 19:00:00,34,1,35
"9670",10401,"Mount Pearl","NL",47.50513,-52.79476,2018-02-07 20:00:00,36,1,37
"9671",10401,"Mount Pearl","NL",47.50513,-52.79476,2018-02-07 21:00:00,37,1,38
"9672",10401,"Mount Pearl","NL",47.50513,-52.79476,2018-02-07 22:00:00,37,1,38
"9673",10401,"Mount Pearl","NL",47.50513,-52.79476,2018-02-07 23:00:00,38,1,39
"9674",10401,"Mount Pearl","NL",47.50513,-52.79476,2018-02-08 00:00:00,38,1,39
"9675",10401,"Mount Pearl","NL",47.50513,-52.79476,2018-02-08 01:00:00,39,1,40
"9676",10401,"Mount Pearl","NL",47.50513,-52.79476,2018-02-08 02:00:00,39,1,40
"9677",10401,"Mount Pearl","NL",47.50513,-52.79476,2018-02-08 03:00:00,38,1,39
"9678",10401,"Mount Pearl","NL",47.50513,-52.79476,2018-02-08 04:00:00,37,1,38
"9679",10401,"Mount Pearl","NL",47.50513,-52.79476,2018-02-08 05:00:00,37,1,38
"9680",10401,"Mount Pearl","NL",47.50513,-52.79476,2018-02-08 06:00:00,37,1,38
"9681",10401,"Mount Pearl","NL",47.50513,-52.79476,2018-02-08 07:00:00,37,1,38
"9682",10401,"Mount Pearl","NL",47.50513,-52.79476,2018-02-08 08:00:00,39,1,40
"9683",10401,"Mount Pearl","NL",47.50513,-52.79476,2018-02-08 09:00:00,40,1,41
"9684",10401,"Mount Pearl","NL",47.50513,-52.79476,2018-02-08 10:00:00,40,1,41
"9685",10401,"Mount Pearl","NL",47.50513,-52.79476,2018-02-08 11:00:00,40,1,41
"9686",10401,"Mount Pearl","NL",47.50513,-52.79476,2018-02-08 12:00:00,39,0,39
"9687",10401,"Mount Pearl","NL",47.50513,-52.79476,2018-02-08 13:00:00,40,0,40
"9688",10401,"Mount Pearl","NL",47.50513,-52.79476,2018-02-08 14:00:00,40,0,40
"9689",10401,"Mount Pearl","NL",47.50513,-52.79476,2018-02-08 15:00:00,40,0,40
"9690",10401,"Mount Pearl","NL",47.50513,-52.79476,2018-02-08 16:00:00,41,1,42
"9691",10401,"Mount Pearl","NL",47.50513,-52.79476,2018-02-08 17:00:00,41,1,42
"9692",10401,"Mount Pearl","NL",47.50513,-52.79476,2018-02-08 18:00:00,41,0,41
"9693",10401,"Mount Pearl","NL",47.50513,-52.79476,2018-02-08 19:00:00,40,1,41
"9694",10401,"Mount Pearl","NL",47.50513,-52.79476,2018-02-08 20:00:00,37,1,38
"9695",10401,"Mount Pearl","NL",47.50513,-52.79476,2018-02-08 21:00:00,NA,NA,NA
"9696",10401,"Mount Pearl","NL",47.50513,-52.79476,2018-02-08 22:00:00,35,0,35
"9697",10401,"Mount Pearl","NL",47.50513,-52.79476,2018-02-08 23:00:00,36,0,36
"9698",10401,"Mount Pearl","NL",47.50513,-52.79476,2018-02-09 00:00:00,37,0,37
"9699",10401,"Mount Pearl","NL",47.50513,-52.79476,2018-02-09 01:00:00,38,0,38
"9700",10401,"Mount Pearl","NL",47.50513,-52.79476,2018-02-09 02:00:00,38,0,38
"9701",10401,"Mount Pearl","NL",47.50513,-52.79476,2018-02-09 03:00:00,NA,NA,NA
"9702",10401,"Mount Pearl","NL",47.50513,-52.79476,2018-02-09 04:00:00,NA,NA,NA
"9703",10401,"Mount Pearl","NL",47.50513,-52.79476,2018-02-09 05:00:00,NA,NA,NA
"9704",10401,"Mount Pearl","NL",47.50513,-52.79476,2018-02-09 06:00:00,NA,NA,NA
"9705",10401,"Mount Pearl","NL",47.50513,-52.79476,2018-02-09 07:00:00,NA,NA,NA
"9706",10401,"Mount Pearl","NL",47.50513,-52.79476,2018-02-09 08:00:00,NA,NA,NA
"9707",10401,"Mount Pearl","NL",47.50513,-52.79476,2018-02-09 09:00:00,NA,NA,NA
"9708",10401,"Mount Pearl","NL",47.50513,-52.79476,2018-02-09 10:00:00,NA,NA,NA
"9709",10401,"Mount Pearl","NL",47.50513,-52.79476,2018-02-09 11:00:00,NA,NA,NA
"9710",10401,"Mount Pearl","NL",47.50513,-52.79476,2018-02-09 12:00:00,NA,NA,NA
"9711",10401,"Mount Pearl","NL",47.50513,-52.79476,2018-02-09 13:00:00,NA,NA,NA
"9712",10401,"Mount Pearl","NL",47.50513,-52.79476,2018-02-09 14:00:00,36,1,37
"9713",10401,"Mount Pearl","NL",47.50513,-52.79476,2018-02-09 15:00:00,36,1,37
"9714",10401,"Mount Pearl","NL",47.50513,-52.79476,2018-02-09 16:00:00,37,0,37
"9715",10401,"Mount Pearl","NL",47.50513,-52.79476,2018-02-09 17:00:00,37,1,38
"9716",10401,"Mount Pearl","NL",47.50513,-52.79476,2018-02-09 18:00:00,36,1,37
"9717",10401,"Mount Pearl","NL",47.50513,-52.79476,2018-02-09 19:00:00,35,1,36
"9718",10401,"Mount Pearl","NL",47.50513,-52.79476,2018-02-09 20:00:00,34,1,35
"9719",10401,"Mount Pearl","NL",47.50513,-52.79476,2018-02-09 21:00:00,33,1,34
"9720",10401,"Mount Pearl","NL",47.50513,-52.79476,2018-02-09 22:00:00,35,0,35
"9721",10401,"Mount Pearl","NL",47.50513,-52.79476,2018-02-09 23:00:00,35,1,36
"9722",10401,"Mount Pearl","NL",47.50513,-52.79476,2018-02-10 00:00:00,35,0,35
"9723",10401,"Mount Pearl","NL",47.50513,-52.79476,2018-02-10 01:00:00,35,1,36
"9724",10401,"Mount Pearl","NL",47.50513,-52.79476,2018-02-10 02:00:00,30,1,31
"9725",10401,"Mount Pearl","NL",47.50513,-52.79476,2018-02-10 03:00:00,29,1,30
"9726",10401,"Mount Pearl","NL",47.50513,-52.79476,2018-02-10 04:00:00,28,1,29
"9727",10401,"Mount Pearl","NL",47.50513,-52.79476,2018-02-10 05:00:00,25,1,26
"9728",10401,"Mount Pearl","NL",47.50513,-52.79476,2018-02-10 06:00:00,22,1,23
"9729",10401,"Mount Pearl","NL",47.50513,-52.79476,2018-02-10 07:00:00,22,1,23
"9730",10401,"Mount Pearl","NL",47.50513,-52.79476,2018-02-10 08:00:00,23,1,24
"9731",10401,"Mount Pearl","NL",47.50513,-52.79476,2018-02-10 09:00:00,27,1,28
"9732",10401,"Mount Pearl","NL",47.50513,-52.79476,2018-02-10 10:00:00,30,1,31
"9733",10401,"Mount Pearl","NL",47.50513,-52.79476,2018-02-10 11:00:00,36,0,36
"9734",10401,"Mount Pearl","NL",47.50513,-52.79476,2018-02-10 12:00:00,37,0,37
"9735",10401,"Mount Pearl","NL",47.50513,-52.79476,2018-02-10 13:00:00,37,0,37
"9736",10401,"Mount Pearl","NL",47.50513,-52.79476,2018-02-10 14:00:00,37,0,37
"9737",10401,"Mount Pearl","NL",47.50513,-52.79476,2018-02-10 15:00:00,38,0,38
"9738",10401,"Mount Pearl","NL",47.50513,-52.79476,2018-02-10 16:00:00,39,0,39
"9739",10401,"Mount Pearl","NL",47.50513,-52.79476,2018-02-10 17:00:00,39,0,39
"9740",10401,"Mount Pearl","NL",47.50513,-52.79476,2018-02-10 18:00:00,38,0,38
"9741",10401,"Mount Pearl","NL",47.50513,-52.79476,2018-02-10 19:00:00,37,1,38
"9742",10401,"Mount Pearl","NL",47.50513,-52.79476,2018-02-10 20:00:00,38,1,39
"9743",10401,"Mount Pearl","NL",47.50513,-52.79476,2018-02-10 21:00:00,37,0,37
"9744",10401,"Mount Pearl","NL",47.50513,-52.79476,2018-02-10 22:00:00,39,0,39
"9745",10401,"Mount Pearl","NL",47.50513,-52.79476,2018-02-10 23:00:00,37,0,37
"9746",10401,"Mount Pearl","NL",47.50513,-52.79476,2018-02-11 00:00:00,36,0,36
"9747",10401,"Mount Pearl","NL",47.50513,-52.79476,2018-02-11 01:00:00,37,0,37
"9748",10401,"Mount Pearl","NL",47.50513,-52.79476,2018-02-11 02:00:00,38,1,39
"9749",10401,"Mount Pearl","NL",47.50513,-52.79476,2018-02-11 03:00:00,38,0,38
"9750",10401,"Mount Pearl","NL",47.50513,-52.79476,2018-02-11 04:00:00,39,0,39
"9751",10401,"Mount Pearl","NL",47.50513,-52.79476,2018-02-11 05:00:00,40,0,40
"9752",10401,"Mount Pearl","NL",47.50513,-52.79476,2018-02-11 06:00:00,40,0,40
"9753",10401,"Mount Pearl","NL",47.50513,-52.79476,2018-02-11 07:00:00,41,0,41
"9754",10401,"Mount Pearl","NL",47.50513,-52.79476,2018-02-11 08:00:00,41,0,41
"9755",10401,"Mount Pearl","NL",47.50513,-52.79476,2018-02-11 09:00:00,40,0,40
"9756",10401,"Mount Pearl","NL",47.50513,-52.79476,2018-02-11 10:00:00,40,0,40
"9757",10401,"Mount Pearl","NL",47.50513,-52.79476,2018-02-11 11:00:00,40,0,40
"9758",10401,"Mount Pearl","NL",47.50513,-52.79476,2018-02-11 12:00:00,38,0,38
"9759",10401,"Mount Pearl","NL",47.50513,-52.79476,2018-02-11 13:00:00,37,0,37
"9760",10401,"Mount Pearl","NL",47.50513,-52.79476,2018-02-11 14:00:00,37,1,38
"9761",10401,"Mount Pearl","NL",47.50513,-52.79476,2018-02-11 15:00:00,37,0,37
"9762",10401,"Mount Pearl","NL",47.50513,-52.79476,2018-02-11 16:00:00,37,0,37
"9763",10401,"Mount Pearl","NL",47.50513,-52.79476,2018-02-11 17:00:00,37,1,38
"9764",10401,"Mount Pearl","NL",47.50513,-52.79476,2018-02-11 18:00:00,38,0,38
"9765",10401,"Mount Pearl","NL",47.50513,-52.79476,2018-02-11 19:00:00,38,1,39
"9766",10401,"Mount Pearl","NL",47.50513,-52.79476,2018-02-11 20:00:00,38,0,38
"9767",10401,"Mount Pearl","NL",47.50513,-52.79476,2018-02-11 21:00:00,39,0,39
"9768",10401,"Mount Pearl","NL",47.50513,-52.79476,2018-02-11 22:00:00,40,0,40
"9769",10401,"Mount Pearl","NL",47.50513,-52.79476,2018-02-11 23:00:00,40,0,40
"9770",10401,"Mount Pearl","NL",47.50513,-52.79476,2018-02-12 00:00:00,39,0,39
"9771",10401,"Mount Pearl","NL",47.50513,-52.79476,2018-02-12 01:00:00,40,1,41
"9772",10401,"Mount Pearl","NL",47.50513,-52.79476,2018-02-12 02:00:00,40,0,40
"9773",10401,"Mount Pearl","NL",47.50513,-52.79476,2018-02-12 03:00:00,40,0,40
"9774",10401,"Mount Pearl","NL",47.50513,-52.79476,2018-02-12 04:00:00,40,0,40
"9775",10401,"Mount Pearl","NL",47.50513,-52.79476,2018-02-12 05:00:00,40,0,40
"9776",10401,"Mount Pearl","NL",47.50513,-52.79476,2018-02-12 06:00:00,40,0,40
"9777",10401,"Mount Pearl","NL",47.50513,-52.79476,2018-02-12 07:00:00,40,0,40
"9778",10401,"Mount Pearl","NL",47.50513,-52.79476,2018-02-12 08:00:00,40,0,40
"9779",10401,"Mount Pearl","NL",47.50513,-52.79476,2018-02-12 09:00:00,39,0,39
"9780",10401,"Mount Pearl","NL",47.50513,-52.79476,2018-02-12 10:00:00,38,1,39
"9781",10401,"Mount Pearl","NL",47.50513,-52.79476,2018-02-12 11:00:00,36,1,37
"9782",10401,"Mount Pearl","NL",47.50513,-52.79476,2018-02-12 12:00:00,29,0,29
"9783",10401,"Mount Pearl","NL",47.50513,-52.79476,2018-02-12 13:00:00,27,1,28
"9784",10401,"Mount Pearl","NL",47.50513,-52.79476,2018-02-12 14:00:00,26,0,26
"9785",10401,"Mount Pearl","NL",47.50513,-52.79476,2018-02-12 15:00:00,26,1,27
"9786",10401,"Mount Pearl","NL",47.50513,-52.79476,2018-02-12 16:00:00,27,1,28
"9787",10401,"Mount Pearl","NL",47.50513,-52.79476,2018-02-12 17:00:00,28,1,29
"9788",10401,"Mount Pearl","NL",47.50513,-52.79476,2018-02-12 18:00:00,29,1,30
"9789",10401,"Mount Pearl","NL",47.50513,-52.79476,2018-02-12 19:00:00,29,1,30
"9790",10401,"Mount Pearl","NL",47.50513,-52.79476,2018-02-12 20:00:00,27,3,30
"9791",10401,"Mount Pearl","NL",47.50513,-52.79476,2018-02-12 21:00:00,30,2,32
"9792",10401,"Mount Pearl","NL",47.50513,-52.79476,2018-02-12 22:00:00,32,1,33
"9793",10401,"Mount Pearl","NL",47.50513,-52.79476,2018-02-12 23:00:00,35,0,35
"9794",10401,"Mount Pearl","NL",47.50513,-52.79476,2018-02-13 00:00:00,41,0,41
"9795",10401,"Mount Pearl","NL",47.50513,-52.79476,2018-02-13 01:00:00,44,0,44
"9796",10401,"Mount Pearl","NL",47.50513,-52.79476,2018-02-13 02:00:00,42,0,42
"9797",10401,"Mount Pearl","NL",47.50513,-52.79476,2018-02-13 03:00:00,41,0,41
"9798",10401,"Mount Pearl","NL",47.50513,-52.79476,2018-02-13 04:00:00,40,0,40
"9799",10401,"Mount Pearl","NL",47.50513,-52.79476,2018-02-13 05:00:00,39,0,39
"9800",10401,"Mount Pearl","NL",47.50513,-52.79476,2018-02-13 06:00:00,39,0,39
"9801",10401,"Mount Pearl","NL",47.50513,-52.79476,2018-02-13 07:00:00,38,1,39
"9802",10401,"Mount Pearl","NL",47.50513,-52.79476,2018-02-13 08:00:00,37,1,38
"9803",10401,"Mount Pearl","NL",47.50513,-52.79476,2018-02-13 09:00:00,37,1,38
"9804",10401,"Mount Pearl","NL",47.50513,-52.79476,2018-02-13 10:00:00,36,1,37
"9805",10401,"Mount Pearl","NL",47.50513,-52.79476,2018-02-13 11:00:00,36,1,37
"9806",10401,"Mount Pearl","NL",47.50513,-52.79476,2018-02-13 12:00:00,35,0,35
"9807",10401,"Mount Pearl","NL",47.50513,-52.79476,2018-02-13 13:00:00,35,0,35
"9808",10401,"Mount Pearl","NL",47.50513,-52.79476,2018-02-13 14:00:00,34,0,34
"9809",10401,"Mount Pearl","NL",47.50513,-52.79476,2018-02-13 15:00:00,35,0,35
"9810",10401,"Mount Pearl","NL",47.50513,-52.79476,2018-02-13 16:00:00,36,0,36
"9811",10401,"Mount Pearl","NL",47.50513,-52.79476,2018-02-13 17:00:00,37,0,37
"9812",10401,"Mount Pearl","NL",47.50513,-52.79476,2018-02-13 18:00:00,37,0,37
"9813",10401,"Mount Pearl","NL",47.50513,-52.79476,2018-02-13 19:00:00,37,0,37
"9814",10401,"Mount Pearl","NL",47.50513,-52.79476,2018-02-13 20:00:00,37,0,37
"9815",10401,"Mount Pearl","NL",47.50513,-52.79476,2018-02-13 21:00:00,37,0,37
"9816",10401,"Mount Pearl","NL",47.50513,-52.79476,2018-02-13 22:00:00,37,0,37
"9817",10401,"Mount Pearl","NL",47.50513,-52.79476,2018-02-13 23:00:00,37,0,37
"9818",10401,"Mount Pearl","NL",47.50513,-52.79476,2018-02-14 00:00:00,36,0,36
"9819",10401,"Mount Pearl","NL",47.50513,-52.79476,2018-02-14 01:00:00,36,0,36
"9820",10401,"Mount Pearl","NL",47.50513,-52.79476,2018-02-14 02:00:00,35,0,35
"9821",10401,"Mount Pearl","NL",47.50513,-52.79476,2018-02-14 03:00:00,35,0,35
"9822",10401,"Mount Pearl","NL",47.50513,-52.79476,2018-02-14 04:00:00,34,0,34
"9823",10401,"Mount Pearl","NL",47.50513,-52.79476,2018-02-14 05:00:00,34,0,34
"9824",10401,"Mount Pearl","NL",47.50513,-52.79476,2018-02-14 06:00:00,34,0,34
"9825",10401,"Mount Pearl","NL",47.50513,-52.79476,2018-02-14 07:00:00,32,0,32
"9826",10401,"Mount Pearl","NL",47.50513,-52.79476,2018-02-14 08:00:00,28,2,30
"9827",10401,"Mount Pearl","NL",47.50513,-52.79476,2018-02-14 09:00:00,28,1,29
"9828",10401,"Mount Pearl","NL",47.50513,-52.79476,2018-02-14 10:00:00,30,0,30
"9829",10401,"Mount Pearl","NL",47.50513,-52.79476,2018-02-14 11:00:00,33,0,33
"9830",10401,"Mount Pearl","NL",47.50513,-52.79476,2018-02-14 12:00:00,36,1,37
"9831",10401,"Mount Pearl","NL",47.50513,-52.79476,2018-02-14 13:00:00,38,0,38
"9832",10401,"Mount Pearl","NL",47.50513,-52.79476,2018-02-14 14:00:00,38,0,38
"9833",10401,"Mount Pearl","NL",47.50513,-52.79476,2018-02-14 15:00:00,39,1,40
"9834",10401,"Mount Pearl","NL",47.50513,-52.79476,2018-02-14 16:00:00,40,1,41
"9835",10401,"Mount Pearl","NL",47.50513,-52.79476,2018-02-14 17:00:00,41,0,41
"9836",10401,"Mount Pearl","NL",47.50513,-52.79476,2018-02-14 18:00:00,41,0,41
"9837",10401,"Mount Pearl","NL",47.50513,-52.79476,2018-02-14 19:00:00,41,1,42
"9838",10401,"Mount Pearl","NL",47.50513,-52.79476,2018-02-14 20:00:00,41,0,41
"9839",10401,"Mount Pearl","NL",47.50513,-52.79476,2018-02-14 21:00:00,40,1,41
"9840",10401,"Mount Pearl","NL",47.50513,-52.79476,2018-02-14 22:00:00,40,1,41
"9841",10401,"Mount Pearl","NL",47.50513,-52.79476,2018-02-14 23:00:00,40,0,40
"9842",10401,"Mount Pearl","NL",47.50513,-52.79476,2018-02-15 00:00:00,39,0,39
"9843",10401,"Mount Pearl","NL",47.50513,-52.79476,2018-02-15 01:00:00,39,1,40
"9844",10401,"Mount Pearl","NL",47.50513,-52.79476,2018-02-15 02:00:00,39,0,39
"9845",10401,"Mount Pearl","NL",47.50513,-52.79476,2018-02-15 03:00:00,39,0,39
"9846",10401,"Mount Pearl","NL",47.50513,-52.79476,2018-02-15 04:00:00,38,0,38
"9847",10401,"Mount Pearl","NL",47.50513,-52.79476,2018-02-15 05:00:00,37,1,38
"9848",10401,"Mount Pearl","NL",47.50513,-52.79476,2018-02-15 06:00:00,36,0,36
"9849",10401,"Mount Pearl","NL",47.50513,-52.79476,2018-02-15 07:00:00,38,1,39
"9850",10401,"Mount Pearl","NL",47.50513,-52.79476,2018-02-15 08:00:00,38,1,39
"9851",10401,"Mount Pearl","NL",47.50513,-52.79476,2018-02-15 09:00:00,37,1,38
"9852",10401,"Mount Pearl","NL",47.50513,-52.79476,2018-02-15 10:00:00,38,1,39
"9853",10401,"Mount Pearl","NL",47.50513,-52.79476,2018-02-15 11:00:00,37,1,38
"9854",10401,"Mount Pearl","NL",47.50513,-52.79476,2018-02-15 12:00:00,35,0,35
"9855",10401,"Mount Pearl","NL",47.50513,-52.79476,2018-02-15 13:00:00,35,1,36
"9856",10401,"Mount Pearl","NL",47.50513,-52.79476,2018-02-15 14:00:00,37,1,38
"9857",10401,"Mount Pearl","NL",47.50513,-52.79476,2018-02-15 15:00:00,36,1,37
"9858",10401,"Mount Pearl","NL",47.50513,-52.79476,2018-02-15 16:00:00,40,1,41
"9859",10401,"Mount Pearl","NL",47.50513,-52.79476,2018-02-15 17:00:00,39,1,40
"9860",10401,"Mount Pearl","NL",47.50513,-52.79476,2018-02-15 18:00:00,33,2,35
"9861",10401,"Mount Pearl","NL",47.50513,-52.79476,2018-02-15 19:00:00,18,7,25
"9862",10401,"Mount Pearl","NL",47.50513,-52.79476,2018-02-15 20:00:00,6,10,16
"9863",10401,"Mount Pearl","NL",47.50513,-52.79476,2018-02-15 21:00:00,11,7,18
"9864",10401,"Mount Pearl","NL",47.50513,-52.79476,2018-02-15 22:00:00,4,9,13
"9865",10401,"Mount Pearl","NL",47.50513,-52.79476,2018-02-15 23:00:00,5,9,14
"9866",10401,"Mount Pearl","NL",47.50513,-52.79476,2018-02-16 00:00:00,26,2,28
"9867",10401,"Mount Pearl","NL",47.50513,-52.79476,2018-02-16 01:00:00,31,1,32
"9868",10401,"Mount Pearl","NL",47.50513,-52.79476,2018-02-16 02:00:00,35,0,35
"9869",10401,"Mount Pearl","NL",47.50513,-52.79476,2018-02-16 03:00:00,35,0,35
"9870",10401,"Mount Pearl","NL",47.50513,-52.79476,2018-02-16 04:00:00,35,0,35
"9871",10401,"Mount Pearl","NL",47.50513,-52.79476,2018-02-16 05:00:00,33,1,34
"9872",10401,"Mount Pearl","NL",47.50513,-52.79476,2018-02-16 06:00:00,34,1,35
"9873",10401,"Mount Pearl","NL",47.50513,-52.79476,2018-02-16 07:00:00,35,1,36
"9874",10401,"Mount Pearl","NL",47.50513,-52.79476,2018-02-16 08:00:00,33,2,35
"9875",10401,"Mount Pearl","NL",47.50513,-52.79476,2018-02-16 09:00:00,33,1,34
"9876",10401,"Mount Pearl","NL",47.50513,-52.79476,2018-02-16 10:00:00,28,2,30
"9877",10401,"Mount Pearl","NL",47.50513,-52.79476,2018-02-16 11:00:00,32,2,34
"9878",10401,"Mount Pearl","NL",47.50513,-52.79476,2018-02-16 12:00:00,35,3,38
"9879",10401,"Mount Pearl","NL",47.50513,-52.79476,2018-02-16 13:00:00,35,3,38
"9880",10401,"Mount Pearl","NL",47.50513,-52.79476,2018-02-16 14:00:00,36,2,38
"9881",10401,"Mount Pearl","NL",47.50513,-52.79476,2018-02-16 15:00:00,36,2,38
"9882",10401,"Mount Pearl","NL",47.50513,-52.79476,2018-02-16 16:00:00,35,2,37
"9883",10401,"Mount Pearl","NL",47.50513,-52.79476,2018-02-16 17:00:00,34,2,36
"9884",10401,"Mount Pearl","NL",47.50513,-52.79476,2018-02-16 18:00:00,36,2,38
"9885",10401,"Mount Pearl","NL",47.50513,-52.79476,2018-02-16 19:00:00,36,2,38
"9886",10401,"Mount Pearl","NL",47.50513,-52.79476,2018-02-16 20:00:00,33,2,35
"9887",10401,"Mount Pearl","NL",47.50513,-52.79476,2018-02-16 21:00:00,30,5,35
"9888",10401,"Mount Pearl","NL",47.50513,-52.79476,2018-02-16 22:00:00,31,2,33
"9889",10401,"Mount Pearl","NL",47.50513,-52.79476,2018-02-16 23:00:00,27,3,30
"9890",10401,"Mount Pearl","NL",47.50513,-52.79476,2018-02-17 00:00:00,25,2,27
"9891",10401,"Mount Pearl","NL",47.50513,-52.79476,2018-02-17 01:00:00,25,3,28
"9892",10401,"Mount Pearl","NL",47.50513,-52.79476,2018-02-17 02:00:00,25,2,27
"9893",10401,"Mount Pearl","NL",47.50513,-52.79476,2018-02-17 03:00:00,25,4,29
"9894",10401,"Mount Pearl","NL",47.50513,-52.79476,2018-02-17 04:00:00,22,4,26
"9895",10401,"Mount Pearl","NL",47.50513,-52.79476,2018-02-17 05:00:00,24,4,28
"9896",10401,"Mount Pearl","NL",47.50513,-52.79476,2018-02-17 06:00:00,28,3,31
"9897",10401,"Mount Pearl","NL",47.50513,-52.79476,2018-02-17 07:00:00,32,2,34
"9898",10401,"Mount Pearl","NL",47.50513,-52.79476,2018-02-17 08:00:00,33,3,36
"9899",10401,"Mount Pearl","NL",47.50513,-52.79476,2018-02-17 09:00:00,33,3,36
"9900",10401,"Mount Pearl","NL",47.50513,-52.79476,2018-02-17 10:00:00,34,2,36
"9901",10401,"Mount Pearl","NL",47.50513,-52.79476,2018-02-17 11:00:00,33,2,35
"9902",10401,"Mount Pearl","NL",47.50513,-52.79476,2018-02-17 12:00:00,33,1,34
"9903",10401,"Mount Pearl","NL",47.50513,-52.79476,2018-02-17 13:00:00,33,1,34
"9904",10401,"Mount Pearl","NL",47.50513,-52.79476,2018-02-17 14:00:00,33,2,35
"9905",10401,"Mount Pearl","NL",47.50513,-52.79476,2018-02-17 15:00:00,35,1,36
"9906",10401,"Mount Pearl","NL",47.50513,-52.79476,2018-02-17 16:00:00,37,1,38
"9907",10401,"Mount Pearl","NL",47.50513,-52.79476,2018-02-17 17:00:00,37,1,38
"9908",10401,"Mount Pearl","NL",47.50513,-52.79476,2018-02-17 18:00:00,37,1,38
"9909",10401,"Mount Pearl","NL",47.50513,-52.79476,2018-02-17 19:00:00,37,1,38
"9910",10401,"Mount Pearl","NL",47.50513,-52.79476,2018-02-17 20:00:00,37,1,38
"9911",10401,"Mount Pearl","NL",47.50513,-52.79476,2018-02-17 21:00:00,37,2,39
"9912",10401,"Mount Pearl","NL",47.50513,-52.79476,2018-02-17 22:00:00,36,1,37
"9913",10401,"Mount Pearl","NL",47.50513,-52.79476,2018-02-17 23:00:00,35,1,36
"9914",10401,"Mount Pearl","NL",47.50513,-52.79476,2018-02-18 00:00:00,35,1,36
"9915",10401,"Mount Pearl","NL",47.50513,-52.79476,2018-02-18 01:00:00,34,0,34
"9916",10401,"Mount Pearl","NL",47.50513,-52.79476,2018-02-18 02:00:00,34,1,35
"9917",10401,"Mount Pearl","NL",47.50513,-52.79476,2018-02-18 03:00:00,33,1,34
"9918",10401,"Mount Pearl","NL",47.50513,-52.79476,2018-02-18 04:00:00,34,0,34
"9919",10401,"Mount Pearl","NL",47.50513,-52.79476,2018-02-18 05:00:00,34,1,35
"9920",10401,"Mount Pearl","NL",47.50513,-52.79476,2018-02-18 06:00:00,33,1,34
"9921",10401,"Mount Pearl","NL",47.50513,-52.79476,2018-02-18 07:00:00,33,1,34
"9922",10401,"Mount Pearl","NL",47.50513,-52.79476,2018-02-18 08:00:00,32,1,33
"9923",10401,"Mount Pearl","NL",47.50513,-52.79476,2018-02-18 09:00:00,32,1,33
"9924",10401,"Mount Pearl","NL",47.50513,-52.79476,2018-02-18 10:00:00,31,1,32
"9925",10401,"Mount Pearl","NL",47.50513,-52.79476,2018-02-18 11:00:00,31,1,32
"9926",10401,"Mount Pearl","NL",47.50513,-52.79476,2018-02-18 12:00:00,32,0,32
"9927",10401,"Mount Pearl","NL",47.50513,-52.79476,2018-02-18 13:00:00,33,0,33
"9928",10401,"Mount Pearl","NL",47.50513,-52.79476,2018-02-18 14:00:00,31,1,32
"9929",10401,"Mount Pearl","NL",47.50513,-52.79476,2018-02-18 15:00:00,34,1,35
"9930",10401,"Mount Pearl","NL",47.50513,-52.79476,2018-02-18 16:00:00,34,0,34
"9931",10401,"Mount Pearl","NL",47.50513,-52.79476,2018-02-18 17:00:00,33,0,33
"9932",10401,"Mount Pearl","NL",47.50513,-52.79476,2018-02-18 18:00:00,34,0,34
"9933",10401,"Mount Pearl","NL",47.50513,-52.79476,2018-02-18 19:00:00,33,1,34
"9934",10401,"Mount Pearl","NL",47.50513,-52.79476,2018-02-18 20:00:00,34,0,34
"9935",10401,"Mount Pearl","NL",47.50513,-52.79476,2018-02-18 21:00:00,36,1,37
"9936",10401,"Mount Pearl","NL",47.50513,-52.79476,2018-02-18 22:00:00,36,1,37
"9937",10401,"Mount Pearl","NL",47.50513,-52.79476,2018-02-18 23:00:00,34,1,35
"9938",10401,"Mount Pearl","NL",47.50513,-52.79476,2018-02-19 00:00:00,35,1,36
"9939",10401,"Mount Pearl","NL",47.50513,-52.79476,2018-02-19 01:00:00,34,1,35
"9940",10401,"Mount Pearl","NL",47.50513,-52.79476,2018-02-19 02:00:00,35,0,35
"9941",10401,"Mount Pearl","NL",47.50513,-52.79476,2018-02-19 03:00:00,36,0,36
"9942",10401,"Mount Pearl","NL",47.50513,-52.79476,2018-02-19 04:00:00,36,0,36
"9943",10401,"Mount Pearl","NL",47.50513,-52.79476,2018-02-19 05:00:00,34,0,34
"9944",10401,"Mount Pearl","NL",47.50513,-52.79476,2018-02-19 06:00:00,33,0,33
"9945",10401,"Mount Pearl","NL",47.50513,-52.79476,2018-02-19 07:00:00,34,0,34
"9946",10401,"Mount Pearl","NL",47.50513,-52.79476,2018-02-19 08:00:00,33,1,34
"9947",10401,"Mount Pearl","NL",47.50513,-52.79476,2018-02-19 09:00:00,34,0,34
"9948",10401,"Mount Pearl","NL",47.50513,-52.79476,2018-02-19 10:00:00,34,0,34
"9949",10401,"Mount Pearl","NL",47.50513,-52.79476,2018-02-19 11:00:00,34,0,34
"9950",10401,"Mount Pearl","NL",47.50513,-52.79476,2018-02-19 12:00:00,33,0,33
"9951",10401,"Mount Pearl","NL",47.50513,-52.79476,2018-02-19 13:00:00,33,0,33
"9952",10401,"Mount Pearl","NL",47.50513,-52.79476,2018-02-19 14:00:00,33,0,33
"9953",10401,"Mount Pearl","NL",47.50513,-52.79476,2018-02-19 15:00:00,34,0,34
"9954",10401,"Mount Pearl","NL",47.50513,-52.79476,2018-02-19 16:00:00,34,0,34
"9955",10401,"Mount Pearl","NL",47.50513,-52.79476,2018-02-19 17:00:00,34,0,34
"9956",10401,"Mount Pearl","NL",47.50513,-52.79476,2018-02-19 18:00:00,30,2,32
"9957",10401,"Mount Pearl","NL",47.50513,-52.79476,2018-02-19 19:00:00,20,4,24
"9958",10401,"Mount Pearl","NL",47.50513,-52.79476,2018-02-19 20:00:00,21,3,24
"9959",10401,"Mount Pearl","NL",47.50513,-52.79476,2018-02-19 21:00:00,23,2,25
"9960",10401,"Mount Pearl","NL",47.50513,-52.79476,2018-02-19 22:00:00,23,1,24
"9961",10401,"Mount Pearl","NL",47.50513,-52.79476,2018-02-19 23:00:00,30,1,31
"9962",10401,"Mount Pearl","NL",47.50513,-52.79476,2018-02-20 00:00:00,32,0,32
"9963",10401,"Mount Pearl","NL",47.50513,-52.79476,2018-02-20 01:00:00,33,0,33
"9964",10401,"Mount Pearl","NL",47.50513,-52.79476,2018-02-20 02:00:00,34,0,34
"9965",10401,"Mount Pearl","NL",47.50513,-52.79476,2018-02-20 03:00:00,31,1,32
"9966",10401,"Mount Pearl","NL",47.50513,-52.79476,2018-02-20 04:00:00,36,0,36
"9967",10401,"Mount Pearl","NL",47.50513,-52.79476,2018-02-20 05:00:00,31,6,37
"9968",10401,"Mount Pearl","NL",47.50513,-52.79476,2018-02-20 06:00:00,35,1,36
"9969",10401,"Mount Pearl","NL",47.50513,-52.79476,2018-02-20 07:00:00,36,1,37
"9970",10401,"Mount Pearl","NL",47.50513,-52.79476,2018-02-20 08:00:00,36,0,36
"9971",10401,"Mount Pearl","NL",47.50513,-52.79476,2018-02-20 09:00:00,35,0,35
"9972",10401,"Mount Pearl","NL",47.50513,-52.79476,2018-02-20 10:00:00,35,0,35
"9973",10401,"Mount Pearl","NL",47.50513,-52.79476,2018-02-20 11:00:00,35,0,35
"9974",10401,"Mount Pearl","NL",47.50513,-52.79476,2018-02-20 12:00:00,33,1,34
"9975",10401,"Mount Pearl","NL",47.50513,-52.79476,2018-02-20 13:00:00,35,0,35
"9976",10401,"Mount Pearl","NL",47.50513,-52.79476,2018-02-20 14:00:00,36,0,36
"9977",10401,"Mount Pearl","NL",47.50513,-52.79476,2018-02-20 15:00:00,35,0,35
"9978",10401,"Mount Pearl","NL",47.50513,-52.79476,2018-02-20 16:00:00,35,1,36
"9979",10401,"Mount Pearl","NL",47.50513,-52.79476,2018-02-20 17:00:00,35,0,35
"9980",10401,"Mount Pearl","NL",47.50513,-52.79476,2018-02-20 18:00:00,33,1,34
"9981",10401,"Mount Pearl","NL",47.50513,-52.79476,2018-02-20 19:00:00,26,3,29
"9982",10401,"Mount Pearl","NL",47.50513,-52.79476,2018-02-20 20:00:00,34,1,35
"9983",10401,"Mount Pearl","NL",47.50513,-52.79476,2018-02-20 21:00:00,37,0,37
"9984",10401,"Mount Pearl","NL",47.50513,-52.79476,2018-02-20 22:00:00,37,0,37
"9985",10401,"Mount Pearl","NL",47.50513,-52.79476,2018-02-20 23:00:00,37,0,37
"9986",10401,"Mount Pearl","NL",47.50513,-52.79476,2018-02-21 00:00:00,37,0,37
"9987",10401,"Mount Pearl","NL",47.50513,-52.79476,2018-02-21 01:00:00,37,0,37
"9988",10401,"Mount Pearl","NL",47.50513,-52.79476,2018-02-21 02:00:00,37,0,37
"9989",10401,"Mount Pearl","NL",47.50513,-52.79476,2018-02-21 03:00:00,38,0,38
"9990",10401,"Mount Pearl","NL",47.50513,-52.79476,2018-02-21 04:00:00,38,0,38
"9991",10401,"Mount Pearl","NL",47.50513,-52.79476,2018-02-21 05:00:00,38,0,38
"9992",10401,"Mount Pearl","NL",47.50513,-52.79476,2018-02-21 06:00:00,38,0,38
"9993",10401,"Mount Pearl","NL",47.50513,-52.79476,2018-02-21 07:00:00,38,0,38
"9994",10401,"Mount Pearl","NL",47.50513,-52.79476,2018-02-21 08:00:00,37,1,38
"9995",10401,"Mount Pearl","NL",47.50513,-52.79476,2018-02-21 09:00:00,36,1,37
"9996",10401,"Mount Pearl","NL",47.50513,-52.79476,2018-02-21 10:00:00,34,2,36
"9997",10401,"Mount Pearl","NL",47.50513,-52.79476,2018-02-21 11:00:00,36,0,36
"9998",10401,"Mount Pearl","NL",47.50513,-52.79476,2018-02-21 12:00:00,35,1,36
"9999",10401,"Mount Pearl","NL",47.50513,-52.79476,2018-02-21 13:00:00,35,1,36
"10000",10401,"Mount Pearl","NL",47.50513,-52.79476,2018-02-21 14:00:00,36,1,37
"10001",10401,"Mount Pearl","NL",47.50513,-52.79476,2018-02-21 15:00:00,35,1,36
"10002",10401,"Mount Pearl","NL",47.50513,-52.79476,2018-02-21 16:00:00,35,1,36
"10003",10401,"Mount Pearl","NL",47.50513,-52.79476,2018-02-21 17:00:00,35,1,36
"10004",10401,"Mount Pearl","NL",47.50513,-52.79476,2018-02-21 18:00:00,36,1,37
"10005",10401,"Mount Pearl","NL",47.50513,-52.79476,2018-02-21 19:00:00,36,1,37
"10006",10401,"Mount Pearl","NL",47.50513,-52.79476,2018-02-21 20:00:00,34,1,35
"10007",10401,"Mount Pearl","NL",47.50513,-52.79476,2018-02-21 21:00:00,34,1,35
"10008",10401,"Mount Pearl","NL",47.50513,-52.79476,2018-02-21 22:00:00,34,1,35
"10009",10401,"Mount Pearl","NL",47.50513,-52.79476,2018-02-21 23:00:00,35,1,36
"10010",10401,"Mount Pearl","NL",47.50513,-52.79476,2018-02-22 00:00:00,35,1,36
"10011",10401,"Mount Pearl","NL",47.50513,-52.79476,2018-02-22 01:00:00,33,1,34
"10012",10401,"Mount Pearl","NL",47.50513,-52.79476,2018-02-22 02:00:00,30,2,32
"10013",10401,"Mount Pearl","NL",47.50513,-52.79476,2018-02-22 03:00:00,30,2,32
"10014",10401,"Mount Pearl","NL",47.50513,-52.79476,2018-02-22 04:00:00,30,1,31
"10015",10401,"Mount Pearl","NL",47.50513,-52.79476,2018-02-22 05:00:00,30,1,31
"10016",10401,"Mount Pearl","NL",47.50513,-52.79476,2018-02-22 06:00:00,31,1,32
"10017",10401,"Mount Pearl","NL",47.50513,-52.79476,2018-02-22 07:00:00,33,1,34
"10018",10401,"Mount Pearl","NL",47.50513,-52.79476,2018-02-22 08:00:00,32,1,33
"10019",10401,"Mount Pearl","NL",47.50513,-52.79476,2018-02-22 09:00:00,32,1,33
"10020",10401,"Mount Pearl","NL",47.50513,-52.79476,2018-02-22 10:00:00,32,1,33
"10021",10401,"Mount Pearl","NL",47.50513,-52.79476,2018-02-22 11:00:00,32,1,33
"10022",10401,"Mount Pearl","NL",47.50513,-52.79476,2018-02-22 12:00:00,33,0,33
"10023",10401,"Mount Pearl","NL",47.50513,-52.79476,2018-02-22 13:00:00,33,0,33
"10024",10401,"Mount Pearl","NL",47.50513,-52.79476,2018-02-22 14:00:00,34,0,34
"10025",10401,"Mount Pearl","NL",47.50513,-52.79476,2018-02-22 15:00:00,36,0,36
"10026",10401,"Mount Pearl","NL",47.50513,-52.79476,2018-02-22 16:00:00,37,0,37
"10027",10401,"Mount Pearl","NL",47.50513,-52.79476,2018-02-22 17:00:00,37,0,37
"10028",10401,"Mount Pearl","NL",47.50513,-52.79476,2018-02-22 18:00:00,37,0,37
"10029",10401,"Mount Pearl","NL",47.50513,-52.79476,2018-02-22 19:00:00,37,1,38
"10030",10401,"Mount Pearl","NL",47.50513,-52.79476,2018-02-22 20:00:00,37,1,38
"10031",10401,"Mount Pearl","NL",47.50513,-52.79476,2018-02-22 21:00:00,37,1,38
"10032",10401,"Mount Pearl","NL",47.50513,-52.79476,2018-02-22 22:00:00,37,0,37
"10033",10401,"Mount Pearl","NL",47.50513,-52.79476,2018-02-22 23:00:00,38,0,38
"10034",10401,"Mount Pearl","NL",47.50513,-52.79476,2018-02-23 00:00:00,38,0,38
"10035",10401,"Mount Pearl","NL",47.50513,-52.79476,2018-02-23 01:00:00,38,0,38
"10036",10401,"Mount Pearl","NL",47.50513,-52.79476,2018-02-23 02:00:00,38,0,38
"10037",10401,"Mount Pearl","NL",47.50513,-52.79476,2018-02-23 03:00:00,37,0,37
"10038",10401,"Mount Pearl","NL",47.50513,-52.79476,2018-02-23 04:00:00,37,0,37
"10039",10401,"Mount Pearl","NL",47.50513,-52.79476,2018-02-23 05:00:00,38,0,38
"10040",10401,"Mount Pearl","NL",47.50513,-52.79476,2018-02-23 06:00:00,37,0,37
"10041",10401,"Mount Pearl","NL",47.50513,-52.79476,2018-02-23 07:00:00,37,0,37
"10042",10401,"Mount Pearl","NL",47.50513,-52.79476,2018-02-23 08:00:00,37,1,38
"10043",10401,"Mount Pearl","NL",47.50513,-52.79476,2018-02-23 09:00:00,37,1,38
"10044",10401,"Mount Pearl","NL",47.50513,-52.79476,2018-02-23 10:00:00,37,0,37
"10045",10401,"Mount Pearl","NL",47.50513,-52.79476,2018-02-23 11:00:00,37,1,38
"10046",10401,"Mount Pearl","NL",47.50513,-52.79476,2018-02-23 12:00:00,36,0,36
"10047",10401,"Mount Pearl","NL",47.50513,-52.79476,2018-02-23 13:00:00,37,0,37
"10048",10401,"Mount Pearl","NL",47.50513,-52.79476,2018-02-23 14:00:00,37,1,38
"10049",10401,"Mount Pearl","NL",47.50513,-52.79476,2018-02-23 15:00:00,38,1,39
"10050",10401,"Mount Pearl","NL",47.50513,-52.79476,2018-02-23 16:00:00,39,1,40
"10051",10401,"Mount Pearl","NL",47.50513,-52.79476,2018-02-23 17:00:00,39,1,40
"10052",10401,"Mount Pearl","NL",47.50513,-52.79476,2018-02-23 18:00:00,39,1,40
"10053",10401,"Mount Pearl","NL",47.50513,-52.79476,2018-02-23 19:00:00,38,1,39
"10054",10401,"Mount Pearl","NL",47.50513,-52.79476,2018-02-23 20:00:00,39,1,40
"10055",10401,"Mount Pearl","NL",47.50513,-52.79476,2018-02-23 21:00:00,38,1,39
"10056",10401,"Mount Pearl","NL",47.50513,-52.79476,2018-02-23 22:00:00,38,1,39
"10057",10401,"Mount Pearl","NL",47.50513,-52.79476,2018-02-23 23:00:00,38,1,39
"10058",10401,"Mount Pearl","NL",47.50513,-52.79476,2018-02-24 00:00:00,36,1,37
"10059",10401,"Mount Pearl","NL",47.50513,-52.79476,2018-02-24 01:00:00,33,2,35
"10060",10401,"Mount Pearl","NL",47.50513,-52.79476,2018-02-24 02:00:00,36,0,36
"10061",10401,"Mount Pearl","NL",47.50513,-52.79476,2018-02-24 03:00:00,35,1,36
"10062",10401,"Mount Pearl","NL",47.50513,-52.79476,2018-02-24 04:00:00,34,1,35
"10063",10401,"Mount Pearl","NL",47.50513,-52.79476,2018-02-24 05:00:00,35,1,36
"10064",10401,"Mount Pearl","NL",47.50513,-52.79476,2018-02-24 06:00:00,37,0,37
"10065",10401,"Mount Pearl","NL",47.50513,-52.79476,2018-02-24 07:00:00,37,0,37
"10066",10401,"Mount Pearl","NL",47.50513,-52.79476,2018-02-24 08:00:00,37,0,37
"10067",10401,"Mount Pearl","NL",47.50513,-52.79476,2018-02-24 09:00:00,37,0,37
"10068",10401,"Mount Pearl","NL",47.50513,-52.79476,2018-02-24 10:00:00,38,0,38
"10069",10401,"Mount Pearl","NL",47.50513,-52.79476,2018-02-24 11:00:00,36,1,37
"10070",10401,"Mount Pearl","NL",47.50513,-52.79476,2018-02-24 12:00:00,39,1,40
"10071",10401,"Mount Pearl","NL",47.50513,-52.79476,2018-02-24 13:00:00,40,1,41
"10072",10401,"Mount Pearl","NL",47.50513,-52.79476,2018-02-24 14:00:00,39,0,39
"10073",10401,"Mount Pearl","NL",47.50513,-52.79476,2018-02-24 15:00:00,38,1,39
"10074",10401,"Mount Pearl","NL",47.50513,-52.79476,2018-02-24 16:00:00,37,2,39
"10075",10401,"Mount Pearl","NL",47.50513,-52.79476,2018-02-24 17:00:00,37,2,39
"10076",10401,"Mount Pearl","NL",47.50513,-52.79476,2018-02-24 18:00:00,35,4,39
"10077",10401,"Mount Pearl","NL",47.50513,-52.79476,2018-02-24 19:00:00,33,3,36
"10078",10401,"Mount Pearl","NL",47.50513,-52.79476,2018-02-24 20:00:00,31,4,35
"10079",10401,"Mount Pearl","NL",47.50513,-52.79476,2018-02-24 21:00:00,30,3,33
"10080",10401,"Mount Pearl","NL",47.50513,-52.79476,2018-02-24 22:00:00,38,1,39
"10081",10401,"Mount Pearl","NL",47.50513,-52.79476,2018-02-24 23:00:00,39,1,40
"10082",10401,"Mount Pearl","NL",47.50513,-52.79476,2018-02-25 00:00:00,40,1,41
"10083",10401,"Mount Pearl","NL",47.50513,-52.79476,2018-02-25 01:00:00,40,1,41
"10084",10401,"Mount Pearl","NL",47.50513,-52.79476,2018-02-25 02:00:00,41,1,42
"10085",10401,"Mount Pearl","NL",47.50513,-52.79476,2018-02-25 03:00:00,43,1,44
"10086",10401,"Mount Pearl","NL",47.50513,-52.79476,2018-02-25 04:00:00,43,0,43
"10087",10401,"Mount Pearl","NL",47.50513,-52.79476,2018-02-25 05:00:00,42,1,43
"10088",10401,"Mount Pearl","NL",47.50513,-52.79476,2018-02-25 06:00:00,41,1,42
"10089",10401,"Mount Pearl","NL",47.50513,-52.79476,2018-02-25 07:00:00,40,1,41
"10090",10401,"Mount Pearl","NL",47.50513,-52.79476,2018-02-25 08:00:00,39,1,40
"10091",10401,"Mount Pearl","NL",47.50513,-52.79476,2018-02-25 09:00:00,38,1,39
"10092",10401,"Mount Pearl","NL",47.50513,-52.79476,2018-02-25 10:00:00,37,1,38
"10093",10401,"Mount Pearl","NL",47.50513,-52.79476,2018-02-25 11:00:00,36,1,37
"10094",10401,"Mount Pearl","NL",47.50513,-52.79476,2018-02-25 12:00:00,35,0,35
"10095",10401,"Mount Pearl","NL",47.50513,-52.79476,2018-02-25 13:00:00,36,0,36
"10096",10401,"Mount Pearl","NL",47.50513,-52.79476,2018-02-25 14:00:00,37,0,37
"10097",10401,"Mount Pearl","NL",47.50513,-52.79476,2018-02-25 15:00:00,37,0,37
"10098",10401,"Mount Pearl","NL",47.50513,-52.79476,2018-02-25 16:00:00,37,0,37
"10099",10401,"Mount Pearl","NL",47.50513,-52.79476,2018-02-25 17:00:00,37,0,37
"10100",10401,"Mount Pearl","NL",47.50513,-52.79476,2018-02-25 18:00:00,37,0,37
"10101",10401,"Mount Pearl","NL",47.50513,-52.79476,2018-02-25 19:00:00,37,0,37
"10102",10401,"Mount Pearl","NL",47.50513,-52.79476,2018-02-25 20:00:00,37,0,37
"10103",10401,"Mount Pearl","NL",47.50513,-52.79476,2018-02-25 21:00:00,37,0,37
"10104",10401,"Mount Pearl","NL",47.50513,-52.79476,2018-02-25 22:00:00,37,1,38
"10105",10401,"Mount Pearl","NL",47.50513,-52.79476,2018-02-25 23:00:00,37,0,37
"10106",10401,"Mount Pearl","NL",47.50513,-52.79476,2018-02-26 00:00:00,37,0,37
"10107",10401,"Mount Pearl","NL",47.50513,-52.79476,2018-02-26 01:00:00,34,1,35
"10108",10401,"Mount Pearl","NL",47.50513,-52.79476,2018-02-26 02:00:00,35,0,35
"10109",10401,"Mount Pearl","NL",47.50513,-52.79476,2018-02-26 03:00:00,35,1,36
"10110",10401,"Mount Pearl","NL",47.50513,-52.79476,2018-02-26 04:00:00,32,1,33
"10111",10401,"Mount Pearl","NL",47.50513,-52.79476,2018-02-26 05:00:00,35,1,36
"10112",10401,"Mount Pearl","NL",47.50513,-52.79476,2018-02-26 06:00:00,31,2,33
"10113",10401,"Mount Pearl","NL",47.50513,-52.79476,2018-02-26 07:00:00,31,2,33
"10114",10401,"Mount Pearl","NL",47.50513,-52.79476,2018-02-26 08:00:00,27,4,31
"10115",10401,"Mount Pearl","NL",47.50513,-52.79476,2018-02-26 09:00:00,28,3,31
"10116",10401,"Mount Pearl","NL",47.50513,-52.79476,2018-02-26 10:00:00,29,2,31
"10117",10401,"Mount Pearl","NL",47.50513,-52.79476,2018-02-26 11:00:00,30,2,32
"10118",10401,"Mount Pearl","NL",47.50513,-52.79476,2018-02-26 12:00:00,33,1,34
"10119",10401,"Mount Pearl","NL",47.50513,-52.79476,2018-02-26 13:00:00,36,1,37
"10120",10401,"Mount Pearl","NL",47.50513,-52.79476,2018-02-26 14:00:00,36,0,36
"10121",10401,"Mount Pearl","NL",47.50513,-52.79476,2018-02-26 15:00:00,35,1,36
"10122",10401,"Mount Pearl","NL",47.50513,-52.79476,2018-02-26 16:00:00,35,1,36
"10123",10401,"Mount Pearl","NL",47.50513,-52.79476,2018-02-26 17:00:00,36,1,37
"10124",10401,"Mount Pearl","NL",47.50513,-52.79476,2018-02-26 18:00:00,36,1,37
"10125",10401,"Mount Pearl","NL",47.50513,-52.79476,2018-02-26 19:00:00,37,0,37
"10126",10401,"Mount Pearl","NL",47.50513,-52.79476,2018-02-26 20:00:00,37,0,37
"10127",10401,"Mount Pearl","NL",47.50513,-52.79476,2018-02-26 21:00:00,38,0,38
"10128",10401,"Mount Pearl","NL",47.50513,-52.79476,2018-02-26 22:00:00,38,0,38
"10129",10401,"Mount Pearl","NL",47.50513,-52.79476,2018-02-26 23:00:00,39,0,39
"10130",10401,"Mount Pearl","NL",47.50513,-52.79476,2018-02-27 00:00:00,39,0,39
"10131",10401,"Mount Pearl","NL",47.50513,-52.79476,2018-02-27 01:00:00,39,0,39
"10132",10401,"Mount Pearl","NL",47.50513,-52.79476,2018-02-27 02:00:00,39,0,39
"10133",10401,"Mount Pearl","NL",47.50513,-52.79476,2018-02-27 03:00:00,39,0,39
"10134",10401,"Mount Pearl","NL",47.50513,-52.79476,2018-02-27 04:00:00,40,0,40
"10135",10401,"Mount Pearl","NL",47.50513,-52.79476,2018-02-27 05:00:00,41,0,41
"10136",10401,"Mount Pearl","NL",47.50513,-52.79476,2018-02-27 06:00:00,41,0,41
"10137",10401,"Mount Pearl","NL",47.50513,-52.79476,2018-02-27 07:00:00,41,0,41
"10138",10401,"Mount Pearl","NL",47.50513,-52.79476,2018-02-27 08:00:00,41,1,42
"10139",10401,"Mount Pearl","NL",47.50513,-52.79476,2018-02-27 09:00:00,40,0,40
"10140",10401,"Mount Pearl","NL",47.50513,-52.79476,2018-02-27 10:00:00,40,0,40
"10141",10401,"Mount Pearl","NL",47.50513,-52.79476,2018-02-27 11:00:00,39,0,39
"10142",10401,"Mount Pearl","NL",47.50513,-52.79476,2018-02-27 12:00:00,37,1,38
"10143",10401,"Mount Pearl","NL",47.50513,-52.79476,2018-02-27 13:00:00,38,0,38
"10144",10401,"Mount Pearl","NL",47.50513,-52.79476,2018-02-27 14:00:00,38,0,38
"10145",10401,"Mount Pearl","NL",47.50513,-52.79476,2018-02-27 15:00:00,39,0,39
"10146",10401,"Mount Pearl","NL",47.50513,-52.79476,2018-02-27 16:00:00,40,1,41
"10147",10401,"Mount Pearl","NL",47.50513,-52.79476,2018-02-27 17:00:00,40,1,41
"10148",10401,"Mount Pearl","NL",47.50513,-52.79476,2018-02-27 18:00:00,42,0,42
"10149",10401,"Mount Pearl","NL",47.50513,-52.79476,2018-02-27 19:00:00,42,0,42
"10150",10401,"Mount Pearl","NL",47.50513,-52.79476,2018-02-27 20:00:00,42,0,42
"10151",10401,"Mount Pearl","NL",47.50513,-52.79476,2018-02-27 21:00:00,41,1,42
"10152",10401,"Mount Pearl","NL",47.50513,-52.79476,2018-02-27 22:00:00,42,1,43
"10153",10401,"Mount Pearl","NL",47.50513,-52.79476,2018-02-27 23:00:00,40,0,40
"10154",10401,"Mount Pearl","NL",47.50513,-52.79476,2018-02-28 00:00:00,38,1,39
"10155",10401,"Mount Pearl","NL",47.50513,-52.79476,2018-02-28 01:00:00,39,0,39
"10156",10401,"Mount Pearl","NL",47.50513,-52.79476,2018-02-28 02:00:00,39,0,39
"10157",10401,"Mount Pearl","NL",47.50513,-52.79476,2018-02-28 03:00:00,38,0,38
"10158",10401,"Mount Pearl","NL",47.50513,-52.79476,2018-02-28 04:00:00,37,0,37
"10159",10401,"Mount Pearl","NL",47.50513,-52.79476,2018-02-28 05:00:00,37,0,37
"10160",10401,"Mount Pearl","NL",47.50513,-52.79476,2018-02-28 06:00:00,37,0,37
"10161",10401,"Mount Pearl","NL",47.50513,-52.79476,2018-02-28 07:00:00,36,1,37
"10162",10401,"Mount Pearl","NL",47.50513,-52.79476,2018-02-28 08:00:00,34,1,35
"10163",10401,"Mount Pearl","NL",47.50513,-52.79476,2018-02-28 09:00:00,34,1,35
"10164",10401,"Mount Pearl","NL",47.50513,-52.79476,2018-02-28 10:00:00,34,1,35
"10165",10401,"Mount Pearl","NL",47.50513,-52.79476,2018-02-28 11:00:00,33,1,34
"10166",10401,"Mount Pearl","NL",47.50513,-52.79476,2018-02-28 12:00:00,31,0,31
"10167",10401,"Mount Pearl","NL",47.50513,-52.79476,2018-02-28 13:00:00,32,0,32
"10168",10401,"Mount Pearl","NL",47.50513,-52.79476,2018-02-28 14:00:00,33,1,34
"10169",10401,"Mount Pearl","NL",47.50513,-52.79476,2018-02-28 15:00:00,34,1,35
"10170",10401,"Mount Pearl","NL",47.50513,-52.79476,2018-02-28 16:00:00,36,1,37
"10171",10401,"Mount Pearl","NL",47.50513,-52.79476,2018-02-28 17:00:00,37,1,38
"10172",10401,"Mount Pearl","NL",47.50513,-52.79476,2018-02-28 18:00:00,39,0,39
"10173",10401,"Mount Pearl","NL",47.50513,-52.79476,2018-02-28 19:00:00,37,2,39
"10174",10401,"Mount Pearl","NL",47.50513,-52.79476,2018-02-28 20:00:00,39,0,39
"10175",10401,"Mount Pearl","NL",47.50513,-52.79476,2018-02-28 21:00:00,39,0,39
"10176",10401,"Mount Pearl","NL",47.50513,-52.79476,2018-02-28 22:00:00,38,0,38
"10177",10401,"Mount Pearl","NL",47.50513,-52.79476,2018-02-28 23:00:00,38,0,38
"10178",10401,"Mount Pearl","NL",47.50513,-52.79476,2018-03-01 00:00:00,37,0,37
"10179",10401,"Mount Pearl","NL",47.50513,-52.79476,2018-03-01 01:00:00,36,0,36
"10180",10401,"Mount Pearl","NL",47.50513,-52.79476,2018-03-01 02:00:00,37,0,37
"10181",10401,"Mount Pearl","NL",47.50513,-52.79476,2018-03-01 03:00:00,37,0,37
"10182",10401,"Mount Pearl","NL",47.50513,-52.79476,2018-03-01 04:00:00,39,0,39
"10183",10401,"Mount Pearl","NL",47.50513,-52.79476,2018-03-01 05:00:00,38,0,38
"10184",10401,"Mount Pearl","NL",47.50513,-52.79476,2018-03-01 06:00:00,39,0,39
"10185",10401,"Mount Pearl","NL",47.50513,-52.79476,2018-03-01 07:00:00,39,0,39
"10186",10401,"Mount Pearl","NL",47.50513,-52.79476,2018-03-01 08:00:00,38,0,38
"10187",10401,"Mount Pearl","NL",47.50513,-52.79476,2018-03-01 09:00:00,38,0,38
"10188",10401,"Mount Pearl","NL",47.50513,-52.79476,2018-03-01 10:00:00,38,0,38
"10189",10401,"Mount Pearl","NL",47.50513,-52.79476,2018-03-01 11:00:00,37,0,37
"10190",10401,"Mount Pearl","NL",47.50513,-52.79476,2018-03-01 12:00:00,36,1,37
"10191",10401,"Mount Pearl","NL",47.50513,-52.79476,2018-03-01 13:00:00,36,1,37
"10192",10401,"Mount Pearl","NL",47.50513,-52.79476,2018-03-01 14:00:00,35,1,36
"10193",10401,"Mount Pearl","NL",47.50513,-52.79476,2018-03-01 15:00:00,31,3,34
"10194",10401,"Mount Pearl","NL",47.50513,-52.79476,2018-03-01 16:00:00,25,6,31
"10195",10401,"Mount Pearl","NL",47.50513,-52.79476,2018-03-01 17:00:00,35,2,37
"10196",10401,"Mount Pearl","NL",47.50513,-52.79476,2018-03-01 18:00:00,35,2,37
"10197",10401,"Mount Pearl","NL",47.50513,-52.79476,2018-03-01 19:00:00,32,3,35
"10198",10401,"Mount Pearl","NL",47.50513,-52.79476,2018-03-01 20:00:00,36,2,38
"10199",10401,"Mount Pearl","NL",47.50513,-52.79476,2018-03-01 21:00:00,35,2,37
"10200",10401,"Mount Pearl","NL",47.50513,-52.79476,2018-03-01 22:00:00,37,1,38
"10201",10401,"Mount Pearl","NL",47.50513,-52.79476,2018-03-01 23:00:00,40,1,41
"10202",10401,"Mount Pearl","NL",47.50513,-52.79476,2018-03-02 00:00:00,38,1,39
"10203",10401,"Mount Pearl","NL",47.50513,-52.79476,2018-03-02 01:00:00,36,2,38
"10204",10401,"Mount Pearl","NL",47.50513,-52.79476,2018-03-02 02:00:00,36,2,38
"10205",10401,"Mount Pearl","NL",47.50513,-52.79476,2018-03-02 03:00:00,37,2,39
"10206",10401,"Mount Pearl","NL",47.50513,-52.79476,2018-03-02 04:00:00,35,2,37
"10207",10401,"Mount Pearl","NL",47.50513,-52.79476,2018-03-02 05:00:00,39,1,40
"10208",10401,"Mount Pearl","NL",47.50513,-52.79476,2018-03-02 06:00:00,37,1,38
"10209",10401,"Mount Pearl","NL",47.50513,-52.79476,2018-03-02 07:00:00,33,3,36
"10210",10401,"Mount Pearl","NL",47.50513,-52.79476,2018-03-02 08:00:00,28,6,34
"10211",10401,"Mount Pearl","NL",47.50513,-52.79476,2018-03-02 09:00:00,32,4,36
"10212",10401,"Mount Pearl","NL",47.50513,-52.79476,2018-03-02 10:00:00,35,2,37
"10213",10401,"Mount Pearl","NL",47.50513,-52.79476,2018-03-02 11:00:00,37,2,39
"10214",10401,"Mount Pearl","NL",47.50513,-52.79476,2018-03-02 12:00:00,38,2,40
"10215",10401,"Mount Pearl","NL",47.50513,-52.79476,2018-03-02 13:00:00,38,2,40
"10216",10401,"Mount Pearl","NL",47.50513,-52.79476,2018-03-02 14:00:00,38,2,40
"10217",10401,"Mount Pearl","NL",47.50513,-52.79476,2018-03-02 15:00:00,39,2,41
"10218",10401,"Mount Pearl","NL",47.50513,-52.79476,2018-03-02 16:00:00,39,2,41
"10219",10401,"Mount Pearl","NL",47.50513,-52.79476,2018-03-02 17:00:00,38,2,40
"10220",10401,"Mount Pearl","NL",47.50513,-52.79476,2018-03-02 18:00:00,37,2,39
"10221",10401,"Mount Pearl","NL",47.50513,-52.79476,2018-03-02 19:00:00,40,2,42
"10222",10401,"Mount Pearl","NL",47.50513,-52.79476,2018-03-02 20:00:00,41,1,42
"10223",10401,"Mount Pearl","NL",47.50513,-52.79476,2018-03-02 21:00:00,41,1,42
"10224",10401,"Mount Pearl","NL",47.50513,-52.79476,2018-03-02 22:00:00,42,1,43
"10225",10401,"Mount Pearl","NL",47.50513,-52.79476,2018-03-02 23:00:00,41,1,42
"10226",10401,"Mount Pearl","NL",47.50513,-52.79476,2018-03-03 00:00:00,41,0,41
"10227",10401,"Mount Pearl","NL",47.50513,-52.79476,2018-03-03 01:00:00,41,0,41
"10228",10401,"Mount Pearl","NL",47.50513,-52.79476,2018-03-03 02:00:00,41,1,42
"10229",10401,"Mount Pearl","NL",47.50513,-52.79476,2018-03-03 03:00:00,42,1,43
"10230",10401,"Mount Pearl","NL",47.50513,-52.79476,2018-03-03 04:00:00,42,1,43
"10231",10401,"Mount Pearl","NL",47.50513,-52.79476,2018-03-03 05:00:00,42,1,43
"10232",10401,"Mount Pearl","NL",47.50513,-52.79476,2018-03-03 06:00:00,42,1,43
"10233",10401,"Mount Pearl","NL",47.50513,-52.79476,2018-03-03 07:00:00,42,1,43
"10234",10401,"Mount Pearl","NL",47.50513,-52.79476,2018-03-03 08:00:00,41,1,42
"10235",10401,"Mount Pearl","NL",47.50513,-52.79476,2018-03-03 09:00:00,41,1,42
"10236",10401,"Mount Pearl","NL",47.50513,-52.79476,2018-03-03 10:00:00,40,1,41
"10237",10401,"Mount Pearl","NL",47.50513,-52.79476,2018-03-03 11:00:00,40,1,41
"10238",10401,"Mount Pearl","NL",47.50513,-52.79476,2018-03-03 12:00:00,40,0,40
"10239",10401,"Mount Pearl","NL",47.50513,-52.79476,2018-03-03 13:00:00,40,0,40
"10240",10401,"Mount Pearl","NL",47.50513,-52.79476,2018-03-03 14:00:00,39,0,39
"10241",10401,"Mount Pearl","NL",47.50513,-52.79476,2018-03-03 15:00:00,39,0,39
"10242",10401,"Mount Pearl","NL",47.50513,-52.79476,2018-03-03 16:00:00,39,1,40
"10243",10401,"Mount Pearl","NL",47.50513,-52.79476,2018-03-03 17:00:00,40,0,40
"10244",10401,"Mount Pearl","NL",47.50513,-52.79476,2018-03-03 18:00:00,41,1,42
"10245",10401,"Mount Pearl","NL",47.50513,-52.79476,2018-03-03 19:00:00,42,0,42
"10246",10401,"Mount Pearl","NL",47.50513,-52.79476,2018-03-03 20:00:00,43,0,43
"10247",10401,"Mount Pearl","NL",47.50513,-52.79476,2018-03-03 21:00:00,44,0,44
"10248",10401,"Mount Pearl","NL",47.50513,-52.79476,2018-03-03 22:00:00,44,0,44
"10249",10401,"Mount Pearl","NL",47.50513,-52.79476,2018-03-03 23:00:00,43,1,44
"10250",10401,"Mount Pearl","NL",47.50513,-52.79476,2018-03-04 00:00:00,43,1,44
"10251",10401,"Mount Pearl","NL",47.50513,-52.79476,2018-03-04 01:00:00,44,0,44
"10252",10401,"Mount Pearl","NL",47.50513,-52.79476,2018-03-04 02:00:00,44,0,44
"10253",10401,"Mount Pearl","NL",47.50513,-52.79476,2018-03-04 03:00:00,44,1,45
"10254",10401,"Mount Pearl","NL",47.50513,-52.79476,2018-03-04 04:00:00,44,0,44
"10255",10401,"Mount Pearl","NL",47.50513,-52.79476,2018-03-04 05:00:00,45,0,45
"10256",10401,"Mount Pearl","NL",47.50513,-52.79476,2018-03-04 06:00:00,44,0,44
"10257",10401,"Mount Pearl","NL",47.50513,-52.79476,2018-03-04 07:00:00,44,1,45
"10258",10401,"Mount Pearl","NL",47.50513,-52.79476,2018-03-04 08:00:00,44,0,44
"10259",10401,"Mount Pearl","NL",47.50513,-52.79476,2018-03-04 09:00:00,43,0,43
"10260",10401,"Mount Pearl","NL",47.50513,-52.79476,2018-03-04 10:00:00,42,1,43
"10261",10401,"Mount Pearl","NL",47.50513,-52.79476,2018-03-04 11:00:00,42,1,43
"10262",10401,"Mount Pearl","NL",47.50513,-52.79476,2018-03-04 12:00:00,41,1,42
"10263",10401,"Mount Pearl","NL",47.50513,-52.79476,2018-03-04 13:00:00,41,1,42
"10264",10401,"Mount Pearl","NL",47.50513,-52.79476,2018-03-04 14:00:00,41,1,42
"10265",10401,"Mount Pearl","NL",47.50513,-52.79476,2018-03-04 15:00:00,41,1,42
"10266",10401,"Mount Pearl","NL",47.50513,-52.79476,2018-03-04 16:00:00,41,1,42
"10267",10401,"Mount Pearl","NL",47.50513,-52.79476,2018-03-04 17:00:00,42,1,43
"10268",10401,"Mount Pearl","NL",47.50513,-52.79476,2018-03-04 18:00:00,42,1,43
"10269",10401,"Mount Pearl","NL",47.50513,-52.79476,2018-03-04 19:00:00,39,2,41
"10270",10401,"Mount Pearl","NL",47.50513,-52.79476,2018-03-04 20:00:00,39,2,41
"10271",10401,"Mount Pearl","NL",47.50513,-52.79476,2018-03-04 21:00:00,41,1,42
"10272",10401,"Mount Pearl","NL",47.50513,-52.79476,2018-03-04 22:00:00,42,1,43
"10273",10401,"Mount Pearl","NL",47.50513,-52.79476,2018-03-04 23:00:00,42,1,43
"10274",10401,"Mount Pearl","NL",47.50513,-52.79476,2018-03-05 00:00:00,43,1,44
"10275",10401,"Mount Pearl","NL",47.50513,-52.79476,2018-03-05 01:00:00,42,1,43
"10276",10401,"Mount Pearl","NL",47.50513,-52.79476,2018-03-05 02:00:00,42,1,43
"10277",10401,"Mount Pearl","NL",47.50513,-52.79476,2018-03-05 03:00:00,42,1,43
"10278",10401,"Mount Pearl","NL",47.50513,-52.79476,2018-03-05 04:00:00,42,1,43
"10279",10401,"Mount Pearl","NL",47.50513,-52.79476,2018-03-05 05:00:00,42,1,43
"10280",10401,"Mount Pearl","NL",47.50513,-52.79476,2018-03-05 06:00:00,43,1,44
"10281",10401,"Mount Pearl","NL",47.50513,-52.79476,2018-03-05 07:00:00,42,1,43
"10282",10401,"Mount Pearl","NL",47.50513,-52.79476,2018-03-05 08:00:00,41,1,42
"10283",10401,"Mount Pearl","NL",47.50513,-52.79476,2018-03-05 09:00:00,41,1,42
"10284",10401,"Mount Pearl","NL",47.50513,-52.79476,2018-03-05 10:00:00,41,1,42
"10285",10401,"Mount Pearl","NL",47.50513,-52.79476,2018-03-05 11:00:00,41,1,42
"10286",10401,"Mount Pearl","NL",47.50513,-52.79476,2018-03-05 12:00:00,42,1,43
"10287",10401,"Mount Pearl","NL",47.50513,-52.79476,2018-03-05 13:00:00,42,1,43
"10288",10401,"Mount Pearl","NL",47.50513,-52.79476,2018-03-05 14:00:00,43,1,44
"10289",10401,"Mount Pearl","NL",47.50513,-52.79476,2018-03-05 15:00:00,42,1,43
"10290",10401,"Mount Pearl","NL",47.50513,-52.79476,2018-03-05 16:00:00,41,1,42
"10291",10401,"Mount Pearl","NL",47.50513,-52.79476,2018-03-05 17:00:00,42,1,43
"10292",10401,"Mount Pearl","NL",47.50513,-52.79476,2018-03-05 18:00:00,43,0,43
"10293",10401,"Mount Pearl","NL",47.50513,-52.79476,2018-03-05 19:00:00,43,0,43
"10294",10401,"Mount Pearl","NL",47.50513,-52.79476,2018-03-05 20:00:00,44,0,44
"10295",10401,"Mount Pearl","NL",47.50513,-52.79476,2018-03-05 21:00:00,44,1,45
"10296",10401,"Mount Pearl","NL",47.50513,-52.79476,2018-03-05 22:00:00,44,0,44
"10297",10401,"Mount Pearl","NL",47.50513,-52.79476,2018-03-05 23:00:00,44,0,44
"10298",10401,"Mount Pearl","NL",47.50513,-52.79476,2018-03-06 00:00:00,44,0,44
"10299",10401,"Mount Pearl","NL",47.50513,-52.79476,2018-03-06 01:00:00,45,0,45
"10300",10401,"Mount Pearl","NL",47.50513,-52.79476,2018-03-06 02:00:00,45,0,45
"10301",10401,"Mount Pearl","NL",47.50513,-52.79476,2018-03-06 03:00:00,44,0,44
"10302",10401,"Mount Pearl","NL",47.50513,-52.79476,2018-03-06 04:00:00,44,0,44
"10303",10401,"Mount Pearl","NL",47.50513,-52.79476,2018-03-06 05:00:00,44,0,44
"10304",10401,"Mount Pearl","NL",47.50513,-52.79476,2018-03-06 06:00:00,44,0,44
"10305",10401,"Mount Pearl","NL",47.50513,-52.79476,2018-03-06 07:00:00,43,0,43
"10306",10401,"Mount Pearl","NL",47.50513,-52.79476,2018-03-06 08:00:00,41,1,42
"10307",10401,"Mount Pearl","NL",47.50513,-52.79476,2018-03-06 09:00:00,42,1,43
"10308",10401,"Mount Pearl","NL",47.50513,-52.79476,2018-03-06 10:00:00,43,0,43
"10309",10401,"Mount Pearl","NL",47.50513,-52.79476,2018-03-06 11:00:00,43,1,44
"10310",10401,"Mount Pearl","NL",47.50513,-52.79476,2018-03-06 12:00:00,43,1,44
"10311",10401,"Mount Pearl","NL",47.50513,-52.79476,2018-03-06 13:00:00,43,1,44
"10312",10401,"Mount Pearl","NL",47.50513,-52.79476,2018-03-06 14:00:00,43,1,44
"10313",10401,"Mount Pearl","NL",47.50513,-52.79476,2018-03-06 15:00:00,44,1,45
"10314",10401,"Mount Pearl","NL",47.50513,-52.79476,2018-03-06 16:00:00,45,1,46
"10315",10401,"Mount Pearl","NL",47.50513,-52.79476,2018-03-06 17:00:00,45,1,46
"10316",10401,"Mount Pearl","NL",47.50513,-52.79476,2018-03-06 18:00:00,45,1,46
"10317",10401,"Mount Pearl","NL",47.50513,-52.79476,2018-03-06 19:00:00,44,1,45
"10318",10401,"Mount Pearl","NL",47.50513,-52.79476,2018-03-06 20:00:00,44,1,45
"10319",10401,"Mount Pearl","NL",47.50513,-52.79476,2018-03-06 21:00:00,43,0,43
"10320",10401,"Mount Pearl","NL",47.50513,-52.79476,2018-03-06 22:00:00,44,0,44
"10321",10401,"Mount Pearl","NL",47.50513,-52.79476,2018-03-06 23:00:00,43,1,44
"10322",10401,"Mount Pearl","NL",47.50513,-52.79476,2018-03-07 00:00:00,43,1,44
"10323",10401,"Mount Pearl","NL",47.50513,-52.79476,2018-03-07 01:00:00,43,0,43
"10324",10401,"Mount Pearl","NL",47.50513,-52.79476,2018-03-07 02:00:00,43,1,44
"10325",10401,"Mount Pearl","NL",47.50513,-52.79476,2018-03-07 03:00:00,44,0,44
"10326",10401,"Mount Pearl","NL",47.50513,-52.79476,2018-03-07 04:00:00,44,0,44
"10327",10401,"Mount Pearl","NL",47.50513,-52.79476,2018-03-07 05:00:00,44,1,45
"10328",10401,"Mount Pearl","NL",47.50513,-52.79476,2018-03-07 06:00:00,44,0,44
"10329",10401,"Mount Pearl","NL",47.50513,-52.79476,2018-03-07 07:00:00,44,0,44
"10330",10401,"Mount Pearl","NL",47.50513,-52.79476,2018-03-07 08:00:00,43,1,44
"10331",10401,"Mount Pearl","NL",47.50513,-52.79476,2018-03-07 09:00:00,43,1,44
"10332",10401,"Mount Pearl","NL",47.50513,-52.79476,2018-03-07 10:00:00,43,1,44
"10333",10401,"Mount Pearl","NL",47.50513,-52.79476,2018-03-07 11:00:00,43,0,43
"10334",10401,"Mount Pearl","NL",47.50513,-52.79476,2018-03-07 12:00:00,42,0,42
"10335",10401,"Mount Pearl","NL",47.50513,-52.79476,2018-03-07 13:00:00,42,1,43
"10336",10401,"Mount Pearl","NL",47.50513,-52.79476,2018-03-07 14:00:00,42,1,43
"10337",10401,"Mount Pearl","NL",47.50513,-52.79476,2018-03-07 15:00:00,42,1,43
"10338",10401,"Mount Pearl","NL",47.50513,-52.79476,2018-03-07 16:00:00,42,1,43
"10339",10401,"Mount Pearl","NL",47.50513,-52.79476,2018-03-07 17:00:00,42,1,43
"10340",10401,"Mount Pearl","NL",47.50513,-52.79476,2018-03-07 18:00:00,42,1,43
"10341",10401,"Mount Pearl","NL",47.50513,-52.79476,2018-03-07 19:00:00,43,1,44
"10342",10401,"Mount Pearl","NL",47.50513,-52.79476,2018-03-07 20:00:00,43,1,44
"10343",10401,"Mount Pearl","NL",47.50513,-52.79476,2018-03-07 21:00:00,43,1,44
"10344",10401,"Mount Pearl","NL",47.50513,-52.79476,2018-03-07 22:00:00,43,1,44
"10345",10401,"Mount Pearl","NL",47.50513,-52.79476,2018-03-07 23:00:00,43,1,44
"10346",10401,"Mount Pearl","NL",47.50513,-52.79476,2018-03-08 00:00:00,43,1,44
"10347",10401,"Mount Pearl","NL",47.50513,-52.79476,2018-03-08 01:00:00,43,1,44
"10348",10401,"Mount Pearl","NL",47.50513,-52.79476,2018-03-08 02:00:00,43,0,43
"10349",10401,"Mount Pearl","NL",47.50513,-52.79476,2018-03-08 03:00:00,43,1,44
"10350",10401,"Mount Pearl","NL",47.50513,-52.79476,2018-03-08 04:00:00,43,1,44
"10351",10401,"Mount Pearl","NL",47.50513,-52.79476,2018-03-08 05:00:00,43,1,44
"10352",10401,"Mount Pearl","NL",47.50513,-52.79476,2018-03-08 06:00:00,43,1,44
"10353",10401,"Mount Pearl","NL",47.50513,-52.79476,2018-03-08 07:00:00,43,1,44
"10354",10401,"Mount Pearl","NL",47.50513,-52.79476,2018-03-08 08:00:00,42,1,43
"10355",10401,"Mount Pearl","NL",47.50513,-52.79476,2018-03-08 09:00:00,42,1,43
"10356",10401,"Mount Pearl","NL",47.50513,-52.79476,2018-03-08 10:00:00,42,1,43
"10357",10401,"Mount Pearl","NL",47.50513,-52.79476,2018-03-08 11:00:00,42,1,43
"10358",10401,"Mount Pearl","NL",47.50513,-52.79476,2018-03-08 12:00:00,42,0,42
"10359",10401,"Mount Pearl","NL",47.50513,-52.79476,2018-03-08 13:00:00,42,0,42
"10360",10401,"Mount Pearl","NL",47.50513,-52.79476,2018-03-08 14:00:00,41,0,41
"10361",10401,"Mount Pearl","NL",47.50513,-52.79476,2018-03-08 15:00:00,41,1,42
"10362",10401,"Mount Pearl","NL",47.50513,-52.79476,2018-03-08 16:00:00,42,1,43
"10363",10401,"Mount Pearl","NL",47.50513,-52.79476,2018-03-08 17:00:00,41,1,42
"10364",10401,"Mount Pearl","NL",47.50513,-52.79476,2018-03-08 18:00:00,41,1,42
"10365",10401,"Mount Pearl","NL",47.50513,-52.79476,2018-03-08 19:00:00,38,1,39
"10366",10401,"Mount Pearl","NL",47.50513,-52.79476,2018-03-08 20:00:00,38,2,40
"10367",10401,"Mount Pearl","NL",47.50513,-52.79476,2018-03-08 21:00:00,40,1,41
"10368",10401,"Mount Pearl","NL",47.50513,-52.79476,2018-03-08 22:00:00,42,0,42
"10369",10401,"Mount Pearl","NL",47.50513,-52.79476,2018-03-08 23:00:00,42,0,42
"10370",10401,"Mount Pearl","NL",47.50513,-52.79476,2018-03-09 00:00:00,43,0,43
"10371",10401,"Mount Pearl","NL",47.50513,-52.79476,2018-03-09 01:00:00,42,0,42
"10372",10401,"Mount Pearl","NL",47.50513,-52.79476,2018-03-09 02:00:00,43,0,43
"10373",10401,"Mount Pearl","NL",47.50513,-52.79476,2018-03-09 03:00:00,43,0,43
"10374",10401,"Mount Pearl","NL",47.50513,-52.79476,2018-03-09 04:00:00,43,0,43
"10375",10401,"Mount Pearl","NL",47.50513,-52.79476,2018-03-09 05:00:00,42,0,42
"10376",10401,"Mount Pearl","NL",47.50513,-52.79476,2018-03-09 06:00:00,42,0,42
"10377",10401,"Mount Pearl","NL",47.50513,-52.79476,2018-03-09 07:00:00,40,1,41
"10378",10401,"Mount Pearl","NL",47.50513,-52.79476,2018-03-09 08:00:00,38,1,39
"10379",10401,"Mount Pearl","NL",47.50513,-52.79476,2018-03-09 09:00:00,37,1,38
"10380",10401,"Mount Pearl","NL",47.50513,-52.79476,2018-03-09 10:00:00,40,0,40
"10381",10401,"Mount Pearl","NL",47.50513,-52.79476,2018-03-09 11:00:00,40,0,40
"10382",10401,"Mount Pearl","NL",47.50513,-52.79476,2018-03-09 12:00:00,40,1,41
"10383",10401,"Mount Pearl","NL",47.50513,-52.79476,2018-03-09 13:00:00,40,1,41
"10384",10401,"Mount Pearl","NL",47.50513,-52.79476,2018-03-09 14:00:00,41,1,42
"10385",10401,"Mount Pearl","NL",47.50513,-52.79476,2018-03-09 15:00:00,41,1,42
"10386",10401,"Mount Pearl","NL",47.50513,-52.79476,2018-03-09 16:00:00,41,1,42
"10387",10401,"Mount Pearl","NL",47.50513,-52.79476,2018-03-09 17:00:00,41,1,42
"10388",10401,"Mount Pearl","NL",47.50513,-52.79476,2018-03-09 18:00:00,42,1,43
"10389",10401,"Mount Pearl","NL",47.50513,-52.79476,2018-03-09 19:00:00,42,1,43
"10390",10401,"Mount Pearl","NL",47.50513,-52.79476,2018-03-09 20:00:00,43,1,44
"10391",10401,"Mount Pearl","NL",47.50513,-52.79476,2018-03-09 21:00:00,43,1,44
"10392",10401,"Mount Pearl","NL",47.50513,-52.79476,2018-03-09 22:00:00,44,1,45
"10393",10401,"Mount Pearl","NL",47.50513,-52.79476,2018-03-09 23:00:00,44,1,45
"10394",10401,"Mount Pearl","NL",47.50513,-52.79476,2018-03-10 00:00:00,45,1,46
"10395",10401,"Mount Pearl","NL",47.50513,-52.79476,2018-03-10 01:00:00,45,1,46
"10396",10401,"Mount Pearl","NL",47.50513,-52.79476,2018-03-10 02:00:00,45,1,46
"10397",10401,"Mount Pearl","NL",47.50513,-52.79476,2018-03-10 03:00:00,45,1,46
"10398",10401,"Mount Pearl","NL",47.50513,-52.79476,2018-03-10 04:00:00,45,1,46
"10399",10401,"Mount Pearl","NL",47.50513,-52.79476,2018-03-10 05:00:00,44,1,45
"10400",10401,"Mount Pearl","NL",47.50513,-52.79476,2018-03-10 06:00:00,43,1,44
"10401",10401,"Mount Pearl","NL",47.50513,-52.79476,2018-03-10 07:00:00,43,1,44
"10402",10401,"Mount Pearl","NL",47.50513,-52.79476,2018-03-10 08:00:00,43,1,44
"10403",10401,"Mount Pearl","NL",47.50513,-52.79476,2018-03-10 09:00:00,42,1,43
"10404",10401,"Mount Pearl","NL",47.50513,-52.79476,2018-03-10 10:00:00,43,1,44
"10405",10401,"Mount Pearl","NL",47.50513,-52.79476,2018-03-10 11:00:00,42,1,43
"10406",10401,"Mount Pearl","NL",47.50513,-52.79476,2018-03-10 12:00:00,41,1,42
"10407",10401,"Mount Pearl","NL",47.50513,-52.79476,2018-03-10 13:00:00,40,1,41
"10408",10401,"Mount Pearl","NL",47.50513,-52.79476,2018-03-10 14:00:00,40,1,41
"10409",10401,"Mount Pearl","NL",47.50513,-52.79476,2018-03-10 15:00:00,41,1,42
"10410",10401,"Mount Pearl","NL",47.50513,-52.79476,2018-03-10 16:00:00,41,1,42
"10411",10401,"Mount Pearl","NL",47.50513,-52.79476,2018-03-10 17:00:00,41,1,42
"10412",10401,"Mount Pearl","NL",47.50513,-52.79476,2018-03-10 18:00:00,42,1,43
"10413",10401,"Mount Pearl","NL",47.50513,-52.79476,2018-03-10 19:00:00,40,1,41
"10414",10401,"Mount Pearl","NL",47.50513,-52.79476,2018-03-10 20:00:00,41,1,42
"10415",10401,"Mount Pearl","NL",47.50513,-52.79476,2018-03-10 21:00:00,41,1,42
"10416",10401,"Mount Pearl","NL",47.50513,-52.79476,2018-03-10 22:00:00,42,1,43
"10417",10401,"Mount Pearl","NL",47.50513,-52.79476,2018-03-10 23:00:00,40,1,41
"10418",10401,"Mount Pearl","NL",47.50513,-52.79476,2018-03-11 00:00:00,42,1,43
"10419",10401,"Mount Pearl","NL",47.50513,-52.79476,2018-03-11 01:00:00,42,0,42
"10420",10401,"Mount Pearl","NL",47.50513,-52.79476,2018-03-11 01:00:00,42,1,43
"10421",10401,"Mount Pearl","NL",47.50513,-52.79476,2018-03-11 01:00:00,41,0,41
"10422",10401,"Mount Pearl","NL",47.50513,-52.79476,2018-03-11 01:00:00,41,1,42
"10423",10401,"Mount Pearl","NL",47.50513,-52.79476,2018-03-11 03:00:00,40,1,41
"10424",10401,"Mount Pearl","NL",47.50513,-52.79476,2018-03-11 04:00:00,39,1,40
"10425",10401,"Mount Pearl","NL",47.50513,-52.79476,2018-03-11 05:00:00,36,1,37
"10426",10401,"Mount Pearl","NL",47.50513,-52.79476,2018-03-11 06:00:00,37,1,38
"10427",10401,"Mount Pearl","NL",47.50513,-52.79476,2018-03-11 07:00:00,34,2,36
"10428",10401,"Mount Pearl","NL",47.50513,-52.79476,2018-03-11 08:00:00,34,3,37
"10429",10401,"Mount Pearl","NL",47.50513,-52.79476,2018-03-11 09:00:00,36,2,38
"10430",10401,"Mount Pearl","NL",47.50513,-52.79476,2018-03-11 10:00:00,37,2,39
"10431",10401,"Mount Pearl","NL",47.50513,-52.79476,2018-03-11 11:00:00,41,1,42
"10432",10401,"Mount Pearl","NL",47.50513,-52.79476,2018-03-11 12:00:00,41,1,42
"10433",10401,"Mount Pearl","NL",47.50513,-52.79476,2018-03-11 13:00:00,40,1,41
"10434",10401,"Mount Pearl","NL",47.50513,-52.79476,2018-03-11 14:00:00,39,1,40
"10435",10401,"Mount Pearl","NL",47.50513,-52.79476,2018-03-11 15:00:00,40,0,40
"10436",10401,"Mount Pearl","NL",47.50513,-52.79476,2018-03-11 16:00:00,42,0,42
"10437",10401,"Mount Pearl","NL",47.50513,-52.79476,2018-03-11 17:00:00,42,1,43
"10438",10401,"Mount Pearl","NL",47.50513,-52.79476,2018-03-11 18:00:00,44,0,44
"10439",10401,"Mount Pearl","NL",47.50513,-52.79476,2018-03-11 19:00:00,45,0,45
"10440",10401,"Mount Pearl","NL",47.50513,-52.79476,2018-03-11 20:00:00,45,0,45
"10441",10401,"Mount Pearl","NL",47.50513,-52.79476,2018-03-11 21:00:00,46,0,46
"10442",10401,"Mount Pearl","NL",47.50513,-52.79476,2018-03-11 22:00:00,46,0,46
"10443",10401,"Mount Pearl","NL",47.50513,-52.79476,2018-03-11 23:00:00,45,0,45
"10444",10401,"Mount Pearl","NL",47.50513,-52.79476,2018-03-12 00:00:00,45,0,45
"10445",10401,"Mount Pearl","NL",47.50513,-52.79476,2018-03-12 01:00:00,45,0,45
"10446",10401,"Mount Pearl","NL",47.50513,-52.79476,2018-03-12 02:00:00,44,0,44
"10447",10401,"Mount Pearl","NL",47.50513,-52.79476,2018-03-12 03:00:00,44,0,44
"10448",10401,"Mount Pearl","NL",47.50513,-52.79476,2018-03-12 04:00:00,44,0,44
"10449",10401,"Mount Pearl","NL",47.50513,-52.79476,2018-03-12 05:00:00,44,0,44
"10450",10401,"Mount Pearl","NL",47.50513,-52.79476,2018-03-12 06:00:00,45,0,45
"10451",10401,"Mount Pearl","NL",47.50513,-52.79476,2018-03-12 07:00:00,44,0,44
"10452",10401,"Mount Pearl","NL",47.50513,-52.79476,2018-03-12 08:00:00,41,1,42
"10453",10401,"Mount Pearl","NL",47.50513,-52.79476,2018-03-12 09:00:00,41,0,41
"10454",10401,"Mount Pearl","NL",47.50513,-52.79476,2018-03-12 10:00:00,41,0,41
"10455",10401,"Mount Pearl","NL",47.50513,-52.79476,2018-03-12 11:00:00,40,0,40
"10456",10401,"Mount Pearl","NL",47.50513,-52.79476,2018-03-12 12:00:00,41,1,42
"10457",10401,"Mount Pearl","NL",47.50513,-52.79476,2018-03-12 13:00:00,42,0,42
"10458",10401,"Mount Pearl","NL",47.50513,-52.79476,2018-03-12 14:00:00,43,0,43
"10459",10401,"Mount Pearl","NL",47.50513,-52.79476,2018-03-12 15:00:00,43,1,44
"10460",10401,"Mount Pearl","NL",47.50513,-52.79476,2018-03-12 16:00:00,43,0,43
"10461",10401,"Mount Pearl","NL",47.50513,-52.79476,2018-03-12 17:00:00,43,0,43
"10462",10401,"Mount Pearl","NL",47.50513,-52.79476,2018-03-12 18:00:00,44,0,44
"10463",10401,"Mount Pearl","NL",47.50513,-52.79476,2018-03-12 19:00:00,45,0,45
"10464",10401,"Mount Pearl","NL",47.50513,-52.79476,2018-03-12 20:00:00,46,0,46
"10465",10401,"Mount Pearl","NL",47.50513,-52.79476,2018-03-12 21:00:00,45,0,45
"10466",10401,"Mount Pearl","NL",47.50513,-52.79476,2018-03-12 22:00:00,44,0,44
"10467",10401,"Mount Pearl","NL",47.50513,-52.79476,2018-03-12 23:00:00,45,0,45
"10468",10401,"Mount Pearl","NL",47.50513,-52.79476,2018-03-13 00:00:00,46,0,46
"10469",10401,"Mount Pearl","NL",47.50513,-52.79476,2018-03-13 01:00:00,45,0,45
"10470",10401,"Mount Pearl","NL",47.50513,-52.79476,2018-03-13 02:00:00,43,0,43
"10471",10401,"Mount Pearl","NL",47.50513,-52.79476,2018-03-13 03:00:00,43,0,43
"10472",10401,"Mount Pearl","NL",47.50513,-52.79476,2018-03-13 04:00:00,42,0,42
"10473",10401,"Mount Pearl","NL",47.50513,-52.79476,2018-03-13 05:00:00,40,0,40
"10474",10401,"Mount Pearl","NL",47.50513,-52.79476,2018-03-13 06:00:00,38,0,38
"10475",10401,"Mount Pearl","NL",47.50513,-52.79476,2018-03-13 07:00:00,37,1,38
"10476",10401,"Mount Pearl","NL",47.50513,-52.79476,2018-03-13 08:00:00,37,1,38
"10477",10401,"Mount Pearl","NL",47.50513,-52.79476,2018-03-13 09:00:00,36,1,37
"10478",10401,"Mount Pearl","NL",47.50513,-52.79476,2018-03-13 10:00:00,36,1,37
"10479",10401,"Mount Pearl","NL",47.50513,-52.79476,2018-03-13 11:00:00,37,1,38
"10480",10401,"Mount Pearl","NL",47.50513,-52.79476,2018-03-13 12:00:00,36,0,36
"10481",10401,"Mount Pearl","NL",47.50513,-52.79476,2018-03-13 13:00:00,37,1,38
"10482",10401,"Mount Pearl","NL",47.50513,-52.79476,2018-03-13 14:00:00,37,1,38
"10483",10401,"Mount Pearl","NL",47.50513,-52.79476,2018-03-13 15:00:00,37,0,37
"10484",10401,"Mount Pearl","NL",47.50513,-52.79476,2018-03-13 16:00:00,37,0,37
"10485",10401,"Mount Pearl","NL",47.50513,-52.79476,2018-03-13 17:00:00,38,0,38
"10486",10401,"Mount Pearl","NL",47.50513,-52.79476,2018-03-13 18:00:00,38,1,39
"10487",10401,"Mount Pearl","NL",47.50513,-52.79476,2018-03-13 19:00:00,39,1,40
"10488",10401,"Mount Pearl","NL",47.50513,-52.79476,2018-03-13 20:00:00,41,0,41
"10489",10401,"Mount Pearl","NL",47.50513,-52.79476,2018-03-13 21:00:00,42,0,42
"10490",10401,"Mount Pearl","NL",47.50513,-52.79476,2018-03-13 22:00:00,42,0,42
"10491",10401,"Mount Pearl","NL",47.50513,-52.79476,2018-03-13 23:00:00,42,0,42
"10492",10401,"Mount Pearl","NL",47.50513,-52.79476,2018-03-14 00:00:00,43,0,43
"10493",10401,"Mount Pearl","NL",47.50513,-52.79476,2018-03-14 01:00:00,43,0,43
"10494",10401,"Mount Pearl","NL",47.50513,-52.79476,2018-03-14 02:00:00,43,0,43
"10495",10401,"Mount Pearl","NL",47.50513,-52.79476,2018-03-14 03:00:00,44,0,44
"10496",10401,"Mount Pearl","NL",47.50513,-52.79476,2018-03-14 04:00:00,44,0,44
"10497",10401,"Mount Pearl","NL",47.50513,-52.79476,2018-03-14 05:00:00,44,0,44
"10498",10401,"Mount Pearl","NL",47.50513,-52.79476,2018-03-14 06:00:00,44,0,44
"10499",10401,"Mount Pearl","NL",47.50513,-52.79476,2018-03-14 07:00:00,44,0,44
"10500",10401,"Mount Pearl","NL",47.50513,-52.79476,2018-03-14 08:00:00,44,1,45
"10501",10401,"Mount Pearl","NL",47.50513,-52.79476,2018-03-14 09:00:00,45,1,46
"10502",10401,"Mount Pearl","NL",47.50513,-52.79476,2018-03-14 10:00:00,45,0,45
"10503",10401,"Mount Pearl","NL",47.50513,-52.79476,2018-03-14 11:00:00,44,0,44
"10504",10401,"Mount Pearl","NL",47.50513,-52.79476,2018-03-14 12:00:00,44,1,45
"10505",10401,"Mount Pearl","NL",47.50513,-52.79476,2018-03-14 13:00:00,43,1,44
"10506",10401,"Mount Pearl","NL",47.50513,-52.79476,2018-03-14 14:00:00,43,1,44
"10507",10401,"Mount Pearl","NL",47.50513,-52.79476,2018-03-14 15:00:00,43,1,44
"10508",10401,"Mount Pearl","NL",47.50513,-52.79476,2018-03-14 16:00:00,43,1,44
"10509",10401,"Mount Pearl","NL",47.50513,-52.79476,2018-03-14 17:00:00,43,1,44
"10510",10401,"Mount Pearl","NL",47.50513,-52.79476,2018-03-14 18:00:00,40,2,42
"10511",10401,"Mount Pearl","NL",47.50513,-52.79476,2018-03-14 19:00:00,40,1,41
"10512",10401,"Mount Pearl","NL",47.50513,-52.79476,2018-03-14 20:00:00,40,1,41
"10513",10401,"Mount Pearl","NL",47.50513,-52.79476,2018-03-14 21:00:00,40,1,41
"10514",10401,"Mount Pearl","NL",47.50513,-52.79476,2018-03-14 22:00:00,40,0,40
"10515",10401,"Mount Pearl","NL",47.50513,-52.79476,2018-03-14 23:00:00,40,1,41
"10516",10401,"Mount Pearl","NL",47.50513,-52.79476,2018-03-15 00:00:00,35,1,36
"10517",10401,"Mount Pearl","NL",47.50513,-52.79476,2018-03-15 01:00:00,32,2,34
"10518",10401,"Mount Pearl","NL",47.50513,-52.79476,2018-03-15 02:00:00,34,1,35
"10519",10401,"Mount Pearl","NL",47.50513,-52.79476,2018-03-15 03:00:00,36,1,37
"10520",10401,"Mount Pearl","NL",47.50513,-52.79476,2018-03-15 04:00:00,36,1,37
"10521",10401,"Mount Pearl","NL",47.50513,-52.79476,2018-03-15 05:00:00,37,1,38
"10522",10401,"Mount Pearl","NL",47.50513,-52.79476,2018-03-15 06:00:00,40,1,41
"10523",10401,"Mount Pearl","NL",47.50513,-52.79476,2018-03-15 07:00:00,41,1,42
"10524",10401,"Mount Pearl","NL",47.50513,-52.79476,2018-03-15 08:00:00,41,1,42
"10525",10401,"Mount Pearl","NL",47.50513,-52.79476,2018-03-15 09:00:00,41,1,42
"10526",10401,"Mount Pearl","NL",47.50513,-52.79476,2018-03-15 10:00:00,40,1,41
"10527",10401,"Mount Pearl","NL",47.50513,-52.79476,2018-03-15 11:00:00,40,1,41
"10528",10401,"Mount Pearl","NL",47.50513,-52.79476,2018-03-15 12:00:00,40,0,40
"10529",10401,"Mount Pearl","NL",47.50513,-52.79476,2018-03-15 13:00:00,42,0,42
"10530",10401,"Mount Pearl","NL",47.50513,-52.79476,2018-03-15 14:00:00,43,0,43
"10531",10401,"Mount Pearl","NL",47.50513,-52.79476,2018-03-15 15:00:00,43,0,43
"10532",10401,"Mount Pearl","NL",47.50513,-52.79476,2018-03-15 16:00:00,43,0,43
"10533",10401,"Mount Pearl","NL",47.50513,-52.79476,2018-03-15 17:00:00,44,0,44
"10534",10401,"Mount Pearl","NL",47.50513,-52.79476,2018-03-15 18:00:00,40,1,41
"10535",10401,"Mount Pearl","NL",47.50513,-52.79476,2018-03-15 19:00:00,37,2,39
"10536",10401,"Mount Pearl","NL",47.50513,-52.79476,2018-03-15 20:00:00,41,1,42
"10537",10401,"Mount Pearl","NL",47.50513,-52.79476,2018-03-15 21:00:00,43,0,43
"10538",10401,"Mount Pearl","NL",47.50513,-52.79476,2018-03-15 22:00:00,42,1,43
"10539",10401,"Mount Pearl","NL",47.50513,-52.79476,2018-03-15 23:00:00,42,0,42
"10540",10401,"Mount Pearl","NL",47.50513,-52.79476,2018-03-16 00:00:00,45,0,45
"10541",10401,"Mount Pearl","NL",47.50513,-52.79476,2018-03-16 01:00:00,44,0,44
"10542",10401,"Mount Pearl","NL",47.50513,-52.79476,2018-03-16 02:00:00,42,0,42
"10543",10401,"Mount Pearl","NL",47.50513,-52.79476,2018-03-16 03:00:00,41,0,41
"10544",10401,"Mount Pearl","NL",47.50513,-52.79476,2018-03-16 04:00:00,41,0,41
"10545",10401,"Mount Pearl","NL",47.50513,-52.79476,2018-03-16 05:00:00,41,0,41
"10546",10401,"Mount Pearl","NL",47.50513,-52.79476,2018-03-16 06:00:00,39,0,39
"10547",10401,"Mount Pearl","NL",47.50513,-52.79476,2018-03-16 07:00:00,38,0,38
"10548",10401,"Mount Pearl","NL",47.50513,-52.79476,2018-03-16 08:00:00,35,0,35
"10549",10401,"Mount Pearl","NL",47.50513,-52.79476,2018-03-16 09:00:00,35,0,35
"10550",10401,"Mount Pearl","NL",47.50513,-52.79476,2018-03-16 10:00:00,35,0,35
"10551",10401,"Mount Pearl","NL",47.50513,-52.79476,2018-03-16 11:00:00,34,0,34
"10552",10401,"Mount Pearl","NL",47.50513,-52.79476,2018-03-16 12:00:00,35,0,35
"10553",10401,"Mount Pearl","NL",47.50513,-52.79476,2018-03-16 13:00:00,37,0,37
"10554",10401,"Mount Pearl","NL",47.50513,-52.79476,2018-03-16 14:00:00,38,0,38
"10555",10401,"Mount Pearl","NL",47.50513,-52.79476,2018-03-16 15:00:00,39,1,40
"10556",10401,"Mount Pearl","NL",47.50513,-52.79476,2018-03-16 16:00:00,40,1,41
"10557",10401,"Mount Pearl","NL",47.50513,-52.79476,2018-03-16 17:00:00,40,1,41
"10558",10401,"Mount Pearl","NL",47.50513,-52.79476,2018-03-16 18:00:00,40,0,40
"10559",10401,"Mount Pearl","NL",47.50513,-52.79476,2018-03-16 19:00:00,36,2,38
"10560",10401,"Mount Pearl","NL",47.50513,-52.79476,2018-03-16 20:00:00,34,2,36
"10561",10401,"Mount Pearl","NL",47.50513,-52.79476,2018-03-16 21:00:00,32,2,34
"10562",10401,"Mount Pearl","NL",47.50513,-52.79476,2018-03-16 22:00:00,33,2,35
"10563",10401,"Mount Pearl","NL",47.50513,-52.79476,2018-03-16 23:00:00,21,5,26
"10564",10401,"Mount Pearl","NL",47.50513,-52.79476,2018-03-17 00:00:00,18,7,25
"10565",10401,"Mount Pearl","NL",47.50513,-52.79476,2018-03-17 01:00:00,27,4,31
"10566",10401,"Mount Pearl","NL",47.50513,-52.79476,2018-03-17 02:00:00,34,1,35
"10567",10401,"Mount Pearl","NL",47.50513,-52.79476,2018-03-17 03:00:00,35,1,36
"10568",10401,"Mount Pearl","NL",47.50513,-52.79476,2018-03-17 04:00:00,34,1,35
"10569",10401,"Mount Pearl","NL",47.50513,-52.79476,2018-03-17 05:00:00,36,1,37
"10570",10401,"Mount Pearl","NL",47.50513,-52.79476,2018-03-17 06:00:00,37,0,37
"10571",10401,"Mount Pearl","NL",47.50513,-52.79476,2018-03-17 07:00:00,35,1,36
"10572",10401,"Mount Pearl","NL",47.50513,-52.79476,2018-03-17 08:00:00,31,1,32
"10573",10401,"Mount Pearl","NL",47.50513,-52.79476,2018-03-17 09:00:00,34,1,35
"10574",10401,"Mount Pearl","NL",47.50513,-52.79476,2018-03-17 10:00:00,34,0,34
"10575",10401,"Mount Pearl","NL",47.50513,-52.79476,2018-03-17 11:00:00,34,0,34
"10576",10401,"Mount Pearl","NL",47.50513,-52.79476,2018-03-17 12:00:00,36,1,37
"10577",10401,"Mount Pearl","NL",47.50513,-52.79476,2018-03-17 13:00:00,38,1,39
"10578",10401,"Mount Pearl","NL",47.50513,-52.79476,2018-03-17 14:00:00,39,2,41
"10579",10401,"Mount Pearl","NL",47.50513,-52.79476,2018-03-17 15:00:00,39,2,41
"10580",10401,"Mount Pearl","NL",47.50513,-52.79476,2018-03-17 16:00:00,39,1,40
"10581",10401,"Mount Pearl","NL",47.50513,-52.79476,2018-03-17 17:00:00,39,2,41
"10582",10401,"Mount Pearl","NL",47.50513,-52.79476,2018-03-17 18:00:00,38,1,39
"10583",10401,"Mount Pearl","NL",47.50513,-52.79476,2018-03-17 19:00:00,37,2,39
"10584",10401,"Mount Pearl","NL",47.50513,-52.79476,2018-03-17 20:00:00,37,2,39
"10585",10401,"Mount Pearl","NL",47.50513,-52.79476,2018-03-17 21:00:00,34,3,37
"10586",10401,"Mount Pearl","NL",47.50513,-52.79476,2018-03-17 22:00:00,33,2,35
"10587",10401,"Mount Pearl","NL",47.50513,-52.79476,2018-03-17 23:00:00,35,2,37
"10588",10401,"Mount Pearl","NL",47.50513,-52.79476,2018-03-18 00:00:00,36,1,37
"10589",10401,"Mount Pearl","NL",47.50513,-52.79476,2018-03-18 01:00:00,37,1,38
"10590",10401,"Mount Pearl","NL",47.50513,-52.79476,2018-03-18 02:00:00,37,2,39
"10591",10401,"Mount Pearl","NL",47.50513,-52.79476,2018-03-18 03:00:00,36,1,37
"10592",10401,"Mount Pearl","NL",47.50513,-52.79476,2018-03-18 04:00:00,37,2,39
"10593",10401,"Mount Pearl","NL",47.50513,-52.79476,2018-03-18 05:00:00,41,1,42
"10594",10401,"Mount Pearl","NL",47.50513,-52.79476,2018-03-18 06:00:00,40,1,41
"10595",10401,"Mount Pearl","NL",47.50513,-52.79476,2018-03-18 07:00:00,37,1,38
"10596",10401,"Mount Pearl","NL",47.50513,-52.79476,2018-03-18 08:00:00,36,1,37
"10597",10401,"Mount Pearl","NL",47.50513,-52.79476,2018-03-18 09:00:00,35,2,37
"10598",10401,"Mount Pearl","NL",47.50513,-52.79476,2018-03-18 10:00:00,35,1,36
"10599",10401,"Mount Pearl","NL",47.50513,-52.79476,2018-03-18 11:00:00,36,1,37
"10600",10401,"Mount Pearl","NL",47.50513,-52.79476,2018-03-18 12:00:00,37,2,39
"10601",10401,"Mount Pearl","NL",47.50513,-52.79476,2018-03-18 13:00:00,36,2,38
"10602",10401,"Mount Pearl","NL",47.50513,-52.79476,2018-03-18 14:00:00,35,2,37
"10603",10401,"Mount Pearl","NL",47.50513,-52.79476,2018-03-18 15:00:00,34,3,37
"10604",10401,"Mount Pearl","NL",47.50513,-52.79476,2018-03-18 16:00:00,34,3,37
"10605",10401,"Mount Pearl","NL",47.50513,-52.79476,2018-03-18 17:00:00,35,3,38
"10606",10401,"Mount Pearl","NL",47.50513,-52.79476,2018-03-18 18:00:00,35,4,39
"10607",10401,"Mount Pearl","NL",47.50513,-52.79476,2018-03-18 19:00:00,34,3,37
"10608",10401,"Mount Pearl","NL",47.50513,-52.79476,2018-03-18 20:00:00,35,3,38
"10609",10401,"Mount Pearl","NL",47.50513,-52.79476,2018-03-18 21:00:00,36,2,38
"10610",10401,"Mount Pearl","NL",47.50513,-52.79476,2018-03-18 22:00:00,36,2,38
"10611",10401,"Mount Pearl","NL",47.50513,-52.79476,2018-03-18 23:00:00,36,2,38
"10612",10401,"Mount Pearl","NL",47.50513,-52.79476,2018-03-19 00:00:00,37,2,39
"10613",10401,"Mount Pearl","NL",47.50513,-52.79476,2018-03-19 01:00:00,37,1,38
"10614",10401,"Mount Pearl","NL",47.50513,-52.79476,2018-03-19 02:00:00,37,2,39
"10615",10401,"Mount Pearl","NL",47.50513,-52.79476,2018-03-19 03:00:00,36,2,38
"10616",10401,"Mount Pearl","NL",47.50513,-52.79476,2018-03-19 04:00:00,36,2,38
"10617",10401,"Mount Pearl","NL",47.50513,-52.79476,2018-03-19 05:00:00,35,2,37
"10618",10401,"Mount Pearl","NL",47.50513,-52.79476,2018-03-19 06:00:00,36,2,38
"10619",10401,"Mount Pearl","NL",47.50513,-52.79476,2018-03-19 07:00:00,36,1,37
"10620",10401,"Mount Pearl","NL",47.50513,-52.79476,2018-03-19 08:00:00,36,2,38
"10621",10401,"Mount Pearl","NL",47.50513,-52.79476,2018-03-19 09:00:00,36,2,38
"10622",10401,"Mount Pearl","NL",47.50513,-52.79476,2018-03-19 10:00:00,35,2,37
"10623",10401,"Mount Pearl","NL",47.50513,-52.79476,2018-03-19 11:00:00,35,2,37
"10624",10401,"Mount Pearl","NL",47.50513,-52.79476,2018-03-19 12:00:00,34,0,34
"10625",10401,"Mount Pearl","NL",47.50513,-52.79476,2018-03-19 13:00:00,34,0,34
"10626",10401,"Mount Pearl","NL",47.50513,-52.79476,2018-03-19 14:00:00,34,0,34
"10627",10401,"Mount Pearl","NL",47.50513,-52.79476,2018-03-19 15:00:00,33,1,34
"10628",10401,"Mount Pearl","NL",47.50513,-52.79476,2018-03-19 16:00:00,34,1,35
"10629",10401,"Mount Pearl","NL",47.50513,-52.79476,2018-03-19 17:00:00,34,1,35
"10630",10401,"Mount Pearl","NL",47.50513,-52.79476,2018-03-19 18:00:00,34,1,35
"10631",10401,"Mount Pearl","NL",47.50513,-52.79476,2018-03-19 19:00:00,34,1,35
"10632",10401,"Mount Pearl","NL",47.50513,-52.79476,2018-03-19 20:00:00,35,1,36
"10633",10401,"Mount Pearl","NL",47.50513,-52.79476,2018-03-19 21:00:00,35,1,36
"10634",10401,"Mount Pearl","NL",47.50513,-52.79476,2018-03-19 22:00:00,34,1,35
"10635",10401,"Mount Pearl","NL",47.50513,-52.79476,2018-03-19 23:00:00,34,1,35
"10636",10401,"Mount Pearl","NL",47.50513,-52.79476,2018-03-20 00:00:00,35,1,36
"10637",10401,"Mount Pearl","NL",47.50513,-52.79476,2018-03-20 01:00:00,36,1,37
"10638",10401,"Mount Pearl","NL",47.50513,-52.79476,2018-03-20 02:00:00,35,0,35
"10639",10401,"Mount Pearl","NL",47.50513,-52.79476,2018-03-20 03:00:00,36,0,36
"10640",10401,"Mount Pearl","NL",47.50513,-52.79476,2018-03-20 04:00:00,36,1,37
"10641",10401,"Mount Pearl","NL",47.50513,-52.79476,2018-03-20 05:00:00,35,1,36
"10642",10401,"Mount Pearl","NL",47.50513,-52.79476,2018-03-20 06:00:00,34,1,35
"10643",10401,"Mount Pearl","NL",47.50513,-52.79476,2018-03-20 07:00:00,34,1,35
"10644",10401,"Mount Pearl","NL",47.50513,-52.79476,2018-03-20 08:00:00,31,1,32
"10645",10401,"Mount Pearl","NL",47.50513,-52.79476,2018-03-20 09:00:00,33,1,34
"10646",10401,"Mount Pearl","NL",47.50513,-52.79476,2018-03-20 10:00:00,32,1,33
"10647",10401,"Mount Pearl","NL",47.50513,-52.79476,2018-03-20 11:00:00,32,1,33
"10648",10401,"Mount Pearl","NL",47.50513,-52.79476,2018-03-20 12:00:00,31,1,32
"10649",10401,"Mount Pearl","NL",47.50513,-52.79476,2018-03-20 13:00:00,31,0,31
"10650",10401,"Mount Pearl","NL",47.50513,-52.79476,2018-03-20 14:00:00,32,0,32
"10651",10401,"Mount Pearl","NL",47.50513,-52.79476,2018-03-20 15:00:00,35,0,35
"10652",10401,"Mount Pearl","NL",47.50513,-52.79476,2018-03-20 16:00:00,34,0,34
"10653",10401,"Mount Pearl","NL",47.50513,-52.79476,2018-03-20 17:00:00,35,0,35
"10654",10401,"Mount Pearl","NL",47.50513,-52.79476,2018-03-20 18:00:00,35,0,35
"10655",10401,"Mount Pearl","NL",47.50513,-52.79476,2018-03-20 19:00:00,35,0,35
"10656",10401,"Mount Pearl","NL",47.50513,-52.79476,2018-03-20 20:00:00,35,0,35
"10657",10401,"Mount Pearl","NL",47.50513,-52.79476,2018-03-20 21:00:00,36,0,36
"10658",10401,"Mount Pearl","NL",47.50513,-52.79476,2018-03-20 22:00:00,35,0,35
"10659",10401,"Mount Pearl","NL",47.50513,-52.79476,2018-03-20 23:00:00,35,0,35
"10660",10401,"Mount Pearl","NL",47.50513,-52.79476,2018-03-21 00:00:00,38,1,39
"10661",10401,"Mount Pearl","NL",47.50513,-52.79476,2018-03-21 01:00:00,39,0,39
"10662",10401,"Mount Pearl","NL",47.50513,-52.79476,2018-03-21 02:00:00,40,0,40
"10663",10401,"Mount Pearl","NL",47.50513,-52.79476,2018-03-21 03:00:00,40,0,40
"10664",10401,"Mount Pearl","NL",47.50513,-52.79476,2018-03-21 04:00:00,40,0,40
"10665",10401,"Mount Pearl","NL",47.50513,-52.79476,2018-03-21 05:00:00,40,1,41
"10666",10401,"Mount Pearl","NL",47.50513,-52.79476,2018-03-21 06:00:00,41,0,41
"10667",10401,"Mount Pearl","NL",47.50513,-52.79476,2018-03-21 07:00:00,40,1,41
"10668",10401,"Mount Pearl","NL",47.50513,-52.79476,2018-03-21 08:00:00,38,1,39
"10669",10401,"Mount Pearl","NL",47.50513,-52.79476,2018-03-21 09:00:00,37,1,38
"10670",10401,"Mount Pearl","NL",47.50513,-52.79476,2018-03-21 10:00:00,38,0,38
"10671",10401,"Mount Pearl","NL",47.50513,-52.79476,2018-03-21 11:00:00,37,1,38
"10672",10401,"Mount Pearl","NL",47.50513,-52.79476,2018-03-21 12:00:00,38,0,38
"10673",10401,"Mount Pearl","NL",47.50513,-52.79476,2018-03-21 13:00:00,39,0,39
"10674",10401,"Mount Pearl","NL",47.50513,-52.79476,2018-03-21 14:00:00,39,0,39
"10675",10401,"Mount Pearl","NL",47.50513,-52.79476,2018-03-21 15:00:00,38,1,39
"10676",10401,"Mount Pearl","NL",47.50513,-52.79476,2018-03-21 16:00:00,38,0,38
"10677",10401,"Mount Pearl","NL",47.50513,-52.79476,2018-03-21 17:00:00,39,0,39
"10678",10401,"Mount Pearl","NL",47.50513,-52.79476,2018-03-21 18:00:00,39,0,39
"10679",10401,"Mount Pearl","NL",47.50513,-52.79476,2018-03-21 19:00:00,38,0,38
"10680",10401,"Mount Pearl","NL",47.50513,-52.79476,2018-03-21 20:00:00,35,1,36
"10681",10401,"Mount Pearl","NL",47.50513,-52.79476,2018-03-21 21:00:00,34,1,35
"10682",10401,"Mount Pearl","NL",47.50513,-52.79476,2018-03-21 22:00:00,37,0,37
"10683",10401,"Mount Pearl","NL",47.50513,-52.79476,2018-03-21 23:00:00,35,1,36
"10684",10401,"Mount Pearl","NL",47.50513,-52.79476,2018-03-22 00:00:00,38,0,38
"10685",10401,"Mount Pearl","NL",47.50513,-52.79476,2018-03-22 01:00:00,38,0,38
"10686",10401,"Mount Pearl","NL",47.50513,-52.79476,2018-03-22 02:00:00,38,0,38
"10687",10401,"Mount Pearl","NL",47.50513,-52.79476,2018-03-22 03:00:00,39,0,39
"10688",10401,"Mount Pearl","NL",47.50513,-52.79476,2018-03-22 04:00:00,39,0,39
"10689",10401,"Mount Pearl","NL",47.50513,-52.79476,2018-03-22 05:00:00,40,0,40
"10690",10401,"Mount Pearl","NL",47.50513,-52.79476,2018-03-22 06:00:00,38,1,39
"10691",10401,"Mount Pearl","NL",47.50513,-52.79476,2018-03-22 07:00:00,37,1,38
"10692",10401,"Mount Pearl","NL",47.50513,-52.79476,2018-03-22 08:00:00,37,1,38
"10693",10401,"Mount Pearl","NL",47.50513,-52.79476,2018-03-22 09:00:00,39,0,39
"10694",10401,"Mount Pearl","NL",47.50513,-52.79476,2018-03-22 10:00:00,40,0,40
"10695",10401,"Mount Pearl","NL",47.50513,-52.79476,2018-03-22 11:00:00,40,0,40
"10696",10401,"Mount Pearl","NL",47.50513,-52.79476,2018-03-22 12:00:00,40,0,40
"10697",10401,"Mount Pearl","NL",47.50513,-52.79476,2018-03-22 13:00:00,40,0,40
"10698",10401,"Mount Pearl","NL",47.50513,-52.79476,2018-03-22 14:00:00,40,0,40
"10699",10401,"Mount Pearl","NL",47.50513,-52.79476,2018-03-22 15:00:00,40,1,41
"10700",10401,"Mount Pearl","NL",47.50513,-52.79476,2018-03-22 16:00:00,40,0,40
"10701",10401,"Mount Pearl","NL",47.50513,-52.79476,2018-03-22 17:00:00,40,0,40
"10702",10401,"Mount Pearl","NL",47.50513,-52.79476,2018-03-22 18:00:00,40,0,40
"10703",10401,"Mount Pearl","NL",47.50513,-52.79476,2018-03-22 19:00:00,40,0,40
"10704",10401,"Mount Pearl","NL",47.50513,-52.79476,2018-03-22 20:00:00,39,0,39
"10705",10401,"Mount Pearl","NL",47.50513,-52.79476,2018-03-22 21:00:00,39,0,39
"10706",10401,"Mount Pearl","NL",47.50513,-52.79476,2018-03-22 22:00:00,39,0,39
"10707",10401,"Mount Pearl","NL",47.50513,-52.79476,2018-03-22 23:00:00,40,0,40
"10708",10401,"Mount Pearl","NL",47.50513,-52.79476,2018-03-23 00:00:00,40,0,40
"10709",10401,"Mount Pearl","NL",47.50513,-52.79476,2018-03-23 01:00:00,38,1,39
"10710",10401,"Mount Pearl","NL",47.50513,-52.79476,2018-03-23 02:00:00,38,1,39
"10711",10401,"Mount Pearl","NL",47.50513,-52.79476,2018-03-23 03:00:00,38,1,39
"10712",10401,"Mount Pearl","NL",47.50513,-52.79476,2018-03-23 04:00:00,35,0,35
"10713",10401,"Mount Pearl","NL",47.50513,-52.79476,2018-03-23 05:00:00,29,2,31
"10714",10401,"Mount Pearl","NL",47.50513,-52.79476,2018-03-23 06:00:00,22,3,25
"10715",10401,"Mount Pearl","NL",47.50513,-52.79476,2018-03-23 07:00:00,25,2,27
"10716",10401,"Mount Pearl","NL",47.50513,-52.79476,2018-03-23 08:00:00,31,1,32
"10717",10401,"Mount Pearl","NL",47.50513,-52.79476,2018-03-23 09:00:00,31,0,31
"10718",10401,"Mount Pearl","NL",47.50513,-52.79476,2018-03-23 10:00:00,32,0,32
"10719",10401,"Mount Pearl","NL",47.50513,-52.79476,2018-03-23 11:00:00,31,0,31
"10720",10401,"Mount Pearl","NL",47.50513,-52.79476,2018-03-23 12:00:00,35,0,35
"10721",10401,"Mount Pearl","NL",47.50513,-52.79476,2018-03-23 13:00:00,35,0,35
"10722",10401,"Mount Pearl","NL",47.50513,-52.79476,2018-03-23 14:00:00,36,0,36
"10723",10401,"Mount Pearl","NL",47.50513,-52.79476,2018-03-23 15:00:00,35,1,36
"10724",10401,"Mount Pearl","NL",47.50513,-52.79476,2018-03-23 16:00:00,37,0,37
"10725",10401,"Mount Pearl","NL",47.50513,-52.79476,2018-03-23 17:00:00,38,0,38
"10726",10401,"Mount Pearl","NL",47.50513,-52.79476,2018-03-23 18:00:00,39,0,39
"10727",10401,"Mount Pearl","NL",47.50513,-52.79476,2018-03-23 19:00:00,38,0,38
"10728",10401,"Mount Pearl","NL",47.50513,-52.79476,2018-03-23 20:00:00,37,0,37
"10729",10401,"Mount Pearl","NL",47.50513,-52.79476,2018-03-23 21:00:00,37,0,37
"10730",10401,"Mount Pearl","NL",47.50513,-52.79476,2018-03-23 22:00:00,37,0,37
"10731",10401,"Mount Pearl","NL",47.50513,-52.79476,2018-03-23 23:00:00,38,0,38
"10732",10401,"Mount Pearl","NL",47.50513,-52.79476,2018-03-24 00:00:00,38,0,38
"10733",10401,"Mount Pearl","NL",47.50513,-52.79476,2018-03-24 01:00:00,38,0,38
"10734",10401,"Mount Pearl","NL",47.50513,-52.79476,2018-03-24 02:00:00,37,0,37
"10735",10401,"Mount Pearl","NL",47.50513,-52.79476,2018-03-24 03:00:00,36,0,36
"10736",10401,"Mount Pearl","NL",47.50513,-52.79476,2018-03-24 04:00:00,34,0,34
"10737",10401,"Mount Pearl","NL",47.50513,-52.79476,2018-03-24 05:00:00,36,0,36
"10738",10401,"Mount Pearl","NL",47.50513,-52.79476,2018-03-24 06:00:00,37,0,37
"10739",10401,"Mount Pearl","NL",47.50513,-52.79476,2018-03-24 07:00:00,40,0,40
"10740",10401,"Mount Pearl","NL",47.50513,-52.79476,2018-03-24 08:00:00,40,0,40
"10741",10401,"Mount Pearl","NL",47.50513,-52.79476,2018-03-24 09:00:00,38,0,38
"10742",10401,"Mount Pearl","NL",47.50513,-52.79476,2018-03-24 10:00:00,39,0,39
"10743",10401,"Mount Pearl","NL",47.50513,-52.79476,2018-03-24 11:00:00,39,0,39
"10744",10401,"Mount Pearl","NL",47.50513,-52.79476,2018-03-24 12:00:00,39,0,39
"10745",10401,"Mount Pearl","NL",47.50513,-52.79476,2018-03-24 13:00:00,39,0,39
"10746",10401,"Mount Pearl","NL",47.50513,-52.79476,2018-03-24 14:00:00,40,0,40
"10747",10401,"Mount Pearl","NL",47.50513,-52.79476,2018-03-24 15:00:00,40,0,40
"10748",10401,"Mount Pearl","NL",47.50513,-52.79476,2018-03-24 16:00:00,40,0,40
"10749",10401,"Mount Pearl","NL",47.50513,-52.79476,2018-03-24 17:00:00,41,0,41
"10750",10401,"Mount Pearl","NL",47.50513,-52.79476,2018-03-24 18:00:00,43,0,43
"10751",10401,"Mount Pearl","NL",47.50513,-52.79476,2018-03-24 19:00:00,43,0,43
"10752",10401,"Mount Pearl","NL",47.50513,-52.79476,2018-03-24 20:00:00,43,0,43
"10753",10401,"Mount Pearl","NL",47.50513,-52.79476,2018-03-24 21:00:00,43,0,43
"10754",10401,"Mount Pearl","NL",47.50513,-52.79476,2018-03-24 22:00:00,43,0,43
"10755",10401,"Mount Pearl","NL",47.50513,-52.79476,2018-03-24 23:00:00,43,0,43
"10756",10401,"Mount Pearl","NL",47.50513,-52.79476,2018-03-25 00:00:00,43,0,43
"10757",10401,"Mount Pearl","NL",47.50513,-52.79476,2018-03-25 01:00:00,42,0,42
"10758",10401,"Mount Pearl","NL",47.50513,-52.79476,2018-03-25 02:00:00,41,0,41
"10759",10401,"Mount Pearl","NL",47.50513,-52.79476,2018-03-25 03:00:00,42,0,42
"10760",10401,"Mount Pearl","NL",47.50513,-52.79476,2018-03-25 04:00:00,43,0,43
"10761",10401,"Mount Pearl","NL",47.50513,-52.79476,2018-03-25 05:00:00,43,0,43
"10762",10401,"Mount Pearl","NL",47.50513,-52.79476,2018-03-25 06:00:00,42,0,42
"10763",10401,"Mount Pearl","NL",47.50513,-52.79476,2018-03-25 07:00:00,42,0,42
"10764",10401,"Mount Pearl","NL",47.50513,-52.79476,2018-03-25 08:00:00,42,0,42
"10765",10401,"Mount Pearl","NL",47.50513,-52.79476,2018-03-25 09:00:00,42,0,42
"10766",10401,"Mount Pearl","NL",47.50513,-52.79476,2018-03-25 10:00:00,42,0,42
"10767",10401,"Mount Pearl","NL",47.50513,-52.79476,2018-03-25 11:00:00,41,0,41
"10768",10401,"Mount Pearl","NL",47.50513,-52.79476,2018-03-25 12:00:00,41,1,42
"10769",10401,"Mount Pearl","NL",47.50513,-52.79476,2018-03-25 13:00:00,41,0,41
"10770",10401,"Mount Pearl","NL",47.50513,-52.79476,2018-03-25 14:00:00,41,1,42
"10771",10401,"Mount Pearl","NL",47.50513,-52.79476,2018-03-25 15:00:00,42,0,42
"10772",10401,"Mount Pearl","NL",47.50513,-52.79476,2018-03-25 16:00:00,42,1,43
"10773",10401,"Mount Pearl","NL",47.50513,-52.79476,2018-03-25 17:00:00,42,0,42
"10774",10401,"Mount Pearl","NL",47.50513,-52.79476,2018-03-25 18:00:00,42,1,43
"10775",10401,"Mount Pearl","NL",47.50513,-52.79476,2018-03-25 19:00:00,43,0,43
"10776",10401,"Mount Pearl","NL",47.50513,-52.79476,2018-03-25 20:00:00,43,1,44
"10777",10401,"Mount Pearl","NL",47.50513,-52.79476,2018-03-25 21:00:00,43,0,43
"10778",10401,"Mount Pearl","NL",47.50513,-52.79476,2018-03-25 22:00:00,43,0,43
"10779",10401,"Mount Pearl","NL",47.50513,-52.79476,2018-03-25 23:00:00,43,0,43
"10780",10401,"Mount Pearl","NL",47.50513,-52.79476,2018-03-26 00:00:00,43,0,43
"10781",10401,"Mount Pearl","NL",47.50513,-52.79476,2018-03-26 01:00:00,43,0,43
"10782",10401,"Mount Pearl","NL",47.50513,-52.79476,2018-03-26 02:00:00,43,1,44
"10783",10401,"Mount Pearl","NL",47.50513,-52.79476,2018-03-26 03:00:00,43,0,43
"10784",10401,"Mount Pearl","NL",47.50513,-52.79476,2018-03-26 04:00:00,43,0,43
"10785",10401,"Mount Pearl","NL",47.50513,-52.79476,2018-03-26 05:00:00,44,1,45
"10786",10401,"Mount Pearl","NL",47.50513,-52.79476,2018-03-26 06:00:00,44,0,44
"10787",10401,"Mount Pearl","NL",47.50513,-52.79476,2018-03-26 07:00:00,43,1,44
"10788",10401,"Mount Pearl","NL",47.50513,-52.79476,2018-03-26 08:00:00,44,1,45
"10789",10401,"Mount Pearl","NL",47.50513,-52.79476,2018-03-26 09:00:00,44,1,45
"10790",10401,"Mount Pearl","NL",47.50513,-52.79476,2018-03-26 10:00:00,42,1,43
"10791",10401,"Mount Pearl","NL",47.50513,-52.79476,2018-03-26 11:00:00,41,1,42
"10792",10401,"Mount Pearl","NL",47.50513,-52.79476,2018-03-26 12:00:00,42,0,42
"10793",10401,"Mount Pearl","NL",47.50513,-52.79476,2018-03-26 13:00:00,42,0,42
"10794",10401,"Mount Pearl","NL",47.50513,-52.79476,2018-03-26 14:00:00,42,0,42
"10795",10401,"Mount Pearl","NL",47.50513,-52.79476,2018-03-26 15:00:00,42,0,42
"10796",10401,"Mount Pearl","NL",47.50513,-52.79476,2018-03-26 16:00:00,43,0,43
"10797",10401,"Mount Pearl","NL",47.50513,-52.79476,2018-03-26 17:00:00,43,0,43
"10798",10401,"Mount Pearl","NL",47.50513,-52.79476,2018-03-26 18:00:00,43,0,43
"10799",10401,"Mount Pearl","NL",47.50513,-52.79476,2018-03-26 19:00:00,41,1,42
"10800",10401,"Mount Pearl","NL",47.50513,-52.79476,2018-03-26 20:00:00,34,2,36
"10801",10401,"Mount Pearl","NL",47.50513,-52.79476,2018-03-26 21:00:00,27,3,30
"10802",10401,"Mount Pearl","NL",47.50513,-52.79476,2018-03-26 22:00:00,31,2,33
"10803",10401,"Mount Pearl","NL",47.50513,-52.79476,2018-03-26 23:00:00,31,1,32
"10804",10401,"Mount Pearl","NL",47.50513,-52.79476,2018-03-27 00:00:00,31,1,32
"10805",10401,"Mount Pearl","NL",47.50513,-52.79476,2018-03-27 01:00:00,29,2,31
"10806",10401,"Mount Pearl","NL",47.50513,-52.79476,2018-03-27 02:00:00,27,2,29
"10807",10401,"Mount Pearl","NL",47.50513,-52.79476,2018-03-27 03:00:00,31,1,32
"10808",10401,"Mount Pearl","NL",47.50513,-52.79476,2018-03-27 04:00:00,31,1,32
"10809",10401,"Mount Pearl","NL",47.50513,-52.79476,2018-03-27 05:00:00,26,3,29
"10810",10401,"Mount Pearl","NL",47.50513,-52.79476,2018-03-27 06:00:00,30,4,34
"10811",10401,"Mount Pearl","NL",47.50513,-52.79476,2018-03-27 07:00:00,28,4,32
"10812",10401,"Mount Pearl","NL",47.50513,-52.79476,2018-03-27 08:00:00,30,4,34
"10813",10401,"Mount Pearl","NL",47.50513,-52.79476,2018-03-27 09:00:00,38,2,40
"10814",10401,"Mount Pearl","NL",47.50513,-52.79476,2018-03-27 10:00:00,42,1,43
"10815",10401,"Mount Pearl","NL",47.50513,-52.79476,2018-03-27 11:00:00,43,1,44
"10816",10401,"Mount Pearl","NL",47.50513,-52.79476,2018-03-27 12:00:00,42,0,42
"10817",10401,"Mount Pearl","NL",47.50513,-52.79476,2018-03-27 13:00:00,43,0,43
"10818",10401,"Mount Pearl","NL",47.50513,-52.79476,2018-03-27 14:00:00,44,1,45
"10819",10401,"Mount Pearl","NL",47.50513,-52.79476,2018-03-27 15:00:00,43,0,43
"10820",10401,"Mount Pearl","NL",47.50513,-52.79476,2018-03-27 16:00:00,43,0,43
"10821",10401,"Mount Pearl","NL",47.50513,-52.79476,2018-03-27 17:00:00,44,0,44
"10822",10401,"Mount Pearl","NL",47.50513,-52.79476,2018-03-27 18:00:00,43,1,44
"10823",10401,"Mount Pearl","NL",47.50513,-52.79476,2018-03-27 19:00:00,45,1,46
"10824",10401,"Mount Pearl","NL",47.50513,-52.79476,2018-03-27 20:00:00,43,1,44
"10825",10401,"Mount Pearl","NL",47.50513,-52.79476,2018-03-27 21:00:00,39,1,40
"10826",10401,"Mount Pearl","NL",47.50513,-52.79476,2018-03-27 22:00:00,31,2,33
"10827",10401,"Mount Pearl","NL",47.50513,-52.79476,2018-03-27 23:00:00,38,1,39
"10828",10401,"Mount Pearl","NL",47.50513,-52.79476,2018-03-28 00:00:00,37,1,38
"10829",10401,"Mount Pearl","NL",47.50513,-52.79476,2018-03-28 01:00:00,42,1,43
"10830",10401,"Mount Pearl","NL",47.50513,-52.79476,2018-03-28 02:00:00,42,0,42
"10831",10401,"Mount Pearl","NL",47.50513,-52.79476,2018-03-28 03:00:00,39,1,40
"10832",10401,"Mount Pearl","NL",47.50513,-52.79476,2018-03-28 04:00:00,40,1,41
"10833",10401,"Mount Pearl","NL",47.50513,-52.79476,2018-03-28 05:00:00,44,0,44
"10834",10401,"Mount Pearl","NL",47.50513,-52.79476,2018-03-28 06:00:00,45,0,45
"10835",10401,"Mount Pearl","NL",47.50513,-52.79476,2018-03-28 07:00:00,45,1,46
"10836",10401,"Mount Pearl","NL",47.50513,-52.79476,2018-03-28 08:00:00,45,1,46
"10837",10401,"Mount Pearl","NL",47.50513,-52.79476,2018-03-28 09:00:00,44,0,44
"10838",10401,"Mount Pearl","NL",47.50513,-52.79476,2018-03-28 10:00:00,43,1,44
"10839",10401,"Mount Pearl","NL",47.50513,-52.79476,2018-03-28 11:00:00,42,0,42
"10840",10401,"Mount Pearl","NL",47.50513,-52.79476,2018-03-28 12:00:00,43,0,43
"10841",10401,"Mount Pearl","NL",47.50513,-52.79476,2018-03-28 13:00:00,44,0,44
"10842",10401,"Mount Pearl","NL",47.50513,-52.79476,2018-03-28 14:00:00,43,0,43
"10843",10401,"Mount Pearl","NL",47.50513,-52.79476,2018-03-28 15:00:00,43,0,43
"10844",10401,"Mount Pearl","NL",47.50513,-52.79476,2018-03-28 16:00:00,41,0,41
"10845",10401,"Mount Pearl","NL",47.50513,-52.79476,2018-03-28 17:00:00,39,1,40
"10846",10401,"Mount Pearl","NL",47.50513,-52.79476,2018-03-28 18:00:00,34,2,36
"10847",10401,"Mount Pearl","NL",47.50513,-52.79476,2018-03-28 19:00:00,31,3,34
"10848",10401,"Mount Pearl","NL",47.50513,-52.79476,2018-03-28 20:00:00,28,3,31
"10849",10401,"Mount Pearl","NL",47.50513,-52.79476,2018-03-28 21:00:00,23,3,26
"10850",10401,"Mount Pearl","NL",47.50513,-52.79476,2018-03-28 22:00:00,21,4,25
"10851",10401,"Mount Pearl","NL",47.50513,-52.79476,2018-03-28 23:00:00,29,2,31
"10852",10401,"Mount Pearl","NL",47.50513,-52.79476,2018-03-29 00:00:00,29,1,30
"10853",10401,"Mount Pearl","NL",47.50513,-52.79476,2018-03-29 01:00:00,23,2,25
"10854",10401,"Mount Pearl","NL",47.50513,-52.79476,2018-03-29 02:00:00,23,1,24
"10855",10401,"Mount Pearl","NL",47.50513,-52.79476,2018-03-29 03:00:00,23,1,24
"10856",10401,"Mount Pearl","NL",47.50513,-52.79476,2018-03-29 04:00:00,24,0,24
"10857",10401,"Mount Pearl","NL",47.50513,-52.79476,2018-03-29 05:00:00,18,1,19
"10858",10401,"Mount Pearl","NL",47.50513,-52.79476,2018-03-29 06:00:00,21,3,24
"10859",10401,"Mount Pearl","NL",47.50513,-52.79476,2018-03-29 07:00:00,15,5,20
"10860",10401,"Mount Pearl","NL",47.50513,-52.79476,2018-03-29 08:00:00,21,3,24
"10861",10401,"Mount Pearl","NL",47.50513,-52.79476,2018-03-29 09:00:00,17,5,22
"10862",10401,"Mount Pearl","NL",47.50513,-52.79476,2018-03-29 10:00:00,26,3,29
"10863",10401,"Mount Pearl","NL",47.50513,-52.79476,2018-03-29 11:00:00,32,1,33
"10864",10401,"Mount Pearl","NL",47.50513,-52.79476,2018-03-29 12:00:00,36,1,37
"10865",10401,"Mount Pearl","NL",47.50513,-52.79476,2018-03-29 13:00:00,36,2,38
"10866",10401,"Mount Pearl","NL",47.50513,-52.79476,2018-03-29 14:00:00,37,1,38
"10867",10401,"Mount Pearl","NL",47.50513,-52.79476,2018-03-29 15:00:00,39,1,40
"10868",10401,"Mount Pearl","NL",47.50513,-52.79476,2018-03-29 16:00:00,42,1,43
"10869",10401,"Mount Pearl","NL",47.50513,-52.79476,2018-03-29 17:00:00,43,1,44
"10870",10401,"Mount Pearl","NL",47.50513,-52.79476,2018-03-29 18:00:00,43,0,43
"10871",10401,"Mount Pearl","NL",47.50513,-52.79476,2018-03-29 19:00:00,43,0,43
"10872",10401,"Mount Pearl","NL",47.50513,-52.79476,2018-03-29 20:00:00,43,1,44
"10873",10401,"Mount Pearl","NL",47.50513,-52.79476,2018-03-29 21:00:00,42,0,42
"10874",10401,"Mount Pearl","NL",47.50513,-52.79476,2018-03-29 22:00:00,42,0,42
"10875",10401,"Mount Pearl","NL",47.50513,-52.79476,2018-03-29 23:00:00,41,0,41
"10876",10401,"Mount Pearl","NL",47.50513,-52.79476,2018-03-30 00:00:00,41,0,41
"10877",10401,"Mount Pearl","NL",47.50513,-52.79476,2018-03-30 01:00:00,41,0,41
"10878",10401,"Mount Pearl","NL",47.50513,-52.79476,2018-03-30 02:00:00,40,1,41
"10879",10401,"Mount Pearl","NL",47.50513,-52.79476,2018-03-30 03:00:00,40,0,40
"10880",10401,"Mount Pearl","NL",47.50513,-52.79476,2018-03-30 04:00:00,40,0,40
"10881",10401,"Mount Pearl","NL",47.50513,-52.79476,2018-03-30 05:00:00,40,1,41
"10882",10401,"Mount Pearl","NL",47.50513,-52.79476,2018-03-30 06:00:00,41,0,41
"10883",10401,"Mount Pearl","NL",47.50513,-52.79476,2018-03-30 07:00:00,41,0,41
"10884",10401,"Mount Pearl","NL",47.50513,-52.79476,2018-03-30 08:00:00,40,0,40
"10885",10401,"Mount Pearl","NL",47.50513,-52.79476,2018-03-30 09:00:00,40,0,40
"10886",10401,"Mount Pearl","NL",47.50513,-52.79476,2018-03-30 10:00:00,41,0,41
"10887",10401,"Mount Pearl","NL",47.50513,-52.79476,2018-03-30 11:00:00,41,0,41
"10888",10401,"Mount Pearl","NL",47.50513,-52.79476,2018-03-30 12:00:00,42,0,42
"10889",10401,"Mount Pearl","NL",47.50513,-52.79476,2018-03-30 13:00:00,42,0,42
"10890",10401,"Mount Pearl","NL",47.50513,-52.79476,2018-03-30 14:00:00,43,0,43
"10891",10401,"Mount Pearl","NL",47.50513,-52.79476,2018-03-30 15:00:00,42,1,43
"10892",10401,"Mount Pearl","NL",47.50513,-52.79476,2018-03-30 16:00:00,42,1,43
"10893",10401,"Mount Pearl","NL",47.50513,-52.79476,2018-03-30 17:00:00,42,0,42
"10894",10401,"Mount Pearl","NL",47.50513,-52.79476,2018-03-30 18:00:00,42,1,43
"10895",10401,"Mount Pearl","NL",47.50513,-52.79476,2018-03-30 19:00:00,40,1,41
"10896",10401,"Mount Pearl","NL",47.50513,-52.79476,2018-03-30 20:00:00,38,1,39
"10897",10401,"Mount Pearl","NL",47.50513,-52.79476,2018-03-30 21:00:00,34,1,35
"10898",10401,"Mount Pearl","NL",47.50513,-52.79476,2018-03-30 22:00:00,40,1,41
"10899",10401,"Mount Pearl","NL",47.50513,-52.79476,2018-03-30 23:00:00,39,1,40
"10900",10401,"Mount Pearl","NL",47.50513,-52.79476,2018-03-31 00:00:00,38,1,39
"10901",10401,"Mount Pearl","NL",47.50513,-52.79476,2018-03-31 01:00:00,34,1,35
"10902",10401,"Mount Pearl","NL",47.50513,-52.79476,2018-03-31 02:00:00,30,1,31
"10903",10401,"Mount Pearl","NL",47.50513,-52.79476,2018-03-31 03:00:00,32,1,33
"10904",10401,"Mount Pearl","NL",47.50513,-52.79476,2018-03-31 04:00:00,35,1,36
"10905",10401,"Mount Pearl","NL",47.50513,-52.79476,2018-03-31 05:00:00,38,1,39
"10906",10401,"Mount Pearl","NL",47.50513,-52.79476,2018-03-31 06:00:00,37,0,37
"10907",10401,"Mount Pearl","NL",47.50513,-52.79476,2018-03-31 07:00:00,36,1,37
"10908",10401,"Mount Pearl","NL",47.50513,-52.79476,2018-03-31 08:00:00,34,1,35
"10909",10401,"Mount Pearl","NL",47.50513,-52.79476,2018-03-31 09:00:00,32,1,33
"10910",10401,"Mount Pearl","NL",47.50513,-52.79476,2018-03-31 10:00:00,30,1,31
"10911",10401,"Mount Pearl","NL",47.50513,-52.79476,2018-03-31 11:00:00,29,1,30
"10912",10401,"Mount Pearl","NL",47.50513,-52.79476,2018-03-31 12:00:00,28,0,28
"10913",10401,"Mount Pearl","NL",47.50513,-52.79476,2018-03-31 13:00:00,31,0,31
"10914",10401,"Mount Pearl","NL",47.50513,-52.79476,2018-03-31 14:00:00,31,0,31
"10915",10401,"Mount Pearl","NL",47.50513,-52.79476,2018-03-31 15:00:00,32,0,32
"10916",10401,"Mount Pearl","NL",47.50513,-52.79476,2018-03-31 16:00:00,32,0,32
"10917",10401,"Mount Pearl","NL",47.50513,-52.79476,2018-03-31 17:00:00,32,0,32
"10918",10401,"Mount Pearl","NL",47.50513,-52.79476,2018-03-31 18:00:00,33,0,33
"10919",10401,"Mount Pearl","NL",47.50513,-52.79476,2018-03-31 19:00:00,36,0,36
"10920",10401,"Mount Pearl","NL",47.50513,-52.79476,2018-03-31 20:00:00,37,0,37
"10921",10401,"Mount Pearl","NL",47.50513,-52.79476,2018-03-31 21:00:00,37,0,37
"10922",10401,"Mount Pearl","NL",47.50513,-52.79476,2018-03-31 22:00:00,36,0,36
"10923",10401,"Mount Pearl","NL",47.50513,-52.79476,2018-03-31 23:00:00,36,0,36
"10924",10401,"Mount Pearl","NL",47.50513,-52.79476,2018-04-01 00:00:00,38,0,38
"10925",10401,"Mount Pearl","NL",47.50513,-52.79476,2018-04-01 01:00:00,41,0,41
"10926",10401,"Mount Pearl","NL",47.50513,-52.79476,2018-04-01 02:00:00,43,0,43
"10927",10401,"Mount Pearl","NL",47.50513,-52.79476,2018-04-01 03:00:00,42,0,42
"10928",10401,"Mount Pearl","NL",47.50513,-52.79476,2018-04-01 04:00:00,42,0,42
"10929",10401,"Mount Pearl","NL",47.50513,-52.79476,2018-04-01 05:00:00,42,0,42
"10930",10401,"Mount Pearl","NL",47.50513,-52.79476,2018-04-01 06:00:00,42,0,42
"10931",10401,"Mount Pearl","NL",47.50513,-52.79476,2018-04-01 07:00:00,40,0,40
"10932",10401,"Mount Pearl","NL",47.50513,-52.79476,2018-04-01 08:00:00,39,0,39
"10933",10401,"Mount Pearl","NL",47.50513,-52.79476,2018-04-01 09:00:00,39,0,39
"10934",10401,"Mount Pearl","NL",47.50513,-52.79476,2018-04-01 10:00:00,38,0,38
"10935",10401,"Mount Pearl","NL",47.50513,-52.79476,2018-04-01 11:00:00,38,0,38
"10936",10401,"Mount Pearl","NL",47.50513,-52.79476,2018-04-01 12:00:00,39,0,39
"10937",10401,"Mount Pearl","NL",47.50513,-52.79476,2018-04-01 13:00:00,40,0,40
"10938",10401,"Mount Pearl","NL",47.50513,-52.79476,2018-04-01 14:00:00,41,0,41
"10939",10401,"Mount Pearl","NL",47.50513,-52.79476,2018-04-01 15:00:00,42,0,42
"10940",10401,"Mount Pearl","NL",47.50513,-52.79476,2018-04-01 16:00:00,42,0,42
"10941",10401,"Mount Pearl","NL",47.50513,-52.79476,2018-04-01 17:00:00,42,0,42
"10942",10401,"Mount Pearl","NL",47.50513,-52.79476,2018-04-01 18:00:00,44,0,44
"10943",10401,"Mount Pearl","NL",47.50513,-52.79476,2018-04-01 19:00:00,42,0,42
"10944",10401,"Mount Pearl","NL",47.50513,-52.79476,2018-04-01 20:00:00,40,0,40
"10945",10401,"Mount Pearl","NL",47.50513,-52.79476,2018-04-01 21:00:00,42,0,42
"10946",10401,"Mount Pearl","NL",47.50513,-52.79476,2018-04-01 22:00:00,39,0,39
"10947",10401,"Mount Pearl","NL",47.50513,-52.79476,2018-04-01 23:00:00,40,0,40
"10948",10401,"Mount Pearl","NL",47.50513,-52.79476,2018-04-02 00:00:00,40,0,40
"10949",10401,"Mount Pearl","NL",47.50513,-52.79476,2018-04-02 01:00:00,40,0,40
"10950",10401,"Mount Pearl","NL",47.50513,-52.79476,2018-04-02 02:00:00,41,0,41
"10951",10401,"Mount Pearl","NL",47.50513,-52.79476,2018-04-02 03:00:00,42,0,42
"10952",10401,"Mount Pearl","NL",47.50513,-52.79476,2018-04-02 04:00:00,42,0,42
"10953",10401,"Mount Pearl","NL",47.50513,-52.79476,2018-04-02 05:00:00,44,0,44
"10954",10401,"Mount Pearl","NL",47.50513,-52.79476,2018-04-02 06:00:00,44,0,44
"10955",10401,"Mount Pearl","NL",47.50513,-52.79476,2018-04-02 07:00:00,42,0,42
"10956",10401,"Mount Pearl","NL",47.50513,-52.79476,2018-04-02 08:00:00,40,0,40
"10957",10401,"Mount Pearl","NL",47.50513,-52.79476,2018-04-02 09:00:00,40,0,40
"10958",10401,"Mount Pearl","NL",47.50513,-52.79476,2018-04-02 10:00:00,36,1,37
"10959",10401,"Mount Pearl","NL",47.50513,-52.79476,2018-04-02 11:00:00,36,0,36
"10960",10401,"Mount Pearl","NL",47.50513,-52.79476,2018-04-02 12:00:00,37,1,38
"10961",10401,"Mount Pearl","NL",47.50513,-52.79476,2018-04-02 13:00:00,41,1,42
"10962",10401,"Mount Pearl","NL",47.50513,-52.79476,2018-04-02 14:00:00,41,1,42
"10963",10401,"Mount Pearl","NL",47.50513,-52.79476,2018-04-02 15:00:00,40,0,40
"10964",10401,"Mount Pearl","NL",47.50513,-52.79476,2018-04-02 16:00:00,39,1,40
"10965",10401,"Mount Pearl","NL",47.50513,-52.79476,2018-04-02 17:00:00,39,0,39
"10966",10401,"Mount Pearl","NL",47.50513,-52.79476,2018-04-02 18:00:00,38,0,38
"10967",10401,"Mount Pearl","NL",47.50513,-52.79476,2018-04-02 19:00:00,37,0,37
"10968",10401,"Mount Pearl","NL",47.50513,-52.79476,2018-04-02 20:00:00,35,1,36
"10969",10401,"Mount Pearl","NL",47.50513,-52.79476,2018-04-02 21:00:00,35,1,36
"10970",10401,"Mount Pearl","NL",47.50513,-52.79476,2018-04-02 22:00:00,34,0,34
"10971",10401,"Mount Pearl","NL",47.50513,-52.79476,2018-04-02 23:00:00,33,1,34
"10972",10401,"Mount Pearl","NL",47.50513,-52.79476,2018-04-03 00:00:00,32,0,32
"10973",10401,"Mount Pearl","NL",47.50513,-52.79476,2018-04-03 01:00:00,33,0,33
"10974",10401,"Mount Pearl","NL",47.50513,-52.79476,2018-04-03 02:00:00,34,0,34
"10975",10401,"Mount Pearl","NL",47.50513,-52.79476,2018-04-03 03:00:00,35,1,36
"10976",10401,"Mount Pearl","NL",47.50513,-52.79476,2018-04-03 04:00:00,36,0,36
"10977",10401,"Mount Pearl","NL",47.50513,-52.79476,2018-04-03 05:00:00,37,0,37
"10978",10401,"Mount Pearl","NL",47.50513,-52.79476,2018-04-03 06:00:00,38,0,38
"10979",10401,"Mount Pearl","NL",47.50513,-52.79476,2018-04-03 07:00:00,38,0,38
"10980",10401,"Mount Pearl","NL",47.50513,-52.79476,2018-04-03 08:00:00,37,1,38
"10981",10401,"Mount Pearl","NL",47.50513,-52.79476,2018-04-03 09:00:00,38,0,38
"10982",10401,"Mount Pearl","NL",47.50513,-52.79476,2018-04-03 10:00:00,38,0,38
"10983",10401,"Mount Pearl","NL",47.50513,-52.79476,2018-04-03 11:00:00,37,0,37
"10984",10401,"Mount Pearl","NL",47.50513,-52.79476,2018-04-03 12:00:00,38,0,38
"10985",10401,"Mount Pearl","NL",47.50513,-52.79476,2018-04-03 13:00:00,39,0,39
"10986",10401,"Mount Pearl","NL",47.50513,-52.79476,2018-04-03 14:00:00,38,0,38
"10987",10401,"Mount Pearl","NL",47.50513,-52.79476,2018-04-03 15:00:00,39,0,39
"10988",10401,"Mount Pearl","NL",47.50513,-52.79476,2018-04-03 16:00:00,39,0,39
"10989",10401,"Mount Pearl","NL",47.50513,-52.79476,2018-04-03 17:00:00,39,0,39
"10990",10401,"Mount Pearl","NL",47.50513,-52.79476,2018-04-03 18:00:00,40,0,40
"10991",10401,"Mount Pearl","NL",47.50513,-52.79476,2018-04-03 19:00:00,38,0,38
"10992",10401,"Mount Pearl","NL",47.50513,-52.79476,2018-04-03 20:00:00,37,0,37
"10993",10401,"Mount Pearl","NL",47.50513,-52.79476,2018-04-03 21:00:00,36,1,37
"10994",10401,"Mount Pearl","NL",47.50513,-52.79476,2018-04-03 22:00:00,37,0,37
"10995",10401,"Mount Pearl","NL",47.50513,-52.79476,2018-04-03 23:00:00,37,0,37
"10996",10401,"Mount Pearl","NL",47.50513,-52.79476,2018-04-04 00:00:00,35,0,35
"10997",10401,"Mount Pearl","NL",47.50513,-52.79476,2018-04-04 01:00:00,39,0,39
"10998",10401,"Mount Pearl","NL",47.50513,-52.79476,2018-04-04 02:00:00,40,0,40
"10999",10401,"Mount Pearl","NL",47.50513,-52.79476,2018-04-04 03:00:00,36,1,37
"11000",10401,"Mount Pearl","NL",47.50513,-52.79476,2018-04-04 04:00:00,34,0,34
"11001",10401,"Mount Pearl","NL",47.50513,-52.79476,2018-04-04 05:00:00,32,0,32
"11002",10401,"Mount Pearl","NL",47.50513,-52.79476,2018-04-04 06:00:00,31,0,31
"11003",10401,"Mount Pearl","NL",47.50513,-52.79476,2018-04-04 07:00:00,28,0,28
"11004",10401,"Mount Pearl","NL",47.50513,-52.79476,2018-04-04 08:00:00,31,1,32
"11005",10401,"Mount Pearl","NL",47.50513,-52.79476,2018-04-04 09:00:00,37,1,38
"11006",10401,"Mount Pearl","NL",47.50513,-52.79476,2018-04-04 10:00:00,40,0,40
"11007",10401,"Mount Pearl","NL",47.50513,-52.79476,2018-04-04 11:00:00,40,0,40
"11008",10401,"Mount Pearl","NL",47.50513,-52.79476,2018-04-04 12:00:00,42,1,43
"11009",10401,"Mount Pearl","NL",47.50513,-52.79476,2018-04-04 13:00:00,43,1,44
"11010",10401,"Mount Pearl","NL",47.50513,-52.79476,2018-04-04 14:00:00,44,1,45
"11011",10401,"Mount Pearl","NL",47.50513,-52.79476,2018-04-04 15:00:00,40,1,41
"11012",10401,"Mount Pearl","NL",47.50513,-52.79476,2018-04-04 16:00:00,41,1,42
"11013",10401,"Mount Pearl","NL",47.50513,-52.79476,2018-04-04 17:00:00,43,1,44
"11014",10401,"Mount Pearl","NL",47.50513,-52.79476,2018-04-04 18:00:00,45,1,46
"11015",10401,"Mount Pearl","NL",47.50513,-52.79476,2018-04-04 19:00:00,44,1,45
"11016",10401,"Mount Pearl","NL",47.50513,-52.79476,2018-04-04 20:00:00,45,1,46
"11017",10401,"Mount Pearl","NL",47.50513,-52.79476,2018-04-04 21:00:00,45,0,45
"11018",10401,"Mount Pearl","NL",47.50513,-52.79476,2018-04-04 22:00:00,42,3,45
"11019",10401,"Mount Pearl","NL",47.50513,-52.79476,2018-04-04 23:00:00,44,0,44
"11020",10401,"Mount Pearl","NL",47.50513,-52.79476,2018-04-05 00:00:00,46,0,46
"11021",10401,"Mount Pearl","NL",47.50513,-52.79476,2018-04-05 01:00:00,45,0,45
"11022",10401,"Mount Pearl","NL",47.50513,-52.79476,2018-04-05 02:00:00,45,0,45
"11023",10401,"Mount Pearl","NL",47.50513,-52.79476,2018-04-05 03:00:00,46,0,46
"11024",10401,"Mount Pearl","NL",47.50513,-52.79476,2018-04-05 04:00:00,46,0,46
"11025",10401,"Mount Pearl","NL",47.50513,-52.79476,2018-04-05 05:00:00,44,0,44
"11026",10401,"Mount Pearl","NL",47.50513,-52.79476,2018-04-05 06:00:00,43,0,43
"11027",10401,"Mount Pearl","NL",47.50513,-52.79476,2018-04-05 07:00:00,42,0,42
"11028",10401,"Mount Pearl","NL",47.50513,-52.79476,2018-04-05 08:00:00,38,0,38
"11029",10401,"Mount Pearl","NL",47.50513,-52.79476,2018-04-05 09:00:00,24,1,25
"11030",10401,"Mount Pearl","NL",47.50513,-52.79476,2018-04-05 10:00:00,23,0,23
"11031",10401,"Mount Pearl","NL",47.50513,-52.79476,2018-04-05 11:00:00,NA,0,NA
"11032",10401,"Mount Pearl","NL",47.50513,-52.79476,2018-04-05 12:00:00,26,NA,NA
"11033",10401,"Mount Pearl","NL",47.50513,-52.79476,2018-04-05 13:00:00,28,NA,NA
"11034",10401,"Mount Pearl","NL",47.50513,-52.79476,2018-04-05 14:00:00,26,NA,NA
"11035",10401,"Mount Pearl","NL",47.50513,-52.79476,2018-04-05 15:00:00,37,0,37
"11036",10401,"Mount Pearl","NL",47.50513,-52.79476,2018-04-05 16:00:00,36,1,37
"11037",10401,"Mount Pearl","NL",47.50513,-52.79476,2018-04-05 17:00:00,35,0,35
"11038",10401,"Mount Pearl","NL",47.50513,-52.79476,2018-04-05 18:00:00,37,1,38
"11039",10401,"Mount Pearl","NL",47.50513,-52.79476,2018-04-05 19:00:00,38,1,39
"11040",10401,"Mount Pearl","NL",47.50513,-52.79476,2018-04-05 20:00:00,38,1,39
"11041",10401,"Mount Pearl","NL",47.50513,-52.79476,2018-04-05 21:00:00,38,0,38
"11042",10401,"Mount Pearl","NL",47.50513,-52.79476,2018-04-05 22:00:00,38,0,38
"11043",10401,"Mount Pearl","NL",47.50513,-52.79476,2018-04-05 23:00:00,39,0,39
"11044",10401,"Mount Pearl","NL",47.50513,-52.79476,2018-04-06 00:00:00,39,1,40
"11045",10401,"Mount Pearl","NL",47.50513,-52.79476,2018-04-06 01:00:00,39,1,40
"11046",10401,"Mount Pearl","NL",47.50513,-52.79476,2018-04-06 02:00:00,39,0,39
"11047",10401,"Mount Pearl","NL",47.50513,-52.79476,2018-04-06 03:00:00,38,0,38
"11048",10401,"Mount Pearl","NL",47.50513,-52.79476,2018-04-06 04:00:00,36,0,36
"11049",10401,"Mount Pearl","NL",47.50513,-52.79476,2018-04-06 05:00:00,34,1,35
"11050",10401,"Mount Pearl","NL",47.50513,-52.79476,2018-04-06 06:00:00,34,0,34
"11051",10401,"Mount Pearl","NL",47.50513,-52.79476,2018-04-06 07:00:00,34,2,36
"11052",10401,"Mount Pearl","NL",47.50513,-52.79476,2018-04-06 08:00:00,35,2,37
"11053",10401,"Mount Pearl","NL",47.50513,-52.79476,2018-04-06 09:00:00,30,2,32
"11054",10401,"Mount Pearl","NL",47.50513,-52.79476,2018-04-06 10:00:00,29,NA,NA
"11055",10401,"Mount Pearl","NL",47.50513,-52.79476,2018-04-06 11:00:00,38,2,40
"11056",10401,"Mount Pearl","NL",47.50513,-52.79476,2018-04-06 12:00:00,39,2,41
"11057",10401,"Mount Pearl","NL",47.50513,-52.79476,2018-04-06 13:00:00,39,2,41
"11058",10401,"Mount Pearl","NL",47.50513,-52.79476,2018-04-06 14:00:00,39,1,40
"11059",10401,"Mount Pearl","NL",47.50513,-52.79476,2018-04-06 15:00:00,40,1,41
"11060",10401,"Mount Pearl","NL",47.50513,-52.79476,2018-04-06 16:00:00,41,1,42
"11061",10401,"Mount Pearl","NL",47.50513,-52.79476,2018-04-06 17:00:00,42,2,44
"11062",10401,"Mount Pearl","NL",47.50513,-52.79476,2018-04-06 18:00:00,42,2,44
"11063",10401,"Mount Pearl","NL",47.50513,-52.79476,2018-04-06 19:00:00,41,2,43
"11064",10401,"Mount Pearl","NL",47.50513,-52.79476,2018-04-06 20:00:00,40,2,42
"11065",10401,"Mount Pearl","NL",47.50513,-52.79476,2018-04-06 21:00:00,41,2,43
"11066",10401,"Mount Pearl","NL",47.50513,-52.79476,2018-04-06 22:00:00,41,1,42
"11067",10401,"Mount Pearl","NL",47.50513,-52.79476,2018-04-06 23:00:00,42,1,43
"11068",10401,"Mount Pearl","NL",47.50513,-52.79476,2018-04-07 00:00:00,42,1,43
"11069",10401,"Mount Pearl","NL",47.50513,-52.79476,2018-04-07 01:00:00,41,2,43
"11070",10401,"Mount Pearl","NL",47.50513,-52.79476,2018-04-07 02:00:00,41,2,43
"11071",10401,"Mount Pearl","NL",47.50513,-52.79476,2018-04-07 03:00:00,40,2,42
"11072",10401,"Mount Pearl","NL",47.50513,-52.79476,2018-04-07 04:00:00,40,1,41
"11073",10401,"Mount Pearl","NL",47.50513,-52.79476,2018-04-07 05:00:00,39,1,40
"11074",10401,"Mount Pearl","NL",47.50513,-52.79476,2018-04-07 06:00:00,37,2,39
"11075",10401,"Mount Pearl","NL",47.50513,-52.79476,2018-04-07 07:00:00,37,2,39
"11076",10401,"Mount Pearl","NL",47.50513,-52.79476,2018-04-07 08:00:00,40,2,42
"11077",10401,"Mount Pearl","NL",47.50513,-52.79476,2018-04-07 09:00:00,42,2,44
"11078",10401,"Mount Pearl","NL",47.50513,-52.79476,2018-04-07 10:00:00,43,2,45
"11079",10401,"Mount Pearl","NL",47.50513,-52.79476,2018-04-07 11:00:00,43,3,46
"11080",10401,"Mount Pearl","NL",47.50513,-52.79476,2018-04-07 12:00:00,43,2,45
"11081",10401,"Mount Pearl","NL",47.50513,-52.79476,2018-04-07 13:00:00,42,2,44
"11082",10401,"Mount Pearl","NL",47.50513,-52.79476,2018-04-07 14:00:00,40,2,42
"11083",10401,"Mount Pearl","NL",47.50513,-52.79476,2018-04-07 15:00:00,45,3,48
"11084",10401,"Mount Pearl","NL",47.50513,-52.79476,2018-04-07 16:00:00,47,3,50
"11085",10401,"Mount Pearl","NL",47.50513,-52.79476,2018-04-07 17:00:00,49,2,51
"11086",10401,"Mount Pearl","NL",47.50513,-52.79476,2018-04-07 18:00:00,49,2,51
"11087",10401,"Mount Pearl","NL",47.50513,-52.79476,2018-04-07 19:00:00,49,2,51
"11088",10401,"Mount Pearl","NL",47.50513,-52.79476,2018-04-07 20:00:00,49,2,51
"11089",10401,"Mount Pearl","NL",47.50513,-52.79476,2018-04-07 21:00:00,48,2,50
"11090",10401,"Mount Pearl","NL",47.50513,-52.79476,2018-04-07 22:00:00,47,3,50
"11091",10401,"Mount Pearl","NL",47.50513,-52.79476,2018-04-07 23:00:00,48,2,50
"11092",10401,"Mount Pearl","NL",47.50513,-52.79476,2018-04-08 00:00:00,50,2,52
"11093",10401,"Mount Pearl","NL",47.50513,-52.79476,2018-04-08 01:00:00,47,3,50
"11094",10401,"Mount Pearl","NL",47.50513,-52.79476,2018-04-08 02:00:00,45,2,47
"11095",10401,"Mount Pearl","NL",47.50513,-52.79476,2018-04-08 03:00:00,44,2,46
"11096",10401,"Mount Pearl","NL",47.50513,-52.79476,2018-04-08 04:00:00,40,2,42
"11097",10401,"Mount Pearl","NL",47.50513,-52.79476,2018-04-08 05:00:00,41,3,44
"11098",10401,"Mount Pearl","NL",47.50513,-52.79476,2018-04-08 06:00:00,43,2,45
"11099",10401,"Mount Pearl","NL",47.50513,-52.79476,2018-04-08 07:00:00,44,2,46
"11100",10401,"Mount Pearl","NL",47.50513,-52.79476,2018-04-08 08:00:00,43,3,46
"11101",10401,"Mount Pearl","NL",47.50513,-52.79476,2018-04-08 09:00:00,44,2,46
"11102",10401,"Mount Pearl","NL",47.50513,-52.79476,2018-04-08 10:00:00,44,2,46
"11103",10401,"Mount Pearl","NL",47.50513,-52.79476,2018-04-08 11:00:00,44,2,46
"11104",10401,"Mount Pearl","NL",47.50513,-52.79476,2018-04-08 12:00:00,43,1,44
"11105",10401,"Mount Pearl","NL",47.50513,-52.79476,2018-04-08 13:00:00,43,1,44
"11106",10401,"Mount Pearl","NL",47.50513,-52.79476,2018-04-08 14:00:00,44,1,45
"11107",10401,"Mount Pearl","NL",47.50513,-52.79476,2018-04-08 15:00:00,44,1,45
"11108",10401,"Mount Pearl","NL",47.50513,-52.79476,2018-04-08 16:00:00,43,1,44
"11109",10401,"Mount Pearl","NL",47.50513,-52.79476,2018-04-08 17:00:00,42,1,43
"11110",10401,"Mount Pearl","NL",47.50513,-52.79476,2018-04-08 18:00:00,43,1,44
"11111",10401,"Mount Pearl","NL",47.50513,-52.79476,2018-04-08 19:00:00,44,1,45
"11112",10401,"Mount Pearl","NL",47.50513,-52.79476,2018-04-08 20:00:00,44,1,45
"11113",10401,"Mount Pearl","NL",47.50513,-52.79476,2018-04-08 21:00:00,44,0,44
"11114",10401,"Mount Pearl","NL",47.50513,-52.79476,2018-04-08 22:00:00,44,1,45
"11115",10401,"Mount Pearl","NL",47.50513,-52.79476,2018-04-08 23:00:00,44,0,44
"11116",10401,"Mount Pearl","NL",47.50513,-52.79476,2018-04-09 00:00:00,45,1,46
"11117",10401,"Mount Pearl","NL",47.50513,-52.79476,2018-04-09 01:00:00,47,1,48
"11118",10401,"Mount Pearl","NL",47.50513,-52.79476,2018-04-09 02:00:00,34,1,35
"11119",10401,"Mount Pearl","NL",47.50513,-52.79476,2018-04-09 03:00:00,24,0,24
"11120",10401,"Mount Pearl","NL",47.50513,-52.79476,2018-04-09 04:00:00,20,1,21
"11121",10401,"Mount Pearl","NL",47.50513,-52.79476,2018-04-09 05:00:00,21,1,22
"11122",10401,"Mount Pearl","NL",47.50513,-52.79476,2018-04-09 06:00:00,22,1,23
"11123",10401,"Mount Pearl","NL",47.50513,-52.79476,2018-04-09 07:00:00,29,1,30
"11124",10401,"Mount Pearl","NL",47.50513,-52.79476,2018-04-09 08:00:00,38,1,39
"11125",10401,"Mount Pearl","NL",47.50513,-52.79476,2018-04-09 09:00:00,38,1,39
"11126",10401,"Mount Pearl","NL",47.50513,-52.79476,2018-04-09 10:00:00,40,0,40
"11127",10401,"Mount Pearl","NL",47.50513,-52.79476,2018-04-09 11:00:00,41,1,42
"11128",10401,"Mount Pearl","NL",47.50513,-52.79476,2018-04-09 12:00:00,41,1,42
"11129",10401,"Mount Pearl","NL",47.50513,-52.79476,2018-04-09 13:00:00,41,1,42
"11130",10401,"Mount Pearl","NL",47.50513,-52.79476,2018-04-09 14:00:00,40,0,40
"11131",10401,"Mount Pearl","NL",47.50513,-52.79476,2018-04-09 15:00:00,40,1,41
"11132",10401,"Mount Pearl","NL",47.50513,-52.79476,2018-04-09 16:00:00,39,0,39
"11133",10401,"Mount Pearl","NL",47.50513,-52.79476,2018-04-09 17:00:00,39,1,40
"11134",10401,"Mount Pearl","NL",47.50513,-52.79476,2018-04-09 18:00:00,39,0,39
"11135",10401,"Mount Pearl","NL",47.50513,-52.79476,2018-04-09 19:00:00,39,0,39
"11136",10401,"Mount Pearl","NL",47.50513,-52.79476,2018-04-09 20:00:00,38,0,38
"11137",10401,"Mount Pearl","NL",47.50513,-52.79476,2018-04-09 21:00:00,38,0,38
"11138",10401,"Mount Pearl","NL",47.50513,-52.79476,2018-04-09 22:00:00,38,1,39
"11139",10401,"Mount Pearl","NL",47.50513,-52.79476,2018-04-09 23:00:00,38,1,39
"11140",10401,"Mount Pearl","NL",47.50513,-52.79476,2018-04-10 00:00:00,38,0,38
"11141",10401,"Mount Pearl","NL",47.50513,-52.79476,2018-04-10 01:00:00,38,0,38
"11142",10401,"Mount Pearl","NL",47.50513,-52.79476,2018-04-10 02:00:00,38,1,39
"11143",10401,"Mount Pearl","NL",47.50513,-52.79476,2018-04-10 03:00:00,38,1,39
"11144",10401,"Mount Pearl","NL",47.50513,-52.79476,2018-04-10 04:00:00,39,1,40
"11145",10401,"Mount Pearl","NL",47.50513,-52.79476,2018-04-10 05:00:00,NA,NA,NA
"11146",10401,"Mount Pearl","NL",47.50513,-52.79476,2018-04-10 06:00:00,NA,NA,NA
"11147",10401,"Mount Pearl","NL",47.50513,-52.79476,2018-04-10 07:00:00,NA,NA,NA
"11148",10401,"Mount Pearl","NL",47.50513,-52.79476,2018-04-10 08:00:00,NA,NA,NA
"11149",10401,"Mount Pearl","NL",47.50513,-52.79476,2018-04-10 09:00:00,NA,NA,NA
"11150",10401,"Mount Pearl","NL",47.50513,-52.79476,2018-04-10 10:00:00,NA,NA,NA
"11151",10401,"Mount Pearl","NL",47.50513,-52.79476,2018-04-10 11:00:00,NA,NA,NA
"11152",10401,"Mount Pearl","NL",47.50513,-52.79476,2018-04-10 12:00:00,NA,NA,NA
"11153",10401,"Mount Pearl","NL",47.50513,-52.79476,2018-04-10 13:00:00,NA,NA,NA
"11154",10401,"Mount Pearl","NL",47.50513,-52.79476,2018-04-10 14:00:00,NA,NA,NA
"11155",10401,"Mount Pearl","NL",47.50513,-52.79476,2018-04-10 15:00:00,NA,NA,NA
"11156",10401,"Mount Pearl","NL",47.50513,-52.79476,2018-04-10 16:00:00,NA,NA,NA
"11157",10401,"Mount Pearl","NL",47.50513,-52.79476,2018-04-10 17:00:00,NA,NA,NA
"11158",10401,"Mount Pearl","NL",47.50513,-52.79476,2018-04-10 18:00:00,NA,NA,NA
"11159",10401,"Mount Pearl","NL",47.50513,-52.79476,2018-04-10 19:00:00,NA,NA,NA
"11160",10401,"Mount Pearl","NL",47.50513,-52.79476,2018-04-10 20:00:00,NA,NA,NA
"11161",10401,"Mount Pearl","NL",47.50513,-52.79476,2018-04-10 21:00:00,NA,NA,NA
"11162",10401,"Mount Pearl","NL",47.50513,-52.79476,2018-04-10 22:00:00,NA,NA,NA
"11163",10401,"Mount Pearl","NL",47.50513,-52.79476,2018-04-10 23:00:00,NA,NA,NA
"11164",10401,"Mount Pearl","NL",47.50513,-52.79476,2018-04-11 00:00:00,NA,NA,NA
"11165",10401,"Mount Pearl","NL",47.50513,-52.79476,2018-04-11 01:00:00,NA,NA,NA
"11166",10401,"Mount Pearl","NL",47.50513,-52.79476,2018-04-11 02:00:00,NA,NA,NA
"11167",10401,"Mount Pearl","NL",47.50513,-52.79476,2018-04-11 03:00:00,NA,NA,NA
"11168",10401,"Mount Pearl","NL",47.50513,-52.79476,2018-04-11 04:00:00,NA,NA,NA
"11169",10401,"Mount Pearl","NL",47.50513,-52.79476,2018-04-11 05:00:00,NA,NA,NA
"11170",10401,"Mount Pearl","NL",47.50513,-52.79476,2018-04-11 06:00:00,NA,NA,NA
"11171",10401,"Mount Pearl","NL",47.50513,-52.79476,2018-04-11 07:00:00,NA,NA,NA
"11172",10401,"Mount Pearl","NL",47.50513,-52.79476,2018-04-11 08:00:00,NA,NA,NA
"11173",10401,"Mount Pearl","NL",47.50513,-52.79476,2018-04-11 09:00:00,NA,NA,NA
"11174",10401,"Mount Pearl","NL",47.50513,-52.79476,2018-04-11 10:00:00,NA,NA,NA
"11175",10401,"Mount Pearl","NL",47.50513,-52.79476,2018-04-11 11:00:00,NA,NA,NA
"11176",10401,"Mount Pearl","NL",47.50513,-52.79476,2018-04-11 12:00:00,NA,NA,NA
"11177",10401,"Mount Pearl","NL",47.50513,-52.79476,2018-04-11 13:00:00,34,2,36
"11178",10401,"Mount Pearl","NL",47.50513,-52.79476,2018-04-11 14:00:00,34,2,36
"11179",10401,"Mount Pearl","NL",47.50513,-52.79476,2018-04-11 15:00:00,34,1,35
"11180",10401,"Mount Pearl","NL",47.50513,-52.79476,2018-04-11 16:00:00,39,1,40
"11181",10401,"Mount Pearl","NL",47.50513,-52.79476,2018-04-11 17:00:00,41,2,43
"11182",10401,"Mount Pearl","NL",47.50513,-52.79476,2018-04-11 18:00:00,41,1,42
"11183",10401,"Mount Pearl","NL",47.50513,-52.79476,2018-04-11 19:00:00,42,1,43
"11184",10401,"Mount Pearl","NL",47.50513,-52.79476,2018-04-11 20:00:00,39,2,41
"11185",10401,"Mount Pearl","NL",47.50513,-52.79476,2018-04-11 21:00:00,36,3,39
"11186",10401,"Mount Pearl","NL",47.50513,-52.79476,2018-04-11 22:00:00,28,5,33
"11187",10401,"Mount Pearl","NL",47.50513,-52.79476,2018-04-11 23:00:00,21,8,29
"11188",10401,"Mount Pearl","NL",47.50513,-52.79476,2018-04-12 00:00:00,32,3,35
"11189",10401,"Mount Pearl","NL",47.50513,-52.79476,2018-04-12 01:00:00,33,2,35
"11190",10401,"Mount Pearl","NL",47.50513,-52.79476,2018-04-12 02:00:00,26,4,30
"11191",10401,"Mount Pearl","NL",47.50513,-52.79476,2018-04-12 03:00:00,19,5,24
"11192",10401,"Mount Pearl","NL",47.50513,-52.79476,2018-04-12 04:00:00,17,5,22
"11193",10401,"Mount Pearl","NL",47.50513,-52.79476,2018-04-12 05:00:00,34,2,36
"11194",10401,"Mount Pearl","NL",47.50513,-52.79476,2018-04-12 06:00:00,35,3,38
"11195",10401,"Mount Pearl","NL",47.50513,-52.79476,2018-04-12 07:00:00,35,6,41
"11196",10401,"Mount Pearl","NL",47.50513,-52.79476,2018-04-12 08:00:00,38,3,41
"11197",10401,"Mount Pearl","NL",47.50513,-52.79476,2018-04-12 09:00:00,37,3,40
"11198",10401,"Mount Pearl","NL",47.50513,-52.79476,2018-04-12 10:00:00,38,2,40
"11199",10401,"Mount Pearl","NL",47.50513,-52.79476,2018-04-12 11:00:00,38,2,40
"11200",10401,"Mount Pearl","NL",47.50513,-52.79476,2018-04-12 12:00:00,38,2,40
"11201",10401,"Mount Pearl","NL",47.50513,-52.79476,2018-04-12 13:00:00,37,3,40
"11202",10401,"Mount Pearl","NL",47.50513,-52.79476,2018-04-12 14:00:00,39,2,41
"11203",10401,"Mount Pearl","NL",47.50513,-52.79476,2018-04-12 15:00:00,38,2,40
"11204",10401,"Mount Pearl","NL",47.50513,-52.79476,2018-04-12 16:00:00,38,1,39
"11205",10401,"Mount Pearl","NL",47.50513,-52.79476,2018-04-12 17:00:00,37,2,39
"11206",10401,"Mount Pearl","NL",47.50513,-52.79476,2018-04-12 18:00:00,37,2,39
"11207",10401,"Mount Pearl","NL",47.50513,-52.79476,2018-04-12 19:00:00,35,2,37
"11208",10401,"Mount Pearl","NL",47.50513,-52.79476,2018-04-12 20:00:00,34,3,37
"11209",10401,"Mount Pearl","NL",47.50513,-52.79476,2018-04-12 21:00:00,33,3,36
"11210",10401,"Mount Pearl","NL",47.50513,-52.79476,2018-04-12 22:00:00,34,2,36
"11211",10401,"Mount Pearl","NL",47.50513,-52.79476,2018-04-12 23:00:00,32,2,34
"11212",10401,"Mount Pearl","NL",47.50513,-52.79476,2018-04-13 00:00:00,29,3,32
"11213",10401,"Mount Pearl","NL",47.50513,-52.79476,2018-04-13 01:00:00,29,4,33
"11214",10401,"Mount Pearl","NL",47.50513,-52.79476,2018-04-13 02:00:00,31,2,33
"11215",10401,"Mount Pearl","NL",47.50513,-52.79476,2018-04-13 03:00:00,30,3,33
"11216",10401,"Mount Pearl","NL",47.50513,-52.79476,2018-04-13 04:00:00,24,4,28
"11217",10401,"Mount Pearl","NL",47.50513,-52.79476,2018-04-13 05:00:00,32,1,33
"11218",10401,"Mount Pearl","NL",47.50513,-52.79476,2018-04-13 06:00:00,21,6,27
"11219",10401,"Mount Pearl","NL",47.50513,-52.79476,2018-04-13 07:00:00,22,7,29
"11220",10401,"Mount Pearl","NL",47.50513,-52.79476,2018-04-13 08:00:00,28,8,36
"11221",10401,"Mount Pearl","NL",47.50513,-52.79476,2018-04-13 09:00:00,36,3,39
"11222",10401,"Mount Pearl","NL",47.50513,-52.79476,2018-04-13 10:00:00,40,2,42
"11223",10401,"Mount Pearl","NL",47.50513,-52.79476,2018-04-13 11:00:00,40,2,42
"11224",10401,"Mount Pearl","NL",47.50513,-52.79476,2018-04-13 12:00:00,39,1,40
"11225",10401,"Mount Pearl","NL",47.50513,-52.79476,2018-04-13 13:00:00,41,1,42
"11226",10401,"Mount Pearl","NL",47.50513,-52.79476,2018-04-13 14:00:00,41,0,41
"11227",10401,"Mount Pearl","NL",47.50513,-52.79476,2018-04-13 15:00:00,41,1,42
"11228",10401,"Mount Pearl","NL",47.50513,-52.79476,2018-04-13 16:00:00,41,1,42
"11229",10401,"Mount Pearl","NL",47.50513,-52.79476,2018-04-13 17:00:00,42,1,43
"11230",10401,"Mount Pearl","NL",47.50513,-52.79476,2018-04-13 18:00:00,40,1,41
"11231",10401,"Mount Pearl","NL",47.50513,-52.79476,2018-04-13 19:00:00,40,1,41
"11232",10401,"Mount Pearl","NL",47.50513,-52.79476,2018-04-13 20:00:00,40,1,41
"11233",10401,"Mount Pearl","NL",47.50513,-52.79476,2018-04-13 21:00:00,39,0,39
"11234",10401,"Mount Pearl","NL",47.50513,-52.79476,2018-04-13 22:00:00,41,2,43
"11235",10401,"Mount Pearl","NL",47.50513,-52.79476,2018-04-13 23:00:00,38,1,39
"11236",10401,"Mount Pearl","NL",47.50513,-52.79476,2018-04-14 00:00:00,38,0,38
"11237",10401,"Mount Pearl","NL",47.50513,-52.79476,2018-04-14 01:00:00,37,1,38
"11238",10401,"Mount Pearl","NL",47.50513,-52.79476,2018-04-14 02:00:00,37,0,37
"11239",10401,"Mount Pearl","NL",47.50513,-52.79476,2018-04-14 03:00:00,37,1,38
"11240",10401,"Mount Pearl","NL",47.50513,-52.79476,2018-04-14 04:00:00,36,1,37
"11241",10401,"Mount Pearl","NL",47.50513,-52.79476,2018-04-14 05:00:00,40,1,41
"11242",10401,"Mount Pearl","NL",47.50513,-52.79476,2018-04-14 06:00:00,39,1,40
"11243",10401,"Mount Pearl","NL",47.50513,-52.79476,2018-04-14 07:00:00,38,1,39
"11244",10401,"Mount Pearl","NL",47.50513,-52.79476,2018-04-14 08:00:00,38,0,38
"11245",10401,"Mount Pearl","NL",47.50513,-52.79476,2018-04-14 09:00:00,40,2,42
"11246",10401,"Mount Pearl","NL",47.50513,-52.79476,2018-04-14 10:00:00,42,1,43
"11247",10401,"Mount Pearl","NL",47.50513,-52.79476,2018-04-14 11:00:00,43,1,44
"11248",10401,"Mount Pearl","NL",47.50513,-52.79476,2018-04-14 12:00:00,41,1,42
"11249",10401,"Mount Pearl","NL",47.50513,-52.79476,2018-04-14 13:00:00,43,0,43
"11250",10401,"Mount Pearl","NL",47.50513,-52.79476,2018-04-14 14:00:00,44,0,44
"11251",10401,"Mount Pearl","NL",47.50513,-52.79476,2018-04-14 15:00:00,45,0,45
"11252",10401,"Mount Pearl","NL",47.50513,-52.79476,2018-04-14 16:00:00,45,0,45
"11253",10401,"Mount Pearl","NL",47.50513,-52.79476,2018-04-14 17:00:00,46,1,47
"11254",10401,"Mount Pearl","NL",47.50513,-52.79476,2018-04-14 18:00:00,44,0,44
"11255",10401,"Mount Pearl","NL",47.50513,-52.79476,2018-04-14 19:00:00,42,1,43
"11256",10401,"Mount Pearl","NL",47.50513,-52.79476,2018-04-14 20:00:00,46,1,47
"11257",10401,"Mount Pearl","NL",47.50513,-52.79476,2018-04-14 21:00:00,44,1,45
"11258",10401,"Mount Pearl","NL",47.50513,-52.79476,2018-04-14 22:00:00,41,1,42
"11259",10401,"Mount Pearl","NL",47.50513,-52.79476,2018-04-14 23:00:00,39,1,40
"11260",10401,"Mount Pearl","NL",47.50513,-52.79476,2018-04-15 00:00:00,37,1,38
"11261",10401,"Mount Pearl","NL",47.50513,-52.79476,2018-04-15 01:00:00,37,2,39
"11262",10401,"Mount Pearl","NL",47.50513,-52.79476,2018-04-15 02:00:00,37,1,38
"11263",10401,"Mount Pearl","NL",47.50513,-52.79476,2018-04-15 03:00:00,38,2,40
"11264",10401,"Mount Pearl","NL",47.50513,-52.79476,2018-04-15 04:00:00,39,1,40
"11265",10401,"Mount Pearl","NL",47.50513,-52.79476,2018-04-15 05:00:00,39,2,41
"11266",10401,"Mount Pearl","NL",47.50513,-52.79476,2018-04-15 06:00:00,38,1,39
"11267",10401,"Mount Pearl","NL",47.50513,-52.79476,2018-04-15 07:00:00,37,2,39
"11268",10401,"Mount Pearl","NL",47.50513,-52.79476,2018-04-15 08:00:00,36,1,37
"11269",10401,"Mount Pearl","NL",47.50513,-52.79476,2018-04-15 09:00:00,36,1,37
"11270",10401,"Mount Pearl","NL",47.50513,-52.79476,2018-04-15 10:00:00,35,1,36
"11271",10401,"Mount Pearl","NL",47.50513,-52.79476,2018-04-15 11:00:00,36,1,37
"11272",10401,"Mount Pearl","NL",47.50513,-52.79476,2018-04-15 12:00:00,37,1,38
"11273",10401,"Mount Pearl","NL",47.50513,-52.79476,2018-04-15 13:00:00,38,0,38
"11274",10401,"Mount Pearl","NL",47.50513,-52.79476,2018-04-15 14:00:00,37,1,38
"11275",10401,"Mount Pearl","NL",47.50513,-52.79476,2018-04-15 15:00:00,37,1,38
"11276",10401,"Mount Pearl","NL",47.50513,-52.79476,2018-04-15 16:00:00,39,1,40
"11277",10401,"Mount Pearl","NL",47.50513,-52.79476,2018-04-15 17:00:00,40,1,41
"11278",10401,"Mount Pearl","NL",47.50513,-52.79476,2018-04-15 18:00:00,41,1,42
"11279",10401,"Mount Pearl","NL",47.50513,-52.79476,2018-04-15 19:00:00,41,0,41
"11280",10401,"Mount Pearl","NL",47.50513,-52.79476,2018-04-15 20:00:00,42,1,43
"11281",10401,"Mount Pearl","NL",47.50513,-52.79476,2018-04-15 21:00:00,44,1,45
"11282",10401,"Mount Pearl","NL",47.50513,-52.79476,2018-04-15 22:00:00,43,1,44
"11283",10401,"Mount Pearl","NL",47.50513,-52.79476,2018-04-15 23:00:00,43,1,44
"11284",10401,"Mount Pearl","NL",47.50513,-52.79476,2018-04-16 00:00:00,43,1,44
"11285",10401,"Mount Pearl","NL",47.50513,-52.79476,2018-04-16 01:00:00,43,0,43
"11286",10401,"Mount Pearl","NL",47.50513,-52.79476,2018-04-16 02:00:00,42,1,43
"11287",10401,"Mount Pearl","NL",47.50513,-52.79476,2018-04-16 03:00:00,40,0,40
"11288",10401,"Mount Pearl","NL",47.50513,-52.79476,2018-04-16 04:00:00,40,0,40
"11289",10401,"Mount Pearl","NL",47.50513,-52.79476,2018-04-16 05:00:00,38,1,39
"11290",10401,"Mount Pearl","NL",47.50513,-52.79476,2018-04-16 06:00:00,35,1,36
"11291",10401,"Mount Pearl","NL",47.50513,-52.79476,2018-04-16 07:00:00,33,1,34
"11292",10401,"Mount Pearl","NL",47.50513,-52.79476,2018-04-16 08:00:00,33,2,35
"11293",10401,"Mount Pearl","NL",47.50513,-52.79476,2018-04-16 09:00:00,33,1,34
"11294",10401,"Mount Pearl","NL",47.50513,-52.79476,2018-04-16 10:00:00,33,1,34
"11295",10401,"Mount Pearl","NL",47.50513,-52.79476,2018-04-16 11:00:00,34,1,35
"11296",10401,"Mount Pearl","NL",47.50513,-52.79476,2018-04-16 12:00:00,40,1,41
"11297",10401,"Mount Pearl","NL",47.50513,-52.79476,2018-04-16 13:00:00,43,1,44
"11298",10401,"Mount Pearl","NL",47.50513,-52.79476,2018-04-16 14:00:00,46,1,47
"11299",10401,"Mount Pearl","NL",47.50513,-52.79476,2018-04-16 15:00:00,45,1,46
"11300",10401,"Mount Pearl","NL",47.50513,-52.79476,2018-04-16 16:00:00,44,1,45
"11301",10401,"Mount Pearl","NL",47.50513,-52.79476,2018-04-16 17:00:00,44,1,45
"11302",10401,"Mount Pearl","NL",47.50513,-52.79476,2018-04-16 18:00:00,44,1,45
"11303",10401,"Mount Pearl","NL",47.50513,-52.79476,2018-04-16 19:00:00,43,1,44
"11304",10401,"Mount Pearl","NL",47.50513,-52.79476,2018-04-16 20:00:00,40,2,42
"11305",10401,"Mount Pearl","NL",47.50513,-52.79476,2018-04-16 21:00:00,39,2,41
"11306",10401,"Mount Pearl","NL",47.50513,-52.79476,2018-04-16 22:00:00,35,4,39
"11307",10401,"Mount Pearl","NL",47.50513,-52.79476,2018-04-16 23:00:00,35,4,39
"11308",10401,"Mount Pearl","NL",47.50513,-52.79476,2018-04-17 00:00:00,36,3,39
"11309",10401,"Mount Pearl","NL",47.50513,-52.79476,2018-04-17 01:00:00,37,2,39
"11310",10401,"Mount Pearl","NL",47.50513,-52.79476,2018-04-17 02:00:00,31,3,34
"11311",10401,"Mount Pearl","NL",47.50513,-52.79476,2018-04-17 03:00:00,37,1,38
"11312",10401,"Mount Pearl","NL",47.50513,-52.79476,2018-04-17 04:00:00,38,1,39
"11313",10401,"Mount Pearl","NL",47.50513,-52.79476,2018-04-17 05:00:00,37,2,39
"11314",10401,"Mount Pearl","NL",47.50513,-52.79476,2018-04-17 06:00:00,35,3,38
"11315",10401,"Mount Pearl","NL",47.50513,-52.79476,2018-04-17 07:00:00,31,6,37
"11316",10401,"Mount Pearl","NL",47.50513,-52.79476,2018-04-17 08:00:00,34,5,39
"11317",10401,"Mount Pearl","NL",47.50513,-52.79476,2018-04-17 09:00:00,40,1,41
"11318",10401,"Mount Pearl","NL",47.50513,-52.79476,2018-04-17 10:00:00,41,1,42
"11319",10401,"Mount Pearl","NL",47.50513,-52.79476,2018-04-17 11:00:00,41,2,43
"11320",10401,"Mount Pearl","NL",47.50513,-52.79476,2018-04-17 12:00:00,42,1,43
"11321",10401,"Mount Pearl","NL",47.50513,-52.79476,2018-04-17 13:00:00,42,0,42
"11322",10401,"Mount Pearl","NL",47.50513,-52.79476,2018-04-17 14:00:00,43,0,43
"11323",10401,"Mount Pearl","NL",47.50513,-52.79476,2018-04-17 15:00:00,43,0,43
"11324",10401,"Mount Pearl","NL",47.50513,-52.79476,2018-04-17 16:00:00,41,0,41
"11325",10401,"Mount Pearl","NL",47.50513,-52.79476,2018-04-17 17:00:00,42,0,42
"11326",10401,"Mount Pearl","NL",47.50513,-52.79476,2018-04-17 18:00:00,42,0,42
"11327",10401,"Mount Pearl","NL",47.50513,-52.79476,2018-04-17 19:00:00,41,1,42
"11328",10401,"Mount Pearl","NL",47.50513,-52.79476,2018-04-17 20:00:00,40,1,41
"11329",10401,"Mount Pearl","NL",47.50513,-52.79476,2018-04-17 21:00:00,40,1,41
"11330",10401,"Mount Pearl","NL",47.50513,-52.79476,2018-04-17 22:00:00,40,0,40
"11331",10401,"Mount Pearl","NL",47.50513,-52.79476,2018-04-17 23:00:00,41,0,41
"11332",10401,"Mount Pearl","NL",47.50513,-52.79476,2018-04-18 00:00:00,42,0,42
"11333",10401,"Mount Pearl","NL",47.50513,-52.79476,2018-04-18 01:00:00,42,0,42
"11334",10401,"Mount Pearl","NL",47.50513,-52.79476,2018-04-18 02:00:00,42,0,42
"11335",10401,"Mount Pearl","NL",47.50513,-52.79476,2018-04-18 03:00:00,42,0,42
"11336",10401,"Mount Pearl","NL",47.50513,-52.79476,2018-04-18 04:00:00,42,0,42
"11337",10401,"Mount Pearl","NL",47.50513,-52.79476,2018-04-18 05:00:00,42,0,42
"11338",10401,"Mount Pearl","NL",47.50513,-52.79476,2018-04-18 06:00:00,43,0,43
"11339",10401,"Mount Pearl","NL",47.50513,-52.79476,2018-04-18 07:00:00,44,0,44
"11340",10401,"Mount Pearl","NL",47.50513,-52.79476,2018-04-18 08:00:00,45,0,45
"11341",10401,"Mount Pearl","NL",47.50513,-52.79476,2018-04-18 09:00:00,45,0,45
"11342",10401,"Mount Pearl","NL",47.50513,-52.79476,2018-04-18 10:00:00,44,0,44
"11343",10401,"Mount Pearl","NL",47.50513,-52.79476,2018-04-18 11:00:00,45,0,45
"11344",10401,"Mount Pearl","NL",47.50513,-52.79476,2018-04-18 12:00:00,45,2,47
"11345",10401,"Mount Pearl","NL",47.50513,-52.79476,2018-04-18 13:00:00,43,2,45
"11346",10401,"Mount Pearl","NL",47.50513,-52.79476,2018-04-18 14:00:00,42,2,44
"11347",10401,"Mount Pearl","NL",47.50513,-52.79476,2018-04-18 15:00:00,42,1,43
"11348",10401,"Mount Pearl","NL",47.50513,-52.79476,2018-04-18 16:00:00,40,1,41
"11349",10401,"Mount Pearl","NL",47.50513,-52.79476,2018-04-18 17:00:00,37,2,39
"11350",10401,"Mount Pearl","NL",47.50513,-52.79476,2018-04-18 18:00:00,32,2,34
"11351",10401,"Mount Pearl","NL",47.50513,-52.79476,2018-04-18 19:00:00,30,2,32
"11352",10401,"Mount Pearl","NL",47.50513,-52.79476,2018-04-18 20:00:00,37,2,39
"11353",10401,"Mount Pearl","NL",47.50513,-52.79476,2018-04-18 21:00:00,39,1,40
"11354",10401,"Mount Pearl","NL",47.50513,-52.79476,2018-04-18 22:00:00,38,2,40
"11355",10401,"Mount Pearl","NL",47.50513,-52.79476,2018-04-18 23:00:00,42,1,43
"11356",10401,"Mount Pearl","NL",47.50513,-52.79476,2018-04-19 00:00:00,41,2,43
"11357",10401,"Mount Pearl","NL",47.50513,-52.79476,2018-04-19 01:00:00,40,2,42
"11358",10401,"Mount Pearl","NL",47.50513,-52.79476,2018-04-19 02:00:00,39,2,41
"11359",10401,"Mount Pearl","NL",47.50513,-52.79476,2018-04-19 03:00:00,39,2,41
"11360",10401,"Mount Pearl","NL",47.50513,-52.79476,2018-04-19 04:00:00,38,1,39
"11361",10401,"Mount Pearl","NL",47.50513,-52.79476,2018-04-19 05:00:00,38,1,39
"11362",10401,"Mount Pearl","NL",47.50513,-52.79476,2018-04-19 06:00:00,38,2,40
"11363",10401,"Mount Pearl","NL",47.50513,-52.79476,2018-04-19 07:00:00,38,2,40
"11364",10401,"Mount Pearl","NL",47.50513,-52.79476,2018-04-19 08:00:00,37,2,39
"11365",10401,"Mount Pearl","NL",47.50513,-52.79476,2018-04-19 09:00:00,36,2,38
"11366",10401,"Mount Pearl","NL",47.50513,-52.79476,2018-04-19 10:00:00,36,2,38
"11367",10401,"Mount Pearl","NL",47.50513,-52.79476,2018-04-19 11:00:00,35,2,37
"11368",10401,"Mount Pearl","NL",47.50513,-52.79476,2018-04-19 12:00:00,33,1,34
"11369",10401,"Mount Pearl","NL",47.50513,-52.79476,2018-04-19 13:00:00,32,1,33
"11370",10401,"Mount Pearl","NL",47.50513,-52.79476,2018-04-19 14:00:00,34,1,35
"11371",10401,"Mount Pearl","NL",47.50513,-52.79476,2018-04-19 15:00:00,33,1,34
"11372",10401,"Mount Pearl","NL",47.50513,-52.79476,2018-04-19 16:00:00,32,1,33
"11373",10401,"Mount Pearl","NL",47.50513,-52.79476,2018-04-19 17:00:00,33,2,35
"11374",10401,"Mount Pearl","NL",47.50513,-52.79476,2018-04-19 18:00:00,33,1,34
"11375",10401,"Mount Pearl","NL",47.50513,-52.79476,2018-04-19 19:00:00,34,1,35
"11376",10401,"Mount Pearl","NL",47.50513,-52.79476,2018-04-19 20:00:00,34,2,36
"11377",10401,"Mount Pearl","NL",47.50513,-52.79476,2018-04-19 21:00:00,34,2,36
"11378",10401,"Mount Pearl","NL",47.50513,-52.79476,2018-04-19 22:00:00,34,2,36
"11379",10401,"Mount Pearl","NL",47.50513,-52.79476,2018-04-19 23:00:00,34,1,35
"11380",10401,"Mount Pearl","NL",47.50513,-52.79476,2018-04-20 00:00:00,32,1,33
"11381",10401,"Mount Pearl","NL",47.50513,-52.79476,2018-04-20 01:00:00,30,1,31
"11382",10401,"Mount Pearl","NL",47.50513,-52.79476,2018-04-20 02:00:00,27,1,28
"11383",10401,"Mount Pearl","NL",47.50513,-52.79476,2018-04-20 03:00:00,24,1,25
"11384",10401,"Mount Pearl","NL",47.50513,-52.79476,2018-04-20 04:00:00,22,1,23
"11385",10401,"Mount Pearl","NL",47.50513,-52.79476,2018-04-20 05:00:00,18,3,21
"11386",10401,"Mount Pearl","NL",47.50513,-52.79476,2018-04-20 06:00:00,18,2,20
"11387",10401,"Mount Pearl","NL",47.50513,-52.79476,2018-04-20 07:00:00,14,13,27
"11388",10401,"Mount Pearl","NL",47.50513,-52.79476,2018-04-20 08:00:00,26,5,31
"11389",10401,"Mount Pearl","NL",47.50513,-52.79476,2018-04-20 09:00:00,31,2,33
"11390",10401,"Mount Pearl","NL",47.50513,-52.79476,2018-04-20 10:00:00,32,1,33
"11391",10401,"Mount Pearl","NL",47.50513,-52.79476,2018-04-20 11:00:00,34,2,36
"11392",10401,"Mount Pearl","NL",47.50513,-52.79476,2018-04-20 12:00:00,34,2,36
"11393",10401,"Mount Pearl","NL",47.50513,-52.79476,2018-04-20 13:00:00,33,2,35
"11394",10401,"Mount Pearl","NL",47.50513,-52.79476,2018-04-20 14:00:00,32,1,33
"11395",10401,"Mount Pearl","NL",47.50513,-52.79476,2018-04-20 15:00:00,32,2,34
"11396",10401,"Mount Pearl","NL",47.50513,-52.79476,2018-04-20 16:00:00,30,3,33
"11397",10401,"Mount Pearl","NL",47.50513,-52.79476,2018-04-20 17:00:00,26,7,33
"11398",10401,"Mount Pearl","NL",47.50513,-52.79476,2018-04-20 18:00:00,34,2,36
"11399",10401,"Mount Pearl","NL",47.50513,-52.79476,2018-04-20 19:00:00,38,1,39
"11400",10401,"Mount Pearl","NL",47.50513,-52.79476,2018-04-20 20:00:00,37,1,38
"11401",10401,"Mount Pearl","NL",47.50513,-52.79476,2018-04-20 21:00:00,36,1,37
"11402",10401,"Mount Pearl","NL",47.50513,-52.79476,2018-04-20 22:00:00,36,0,36
"11403",10401,"Mount Pearl","NL",47.50513,-52.79476,2018-04-20 23:00:00,35,0,35
"11404",10401,"Mount Pearl","NL",47.50513,-52.79476,2018-04-21 00:00:00,33,1,34
"11405",10401,"Mount Pearl","NL",47.50513,-52.79476,2018-04-21 01:00:00,33,1,34
"11406",10401,"Mount Pearl","NL",47.50513,-52.79476,2018-04-21 02:00:00,33,1,34
"11407",10401,"Mount Pearl","NL",47.50513,-52.79476,2018-04-21 03:00:00,33,0,33
"11408",10401,"Mount Pearl","NL",47.50513,-52.79476,2018-04-21 04:00:00,33,0,33
"11409",10401,"Mount Pearl","NL",47.50513,-52.79476,2018-04-21 05:00:00,32,1,33
"11410",10401,"Mount Pearl","NL",47.50513,-52.79476,2018-04-21 06:00:00,32,0,32
"11411",10401,"Mount Pearl","NL",47.50513,-52.79476,2018-04-21 07:00:00,32,1,33
"11412",10401,"Mount Pearl","NL",47.50513,-52.79476,2018-04-21 08:00:00,32,1,33
"11413",10401,"Mount Pearl","NL",47.50513,-52.79476,2018-04-21 09:00:00,31,0,31
"11414",10401,"Mount Pearl","NL",47.50513,-52.79476,2018-04-21 10:00:00,31,0,31
"11415",10401,"Mount Pearl","NL",47.50513,-52.79476,2018-04-21 11:00:00,31,1,32
"11416",10401,"Mount Pearl","NL",47.50513,-52.79476,2018-04-21 12:00:00,31,2,33
"11417",10401,"Mount Pearl","NL",47.50513,-52.79476,2018-04-21 13:00:00,32,1,33
"11418",10401,"Mount Pearl","NL",47.50513,-52.79476,2018-04-21 14:00:00,34,2,36
"11419",10401,"Mount Pearl","NL",47.50513,-52.79476,2018-04-21 15:00:00,36,1,37
"11420",10401,"Mount Pearl","NL",47.50513,-52.79476,2018-04-21 16:00:00,36,2,38
"11421",10401,"Mount Pearl","NL",47.50513,-52.79476,2018-04-21 17:00:00,36,1,37
"11422",10401,"Mount Pearl","NL",47.50513,-52.79476,2018-04-21 18:00:00,37,1,38
"11423",10401,"Mount Pearl","NL",47.50513,-52.79476,2018-04-21 19:00:00,38,1,39
"11424",10401,"Mount Pearl","NL",47.50513,-52.79476,2018-04-21 20:00:00,38,2,40
"11425",10401,"Mount Pearl","NL",47.50513,-52.79476,2018-04-21 21:00:00,38,1,39
"11426",10401,"Mount Pearl","NL",47.50513,-52.79476,2018-04-21 22:00:00,38,1,39
"11427",10401,"Mount Pearl","NL",47.50513,-52.79476,2018-04-21 23:00:00,37,2,39
"11428",10401,"Mount Pearl","NL",47.50513,-52.79476,2018-04-22 00:00:00,35,2,37
"11429",10401,"Mount Pearl","NL",47.50513,-52.79476,2018-04-22 01:00:00,34,2,36
"11430",10401,"Mount Pearl","NL",47.50513,-52.79476,2018-04-22 02:00:00,34,3,37
"11431",10401,"Mount Pearl","NL",47.50513,-52.79476,2018-04-22 03:00:00,34,1,35
"11432",10401,"Mount Pearl","NL",47.50513,-52.79476,2018-04-22 04:00:00,33,2,35
"11433",10401,"Mount Pearl","NL",47.50513,-52.79476,2018-04-22 05:00:00,34,1,35
"11434",10401,"Mount Pearl","NL",47.50513,-52.79476,2018-04-22 06:00:00,34,1,35
"11435",10401,"Mount Pearl","NL",47.50513,-52.79476,2018-04-22 07:00:00,34,2,36
"11436",10401,"Mount Pearl","NL",47.50513,-52.79476,2018-04-22 08:00:00,35,1,36
"11437",10401,"Mount Pearl","NL",47.50513,-52.79476,2018-04-22 09:00:00,36,2,38
"11438",10401,"Mount Pearl","NL",47.50513,-52.79476,2018-04-22 10:00:00,36,2,38
"11439",10401,"Mount Pearl","NL",47.50513,-52.79476,2018-04-22 11:00:00,35,1,36
"11440",10401,"Mount Pearl","NL",47.50513,-52.79476,2018-04-22 12:00:00,35,1,36
"11441",10401,"Mount Pearl","NL",47.50513,-52.79476,2018-04-22 13:00:00,37,1,38
"11442",10401,"Mount Pearl","NL",47.50513,-52.79476,2018-04-22 14:00:00,38,1,39
"11443",10401,"Mount Pearl","NL",47.50513,-52.79476,2018-04-22 15:00:00,38,2,40
"11444",10401,"Mount Pearl","NL",47.50513,-52.79476,2018-04-22 16:00:00,39,2,41
"11445",10401,"Mount Pearl","NL",47.50513,-52.79476,2018-04-22 17:00:00,39,1,40
"11446",10401,"Mount Pearl","NL",47.50513,-52.79476,2018-04-22 18:00:00,40,1,41
"11447",10401,"Mount Pearl","NL",47.50513,-52.79476,2018-04-22 19:00:00,39,3,42
"11448",10401,"Mount Pearl","NL",47.50513,-52.79476,2018-04-22 20:00:00,31,5,36
"11449",10401,"Mount Pearl","NL",47.50513,-52.79476,2018-04-22 21:00:00,33,3,36
"11450",10401,"Mount Pearl","NL",47.50513,-52.79476,2018-04-22 22:00:00,35,2,37
"11451",10401,"Mount Pearl","NL",47.50513,-52.79476,2018-04-22 23:00:00,39,2,41
"11452",10401,"Mount Pearl","NL",47.50513,-52.79476,2018-04-23 00:00:00,41,2,43
"11453",10401,"Mount Pearl","NL",47.50513,-52.79476,2018-04-23 01:00:00,43,1,44
"11454",10401,"Mount Pearl","NL",47.50513,-52.79476,2018-04-23 02:00:00,43,1,44
"11455",10401,"Mount Pearl","NL",47.50513,-52.79476,2018-04-23 03:00:00,42,0,42
"11456",10401,"Mount Pearl","NL",47.50513,-52.79476,2018-04-23 04:00:00,41,0,41
"11457",10401,"Mount Pearl","NL",47.50513,-52.79476,2018-04-23 05:00:00,40,0,40
"11458",10401,"Mount Pearl","NL",47.50513,-52.79476,2018-04-23 06:00:00,38,1,39
"11459",10401,"Mount Pearl","NL",47.50513,-52.79476,2018-04-23 07:00:00,40,2,42
"11460",10401,"Mount Pearl","NL",47.50513,-52.79476,2018-04-23 08:00:00,39,1,40
"11461",10401,"Mount Pearl","NL",47.50513,-52.79476,2018-04-23 09:00:00,40,0,40
"11462",10401,"Mount Pearl","NL",47.50513,-52.79476,2018-04-23 10:00:00,41,0,41
"11463",10401,"Mount Pearl","NL",47.50513,-52.79476,2018-04-23 11:00:00,42,0,42
"11464",10401,"Mount Pearl","NL",47.50513,-52.79476,2018-04-23 12:00:00,43,0,43
"11465",10401,"Mount Pearl","NL",47.50513,-52.79476,2018-04-23 13:00:00,43,0,43
"11466",10401,"Mount Pearl","NL",47.50513,-52.79476,2018-04-23 14:00:00,43,0,43
"11467",10401,"Mount Pearl","NL",47.50513,-52.79476,2018-04-23 15:00:00,43,0,43
"11468",10401,"Mount Pearl","NL",47.50513,-52.79476,2018-04-23 16:00:00,44,0,44
"11469",10401,"Mount Pearl","NL",47.50513,-52.79476,2018-04-23 17:00:00,45,0,45
"11470",10401,"Mount Pearl","NL",47.50513,-52.79476,2018-04-23 18:00:00,45,0,45
"11471",10401,"Mount Pearl","NL",47.50513,-52.79476,2018-04-23 19:00:00,44,1,45
"11472",10401,"Mount Pearl","NL",47.50513,-52.79476,2018-04-23 20:00:00,43,0,43
"11473",10401,"Mount Pearl","NL",47.50513,-52.79476,2018-04-23 21:00:00,43,0,43
"11474",10401,"Mount Pearl","NL",47.50513,-52.79476,2018-04-23 22:00:00,42,0,42
"11475",10401,"Mount Pearl","NL",47.50513,-52.79476,2018-04-23 23:00:00,41,0,41
"11476",10401,"Mount Pearl","NL",47.50513,-52.79476,2018-04-24 00:00:00,41,0,41
"11477",10401,"Mount Pearl","NL",47.50513,-52.79476,2018-04-24 01:00:00,41,0,41
"11478",10401,"Mount Pearl","NL",47.50513,-52.79476,2018-04-24 02:00:00,40,1,41
"11479",10401,"Mount Pearl","NL",47.50513,-52.79476,2018-04-24 03:00:00,39,1,40
"11480",10401,"Mount Pearl","NL",47.50513,-52.79476,2018-04-24 04:00:00,40,1,41
"11481",10401,"Mount Pearl","NL",47.50513,-52.79476,2018-04-24 05:00:00,41,0,41
"11482",10401,"Mount Pearl","NL",47.50513,-52.79476,2018-04-24 06:00:00,40,1,41
"11483",10401,"Mount Pearl","NL",47.50513,-52.79476,2018-04-24 07:00:00,39,2,41
"11484",10401,"Mount Pearl","NL",47.50513,-52.79476,2018-04-24 08:00:00,40,2,42
"11485",10401,"Mount Pearl","NL",47.50513,-52.79476,2018-04-24 09:00:00,41,2,43
"11486",10401,"Mount Pearl","NL",47.50513,-52.79476,2018-04-24 10:00:00,43,1,44
"11487",10401,"Mount Pearl","NL",47.50513,-52.79476,2018-04-24 11:00:00,45,0,45
"11488",10401,"Mount Pearl","NL",47.50513,-52.79476,2018-04-24 12:00:00,46,1,47
"11489",10401,"Mount Pearl","NL",47.50513,-52.79476,2018-04-24 13:00:00,46,1,47
"11490",10401,"Mount Pearl","NL",47.50513,-52.79476,2018-04-24 14:00:00,47,1,48
"11491",10401,"Mount Pearl","NL",47.50513,-52.79476,2018-04-24 15:00:00,48,1,49
"11492",10401,"Mount Pearl","NL",47.50513,-52.79476,2018-04-24 16:00:00,48,1,49
"11493",10401,"Mount Pearl","NL",47.50513,-52.79476,2018-04-24 17:00:00,48,0,48
"11494",10401,"Mount Pearl","NL",47.50513,-52.79476,2018-04-24 18:00:00,49,1,50
"11495",10401,"Mount Pearl","NL",47.50513,-52.79476,2018-04-24 19:00:00,47,1,48
"11496",10401,"Mount Pearl","NL",47.50513,-52.79476,2018-04-24 20:00:00,46,1,47
"11497",10401,"Mount Pearl","NL",47.50513,-52.79476,2018-04-24 21:00:00,45,1,46
"11498",10401,"Mount Pearl","NL",47.50513,-52.79476,2018-04-24 22:00:00,44,1,45
"11499",10401,"Mount Pearl","NL",47.50513,-52.79476,2018-04-24 23:00:00,45,1,46
"11500",10401,"Mount Pearl","NL",47.50513,-52.79476,2018-04-25 00:00:00,45,1,46
"11501",10401,"Mount Pearl","NL",47.50513,-52.79476,2018-04-25 01:00:00,45,0,45
"11502",10401,"Mount Pearl","NL",47.50513,-52.79476,2018-04-25 02:00:00,42,1,43
"11503",10401,"Mount Pearl","NL",47.50513,-52.79476,2018-04-25 03:00:00,42,1,43
"11504",10401,"Mount Pearl","NL",47.50513,-52.79476,2018-04-25 04:00:00,39,1,40
"11505",10401,"Mount Pearl","NL",47.50513,-52.79476,2018-04-25 05:00:00,41,2,43
"11506",10401,"Mount Pearl","NL",47.50513,-52.79476,2018-04-25 06:00:00,46,1,47
"11507",10401,"Mount Pearl","NL",47.50513,-52.79476,2018-04-25 07:00:00,46,2,48
"11508",10401,"Mount Pearl","NL",47.50513,-52.79476,2018-04-25 08:00:00,45,3,48
"11509",10401,"Mount Pearl","NL",47.50513,-52.79476,2018-04-25 09:00:00,47,1,48
"11510",10401,"Mount Pearl","NL",47.50513,-52.79476,2018-04-25 10:00:00,50,1,51
"11511",10401,"Mount Pearl","NL",47.50513,-52.79476,2018-04-25 11:00:00,50,1,51
"11512",10401,"Mount Pearl","NL",47.50513,-52.79476,2018-04-25 12:00:00,50,1,51
"11513",10401,"Mount Pearl","NL",47.50513,-52.79476,2018-04-25 13:00:00,50,1,51
"11514",10401,"Mount Pearl","NL",47.50513,-52.79476,2018-04-25 14:00:00,51,1,52
"11515",10401,"Mount Pearl","NL",47.50513,-52.79476,2018-04-25 15:00:00,52,2,54
"11516",10401,"Mount Pearl","NL",47.50513,-52.79476,2018-04-25 16:00:00,53,2,55
"11517",10401,"Mount Pearl","NL",47.50513,-52.79476,2018-04-25 17:00:00,54,2,56
"11518",10401,"Mount Pearl","NL",47.50513,-52.79476,2018-04-25 18:00:00,55,2,57
"11519",10401,"Mount Pearl","NL",47.50513,-52.79476,2018-04-25 19:00:00,54,1,55
"11520",10401,"Mount Pearl","NL",47.50513,-52.79476,2018-04-25 20:00:00,51,1,52
"11521",10401,"Mount Pearl","NL",47.50513,-52.79476,2018-04-25 21:00:00,53,1,54
"11522",10401,"Mount Pearl","NL",47.50513,-52.79476,2018-04-25 22:00:00,56,1,57
"11523",10401,"Mount Pearl","NL",47.50513,-52.79476,2018-04-25 23:00:00,56,1,57
"11524",10401,"Mount Pearl","NL",47.50513,-52.79476,2018-04-26 00:00:00,54,0,54
"11525",10401,"Mount Pearl","NL",47.50513,-52.79476,2018-04-26 01:00:00,52,1,53
"11526",10401,"Mount Pearl","NL",47.50513,-52.79476,2018-04-26 02:00:00,49,1,50
"11527",10401,"Mount Pearl","NL",47.50513,-52.79476,2018-04-26 03:00:00,49,2,51
"11528",10401,"Mount Pearl","NL",47.50513,-52.79476,2018-04-26 04:00:00,46,1,47
"11529",10401,"Mount Pearl","NL",47.50513,-52.79476,2018-04-26 05:00:00,43,1,44
"11530",10401,"Mount Pearl","NL",47.50513,-52.79476,2018-04-26 06:00:00,37,3,40
"11531",10401,"Mount Pearl","NL",47.50513,-52.79476,2018-04-26 07:00:00,38,2,40
"11532",10401,"Mount Pearl","NL",47.50513,-52.79476,2018-04-26 08:00:00,39,2,41
"11533",10401,"Mount Pearl","NL",47.50513,-52.79476,2018-04-26 09:00:00,39,1,40
"11534",10401,"Mount Pearl","NL",47.50513,-52.79476,2018-04-26 10:00:00,40,1,41
"11535",10401,"Mount Pearl","NL",47.50513,-52.79476,2018-04-26 11:00:00,40,1,41
"11536",10401,"Mount Pearl","NL",47.50513,-52.79476,2018-04-26 12:00:00,40,2,42
"11537",10401,"Mount Pearl","NL",47.50513,-52.79476,2018-04-26 13:00:00,41,2,43
"11538",10401,"Mount Pearl","NL",47.50513,-52.79476,2018-04-26 14:00:00,42,2,44
"11539",10401,"Mount Pearl","NL",47.50513,-52.79476,2018-04-26 15:00:00,44,2,46
"11540",10401,"Mount Pearl","NL",47.50513,-52.79476,2018-04-26 16:00:00,46,2,48
"11541",10401,"Mount Pearl","NL",47.50513,-52.79476,2018-04-26 17:00:00,45,2,47
"11542",10401,"Mount Pearl","NL",47.50513,-52.79476,2018-04-26 18:00:00,42,3,45
"11543",10401,"Mount Pearl","NL",47.50513,-52.79476,2018-04-26 19:00:00,42,2,44
"11544",10401,"Mount Pearl","NL",47.50513,-52.79476,2018-04-26 20:00:00,42,2,44
"11545",10401,"Mount Pearl","NL",47.50513,-52.79476,2018-04-26 21:00:00,40,2,42
"11546",10401,"Mount Pearl","NL",47.50513,-52.79476,2018-04-26 22:00:00,39,2,41
"11547",10401,"Mount Pearl","NL",47.50513,-52.79476,2018-04-26 23:00:00,39,2,41
"11548",10401,"Mount Pearl","NL",47.50513,-52.79476,2018-04-27 00:00:00,39,2,41
"11549",10401,"Mount Pearl","NL",47.50513,-52.79476,2018-04-27 01:00:00,39,2,41
"11550",10401,"Mount Pearl","NL",47.50513,-52.79476,2018-04-27 02:00:00,41,2,43
"11551",10401,"Mount Pearl","NL",47.50513,-52.79476,2018-04-27 03:00:00,42,1,43
"11552",10401,"Mount Pearl","NL",47.50513,-52.79476,2018-04-27 04:00:00,42,2,44
"11553",10401,"Mount Pearl","NL",47.50513,-52.79476,2018-04-27 05:00:00,42,2,44
"11554",10401,"Mount Pearl","NL",47.50513,-52.79476,2018-04-27 06:00:00,42,2,44
"11555",10401,"Mount Pearl","NL",47.50513,-52.79476,2018-04-27 07:00:00,40,3,43
"11556",10401,"Mount Pearl","NL",47.50513,-52.79476,2018-04-27 08:00:00,41,3,44
"11557",10401,"Mount Pearl","NL",47.50513,-52.79476,2018-04-27 09:00:00,40,2,42
"11558",10401,"Mount Pearl","NL",47.50513,-52.79476,2018-04-27 10:00:00,42,2,44
"11559",10401,"Mount Pearl","NL",47.50513,-52.79476,2018-04-27 11:00:00,43,2,45
"11560",10401,"Mount Pearl","NL",47.50513,-52.79476,2018-04-27 12:00:00,42,1,43
"11561",10401,"Mount Pearl","NL",47.50513,-52.79476,2018-04-27 13:00:00,42,2,44
"11562",10401,"Mount Pearl","NL",47.50513,-52.79476,2018-04-27 14:00:00,40,2,42
"11563",10401,"Mount Pearl","NL",47.50513,-52.79476,2018-04-27 15:00:00,41,2,43
"11564",10401,"Mount Pearl","NL",47.50513,-52.79476,2018-04-27 16:00:00,45,2,47
"11565",10401,"Mount Pearl","NL",47.50513,-52.79476,2018-04-27 17:00:00,44,2,46
"11566",10401,"Mount Pearl","NL",47.50513,-52.79476,2018-04-27 18:00:00,42,2,44
"11567",10401,"Mount Pearl","NL",47.50513,-52.79476,2018-04-27 19:00:00,39,2,41
"11568",10401,"Mount Pearl","NL",47.50513,-52.79476,2018-04-27 20:00:00,36,2,38
"11569",10401,"Mount Pearl","NL",47.50513,-52.79476,2018-04-27 21:00:00,35,2,37
"11570",10401,"Mount Pearl","NL",47.50513,-52.79476,2018-04-27 22:00:00,35,2,37
"11571",10401,"Mount Pearl","NL",47.50513,-52.79476,2018-04-27 23:00:00,35,2,37
"11572",10401,"Mount Pearl","NL",47.50513,-52.79476,2018-04-28 00:00:00,35,2,37
"11573",10401,"Mount Pearl","NL",47.50513,-52.79476,2018-04-28 01:00:00,31,2,33
"11574",10401,"Mount Pearl","NL",47.50513,-52.79476,2018-04-28 02:00:00,25,4,29
"11575",10401,"Mount Pearl","NL",47.50513,-52.79476,2018-04-28 03:00:00,21,3,24
"11576",10401,"Mount Pearl","NL",47.50513,-52.79476,2018-04-28 04:00:00,24,2,26
"11577",10401,"Mount Pearl","NL",47.50513,-52.79476,2018-04-28 05:00:00,20,2,22
"11578",10401,"Mount Pearl","NL",47.50513,-52.79476,2018-04-28 06:00:00,16,4,20
"11579",10401,"Mount Pearl","NL",47.50513,-52.79476,2018-04-28 07:00:00,33,2,35
"11580",10401,"Mount Pearl","NL",47.50513,-52.79476,2018-04-28 08:00:00,40,2,42
"11581",10401,"Mount Pearl","NL",47.50513,-52.79476,2018-04-28 09:00:00,42,1,43
"11582",10401,"Mount Pearl","NL",47.50513,-52.79476,2018-04-28 10:00:00,38,2,40
"11583",10401,"Mount Pearl","NL",47.50513,-52.79476,2018-04-28 11:00:00,35,2,37
"11584",10401,"Mount Pearl","NL",47.50513,-52.79476,2018-04-28 12:00:00,33,2,35
"11585",10401,"Mount Pearl","NL",47.50513,-52.79476,2018-04-28 13:00:00,33,2,35
"11586",10401,"Mount Pearl","NL",47.50513,-52.79476,2018-04-28 14:00:00,30,2,32
"11587",10401,"Mount Pearl","NL",47.50513,-52.79476,2018-04-28 15:00:00,28,2,30
"11588",10401,"Mount Pearl","NL",47.50513,-52.79476,2018-04-28 16:00:00,25,2,27
"11589",10401,"Mount Pearl","NL",47.50513,-52.79476,2018-04-28 17:00:00,30,2,32
"11590",10401,"Mount Pearl","NL",47.50513,-52.79476,2018-04-28 18:00:00,31,1,32
"11591",10401,"Mount Pearl","NL",47.50513,-52.79476,2018-04-28 19:00:00,30,2,32
"11592",10401,"Mount Pearl","NL",47.50513,-52.79476,2018-04-28 20:00:00,31,2,33
"11593",10401,"Mount Pearl","NL",47.50513,-52.79476,2018-04-28 21:00:00,31,1,32
"11594",10401,"Mount Pearl","NL",47.50513,-52.79476,2018-04-28 22:00:00,29,2,31
"11595",10401,"Mount Pearl","NL",47.50513,-52.79476,2018-04-28 23:00:00,28,1,29
"11596",10401,"Mount Pearl","NL",47.50513,-52.79476,2018-04-29 00:00:00,29,1,30
"11597",10401,"Mount Pearl","NL",47.50513,-52.79476,2018-04-29 01:00:00,29,1,30
"11598",10401,"Mount Pearl","NL",47.50513,-52.79476,2018-04-29 02:00:00,28,2,30
"11599",10401,"Mount Pearl","NL",47.50513,-52.79476,2018-04-29 03:00:00,28,1,29
"11600",10401,"Mount Pearl","NL",47.50513,-52.79476,2018-04-29 04:00:00,28,1,29
"11601",10401,"Mount Pearl","NL",47.50513,-52.79476,2018-04-29 05:00:00,29,1,30
"11602",10401,"Mount Pearl","NL",47.50513,-52.79476,2018-04-29 06:00:00,28,2,30
"11603",10401,"Mount Pearl","NL",47.50513,-52.79476,2018-04-29 07:00:00,28,1,29
"11604",10401,"Mount Pearl","NL",47.50513,-52.79476,2018-04-29 08:00:00,26,2,28
"11605",10401,"Mount Pearl","NL",47.50513,-52.79476,2018-04-29 09:00:00,26,2,28
"11606",10401,"Mount Pearl","NL",47.50513,-52.79476,2018-04-29 10:00:00,24,1,25
"11607",10401,"Mount Pearl","NL",47.50513,-52.79476,2018-04-29 11:00:00,25,2,27
"11608",10401,"Mount Pearl","NL",47.50513,-52.79476,2018-04-29 12:00:00,25,0,25
"11609",10401,"Mount Pearl","NL",47.50513,-52.79476,2018-04-29 13:00:00,25,1,26
"11610",10401,"Mount Pearl","NL",47.50513,-52.79476,2018-04-29 14:00:00,22,0,22
"11611",10401,"Mount Pearl","NL",47.50513,-52.79476,2018-04-29 15:00:00,21,0,21
"11612",10401,"Mount Pearl","NL",47.50513,-52.79476,2018-04-29 16:00:00,20,1,21
"11613",10401,"Mount Pearl","NL",47.50513,-52.79476,2018-04-29 17:00:00,22,0,22
"11614",10401,"Mount Pearl","NL",47.50513,-52.79476,2018-04-29 18:00:00,23,0,23
"11615",10401,"Mount Pearl","NL",47.50513,-52.79476,2018-04-29 19:00:00,24,0,24
"11616",10401,"Mount Pearl","NL",47.50513,-52.79476,2018-04-29 20:00:00,24,0,24
"11617",10401,"Mount Pearl","NL",47.50513,-52.79476,2018-04-29 21:00:00,25,1,26
"11618",10401,"Mount Pearl","NL",47.50513,-52.79476,2018-04-29 22:00:00,27,1,28
"11619",10401,"Mount Pearl","NL",47.50513,-52.79476,2018-04-29 23:00:00,29,1,30
"11620",10401,"Mount Pearl","NL",47.50513,-52.79476,2018-04-30 00:00:00,31,0,31
"11621",10401,"Mount Pearl","NL",47.50513,-52.79476,2018-04-30 01:00:00,32,0,32
"11622",10401,"Mount Pearl","NL",47.50513,-52.79476,2018-04-30 02:00:00,32,0,32
"11623",10401,"Mount Pearl","NL",47.50513,-52.79476,2018-04-30 03:00:00,30,0,30
"11624",10401,"Mount Pearl","NL",47.50513,-52.79476,2018-04-30 04:00:00,28,1,29
"11625",10401,"Mount Pearl","NL",47.50513,-52.79476,2018-04-30 05:00:00,27,1,28
"11626",10401,"Mount Pearl","NL",47.50513,-52.79476,2018-04-30 06:00:00,29,1,30
"11627",10401,"Mount Pearl","NL",47.50513,-52.79476,2018-04-30 07:00:00,29,2,31
"11628",10401,"Mount Pearl","NL",47.50513,-52.79476,2018-04-30 08:00:00,29,1,30
"11629",10401,"Mount Pearl","NL",47.50513,-52.79476,2018-04-30 09:00:00,30,1,31
"11630",10401,"Mount Pearl","NL",47.50513,-52.79476,2018-04-30 10:00:00,30,1,31
"11631",10401,"Mount Pearl","NL",47.50513,-52.79476,2018-04-30 11:00:00,31,2,33
"11632",10401,"Mount Pearl","NL",47.50513,-52.79476,2018-04-30 12:00:00,31,1,32
"11633",10401,"Mount Pearl","NL",47.50513,-52.79476,2018-04-30 13:00:00,32,1,33
"11634",10401,"Mount Pearl","NL",47.50513,-52.79476,2018-04-30 14:00:00,31,1,32
"11635",10401,"Mount Pearl","NL",47.50513,-52.79476,2018-04-30 15:00:00,32,1,33
"11636",10401,"Mount Pearl","NL",47.50513,-52.79476,2018-04-30 16:00:00,34,1,35
"11637",10401,"Mount Pearl","NL",47.50513,-52.79476,2018-04-30 17:00:00,34,1,35
"11638",10401,"Mount Pearl","NL",47.50513,-52.79476,2018-04-30 18:00:00,34,1,35
"11639",10401,"Mount Pearl","NL",47.50513,-52.79476,2018-04-30 19:00:00,34,1,35
"11640",10401,"Mount Pearl","NL",47.50513,-52.79476,2018-04-30 20:00:00,32,2,34
"11641",10401,"Mount Pearl","NL",47.50513,-52.79476,2018-04-30 21:00:00,33,2,35
"11642",10401,"Mount Pearl","NL",47.50513,-52.79476,2018-04-30 22:00:00,32,2,34
"11643",10401,"Mount Pearl","NL",47.50513,-52.79476,2018-04-30 23:00:00,34,0,34
"11644",10401,"Mount Pearl","NL",47.50513,-52.79476,2018-05-01 00:00:00,34,0,34
"11645",10401,"Mount Pearl","NL",47.50513,-52.79476,2018-05-01 01:00:00,33,1,34
"11646",10401,"Mount Pearl","NL",47.50513,-52.79476,2018-05-01 02:00:00,33,1,34
"11647",10401,"Mount Pearl","NL",47.50513,-52.79476,2018-05-01 03:00:00,32,0,32
"11648",10401,"Mount Pearl","NL",47.50513,-52.79476,2018-05-01 04:00:00,32,0,32
"11649",10401,"Mount Pearl","NL",47.50513,-52.79476,2018-05-01 05:00:00,32,1,33
"11650",10401,"Mount Pearl","NL",47.50513,-52.79476,2018-05-01 06:00:00,29,1,30
"11651",10401,"Mount Pearl","NL",47.50513,-52.79476,2018-05-01 07:00:00,30,2,32
"11652",10401,"Mount Pearl","NL",47.50513,-52.79476,2018-05-01 08:00:00,29,2,31
"11653",10401,"Mount Pearl","NL",47.50513,-52.79476,2018-05-01 09:00:00,30,2,32
"11654",10401,"Mount Pearl","NL",47.50513,-52.79476,2018-05-01 10:00:00,28,2,30
"11655",10401,"Mount Pearl","NL",47.50513,-52.79476,2018-05-01 11:00:00,25,2,27
"11656",10401,"Mount Pearl","NL",47.50513,-52.79476,2018-05-01 12:00:00,25,1,26
"11657",10401,"Mount Pearl","NL",47.50513,-52.79476,2018-05-01 13:00:00,24,1,25
"11658",10401,"Mount Pearl","NL",47.50513,-52.79476,2018-05-01 14:00:00,22,1,23
"11659",10401,"Mount Pearl","NL",47.50513,-52.79476,2018-05-01 15:00:00,21,1,22
"11660",10401,"Mount Pearl","NL",47.50513,-52.79476,2018-05-01 16:00:00,22,2,24
"11661",10401,"Mount Pearl","NL",47.50513,-52.79476,2018-05-01 17:00:00,22,1,23
"11662",10401,"Mount Pearl","NL",47.50513,-52.79476,2018-05-01 18:00:00,20,2,22
"11663",10401,"Mount Pearl","NL",47.50513,-52.79476,2018-05-01 19:00:00,18,3,21
"11664",10401,"Mount Pearl","NL",47.50513,-52.79476,2018-05-01 20:00:00,24,2,26
"11665",10401,"Mount Pearl","NL",47.50513,-52.79476,2018-05-01 21:00:00,31,1,32
"11666",10401,"Mount Pearl","NL",47.50513,-52.79476,2018-05-01 22:00:00,38,0,38
"11667",10401,"Mount Pearl","NL",47.50513,-52.79476,2018-05-01 23:00:00,36,0,36
"11668",10401,"Mount Pearl","NL",47.50513,-52.79476,2018-05-02 00:00:00,35,0,35
"11669",10401,"Mount Pearl","NL",47.50513,-52.79476,2018-05-02 01:00:00,37,0,37
"11670",10401,"Mount Pearl","NL",47.50513,-52.79476,2018-05-02 02:00:00,37,1,38
"11671",10401,"Mount Pearl","NL",47.50513,-52.79476,2018-05-02 03:00:00,37,0,37
"11672",10401,"Mount Pearl","NL",47.50513,-52.79476,2018-05-02 04:00:00,39,1,40
"11673",10401,"Mount Pearl","NL",47.50513,-52.79476,2018-05-02 05:00:00,39,0,39
"11674",10401,"Mount Pearl","NL",47.50513,-52.79476,2018-05-02 06:00:00,39,1,40
"11675",10401,"Mount Pearl","NL",47.50513,-52.79476,2018-05-02 07:00:00,35,1,36
"11676",10401,"Mount Pearl","NL",47.50513,-52.79476,2018-05-02 08:00:00,35,1,36
"11677",10401,"Mount Pearl","NL",47.50513,-52.79476,2018-05-02 09:00:00,35,0,35
"11678",10401,"Mount Pearl","NL",47.50513,-52.79476,2018-05-02 10:00:00,35,0,35
"11679",10401,"Mount Pearl","NL",47.50513,-52.79476,2018-05-02 11:00:00,36,1,37
"11680",10401,"Mount Pearl","NL",47.50513,-52.79476,2018-05-02 12:00:00,37,1,38
"11681",10401,"Mount Pearl","NL",47.50513,-52.79476,2018-05-02 13:00:00,39,1,40
"11682",10401,"Mount Pearl","NL",47.50513,-52.79476,2018-05-02 14:00:00,40,1,41
"11683",10401,"Mount Pearl","NL",47.50513,-52.79476,2018-05-02 15:00:00,40,1,41
"11684",10401,"Mount Pearl","NL",47.50513,-52.79476,2018-05-02 16:00:00,35,1,36
"11685",10401,"Mount Pearl","NL",47.50513,-52.79476,2018-05-02 17:00:00,30,1,31
"11686",10401,"Mount Pearl","NL",47.50513,-52.79476,2018-05-02 18:00:00,29,1,30
"11687",10401,"Mount Pearl","NL",47.50513,-52.79476,2018-05-02 19:00:00,29,1,30
"11688",10401,"Mount Pearl","NL",47.50513,-52.79476,2018-05-02 20:00:00,32,1,33
"11689",10401,"Mount Pearl","NL",47.50513,-52.79476,2018-05-02 21:00:00,33,1,34
"11690",10401,"Mount Pearl","NL",47.50513,-52.79476,2018-05-02 22:00:00,33,1,34
"11691",10401,"Mount Pearl","NL",47.50513,-52.79476,2018-05-02 23:00:00,33,1,34
"11692",10401,"Mount Pearl","NL",47.50513,-52.79476,2018-05-03 00:00:00,32,0,32
"11693",10401,"Mount Pearl","NL",47.50513,-52.79476,2018-05-03 01:00:00,31,1,32
"11694",10401,"Mount Pearl","NL",47.50513,-52.79476,2018-05-03 02:00:00,29,1,30
"11695",10401,"Mount Pearl","NL",47.50513,-52.79476,2018-05-03 03:00:00,27,1,28
"11696",10401,"Mount Pearl","NL",47.50513,-52.79476,2018-05-03 04:00:00,27,1,28
"11697",10401,"Mount Pearl","NL",47.50513,-52.79476,2018-05-03 05:00:00,31,1,32
"11698",10401,"Mount Pearl","NL",47.50513,-52.79476,2018-05-03 06:00:00,33,2,35
"11699",10401,"Mount Pearl","NL",47.50513,-52.79476,2018-05-03 07:00:00,30,3,33
"11700",10401,"Mount Pearl","NL",47.50513,-52.79476,2018-05-03 08:00:00,26,4,30
"11701",10401,"Mount Pearl","NL",47.50513,-52.79476,2018-05-03 09:00:00,26,4,30
"11702",10401,"Mount Pearl","NL",47.50513,-52.79476,2018-05-03 10:00:00,27,2,29
"11703",10401,"Mount Pearl","NL",47.50513,-52.79476,2018-05-03 11:00:00,29,2,31
"11704",10401,"Mount Pearl","NL",47.50513,-52.79476,2018-05-03 12:00:00,38,2,40
"11705",10401,"Mount Pearl","NL",47.50513,-52.79476,2018-05-03 13:00:00,39,2,41
"11706",10401,"Mount Pearl","NL",47.50513,-52.79476,2018-05-03 14:00:00,41,2,43
"11707",10401,"Mount Pearl","NL",47.50513,-52.79476,2018-05-03 15:00:00,41,2,43
"11708",10401,"Mount Pearl","NL",47.50513,-52.79476,2018-05-03 16:00:00,40,2,42
"11709",10401,"Mount Pearl","NL",47.50513,-52.79476,2018-05-03 17:00:00,39,1,40
"11710",10401,"Mount Pearl","NL",47.50513,-52.79476,2018-05-03 18:00:00,38,1,39
"11711",10401,"Mount Pearl","NL",47.50513,-52.79476,2018-05-03 19:00:00,38,1,39
"11712",10401,"Mount Pearl","NL",47.50513,-52.79476,2018-05-03 20:00:00,38,1,39
"11713",10401,"Mount Pearl","NL",47.50513,-52.79476,2018-05-03 21:00:00,37,1,38
"11714",10401,"Mount Pearl","NL",47.50513,-52.79476,2018-05-03 22:00:00,36,1,37
"11715",10401,"Mount Pearl","NL",47.50513,-52.79476,2018-05-03 23:00:00,35,1,36
"11716",10401,"Mount Pearl","NL",47.50513,-52.79476,2018-05-04 00:00:00,36,1,37
"11717",10401,"Mount Pearl","NL",47.50513,-52.79476,2018-05-04 01:00:00,36,1,37
"11718",10401,"Mount Pearl","NL",47.50513,-52.79476,2018-05-04 02:00:00,36,0,36
"11719",10401,"Mount Pearl","NL",47.50513,-52.79476,2018-05-04 03:00:00,36,1,37
"11720",10401,"Mount Pearl","NL",47.50513,-52.79476,2018-05-04 04:00:00,35,1,36
"11721",10401,"Mount Pearl","NL",47.50513,-52.79476,2018-05-04 05:00:00,35,1,36
"11722",10401,"Mount Pearl","NL",47.50513,-52.79476,2018-05-04 06:00:00,35,1,36
"11723",10401,"Mount Pearl","NL",47.50513,-52.79476,2018-05-04 07:00:00,33,3,36
"11724",10401,"Mount Pearl","NL",47.50513,-52.79476,2018-05-04 08:00:00,33,4,37
"11725",10401,"Mount Pearl","NL",47.50513,-52.79476,2018-05-04 09:00:00,34,3,37
"11726",10401,"Mount Pearl","NL",47.50513,-52.79476,2018-05-04 10:00:00,34,2,36
"11727",10401,"Mount Pearl","NL",47.50513,-52.79476,2018-05-04 11:00:00,34,1,35
"11728",10401,"Mount Pearl","NL",47.50513,-52.79476,2018-05-04 12:00:00,33,3,36
"11729",10401,"Mount Pearl","NL",47.50513,-52.79476,2018-05-04 13:00:00,33,4,37
"11730",10401,"Mount Pearl","NL",47.50513,-52.79476,2018-05-04 14:00:00,33,3,36
"11731",10401,"Mount Pearl","NL",47.50513,-52.79476,2018-05-04 15:00:00,33,3,36
"11732",10401,"Mount Pearl","NL",47.50513,-52.79476,2018-05-04 16:00:00,33,4,37
"11733",10401,"Mount Pearl","NL",47.50513,-52.79476,2018-05-04 17:00:00,34,4,38
"11734",10401,"Mount Pearl","NL",47.50513,-52.79476,2018-05-04 18:00:00,33,4,37
"11735",10401,"Mount Pearl","NL",47.50513,-52.79476,2018-05-04 19:00:00,33,4,37
"11736",10401,"Mount Pearl","NL",47.50513,-52.79476,2018-05-04 20:00:00,32,4,36
"11737",10401,"Mount Pearl","NL",47.50513,-52.79476,2018-05-04 21:00:00,32,4,36
"11738",10401,"Mount Pearl","NL",47.50513,-52.79476,2018-05-04 22:00:00,32,3,35
"11739",10401,"Mount Pearl","NL",47.50513,-52.79476,2018-05-04 23:00:00,32,3,35
"11740",10401,"Mount Pearl","NL",47.50513,-52.79476,2018-05-05 00:00:00,33,3,36
"11741",10401,"Mount Pearl","NL",47.50513,-52.79476,2018-05-05 01:00:00,33,3,36
"11742",10401,"Mount Pearl","NL",47.50513,-52.79476,2018-05-05 02:00:00,34,4,38
"11743",10401,"Mount Pearl","NL",47.50513,-52.79476,2018-05-05 03:00:00,35,3,38
"11744",10401,"Mount Pearl","NL",47.50513,-52.79476,2018-05-05 04:00:00,35,3,38
"11745",10401,"Mount Pearl","NL",47.50513,-52.79476,2018-05-05 05:00:00,35,3,38
"11746",10401,"Mount Pearl","NL",47.50513,-52.79476,2018-05-05 06:00:00,34,4,38
"11747",10401,"Mount Pearl","NL",47.50513,-52.79476,2018-05-05 07:00:00,35,3,38
"11748",10401,"Mount Pearl","NL",47.50513,-52.79476,2018-05-05 08:00:00,35,3,38
"11749",10401,"Mount Pearl","NL",47.50513,-52.79476,2018-05-05 09:00:00,34,3,37
"11750",10401,"Mount Pearl","NL",47.50513,-52.79476,2018-05-05 10:00:00,35,3,38
"11751",10401,"Mount Pearl","NL",47.50513,-52.79476,2018-05-05 11:00:00,35,3,38
"11752",10401,"Mount Pearl","NL",47.50513,-52.79476,2018-05-05 12:00:00,35,1,36
"11753",10401,"Mount Pearl","NL",47.50513,-52.79476,2018-05-05 13:00:00,36,1,37
"11754",10401,"Mount Pearl","NL",47.50513,-52.79476,2018-05-05 14:00:00,37,1,38
"11755",10401,"Mount Pearl","NL",47.50513,-52.79476,2018-05-05 15:00:00,39,1,40
"11756",10401,"Mount Pearl","NL",47.50513,-52.79476,2018-05-05 16:00:00,38,1,39
"11757",10401,"Mount Pearl","NL",47.50513,-52.79476,2018-05-05 17:00:00,40,1,41
"11758",10401,"Mount Pearl","NL",47.50513,-52.79476,2018-05-05 18:00:00,40,1,41
"11759",10401,"Mount Pearl","NL",47.50513,-52.79476,2018-05-05 19:00:00,36,1,37
"11760",10401,"Mount Pearl","NL",47.50513,-52.79476,2018-05-05 20:00:00,30,1,31
"11761",10401,"Mount Pearl","NL",47.50513,-52.79476,2018-05-05 21:00:00,29,1,30
"11762",10401,"Mount Pearl","NL",47.50513,-52.79476,2018-05-05 22:00:00,29,1,30
"11763",10401,"Mount Pearl","NL",47.50513,-52.79476,2018-05-05 23:00:00,29,1,30
"11764",10401,"Mount Pearl","NL",47.50513,-52.79476,2018-05-06 00:00:00,30,1,31
"11765",10401,"Mount Pearl","NL",47.50513,-52.79476,2018-05-06 01:00:00,29,1,30
"11766",10401,"Mount Pearl","NL",47.50513,-52.79476,2018-05-06 02:00:00,30,1,31
"11767",10401,"Mount Pearl","NL",47.50513,-52.79476,2018-05-06 03:00:00,31,0,31
"11768",10401,"Mount Pearl","NL",47.50513,-52.79476,2018-05-06 04:00:00,32,0,32
"11769",10401,"Mount Pearl","NL",47.50513,-52.79476,2018-05-06 05:00:00,34,0,34
"11770",10401,"Mount Pearl","NL",47.50513,-52.79476,2018-05-06 06:00:00,34,1,35
"11771",10401,"Mount Pearl","NL",47.50513,-52.79476,2018-05-06 07:00:00,33,0,33
"11772",10401,"Mount Pearl","NL",47.50513,-52.79476,2018-05-06 08:00:00,31,2,33
"11773",10401,"Mount Pearl","NL",47.50513,-52.79476,2018-05-06 09:00:00,32,1,33
"11774",10401,"Mount Pearl","NL",47.50513,-52.79476,2018-05-06 10:00:00,33,1,34
"11775",10401,"Mount Pearl","NL",47.50513,-52.79476,2018-05-06 11:00:00,33,1,34
"11776",10401,"Mount Pearl","NL",47.50513,-52.79476,2018-05-06 12:00:00,32,1,33
"11777",10401,"Mount Pearl","NL",47.50513,-52.79476,2018-05-06 13:00:00,31,1,32
"11778",10401,"Mount Pearl","NL",47.50513,-52.79476,2018-05-06 14:00:00,30,2,32
"11779",10401,"Mount Pearl","NL",47.50513,-52.79476,2018-05-06 15:00:00,32,1,33
"11780",10401,"Mount Pearl","NL",47.50513,-52.79476,2018-05-06 16:00:00,33,1,34
"11781",10401,"Mount Pearl","NL",47.50513,-52.79476,2018-05-06 17:00:00,34,1,35
"11782",10401,"Mount Pearl","NL",47.50513,-52.79476,2018-05-06 18:00:00,33,2,35
"11783",10401,"Mount Pearl","NL",47.50513,-52.79476,2018-05-06 19:00:00,34,1,35
"11784",10401,"Mount Pearl","NL",47.50513,-52.79476,2018-05-06 20:00:00,33,2,35
"11785",10401,"Mount Pearl","NL",47.50513,-52.79476,2018-05-06 21:00:00,32,1,33
"11786",10401,"Mount Pearl","NL",47.50513,-52.79476,2018-05-06 22:00:00,34,1,35
"11787",10401,"Mount Pearl","NL",47.50513,-52.79476,2018-05-06 23:00:00,35,1,36
"11788",10401,"Mount Pearl","NL",47.50513,-52.79476,2018-05-07 00:00:00,34,1,35
"11789",10401,"Mount Pearl","NL",47.50513,-52.79476,2018-05-07 01:00:00,34,1,35
"11790",10401,"Mount Pearl","NL",47.50513,-52.79476,2018-05-07 02:00:00,35,1,36
"11791",10401,"Mount Pearl","NL",47.50513,-52.79476,2018-05-07 03:00:00,38,1,39
"11792",10401,"Mount Pearl","NL",47.50513,-52.79476,2018-05-07 04:00:00,35,1,36
"11793",10401,"Mount Pearl","NL",47.50513,-52.79476,2018-05-07 05:00:00,37,1,38
"11794",10401,"Mount Pearl","NL",47.50513,-52.79476,2018-05-07 06:00:00,35,2,37
"11795",10401,"Mount Pearl","NL",47.50513,-52.79476,2018-05-07 07:00:00,34,3,37
"11796",10401,"Mount Pearl","NL",47.50513,-52.79476,2018-05-07 08:00:00,26,6,32
"11797",10401,"Mount Pearl","NL",47.50513,-52.79476,2018-05-07 09:00:00,33,3,36
"11798",10401,"Mount Pearl","NL",47.50513,-52.79476,2018-05-07 10:00:00,37,3,40
"11799",10401,"Mount Pearl","NL",47.50513,-52.79476,2018-05-07 11:00:00,38,2,40
"11800",10401,"Mount Pearl","NL",47.50513,-52.79476,2018-05-07 12:00:00,40,1,41
"11801",10401,"Mount Pearl","NL",47.50513,-52.79476,2018-05-07 13:00:00,39,1,40
"11802",10401,"Mount Pearl","NL",47.50513,-52.79476,2018-05-07 14:00:00,32,1,33
"11803",10401,"Mount Pearl","NL",47.50513,-52.79476,2018-05-07 15:00:00,26,1,27
"11804",10401,"Mount Pearl","NL",47.50513,-52.79476,2018-05-07 16:00:00,36,1,37
"11805",10401,"Mount Pearl","NL",47.50513,-52.79476,2018-05-07 17:00:00,38,0,38
"11806",10401,"Mount Pearl","NL",47.50513,-52.79476,2018-05-07 18:00:00,38,0,38
"11807",10401,"Mount Pearl","NL",47.50513,-52.79476,2018-05-07 19:00:00,35,1,36
"11808",10401,"Mount Pearl","NL",47.50513,-52.79476,2018-05-07 20:00:00,34,0,34
"11809",10401,"Mount Pearl","NL",47.50513,-52.79476,2018-05-07 21:00:00,35,0,35
"11810",10401,"Mount Pearl","NL",47.50513,-52.79476,2018-05-07 22:00:00,35,0,35
"11811",10401,"Mount Pearl","NL",47.50513,-52.79476,2018-05-07 23:00:00,33,1,34
"11812",10401,"Mount Pearl","NL",47.50513,-52.79476,2018-05-08 00:00:00,34,1,35
"11813",10401,"Mount Pearl","NL",47.50513,-52.79476,2018-05-08 01:00:00,31,1,32
"11814",10401,"Mount Pearl","NL",47.50513,-52.79476,2018-05-08 02:00:00,28,2,30
"11815",10401,"Mount Pearl","NL",47.50513,-52.79476,2018-05-08 03:00:00,30,1,31
"11816",10401,"Mount Pearl","NL",47.50513,-52.79476,2018-05-08 04:00:00,30,1,31
"11817",10401,"Mount Pearl","NL",47.50513,-52.79476,2018-05-08 05:00:00,27,1,28
"11818",10401,"Mount Pearl","NL",47.50513,-52.79476,2018-05-08 06:00:00,26,1,27
"11819",10401,"Mount Pearl","NL",47.50513,-52.79476,2018-05-08 07:00:00,26,2,28
"11820",10401,"Mount Pearl","NL",47.50513,-52.79476,2018-05-08 08:00:00,29,1,30
"11821",10401,"Mount Pearl","NL",47.50513,-52.79476,2018-05-08 09:00:00,30,1,31
"11822",10401,"Mount Pearl","NL",47.50513,-52.79476,2018-05-08 10:00:00,34,1,35
"11823",10401,"Mount Pearl","NL",47.50513,-52.79476,2018-05-08 11:00:00,36,1,37
"11824",10401,"Mount Pearl","NL",47.50513,-52.79476,2018-05-08 12:00:00,36,1,37
"11825",10401,"Mount Pearl","NL",47.50513,-52.79476,2018-05-08 13:00:00,35,1,36
"11826",10401,"Mount Pearl","NL",47.50513,-52.79476,2018-05-08 14:00:00,36,2,38
"11827",10401,"Mount Pearl","NL",47.50513,-52.79476,2018-05-08 15:00:00,37,1,38
"11828",10401,"Mount Pearl","NL",47.50513,-52.79476,2018-05-08 16:00:00,38,1,39
"11829",10401,"Mount Pearl","NL",47.50513,-52.79476,2018-05-08 17:00:00,41,1,42
"11830",10401,"Mount Pearl","NL",47.50513,-52.79476,2018-05-08 18:00:00,41,2,43
"11831",10401,"Mount Pearl","NL",47.50513,-52.79476,2018-05-08 19:00:00,40,1,41
"11832",10401,"Mount Pearl","NL",47.50513,-52.79476,2018-05-08 20:00:00,38,1,39
"11833",10401,"Mount Pearl","NL",47.50513,-52.79476,2018-05-08 21:00:00,37,1,38
"11834",10401,"Mount Pearl","NL",47.50513,-52.79476,2018-05-08 22:00:00,38,1,39
"11835",10401,"Mount Pearl","NL",47.50513,-52.79476,2018-05-08 23:00:00,38,1,39
"11836",10401,"Mount Pearl","NL",47.50513,-52.79476,2018-05-09 00:00:00,38,1,39
"11837",10401,"Mount Pearl","NL",47.50513,-52.79476,2018-05-09 01:00:00,39,1,40
"11838",10401,"Mount Pearl","NL",47.50513,-52.79476,2018-05-09 02:00:00,43,1,44
"11839",10401,"Mount Pearl","NL",47.50513,-52.79476,2018-05-09 03:00:00,44,1,45
"11840",10401,"Mount Pearl","NL",47.50513,-52.79476,2018-05-09 04:00:00,44,1,45
"11841",10401,"Mount Pearl","NL",47.50513,-52.79476,2018-05-09 05:00:00,44,0,44
"11842",10401,"Mount Pearl","NL",47.50513,-52.79476,2018-05-09 06:00:00,43,1,44
"11843",10401,"Mount Pearl","NL",47.50513,-52.79476,2018-05-09 07:00:00,42,1,43
"11844",10401,"Mount Pearl","NL",47.50513,-52.79476,2018-05-09 08:00:00,39,0,39
"11845",10401,"Mount Pearl","NL",47.50513,-52.79476,2018-05-09 09:00:00,37,1,38
"11846",10401,"Mount Pearl","NL",47.50513,-52.79476,2018-05-09 10:00:00,36,1,37
"11847",10401,"Mount Pearl","NL",47.50513,-52.79476,2018-05-09 11:00:00,34,1,35
"11848",10401,"Mount Pearl","NL",47.50513,-52.79476,2018-05-09 12:00:00,36,0,36
"11849",10401,"Mount Pearl","NL",47.50513,-52.79476,2018-05-09 13:00:00,41,0,41
"11850",10401,"Mount Pearl","NL",47.50513,-52.79476,2018-05-09 14:00:00,42,0,42
"11851",10401,"Mount Pearl","NL",47.50513,-52.79476,2018-05-09 15:00:00,42,0,42
"11852",10401,"Mount Pearl","NL",47.50513,-52.79476,2018-05-09 16:00:00,42,0,42
"11853",10401,"Mount Pearl","NL",47.50513,-52.79476,2018-05-09 17:00:00,38,0,38
"11854",10401,"Mount Pearl","NL",47.50513,-52.79476,2018-05-09 18:00:00,34,0,34
"11855",10401,"Mount Pearl","NL",47.50513,-52.79476,2018-05-09 19:00:00,33,0,33
"11856",10401,"Mount Pearl","NL",47.50513,-52.79476,2018-05-09 20:00:00,33,0,33
"11857",10401,"Mount Pearl","NL",47.50513,-52.79476,2018-05-09 21:00:00,32,1,33
"11858",10401,"Mount Pearl","NL",47.50513,-52.79476,2018-05-09 22:00:00,32,0,32
"11859",10401,"Mount Pearl","NL",47.50513,-52.79476,2018-05-09 23:00:00,33,0,33
"11860",10401,"Mount Pearl","NL",47.50513,-52.79476,2018-05-10 00:00:00,31,0,31
"11861",10401,"Mount Pearl","NL",47.50513,-52.79476,2018-05-10 01:00:00,29,1,30
"11862",10401,"Mount Pearl","NL",47.50513,-52.79476,2018-05-10 02:00:00,27,1,28
"11863",10401,"Mount Pearl","NL",47.50513,-52.79476,2018-05-10 03:00:00,27,1,28
"11864",10401,"Mount Pearl","NL",47.50513,-52.79476,2018-05-10 04:00:00,25,1,26
"11865",10401,"Mount Pearl","NL",47.50513,-52.79476,2018-05-10 05:00:00,25,1,26
"11866",10401,"Mount Pearl","NL",47.50513,-52.79476,2018-05-10 06:00:00,19,4,23
"11867",10401,"Mount Pearl","NL",47.50513,-52.79476,2018-05-10 07:00:00,28,2,30
"11868",10401,"Mount Pearl","NL",47.50513,-52.79476,2018-05-10 08:00:00,31,1,32
"11869",10401,"Mount Pearl","NL",47.50513,-52.79476,2018-05-10 09:00:00,31,0,31
"11870",10401,"Mount Pearl","NL",47.50513,-52.79476,2018-05-10 10:00:00,32,0,32
"11871",10401,"Mount Pearl","NL",47.50513,-52.79476,2018-05-10 11:00:00,31,0,31
"11872",10401,"Mount Pearl","NL",47.50513,-52.79476,2018-05-10 12:00:00,33,0,33
"11873",10401,"Mount Pearl","NL",47.50513,-52.79476,2018-05-10 13:00:00,34,1,35
"11874",10401,"Mount Pearl","NL",47.50513,-52.79476,2018-05-10 14:00:00,35,1,36
"11875",10401,"Mount Pearl","NL",47.50513,-52.79476,2018-05-10 15:00:00,35,1,36
"11876",10401,"Mount Pearl","NL",47.50513,-52.79476,2018-05-10 16:00:00,37,1,38
"11877",10401,"Mount Pearl","NL",47.50513,-52.79476,2018-05-10 17:00:00,35,1,36
"11878",10401,"Mount Pearl","NL",47.50513,-52.79476,2018-05-10 18:00:00,34,1,35
"11879",10401,"Mount Pearl","NL",47.50513,-52.79476,2018-05-10 19:00:00,34,1,35
"11880",10401,"Mount Pearl","NL",47.50513,-52.79476,2018-05-10 20:00:00,34,1,35
"11881",10401,"Mount Pearl","NL",47.50513,-52.79476,2018-05-10 21:00:00,35,1,36
"11882",10401,"Mount Pearl","NL",47.50513,-52.79476,2018-05-10 22:00:00,36,1,37
"11883",10401,"Mount Pearl","NL",47.50513,-52.79476,2018-05-10 23:00:00,35,1,36
"11884",10401,"Mount Pearl","NL",47.50513,-52.79476,2018-05-11 00:00:00,36,1,37
"11885",10401,"Mount Pearl","NL",47.50513,-52.79476,2018-05-11 01:00:00,36,1,37
"11886",10401,"Mount Pearl","NL",47.50513,-52.79476,2018-05-11 02:00:00,37,1,38
"11887",10401,"Mount Pearl","NL",47.50513,-52.79476,2018-05-11 03:00:00,38,1,39
"11888",10401,"Mount Pearl","NL",47.50513,-52.79476,2018-05-11 04:00:00,37,1,38
"11889",10401,"Mount Pearl","NL",47.50513,-52.79476,2018-05-11 05:00:00,36,1,37
"11890",10401,"Mount Pearl","NL",47.50513,-52.79476,2018-05-11 06:00:00,34,1,35
"11891",10401,"Mount Pearl","NL",47.50513,-52.79476,2018-05-11 07:00:00,31,1,32
"11892",10401,"Mount Pearl","NL",47.50513,-52.79476,2018-05-11 08:00:00,30,2,32
"11893",10401,"Mount Pearl","NL",47.50513,-52.79476,2018-05-11 09:00:00,32,1,33
"11894",10401,"Mount Pearl","NL",47.50513,-52.79476,2018-05-11 10:00:00,33,1,34
"11895",10401,"Mount Pearl","NL",47.50513,-52.79476,2018-05-11 11:00:00,32,1,33
"11896",10401,"Mount Pearl","NL",47.50513,-52.79476,2018-05-11 12:00:00,35,1,36
"11897",10401,"Mount Pearl","NL",47.50513,-52.79476,2018-05-11 13:00:00,42,1,43
"11898",10401,"Mount Pearl","NL",47.50513,-52.79476,2018-05-11 14:00:00,43,1,44
"11899",10401,"Mount Pearl","NL",47.50513,-52.79476,2018-05-11 15:00:00,38,1,39
"11900",10401,"Mount Pearl","NL",47.50513,-52.79476,2018-05-11 16:00:00,36,1,37
"11901",10401,"Mount Pearl","NL",47.50513,-52.79476,2018-05-11 17:00:00,36,1,37
"11902",10401,"Mount Pearl","NL",47.50513,-52.79476,2018-05-11 18:00:00,33,1,34
"11903",10401,"Mount Pearl","NL",47.50513,-52.79476,2018-05-11 19:00:00,32,1,33
"11904",10401,"Mount Pearl","NL",47.50513,-52.79476,2018-05-11 20:00:00,32,0,32
"11905",10401,"Mount Pearl","NL",47.50513,-52.79476,2018-05-11 21:00:00,33,1,34
"11906",10401,"Mount Pearl","NL",47.50513,-52.79476,2018-05-11 22:00:00,34,1,35
"11907",10401,"Mount Pearl","NL",47.50513,-52.79476,2018-05-11 23:00:00,29,1,30
"11908",10401,"Mount Pearl","NL",47.50513,-52.79476,2018-05-12 00:00:00,27,1,28
"11909",10401,"Mount Pearl","NL",47.50513,-52.79476,2018-05-12 01:00:00,27,1,28
"11910",10401,"Mount Pearl","NL",47.50513,-52.79476,2018-05-12 02:00:00,26,1,27
"11911",10401,"Mount Pearl","NL",47.50513,-52.79476,2018-05-12 03:00:00,25,1,26
"11912",10401,"Mount Pearl","NL",47.50513,-52.79476,2018-05-12 04:00:00,25,1,26
"11913",10401,"Mount Pearl","NL",47.50513,-52.79476,2018-05-12 05:00:00,25,1,26
"11914",10401,"Mount Pearl","NL",47.50513,-52.79476,2018-05-12 06:00:00,24,0,24
"11915",10401,"Mount Pearl","NL",47.50513,-52.79476,2018-05-12 07:00:00,23,0,23
"11916",10401,"Mount Pearl","NL",47.50513,-52.79476,2018-05-12 08:00:00,23,0,23
"11917",10401,"Mount Pearl","NL",47.50513,-52.79476,2018-05-12 09:00:00,24,1,25
"11918",10401,"Mount Pearl","NL",47.50513,-52.79476,2018-05-12 10:00:00,26,1,27
"11919",10401,"Mount Pearl","NL",47.50513,-52.79476,2018-05-12 11:00:00,26,1,27
"11920",10401,"Mount Pearl","NL",47.50513,-52.79476,2018-05-12 12:00:00,26,1,27
"11921",10401,"Mount Pearl","NL",47.50513,-52.79476,2018-05-12 13:00:00,28,1,29
"11922",10401,"Mount Pearl","NL",47.50513,-52.79476,2018-05-12 14:00:00,30,1,31
"11923",10401,"Mount Pearl","NL",47.50513,-52.79476,2018-05-12 15:00:00,30,1,31
"11924",10401,"Mount Pearl","NL",47.50513,-52.79476,2018-05-12 16:00:00,32,1,33
"11925",10401,"Mount Pearl","NL",47.50513,-52.79476,2018-05-12 17:00:00,33,1,34
"11926",10401,"Mount Pearl","NL",47.50513,-52.79476,2018-05-12 18:00:00,31,1,32
"11927",10401,"Mount Pearl","NL",47.50513,-52.79476,2018-05-12 19:00:00,32,1,33
"11928",10401,"Mount Pearl","NL",47.50513,-52.79476,2018-05-12 20:00:00,32,2,34
"11929",10401,"Mount Pearl","NL",47.50513,-52.79476,2018-05-12 21:00:00,33,1,34
"11930",10401,"Mount Pearl","NL",47.50513,-52.79476,2018-05-12 22:00:00,33,1,34
"11931",10401,"Mount Pearl","NL",47.50513,-52.79476,2018-05-12 23:00:00,33,1,34
"11932",10401,"Mount Pearl","NL",47.50513,-52.79476,2018-05-13 00:00:00,32,1,33
"11933",10401,"Mount Pearl","NL",47.50513,-52.79476,2018-05-13 01:00:00,31,1,32
"11934",10401,"Mount Pearl","NL",47.50513,-52.79476,2018-05-13 02:00:00,30,2,32
"11935",10401,"Mount Pearl","NL",47.50513,-52.79476,2018-05-13 03:00:00,31,1,32
"11936",10401,"Mount Pearl","NL",47.50513,-52.79476,2018-05-13 04:00:00,30,1,31
"11937",10401,"Mount Pearl","NL",47.50513,-52.79476,2018-05-13 05:00:00,32,0,32
"11938",10401,"Mount Pearl","NL",47.50513,-52.79476,2018-05-13 06:00:00,31,1,32
"11939",10401,"Mount Pearl","NL",47.50513,-52.79476,2018-05-13 07:00:00,32,1,33
"11940",10401,"Mount Pearl","NL",47.50513,-52.79476,2018-05-13 08:00:00,36,1,37
"11941",10401,"Mount Pearl","NL",47.50513,-52.79476,2018-05-13 09:00:00,37,1,38
"11942",10401,"Mount Pearl","NL",47.50513,-52.79476,2018-05-13 10:00:00,38,0,38
"11943",10401,"Mount Pearl","NL",47.50513,-52.79476,2018-05-13 11:00:00,38,1,39
"11944",10401,"Mount Pearl","NL",47.50513,-52.79476,2018-05-13 12:00:00,39,0,39
"11945",10401,"Mount Pearl","NL",47.50513,-52.79476,2018-05-13 13:00:00,39,0,39
"11946",10401,"Mount Pearl","NL",47.50513,-52.79476,2018-05-13 14:00:00,39,1,40
"11947",10401,"Mount Pearl","NL",47.50513,-52.79476,2018-05-13 15:00:00,39,1,40
"11948",10401,"Mount Pearl","NL",47.50513,-52.79476,2018-05-13 16:00:00,39,1,40
"11949",10401,"Mount Pearl","NL",47.50513,-52.79476,2018-05-13 17:00:00,39,1,40
"11950",10401,"Mount Pearl","NL",47.50513,-52.79476,2018-05-13 18:00:00,40,1,41
"11951",10401,"Mount Pearl","NL",47.50513,-52.79476,2018-05-13 19:00:00,38,1,39
"11952",10401,"Mount Pearl","NL",47.50513,-52.79476,2018-05-13 20:00:00,36,2,38
"11953",10401,"Mount Pearl","NL",47.50513,-52.79476,2018-05-13 21:00:00,36,1,37
"11954",10401,"Mount Pearl","NL",47.50513,-52.79476,2018-05-13 22:00:00,37,1,38
"11955",10401,"Mount Pearl","NL",47.50513,-52.79476,2018-05-13 23:00:00,37,1,38
"11956",10401,"Mount Pearl","NL",47.50513,-52.79476,2018-05-14 00:00:00,36,1,37
"11957",10401,"Mount Pearl","NL",47.50513,-52.79476,2018-05-14 01:00:00,35,1,36
"11958",10401,"Mount Pearl","NL",47.50513,-52.79476,2018-05-14 02:00:00,35,1,36
"11959",10401,"Mount Pearl","NL",47.50513,-52.79476,2018-05-14 03:00:00,35,1,36
"11960",10401,"Mount Pearl","NL",47.50513,-52.79476,2018-05-14 04:00:00,38,1,39
"11961",10401,"Mount Pearl","NL",47.50513,-52.79476,2018-05-14 05:00:00,38,2,40
"11962",10401,"Mount Pearl","NL",47.50513,-52.79476,2018-05-14 06:00:00,32,4,36
"11963",10401,"Mount Pearl","NL",47.50513,-52.79476,2018-05-14 07:00:00,35,2,37
"11964",10401,"Mount Pearl","NL",47.50513,-52.79476,2018-05-14 08:00:00,37,2,39
"11965",10401,"Mount Pearl","NL",47.50513,-52.79476,2018-05-14 09:00:00,39,1,40
"11966",10401,"Mount Pearl","NL",47.50513,-52.79476,2018-05-14 10:00:00,39,1,40
"11967",10401,"Mount Pearl","NL",47.50513,-52.79476,2018-05-14 11:00:00,39,1,40
"11968",10401,"Mount Pearl","NL",47.50513,-52.79476,2018-05-14 12:00:00,40,1,41
"11969",10401,"Mount Pearl","NL",47.50513,-52.79476,2018-05-14 13:00:00,40,0,40
"11970",10401,"Mount Pearl","NL",47.50513,-52.79476,2018-05-14 14:00:00,40,1,41
"11971",10401,"Mount Pearl","NL",47.50513,-52.79476,2018-05-14 15:00:00,40,1,41
"11972",10401,"Mount Pearl","NL",47.50513,-52.79476,2018-05-14 16:00:00,39,1,40
"11973",10401,"Mount Pearl","NL",47.50513,-52.79476,2018-05-14 17:00:00,40,1,41
"11974",10401,"Mount Pearl","NL",47.50513,-52.79476,2018-05-14 18:00:00,42,1,43
"11975",10401,"Mount Pearl","NL",47.50513,-52.79476,2018-05-14 19:00:00,41,1,42
"11976",10401,"Mount Pearl","NL",47.50513,-52.79476,2018-05-14 20:00:00,38,1,39
"11977",10401,"Mount Pearl","NL",47.50513,-52.79476,2018-05-14 21:00:00,38,1,39
"11978",10401,"Mount Pearl","NL",47.50513,-52.79476,2018-05-14 22:00:00,38,1,39
"11979",10401,"Mount Pearl","NL",47.50513,-52.79476,2018-05-14 23:00:00,38,1,39
"11980",10401,"Mount Pearl","NL",47.50513,-52.79476,2018-05-15 00:00:00,36,1,37
"11981",10401,"Mount Pearl","NL",47.50513,-52.79476,2018-05-15 01:00:00,36,1,37
"11982",10401,"Mount Pearl","NL",47.50513,-52.79476,2018-05-15 02:00:00,35,1,36
"11983",10401,"Mount Pearl","NL",47.50513,-52.79476,2018-05-15 03:00:00,33,1,34
"11984",10401,"Mount Pearl","NL",47.50513,-52.79476,2018-05-15 04:00:00,29,2,31
"11985",10401,"Mount Pearl","NL",47.50513,-52.79476,2018-05-15 05:00:00,25,2,27
"11986",10401,"Mount Pearl","NL",47.50513,-52.79476,2018-05-15 06:00:00,21,2,23
"11987",10401,"Mount Pearl","NL",47.50513,-52.79476,2018-05-15 07:00:00,32,1,33
"11988",10401,"Mount Pearl","NL",47.50513,-52.79476,2018-05-15 08:00:00,33,2,35
"11989",10401,"Mount Pearl","NL",47.50513,-52.79476,2018-05-15 09:00:00,31,1,32
"11990",10401,"Mount Pearl","NL",47.50513,-52.79476,2018-05-15 10:00:00,32,1,33
"11991",10401,"Mount Pearl","NL",47.50513,-52.79476,2018-05-15 11:00:00,35,1,36
"11992",10401,"Mount Pearl","NL",47.50513,-52.79476,2018-05-15 12:00:00,35,2,37
"11993",10401,"Mount Pearl","NL",47.50513,-52.79476,2018-05-15 13:00:00,38,2,40
"11994",10401,"Mount Pearl","NL",47.50513,-52.79476,2018-05-15 14:00:00,39,2,41
"11995",10401,"Mount Pearl","NL",47.50513,-52.79476,2018-05-15 15:00:00,39,2,41
"11996",10401,"Mount Pearl","NL",47.50513,-52.79476,2018-05-15 16:00:00,39,2,41
"11997",10401,"Mount Pearl","NL",47.50513,-52.79476,2018-05-15 17:00:00,40,2,42
"11998",10401,"Mount Pearl","NL",47.50513,-52.79476,2018-05-15 18:00:00,41,2,43
"11999",10401,"Mount Pearl","NL",47.50513,-52.79476,2018-05-15 19:00:00,42,2,44
"12000",10401,"Mount Pearl","NL",47.50513,-52.79476,2018-05-15 20:00:00,41,2,43
"12001",10401,"Mount Pearl","NL",47.50513,-52.79476,2018-05-15 21:00:00,38,2,40
"12002",10401,"Mount Pearl","NL",47.50513,-52.79476,2018-05-15 22:00:00,39,2,41
"12003",10401,"Mount Pearl","NL",47.50513,-52.79476,2018-05-15 23:00:00,39,2,41
"12004",10401,"Mount Pearl","NL",47.50513,-52.79476,2018-05-16 00:00:00,38,2,40
"12005",10401,"Mount Pearl","NL",47.50513,-52.79476,2018-05-16 01:00:00,38,2,40
"12006",10401,"Mount Pearl","NL",47.50513,-52.79476,2018-05-16 02:00:00,36,1,37
"12007",10401,"Mount Pearl","NL",47.50513,-52.79476,2018-05-16 03:00:00,37,1,38
"12008",10401,"Mount Pearl","NL",47.50513,-52.79476,2018-05-16 04:00:00,36,1,37
"12009",10401,"Mount Pearl","NL",47.50513,-52.79476,2018-05-16 05:00:00,36,2,38
"12010",10401,"Mount Pearl","NL",47.50513,-52.79476,2018-05-16 06:00:00,37,2,39
"12011",10401,"Mount Pearl","NL",47.50513,-52.79476,2018-05-16 07:00:00,35,3,38
"12012",10401,"Mount Pearl","NL",47.50513,-52.79476,2018-05-16 08:00:00,33,4,37
"12013",10401,"Mount Pearl","NL",47.50513,-52.79476,2018-05-16 09:00:00,33,3,36
"12014",10401,"Mount Pearl","NL",47.50513,-52.79476,2018-05-16 10:00:00,34,2,36
"12015",10401,"Mount Pearl","NL",47.50513,-52.79476,2018-05-16 11:00:00,35,2,37
"12016",10401,"Mount Pearl","NL",47.50513,-52.79476,2018-05-16 12:00:00,30,1,31
"12017",10401,"Mount Pearl","NL",47.50513,-52.79476,2018-05-16 13:00:00,29,1,30
"12018",10401,"Mount Pearl","NL",47.50513,-52.79476,2018-05-16 14:00:00,29,1,30
"12019",10401,"Mount Pearl","NL",47.50513,-52.79476,2018-05-16 15:00:00,29,2,31
"12020",10401,"Mount Pearl","NL",47.50513,-52.79476,2018-05-16 16:00:00,28,1,29
"12021",10401,"Mount Pearl","NL",47.50513,-52.79476,2018-05-16 17:00:00,29,2,31
"12022",10401,"Mount Pearl","NL",47.50513,-52.79476,2018-05-16 18:00:00,29,1,30
"12023",10401,"Mount Pearl","NL",47.50513,-52.79476,2018-05-16 19:00:00,28,1,29
"12024",10401,"Mount Pearl","NL",47.50513,-52.79476,2018-05-16 20:00:00,28,1,29
"12025",10401,"Mount Pearl","NL",47.50513,-52.79476,2018-05-16 21:00:00,27,1,28
"12026",10401,"Mount Pearl","NL",47.50513,-52.79476,2018-05-16 22:00:00,27,1,28
"12027",10401,"Mount Pearl","NL",47.50513,-52.79476,2018-05-16 23:00:00,28,1,29
"12028",10401,"Mount Pearl","NL",47.50513,-52.79476,2018-05-17 00:00:00,28,1,29
"12029",10401,"Mount Pearl","NL",47.50513,-52.79476,2018-05-17 01:00:00,28,0,28
"12030",10401,"Mount Pearl","NL",47.50513,-52.79476,2018-05-17 02:00:00,27,1,28
"12031",10401,"Mount Pearl","NL",47.50513,-52.79476,2018-05-17 03:00:00,29,0,29
"12032",10401,"Mount Pearl","NL",47.50513,-52.79476,2018-05-17 04:00:00,30,0,30
"12033",10401,"Mount Pearl","NL",47.50513,-52.79476,2018-05-17 05:00:00,29,0,29
"12034",10401,"Mount Pearl","NL",47.50513,-52.79476,2018-05-17 06:00:00,26,0,26
"12035",10401,"Mount Pearl","NL",47.50513,-52.79476,2018-05-17 07:00:00,26,0,26
"12036",10401,"Mount Pearl","NL",47.50513,-52.79476,2018-05-17 08:00:00,28,1,29
"12037",10401,"Mount Pearl","NL",47.50513,-52.79476,2018-05-17 09:00:00,31,0,31
"12038",10401,"Mount Pearl","NL",47.50513,-52.79476,2018-05-17 10:00:00,34,0,34
"12039",10401,"Mount Pearl","NL",47.50513,-52.79476,2018-05-17 11:00:00,34,1,35
"12040",10401,"Mount Pearl","NL",47.50513,-52.79476,2018-05-17 12:00:00,43,1,44
"12041",10401,"Mount Pearl","NL",47.50513,-52.79476,2018-05-17 13:00:00,42,1,43
"12042",10401,"Mount Pearl","NL",47.50513,-52.79476,2018-05-17 14:00:00,42,1,43
"12043",10401,"Mount Pearl","NL",47.50513,-52.79476,2018-05-17 15:00:00,47,1,48
"12044",10401,"Mount Pearl","NL",47.50513,-52.79476,2018-05-17 16:00:00,48,1,49
"12045",10401,"Mount Pearl","NL",47.50513,-52.79476,2018-05-17 17:00:00,42,1,43
"12046",10401,"Mount Pearl","NL",47.50513,-52.79476,2018-05-17 18:00:00,38,1,39
"12047",10401,"Mount Pearl","NL",47.50513,-52.79476,2018-05-17 19:00:00,35,0,35
"12048",10401,"Mount Pearl","NL",47.50513,-52.79476,2018-05-17 20:00:00,37,1,38
"12049",10401,"Mount Pearl","NL",47.50513,-52.79476,2018-05-17 21:00:00,35,1,36
"12050",10401,"Mount Pearl","NL",47.50513,-52.79476,2018-05-17 22:00:00,32,1,33
"12051",10401,"Mount Pearl","NL",47.50513,-52.79476,2018-05-17 23:00:00,33,0,33
"12052",10401,"Mount Pearl","NL",47.50513,-52.79476,2018-05-18 00:00:00,31,0,31
"12053",10401,"Mount Pearl","NL",47.50513,-52.79476,2018-05-18 01:00:00,30,0,30
"12054",10401,"Mount Pearl","NL",47.50513,-52.79476,2018-05-18 02:00:00,31,0,31
"12055",10401,"Mount Pearl","NL",47.50513,-52.79476,2018-05-18 03:00:00,30,1,31
"12056",10401,"Mount Pearl","NL",47.50513,-52.79476,2018-05-18 04:00:00,29,0,29
"12057",10401,"Mount Pearl","NL",47.50513,-52.79476,2018-05-18 05:00:00,27,1,28
"12058",10401,"Mount Pearl","NL",47.50513,-52.79476,2018-05-18 06:00:00,25,1,26
"12059",10401,"Mount Pearl","NL",47.50513,-52.79476,2018-05-18 07:00:00,26,0,26
"12060",10401,"Mount Pearl","NL",47.50513,-52.79476,2018-05-18 08:00:00,25,1,26
"12061",10401,"Mount Pearl","NL",47.50513,-52.79476,2018-05-18 09:00:00,26,1,27
"12062",10401,"Mount Pearl","NL",47.50513,-52.79476,2018-05-18 10:00:00,27,0,27
"12063",10401,"Mount Pearl","NL",47.50513,-52.79476,2018-05-18 11:00:00,28,1,29
"12064",10401,"Mount Pearl","NL",47.50513,-52.79476,2018-05-18 12:00:00,28,1,29
"12065",10401,"Mount Pearl","NL",47.50513,-52.79476,2018-05-18 13:00:00,29,0,29
"12066",10401,"Mount Pearl","NL",47.50513,-52.79476,2018-05-18 14:00:00,29,0,29
"12067",10401,"Mount Pearl","NL",47.50513,-52.79476,2018-05-18 15:00:00,28,0,28
"12068",10401,"Mount Pearl","NL",47.50513,-52.79476,2018-05-18 16:00:00,28,0,28
"12069",10401,"Mount Pearl","NL",47.50513,-52.79476,2018-05-18 17:00:00,27,1,28
"12070",10401,"Mount Pearl","NL",47.50513,-52.79476,2018-05-18 18:00:00,29,0,29
"12071",10401,"Mount Pearl","NL",47.50513,-52.79476,2018-05-18 19:00:00,29,0,29
"12072",10401,"Mount Pearl","NL",47.50513,-52.79476,2018-05-18 20:00:00,29,1,30
"12073",10401,"Mount Pearl","NL",47.50513,-52.79476,2018-05-18 21:00:00,30,0,30
"12074",10401,"Mount Pearl","NL",47.50513,-52.79476,2018-05-18 22:00:00,29,1,30
"12075",10401,"Mount Pearl","NL",47.50513,-52.79476,2018-05-18 23:00:00,28,1,29
"12076",10401,"Mount Pearl","NL",47.50513,-52.79476,2018-05-19 00:00:00,26,1,27
"12077",10401,"Mount Pearl","NL",47.50513,-52.79476,2018-05-19 01:00:00,23,1,24
"12078",10401,"Mount Pearl","NL",47.50513,-52.79476,2018-05-19 02:00:00,27,1,28
"12079",10401,"Mount Pearl","NL",47.50513,-52.79476,2018-05-19 03:00:00,30,0,30
"12080",10401,"Mount Pearl","NL",47.50513,-52.79476,2018-05-19 04:00:00,27,1,28
"12081",10401,"Mount Pearl","NL",47.50513,-52.79476,2018-05-19 05:00:00,27,1,28
"12082",10401,"Mount Pearl","NL",47.50513,-52.79476,2018-05-19 06:00:00,26,0,26
"12083",10401,"Mount Pearl","NL",47.50513,-52.79476,2018-05-19 07:00:00,26,0,26
"12084",10401,"Mount Pearl","NL",47.50513,-52.79476,2018-05-19 08:00:00,26,0,26
"12085",10401,"Mount Pearl","NL",47.50513,-52.79476,2018-05-19 09:00:00,26,0,26
"12086",10401,"Mount Pearl","NL",47.50513,-52.79476,2018-05-19 10:00:00,27,0,27
"12087",10401,"Mount Pearl","NL",47.50513,-52.79476,2018-05-19 11:00:00,28,0,28
"12088",10401,"Mount Pearl","NL",47.50513,-52.79476,2018-05-19 12:00:00,30,1,31
"12089",10401,"Mount Pearl","NL",47.50513,-52.79476,2018-05-19 13:00:00,31,0,31
"12090",10401,"Mount Pearl","NL",47.50513,-52.79476,2018-05-19 14:00:00,30,0,30
"12091",10401,"Mount Pearl","NL",47.50513,-52.79476,2018-05-19 15:00:00,30,1,31
"12092",10401,"Mount Pearl","NL",47.50513,-52.79476,2018-05-19 16:00:00,31,0,31
"12093",10401,"Mount Pearl","NL",47.50513,-52.79476,2018-05-19 17:00:00,32,1,33
"12094",10401,"Mount Pearl","NL",47.50513,-52.79476,2018-05-19 18:00:00,32,0,32
"12095",10401,"Mount Pearl","NL",47.50513,-52.79476,2018-05-19 19:00:00,33,1,34
"12096",10401,"Mount Pearl","NL",47.50513,-52.79476,2018-05-19 20:00:00,32,0,32
"12097",10401,"Mount Pearl","NL",47.50513,-52.79476,2018-05-19 21:00:00,32,1,33
"12098",10401,"Mount Pearl","NL",47.50513,-52.79476,2018-05-19 22:00:00,31,0,31
"12099",10401,"Mount Pearl","NL",47.50513,-52.79476,2018-05-19 23:00:00,31,1,32
"12100",10401,"Mount Pearl","NL",47.50513,-52.79476,2018-05-20 00:00:00,31,0,31
"12101",10401,"Mount Pearl","NL",47.50513,-52.79476,2018-05-20 01:00:00,31,1,32
"12102",10401,"Mount Pearl","NL",47.50513,-52.79476,2018-05-20 02:00:00,31,0,31
"12103",10401,"Mount Pearl","NL",47.50513,-52.79476,2018-05-20 03:00:00,30,0,30
"12104",10401,"Mount Pearl","NL",47.50513,-52.79476,2018-05-20 04:00:00,29,1,30
"12105",10401,"Mount Pearl","NL",47.50513,-52.79476,2018-05-20 05:00:00,27,1,28
"12106",10401,"Mount Pearl","NL",47.50513,-52.79476,2018-05-20 06:00:00,24,0,24
"12107",10401,"Mount Pearl","NL",47.50513,-52.79476,2018-05-20 07:00:00,26,0,26
"12108",10401,"Mount Pearl","NL",47.50513,-52.79476,2018-05-20 08:00:00,31,1,32
"12109",10401,"Mount Pearl","NL",47.50513,-52.79476,2018-05-20 09:00:00,32,0,32
"12110",10401,"Mount Pearl","NL",47.50513,-52.79476,2018-05-20 10:00:00,33,1,34
"12111",10401,"Mount Pearl","NL",47.50513,-52.79476,2018-05-20 11:00:00,33,0,33
"12112",10401,"Mount Pearl","NL",47.50513,-52.79476,2018-05-20 12:00:00,32,1,33
"12113",10401,"Mount Pearl","NL",47.50513,-52.79476,2018-05-20 13:00:00,32,1,33
"12114",10401,"Mount Pearl","NL",47.50513,-52.79476,2018-05-20 14:00:00,35,1,36
"12115",10401,"Mount Pearl","NL",47.50513,-52.79476,2018-05-20 15:00:00,33,2,35
"12116",10401,"Mount Pearl","NL",47.50513,-52.79476,2018-05-20 16:00:00,33,1,34
"12117",10401,"Mount Pearl","NL",47.50513,-52.79476,2018-05-20 17:00:00,35,1,36
"12118",10401,"Mount Pearl","NL",47.50513,-52.79476,2018-05-20 18:00:00,34,1,35
"12119",10401,"Mount Pearl","NL",47.50513,-52.79476,2018-05-20 19:00:00,32,1,33
"12120",10401,"Mount Pearl","NL",47.50513,-52.79476,2018-05-20 20:00:00,29,1,30
"12121",10401,"Mount Pearl","NL",47.50513,-52.79476,2018-05-20 21:00:00,26,1,27
"12122",10401,"Mount Pearl","NL",47.50513,-52.79476,2018-05-20 22:00:00,26,1,27
"12123",10401,"Mount Pearl","NL",47.50513,-52.79476,2018-05-20 23:00:00,26,1,27
"12124",10401,"Mount Pearl","NL",47.50513,-52.79476,2018-05-21 00:00:00,26,1,27
"12125",10401,"Mount Pearl","NL",47.50513,-52.79476,2018-05-21 01:00:00,28,1,29
"12126",10401,"Mount Pearl","NL",47.50513,-52.79476,2018-05-21 02:00:00,28,1,29
"12127",10401,"Mount Pearl","NL",47.50513,-52.79476,2018-05-21 03:00:00,28,1,29
"12128",10401,"Mount Pearl","NL",47.50513,-52.79476,2018-05-21 04:00:00,27,1,28
"12129",10401,"Mount Pearl","NL",47.50513,-52.79476,2018-05-21 05:00:00,26,1,27
"12130",10401,"Mount Pearl","NL",47.50513,-52.79476,2018-05-21 06:00:00,25,1,26
"12131",10401,"Mount Pearl","NL",47.50513,-52.79476,2018-05-21 07:00:00,24,1,25
"12132",10401,"Mount Pearl","NL",47.50513,-52.79476,2018-05-21 08:00:00,24,1,25
"12133",10401,"Mount Pearl","NL",47.50513,-52.79476,2018-05-21 09:00:00,24,1,25
"12134",10401,"Mount Pearl","NL",47.50513,-52.79476,2018-05-21 10:00:00,24,1,25
"12135",10401,"Mount Pearl","NL",47.50513,-52.79476,2018-05-21 11:00:00,25,1,26
"12136",10401,"Mount Pearl","NL",47.50513,-52.79476,2018-05-21 12:00:00,26,0,26
"12137",10401,"Mount Pearl","NL",47.50513,-52.79476,2018-05-21 13:00:00,28,1,29
"12138",10401,"Mount Pearl","NL",47.50513,-52.79476,2018-05-21 14:00:00,30,1,31
"12139",10401,"Mount Pearl","NL",47.50513,-52.79476,2018-05-21 15:00:00,28,1,29
"12140",10401,"Mount Pearl","NL",47.50513,-52.79476,2018-05-21 16:00:00,27,1,28
"12141",10401,"Mount Pearl","NL",47.50513,-52.79476,2018-05-21 17:00:00,28,1,29
"12142",10401,"Mount Pearl","NL",47.50513,-52.79476,2018-05-21 18:00:00,28,1,29
"12143",10401,"Mount Pearl","NL",47.50513,-52.79476,2018-05-21 19:00:00,28,1,29
"12144",10401,"Mount Pearl","NL",47.50513,-52.79476,2018-05-21 20:00:00,26,1,27
"12145",10401,"Mount Pearl","NL",47.50513,-52.79476,2018-05-21 21:00:00,22,2,24
"12146",10401,"Mount Pearl","NL",47.50513,-52.79476,2018-05-21 22:00:00,29,1,30
"12147",10401,"Mount Pearl","NL",47.50513,-52.79476,2018-05-21 23:00:00,34,0,34
"12148",10401,"Mount Pearl","NL",47.50513,-52.79476,2018-05-22 00:00:00,35,1,36
"12149",10401,"Mount Pearl","NL",47.50513,-52.79476,2018-05-22 01:00:00,34,0,34
"12150",10401,"Mount Pearl","NL",47.50513,-52.79476,2018-05-22 02:00:00,32,1,33
"12151",10401,"Mount Pearl","NL",47.50513,-52.79476,2018-05-22 03:00:00,32,1,33
"12152",10401,"Mount Pearl","NL",47.50513,-52.79476,2018-05-22 04:00:00,31,0,31
"12153",10401,"Mount Pearl","NL",47.50513,-52.79476,2018-05-22 05:00:00,29,1,30
"12154",10401,"Mount Pearl","NL",47.50513,-52.79476,2018-05-22 06:00:00,28,1,29
"12155",10401,"Mount Pearl","NL",47.50513,-52.79476,2018-05-22 07:00:00,27,1,28
"12156",10401,"Mount Pearl","NL",47.50513,-52.79476,2018-05-22 08:00:00,25,2,27
"12157",10401,"Mount Pearl","NL",47.50513,-52.79476,2018-05-22 09:00:00,26,1,27
"12158",10401,"Mount Pearl","NL",47.50513,-52.79476,2018-05-22 10:00:00,26,1,27
"12159",10401,"Mount Pearl","NL",47.50513,-52.79476,2018-05-22 11:00:00,31,1,32
"12160",10401,"Mount Pearl","NL",47.50513,-52.79476,2018-05-22 12:00:00,33,2,35
"12161",10401,"Mount Pearl","NL",47.50513,-52.79476,2018-05-22 13:00:00,33,2,35
"12162",10401,"Mount Pearl","NL",47.50513,-52.79476,2018-05-22 14:00:00,32,3,35
"12163",10401,"Mount Pearl","NL",47.50513,-52.79476,2018-05-22 15:00:00,32,3,35
"12164",10401,"Mount Pearl","NL",47.50513,-52.79476,2018-05-22 16:00:00,31,2,33
"12165",10401,"Mount Pearl","NL",47.50513,-52.79476,2018-05-22 17:00:00,31,2,33
"12166",10401,"Mount Pearl","NL",47.50513,-52.79476,2018-05-22 18:00:00,32,2,34
"12167",10401,"Mount Pearl","NL",47.50513,-52.79476,2018-05-22 19:00:00,33,2,35
"12168",10401,"Mount Pearl","NL",47.50513,-52.79476,2018-05-22 20:00:00,33,2,35
"12169",10401,"Mount Pearl","NL",47.50513,-52.79476,2018-05-22 21:00:00,31,2,33
"12170",10401,"Mount Pearl","NL",47.50513,-52.79476,2018-05-22 22:00:00,27,2,29
"12171",10401,"Mount Pearl","NL",47.50513,-52.79476,2018-05-22 23:00:00,23,2,25
"12172",10401,"Mount Pearl","NL",47.50513,-52.79476,2018-05-23 00:00:00,21,2,23
"12173",10401,"Mount Pearl","NL",47.50513,-52.79476,2018-05-23 01:00:00,29,2,31
"12174",10401,"Mount Pearl","NL",47.50513,-52.79476,2018-05-23 02:00:00,32,1,33
"12175",10401,"Mount Pearl","NL",47.50513,-52.79476,2018-05-23 03:00:00,34,2,36
"12176",10401,"Mount Pearl","NL",47.50513,-52.79476,2018-05-23 04:00:00,35,2,37
"12177",10401,"Mount Pearl","NL",47.50513,-52.79476,2018-05-23 05:00:00,35,1,36
"12178",10401,"Mount Pearl","NL",47.50513,-52.79476,2018-05-23 06:00:00,36,2,38
"12179",10401,"Mount Pearl","NL",47.50513,-52.79476,2018-05-23 07:00:00,37,2,39
"12180",10401,"Mount Pearl","NL",47.50513,-52.79476,2018-05-23 08:00:00,36,2,38
"12181",10401,"Mount Pearl","NL",47.50513,-52.79476,2018-05-23 09:00:00,36,1,37
"12182",10401,"Mount Pearl","NL",47.50513,-52.79476,2018-05-23 10:00:00,35,2,37
"12183",10401,"Mount Pearl","NL",47.50513,-52.79476,2018-05-23 11:00:00,36,2,38
"12184",10401,"Mount Pearl","NL",47.50513,-52.79476,2018-05-23 12:00:00,36,0,36
"12185",10401,"Mount Pearl","NL",47.50513,-52.79476,2018-05-23 13:00:00,37,0,37
"12186",10401,"Mount Pearl","NL",47.50513,-52.79476,2018-05-23 14:00:00,38,1,39
"12187",10401,"Mount Pearl","NL",47.50513,-52.79476,2018-05-23 15:00:00,38,1,39
"12188",10401,"Mount Pearl","NL",47.50513,-52.79476,2018-05-23 16:00:00,36,1,37
"12189",10401,"Mount Pearl","NL",47.50513,-52.79476,2018-05-23 17:00:00,36,1,37
"12190",10401,"Mount Pearl","NL",47.50513,-52.79476,2018-05-23 18:00:00,35,0,35
"12191",10401,"Mount Pearl","NL",47.50513,-52.79476,2018-05-23 19:00:00,31,1,32
"12192",10401,"Mount Pearl","NL",47.50513,-52.79476,2018-05-23 20:00:00,28,2,30
"12193",10401,"Mount Pearl","NL",47.50513,-52.79476,2018-05-23 21:00:00,28,1,29
"12194",10401,"Mount Pearl","NL",47.50513,-52.79476,2018-05-23 22:00:00,35,1,36
"12195",10401,"Mount Pearl","NL",47.50513,-52.79476,2018-05-23 23:00:00,37,1,38
"12196",10401,"Mount Pearl","NL",47.50513,-52.79476,2018-05-24 00:00:00,36,1,37
"12197",10401,"Mount Pearl","NL",47.50513,-52.79476,2018-05-24 01:00:00,34,1,35
"12198",10401,"Mount Pearl","NL",47.50513,-52.79476,2018-05-24 02:00:00,32,1,33
"12199",10401,"Mount Pearl","NL",47.50513,-52.79476,2018-05-24 03:00:00,32,1,33
"12200",10401,"Mount Pearl","NL",47.50513,-52.79476,2018-05-24 04:00:00,32,1,33
"12201",10401,"Mount Pearl","NL",47.50513,-52.79476,2018-05-24 05:00:00,34,1,35
"12202",10401,"Mount Pearl","NL",47.50513,-52.79476,2018-05-24 06:00:00,32,1,33
"12203",10401,"Mount Pearl","NL",47.50513,-52.79476,2018-05-24 07:00:00,29,3,32
"12204",10401,"Mount Pearl","NL",47.50513,-52.79476,2018-05-24 08:00:00,30,2,32
"12205",10401,"Mount Pearl","NL",47.50513,-52.79476,2018-05-24 09:00:00,31,1,32
"12206",10401,"Mount Pearl","NL",47.50513,-52.79476,2018-05-24 10:00:00,30,1,31
"12207",10401,"Mount Pearl","NL",47.50513,-52.79476,2018-05-24 11:00:00,29,1,30
"12208",10401,"Mount Pearl","NL",47.50513,-52.79476,2018-05-24 12:00:00,29,1,30
"12209",10401,"Mount Pearl","NL",47.50513,-52.79476,2018-05-24 13:00:00,29,2,31
"12210",10401,"Mount Pearl","NL",47.50513,-52.79476,2018-05-24 14:00:00,30,1,31
"12211",10401,"Mount Pearl","NL",47.50513,-52.79476,2018-05-24 15:00:00,31,1,32
"12212",10401,"Mount Pearl","NL",47.50513,-52.79476,2018-05-24 16:00:00,31,1,32
"12213",10401,"Mount Pearl","NL",47.50513,-52.79476,2018-05-24 17:00:00,32,1,33
"12214",10401,"Mount Pearl","NL",47.50513,-52.79476,2018-05-24 18:00:00,31,0,31
"12215",10401,"Mount Pearl","NL",47.50513,-52.79476,2018-05-24 19:00:00,29,0,29
"12216",10401,"Mount Pearl","NL",47.50513,-52.79476,2018-05-24 20:00:00,28,1,29
"12217",10401,"Mount Pearl","NL",47.50513,-52.79476,2018-05-24 21:00:00,27,1,28
"12218",10401,"Mount Pearl","NL",47.50513,-52.79476,2018-05-24 22:00:00,27,1,28
"12219",10401,"Mount Pearl","NL",47.50513,-52.79476,2018-05-24 23:00:00,27,0,27
"12220",10401,"Mount Pearl","NL",47.50513,-52.79476,2018-05-25 00:00:00,26,0,26
"12221",10401,"Mount Pearl","NL",47.50513,-52.79476,2018-05-25 01:00:00,26,1,27
"12222",10401,"Mount Pearl","NL",47.50513,-52.79476,2018-05-25 02:00:00,25,1,26
"12223",10401,"Mount Pearl","NL",47.50513,-52.79476,2018-05-25 03:00:00,25,0,25
"12224",10401,"Mount Pearl","NL",47.50513,-52.79476,2018-05-25 04:00:00,24,1,25
"12225",10401,"Mount Pearl","NL",47.50513,-52.79476,2018-05-25 05:00:00,24,1,25
"12226",10401,"Mount Pearl","NL",47.50513,-52.79476,2018-05-25 06:00:00,24,2,26
"12227",10401,"Mount Pearl","NL",47.50513,-52.79476,2018-05-25 07:00:00,26,1,27
"12228",10401,"Mount Pearl","NL",47.50513,-52.79476,2018-05-25 08:00:00,27,1,28
"12229",10401,"Mount Pearl","NL",47.50513,-52.79476,2018-05-25 09:00:00,27,1,28
"12230",10401,"Mount Pearl","NL",47.50513,-52.79476,2018-05-25 10:00:00,28,2,30
"12231",10401,"Mount Pearl","NL",47.50513,-52.79476,2018-05-25 11:00:00,29,1,30
"12232",10401,"Mount Pearl","NL",47.50513,-52.79476,2018-05-25 12:00:00,27,1,28
"12233",10401,"Mount Pearl","NL",47.50513,-52.79476,2018-05-25 13:00:00,26,0,26
"12234",10401,"Mount Pearl","NL",47.50513,-52.79476,2018-05-25 14:00:00,27,0,27
"12235",10401,"Mount Pearl","NL",47.50513,-52.79476,2018-05-25 15:00:00,28,0,28
"12236",10401,"Mount Pearl","NL",47.50513,-52.79476,2018-05-25 16:00:00,28,0,28
"12237",10401,"Mount Pearl","NL",47.50513,-52.79476,2018-05-25 17:00:00,29,1,30
"12238",10401,"Mount Pearl","NL",47.50513,-52.79476,2018-05-25 18:00:00,30,0,30
"12239",10401,"Mount Pearl","NL",47.50513,-52.79476,2018-05-25 19:00:00,31,0,31
"12240",10401,"Mount Pearl","NL",47.50513,-52.79476,2018-05-25 20:00:00,31,0,31
"12241",10401,"Mount Pearl","NL",47.50513,-52.79476,2018-05-25 21:00:00,32,0,32
"12242",10401,"Mount Pearl","NL",47.50513,-52.79476,2018-05-25 22:00:00,32,0,32
"12243",10401,"Mount Pearl","NL",47.50513,-52.79476,2018-05-25 23:00:00,32,0,32
"12244",10401,"Mount Pearl","NL",47.50513,-52.79476,2018-05-26 00:00:00,33,0,33
"12245",10401,"Mount Pearl","NL",47.50513,-52.79476,2018-05-26 01:00:00,35,0,35
"12246",10401,"Mount Pearl","NL",47.50513,-52.79476,2018-05-26 02:00:00,37,0,37
"12247",10401,"Mount Pearl","NL",47.50513,-52.79476,2018-05-26 03:00:00,37,0,37
"12248",10401,"Mount Pearl","NL",47.50513,-52.79476,2018-05-26 04:00:00,37,1,38
"12249",10401,"Mount Pearl","NL",47.50513,-52.79476,2018-05-26 05:00:00,35,0,35
"12250",10401,"Mount Pearl","NL",47.50513,-52.79476,2018-05-26 06:00:00,31,0,31
"12251",10401,"Mount Pearl","NL",47.50513,-52.79476,2018-05-26 07:00:00,30,1,31
"12252",10401,"Mount Pearl","NL",47.50513,-52.79476,2018-05-26 08:00:00,31,0,31
"12253",10401,"Mount Pearl","NL",47.50513,-52.79476,2018-05-26 09:00:00,29,1,30
"12254",10401,"Mount Pearl","NL",47.50513,-52.79476,2018-05-26 10:00:00,29,1,30
"12255",10401,"Mount Pearl","NL",47.50513,-52.79476,2018-05-26 11:00:00,29,1,30
"12256",10401,"Mount Pearl","NL",47.50513,-52.79476,2018-05-26 12:00:00,30,1,31
"12257",10401,"Mount Pearl","NL",47.50513,-52.79476,2018-05-26 13:00:00,30,2,32
"12258",10401,"Mount Pearl","NL",47.50513,-52.79476,2018-05-26 14:00:00,30,2,32
"12259",10401,"Mount Pearl","NL",47.50513,-52.79476,2018-05-26 15:00:00,31,2,33
"12260",10401,"Mount Pearl","NL",47.50513,-52.79476,2018-05-26 16:00:00,30,2,32
"12261",10401,"Mount Pearl","NL",47.50513,-52.79476,2018-05-26 17:00:00,30,1,31
"12262",10401,"Mount Pearl","NL",47.50513,-52.79476,2018-05-26 18:00:00,28,2,30
"12263",10401,"Mount Pearl","NL",47.50513,-52.79476,2018-05-26 19:00:00,29,3,32
"12264",10401,"Mount Pearl","NL",47.50513,-52.79476,2018-05-26 20:00:00,29,2,31
"12265",10401,"Mount Pearl","NL",47.50513,-52.79476,2018-05-26 21:00:00,27,3,30
"12266",10401,"Mount Pearl","NL",47.50513,-52.79476,2018-05-26 22:00:00,28,2,30
"12267",10401,"Mount Pearl","NL",47.50513,-52.79476,2018-05-26 23:00:00,31,1,32
"12268",10401,"Mount Pearl","NL",47.50513,-52.79476,2018-05-27 00:00:00,29,2,31
"12269",10401,"Mount Pearl","NL",47.50513,-52.79476,2018-05-27 01:00:00,29,1,30
"12270",10401,"Mount Pearl","NL",47.50513,-52.79476,2018-05-27 02:00:00,28,2,30
"12271",10401,"Mount Pearl","NL",47.50513,-52.79476,2018-05-27 03:00:00,28,1,29
"12272",10401,"Mount Pearl","NL",47.50513,-52.79476,2018-05-27 04:00:00,29,1,30
"12273",10401,"Mount Pearl","NL",47.50513,-52.79476,2018-05-27 05:00:00,31,1,32
"12274",10401,"Mount Pearl","NL",47.50513,-52.79476,2018-05-27 06:00:00,31,1,32
"12275",10401,"Mount Pearl","NL",47.50513,-52.79476,2018-05-27 07:00:00,30,1,31
"12276",10401,"Mount Pearl","NL",47.50513,-52.79476,2018-05-27 08:00:00,29,1,30
"12277",10401,"Mount Pearl","NL",47.50513,-52.79476,2018-05-27 09:00:00,29,1,30
"12278",10401,"Mount Pearl","NL",47.50513,-52.79476,2018-05-27 10:00:00,29,1,30
"12279",10401,"Mount Pearl","NL",47.50513,-52.79476,2018-05-27 11:00:00,29,1,30
"12280",10401,"Mount Pearl","NL",47.50513,-52.79476,2018-05-27 12:00:00,29,0,29
"12281",10401,"Mount Pearl","NL",47.50513,-52.79476,2018-05-27 13:00:00,29,0,29
"12282",10401,"Mount Pearl","NL",47.50513,-52.79476,2018-05-27 14:00:00,30,0,30
"12283",10401,"Mount Pearl","NL",47.50513,-52.79476,2018-05-27 15:00:00,30,1,31
"12284",10401,"Mount Pearl","NL",47.50513,-52.79476,2018-05-27 16:00:00,30,1,31
"12285",10401,"Mount Pearl","NL",47.50513,-52.79476,2018-05-27 17:00:00,30,0,30
"12286",10401,"Mount Pearl","NL",47.50513,-52.79476,2018-05-27 18:00:00,31,0,31
"12287",10401,"Mount Pearl","NL",47.50513,-52.79476,2018-05-27 19:00:00,31,1,32
"12288",10401,"Mount Pearl","NL",47.50513,-52.79476,2018-05-27 20:00:00,29,2,31
"12289",10401,"Mount Pearl","NL",47.50513,-52.79476,2018-05-27 21:00:00,23,3,26
"12290",10401,"Mount Pearl","NL",47.50513,-52.79476,2018-05-27 22:00:00,25,1,26
"12291",10401,"Mount Pearl","NL",47.50513,-52.79476,2018-05-27 23:00:00,21,1,22
"12292",10401,"Mount Pearl","NL",47.50513,-52.79476,2018-05-28 00:00:00,20,3,23
"12293",10401,"Mount Pearl","NL",47.50513,-52.79476,2018-05-28 01:00:00,23,3,26
"12294",10401,"Mount Pearl","NL",47.50513,-52.79476,2018-05-28 02:00:00,21,2,23
"12295",10401,"Mount Pearl","NL",47.50513,-52.79476,2018-05-28 03:00:00,22,2,24
"12296",10401,"Mount Pearl","NL",47.50513,-52.79476,2018-05-28 04:00:00,23,1,24
"12297",10401,"Mount Pearl","NL",47.50513,-52.79476,2018-05-28 05:00:00,18,2,20
"12298",10401,"Mount Pearl","NL",47.50513,-52.79476,2018-05-28 06:00:00,20,3,23
"12299",10401,"Mount Pearl","NL",47.50513,-52.79476,2018-05-28 07:00:00,25,2,27
"12300",10401,"Mount Pearl","NL",47.50513,-52.79476,2018-05-28 08:00:00,26,1,27
"12301",10401,"Mount Pearl","NL",47.50513,-52.79476,2018-05-28 09:00:00,27,1,28
"12302",10401,"Mount Pearl","NL",47.50513,-52.79476,2018-05-28 10:00:00,29,0,29
"12303",10401,"Mount Pearl","NL",47.50513,-52.79476,2018-05-28 11:00:00,32,1,33
"12304",10401,"Mount Pearl","NL",47.50513,-52.79476,2018-05-28 12:00:00,26,1,27
"12305",10401,"Mount Pearl","NL",47.50513,-52.79476,2018-05-28 13:00:00,27,2,29
"12306",10401,"Mount Pearl","NL",47.50513,-52.79476,2018-05-28 14:00:00,27,1,28
"12307",10401,"Mount Pearl","NL",47.50513,-52.79476,2018-05-28 15:00:00,27,1,28
"12308",10401,"Mount Pearl","NL",47.50513,-52.79476,2018-05-28 16:00:00,27,1,28
"12309",10401,"Mount Pearl","NL",47.50513,-52.79476,2018-05-28 17:00:00,32,1,33
"12310",10401,"Mount Pearl","NL",47.50513,-52.79476,2018-05-28 18:00:00,32,1,33
"12311",10401,"Mount Pearl","NL",47.50513,-52.79476,2018-05-28 19:00:00,30,1,31
"12312",10401,"Mount Pearl","NL",47.50513,-52.79476,2018-05-28 20:00:00,28,1,29
"12313",10401,"Mount Pearl","NL",47.50513,-52.79476,2018-05-28 21:00:00,28,1,29
"12314",10401,"Mount Pearl","NL",47.50513,-52.79476,2018-05-28 22:00:00,29,1,30
"12315",10401,"Mount Pearl","NL",47.50513,-52.79476,2018-05-28 23:00:00,27,1,28
"12316",10401,"Mount Pearl","NL",47.50513,-52.79476,2018-05-29 00:00:00,25,2,27
"12317",10401,"Mount Pearl","NL",47.50513,-52.79476,2018-05-29 01:00:00,26,1,27
"12318",10401,"Mount Pearl","NL",47.50513,-52.79476,2018-05-29 02:00:00,25,1,26
"12319",10401,"Mount Pearl","NL",47.50513,-52.79476,2018-05-29 03:00:00,25,1,26
"12320",10401,"Mount Pearl","NL",47.50513,-52.79476,2018-05-29 04:00:00,25,1,26
"12321",10401,"Mount Pearl","NL",47.50513,-52.79476,2018-05-29 05:00:00,25,1,26
"12322",10401,"Mount Pearl","NL",47.50513,-52.79476,2018-05-29 06:00:00,28,1,29
"12323",10401,"Mount Pearl","NL",47.50513,-52.79476,2018-05-29 07:00:00,29,2,31
"12324",10401,"Mount Pearl","NL",47.50513,-52.79476,2018-05-29 08:00:00,31,1,32
"12325",10401,"Mount Pearl","NL",47.50513,-52.79476,2018-05-29 09:00:00,30,1,31
"12326",10401,"Mount Pearl","NL",47.50513,-52.79476,2018-05-29 10:00:00,31,1,32
"12327",10401,"Mount Pearl","NL",47.50513,-52.79476,2018-05-29 11:00:00,31,1,32
"12328",10401,"Mount Pearl","NL",47.50513,-52.79476,2018-05-29 12:00:00,29,2,31
"12329",10401,"Mount Pearl","NL",47.50513,-52.79476,2018-05-29 13:00:00,31,1,32
"12330",10401,"Mount Pearl","NL",47.50513,-52.79476,2018-05-29 14:00:00,33,1,34
"12331",10401,"Mount Pearl","NL",47.50513,-52.79476,2018-05-29 15:00:00,33,1,34
"12332",10401,"Mount Pearl","NL",47.50513,-52.79476,2018-05-29 16:00:00,33,1,34
"12333",10401,"Mount Pearl","NL",47.50513,-52.79476,2018-05-29 17:00:00,31,2,33
"12334",10401,"Mount Pearl","NL",47.50513,-52.79476,2018-05-29 18:00:00,32,2,34
"12335",10401,"Mount Pearl","NL",47.50513,-52.79476,2018-05-29 19:00:00,33,1,34
"12336",10401,"Mount Pearl","NL",47.50513,-52.79476,2018-05-29 20:00:00,34,1,35
"12337",10401,"Mount Pearl","NL",47.50513,-52.79476,2018-05-29 21:00:00,34,2,36
"12338",10401,"Mount Pearl","NL",47.50513,-52.79476,2018-05-29 22:00:00,34,1,35
"12339",10401,"Mount Pearl","NL",47.50513,-52.79476,2018-05-29 23:00:00,34,1,35
"12340",10401,"Mount Pearl","NL",47.50513,-52.79476,2018-05-30 00:00:00,33,1,34
"12341",10401,"Mount Pearl","NL",47.50513,-52.79476,2018-05-30 01:00:00,33,1,34
"12342",10401,"Mount Pearl","NL",47.50513,-52.79476,2018-05-30 02:00:00,33,1,34
"12343",10401,"Mount Pearl","NL",47.50513,-52.79476,2018-05-30 03:00:00,32,2,34
"12344",10401,"Mount Pearl","NL",47.50513,-52.79476,2018-05-30 04:00:00,33,2,35
"12345",10401,"Mount Pearl","NL",47.50513,-52.79476,2018-05-30 05:00:00,36,1,37
"12346",10401,"Mount Pearl","NL",47.50513,-52.79476,2018-05-30 06:00:00,37,1,38
"12347",10401,"Mount Pearl","NL",47.50513,-52.79476,2018-05-30 07:00:00,41,2,43
"12348",10401,"Mount Pearl","NL",47.50513,-52.79476,2018-05-30 08:00:00,44,0,44
"12349",10401,"Mount Pearl","NL",47.50513,-52.79476,2018-05-30 09:00:00,43,1,44
"12350",10401,"Mount Pearl","NL",47.50513,-52.79476,2018-05-30 10:00:00,41,1,42
"12351",10401,"Mount Pearl","NL",47.50513,-52.79476,2018-05-30 11:00:00,43,2,45
"12352",10401,"Mount Pearl","NL",47.50513,-52.79476,2018-05-30 12:00:00,41,1,42
"12353",10401,"Mount Pearl","NL",47.50513,-52.79476,2018-05-30 13:00:00,40,1,41
"12354",10401,"Mount Pearl","NL",47.50513,-52.79476,2018-05-30 14:00:00,40,1,41
"12355",10401,"Mount Pearl","NL",47.50513,-52.79476,2018-05-30 15:00:00,40,1,41
"12356",10401,"Mount Pearl","NL",47.50513,-52.79476,2018-05-30 16:00:00,40,1,41
"12357",10401,"Mount Pearl","NL",47.50513,-52.79476,2018-05-30 17:00:00,40,0,40
"12358",10401,"Mount Pearl","NL",47.50513,-52.79476,2018-05-30 18:00:00,41,0,41
"12359",10401,"Mount Pearl","NL",47.50513,-52.79476,2018-05-30 19:00:00,41,1,42
"12360",10401,"Mount Pearl","NL",47.50513,-52.79476,2018-05-30 20:00:00,41,1,42
"12361",10401,"Mount Pearl","NL",47.50513,-52.79476,2018-05-30 21:00:00,40,1,41
"12362",10401,"Mount Pearl","NL",47.50513,-52.79476,2018-05-30 22:00:00,39,1,40
"12363",10401,"Mount Pearl","NL",47.50513,-52.79476,2018-05-30 23:00:00,38,1,39
"12364",10401,"Mount Pearl","NL",47.50513,-52.79476,2018-05-31 00:00:00,39,1,40
"12365",10401,"Mount Pearl","NL",47.50513,-52.79476,2018-05-31 01:00:00,39,0,39
"12366",10401,"Mount Pearl","NL",47.50513,-52.79476,2018-05-31 02:00:00,38,0,38
"12367",10401,"Mount Pearl","NL",47.50513,-52.79476,2018-05-31 03:00:00,37,1,38
"12368",10401,"Mount Pearl","NL",47.50513,-52.79476,2018-05-31 04:00:00,36,0,36
"12369",10401,"Mount Pearl","NL",47.50513,-52.79476,2018-05-31 05:00:00,36,1,37
"12370",10401,"Mount Pearl","NL",47.50513,-52.79476,2018-05-31 06:00:00,35,1,36
"12371",10401,"Mount Pearl","NL",47.50513,-52.79476,2018-05-31 07:00:00,34,1,35
"12372",10401,"Mount Pearl","NL",47.50513,-52.79476,2018-05-31 08:00:00,NA,NA,NA
"12373",10401,"Mount Pearl","NL",47.50513,-52.79476,2018-05-31 09:00:00,NA,NA,NA
"12374",10401,"Mount Pearl","NL",47.50513,-52.79476,2018-05-31 10:00:00,NA,NA,NA
"12375",10401,"Mount Pearl","NL",47.50513,-52.79476,2018-05-31 11:00:00,NA,NA,NA
"12376",10401,"Mount Pearl","NL",47.50513,-52.79476,2018-05-31 12:00:00,NA,NA,NA
"12377",10401,"Mount Pearl","NL",47.50513,-52.79476,2018-05-31 13:00:00,33,0,33
"12378",10401,"Mount Pearl","NL",47.50513,-52.79476,2018-05-31 14:00:00,33,1,34
"12379",10401,"Mount Pearl","NL",47.50513,-52.79476,2018-05-31 15:00:00,33,1,34
"12380",10401,"Mount Pearl","NL",47.50513,-52.79476,2018-05-31 16:00:00,NA,NA,NA
"12381",10401,"Mount Pearl","NL",47.50513,-52.79476,2018-05-31 17:00:00,32,1,33
"12382",10401,"Mount Pearl","NL",47.50513,-52.79476,2018-05-31 18:00:00,32,0,32
"12383",10401,"Mount Pearl","NL",47.50513,-52.79476,2018-05-31 19:00:00,NA,NA,NA
"12384",10401,"Mount Pearl","NL",47.50513,-52.79476,2018-05-31 20:00:00,NA,NA,NA
"12385",10401,"Mount Pearl","NL",47.50513,-52.79476,2018-05-31 21:00:00,NA,NA,NA
"12386",10401,"Mount Pearl","NL",47.50513,-52.79476,2018-05-31 22:00:00,NA,NA,NA
"12387",10401,"Mount Pearl","NL",47.50513,-52.79476,2018-05-31 23:00:00,NA,NA,NA
"12388",10401,"Mount Pearl","NL",47.50513,-52.79476,2018-06-01 00:00:00,NA,NA,NA
"12389",10401,"Mount Pearl","NL",47.50513,-52.79476,2018-06-01 01:00:00,NA,NA,NA
"12390",10401,"Mount Pearl","NL",47.50513,-52.79476,2018-06-01 02:00:00,NA,NA,NA
"12391",10401,"Mount Pearl","NL",47.50513,-52.79476,2018-06-01 03:00:00,NA,NA,NA
"12392",10401,"Mount Pearl","NL",47.50513,-52.79476,2018-06-01 04:00:00,NA,NA,NA
"12393",10401,"Mount Pearl","NL",47.50513,-52.79476,2018-06-01 05:00:00,NA,NA,NA
"12394",10401,"Mount Pearl","NL",47.50513,-52.79476,2018-06-01 06:00:00,NA,NA,NA
"12395",10401,"Mount Pearl","NL",47.50513,-52.79476,2018-06-01 07:00:00,NA,NA,NA
"12396",10401,"Mount Pearl","NL",47.50513,-52.79476,2018-06-01 08:00:00,NA,NA,NA
"12397",10401,"Mount Pearl","NL",47.50513,-52.79476,2018-06-01 09:00:00,NA,NA,NA
"12398",10401,"Mount Pearl","NL",47.50513,-52.79476,2018-06-01 10:00:00,NA,NA,NA
"12399",10401,"Mount Pearl","NL",47.50513,-52.79476,2018-06-01 11:00:00,NA,NA,NA
"12400",10401,"Mount Pearl","NL",47.50513,-52.79476,2018-06-01 12:00:00,NA,NA,NA
"12401",10401,"Mount Pearl","NL",47.50513,-52.79476,2018-06-01 13:00:00,NA,NA,NA
"12402",10401,"Mount Pearl","NL",47.50513,-52.79476,2018-06-01 14:00:00,NA,NA,NA
"12403",10401,"Mount Pearl","NL",47.50513,-52.79476,2018-06-01 15:00:00,NA,NA,NA
"12404",10401,"Mount Pearl","NL",47.50513,-52.79476,2018-06-01 16:00:00,NA,NA,NA
"12405",10401,"Mount Pearl","NL",47.50513,-52.79476,2018-06-01 17:00:00,NA,NA,NA
"12406",10401,"Mount Pearl","NL",47.50513,-52.79476,2018-06-01 18:00:00,NA,NA,NA
"12407",10401,"Mount Pearl","NL",47.50513,-52.79476,2018-06-01 19:00:00,NA,NA,NA
"12408",10401,"Mount Pearl","NL",47.50513,-52.79476,2018-06-01 20:00:00,NA,NA,NA
"12409",10401,"Mount Pearl","NL",47.50513,-52.79476,2018-06-01 21:00:00,NA,NA,NA
"12410",10401,"Mount Pearl","NL",47.50513,-52.79476,2018-06-01 22:00:00,NA,NA,NA
"12411",10401,"Mount Pearl","NL",47.50513,-52.79476,2018-06-01 23:00:00,NA,NA,NA
"12412",10401,"Mount Pearl","NL",47.50513,-52.79476,2018-06-02 00:00:00,NA,NA,NA
"12413",10401,"Mount Pearl","NL",47.50513,-52.79476,2018-06-02 01:00:00,NA,NA,NA
"12414",10401,"Mount Pearl","NL",47.50513,-52.79476,2018-06-02 02:00:00,NA,NA,NA
"12415",10401,"Mount Pearl","NL",47.50513,-52.79476,2018-06-02 03:00:00,NA,NA,NA
"12416",10401,"Mount Pearl","NL",47.50513,-52.79476,2018-06-02 04:00:00,NA,NA,NA
"12417",10401,"Mount Pearl","NL",47.50513,-52.79476,2018-06-02 05:00:00,NA,NA,NA
"12418",10401,"Mount Pearl","NL",47.50513,-52.79476,2018-06-02 06:00:00,NA,NA,NA
"12419",10401,"Mount Pearl","NL",47.50513,-52.79476,2018-06-02 07:00:00,NA,NA,NA
"12420",10401,"Mount Pearl","NL",47.50513,-52.79476,2018-06-02 08:00:00,NA,NA,NA
"12421",10401,"Mount Pearl","NL",47.50513,-52.79476,2018-06-02 09:00:00,NA,NA,NA
"12422",10401,"Mount Pearl","NL",47.50513,-52.79476,2018-06-02 10:00:00,NA,NA,NA
"12423",10401,"Mount Pearl","NL",47.50513,-52.79476,2018-06-02 11:00:00,NA,NA,NA
"12424",10401,"Mount Pearl","NL",47.50513,-52.79476,2018-06-02 12:00:00,NA,NA,NA
"12425",10401,"Mount Pearl","NL",47.50513,-52.79476,2018-06-02 13:00:00,NA,NA,NA
"12426",10401,"Mount Pearl","NL",47.50513,-52.79476,2018-06-02 14:00:00,NA,NA,NA
"12427",10401,"Mount Pearl","NL",47.50513,-52.79476,2018-06-02 15:00:00,NA,NA,NA
"12428",10401,"Mount Pearl","NL",47.50513,-52.79476,2018-06-02 16:00:00,NA,NA,NA
"12429",10401,"Mount Pearl","NL",47.50513,-52.79476,2018-06-02 17:00:00,NA,NA,NA
"12430",10401,"Mount Pearl","NL",47.50513,-52.79476,2018-06-02 18:00:00,NA,NA,NA
"12431",10401,"Mount Pearl","NL",47.50513,-52.79476,2018-06-02 19:00:00,NA,NA,NA
"12432",10401,"Mount Pearl","NL",47.50513,-52.79476,2018-06-02 20:00:00,NA,NA,NA
"12433",10401,"Mount Pearl","NL",47.50513,-52.79476,2018-06-02 21:00:00,NA,NA,NA
"12434",10401,"Mount Pearl","NL",47.50513,-52.79476,2018-06-02 22:00:00,NA,NA,NA
"12435",10401,"Mount Pearl","NL",47.50513,-52.79476,2018-06-02 23:00:00,NA,NA,NA
"12436",10401,"Mount Pearl","NL",47.50513,-52.79476,2018-06-03 00:00:00,NA,NA,NA
"12437",10401,"Mount Pearl","NL",47.50513,-52.79476,2018-06-03 01:00:00,NA,NA,NA
"12438",10401,"Mount Pearl","NL",47.50513,-52.79476,2018-06-03 02:00:00,NA,NA,NA
"12439",10401,"Mount Pearl","NL",47.50513,-52.79476,2018-06-03 03:00:00,NA,NA,NA
"12440",10401,"Mount Pearl","NL",47.50513,-52.79476,2018-06-03 04:00:00,NA,NA,NA
"12441",10401,"Mount Pearl","NL",47.50513,-52.79476,2018-06-03 05:00:00,NA,NA,NA
"12442",10401,"Mount Pearl","NL",47.50513,-52.79476,2018-06-03 06:00:00,NA,NA,NA
"12443",10401,"Mount Pearl","NL",47.50513,-52.79476,2018-06-03 07:00:00,NA,NA,NA
"12444",10401,"Mount Pearl","NL",47.50513,-52.79476,2018-06-03 08:00:00,NA,NA,NA
"12445",10401,"Mount Pearl","NL",47.50513,-52.79476,2018-06-03 09:00:00,NA,NA,NA
"12446",10401,"Mount Pearl","NL",47.50513,-52.79476,2018-06-03 10:00:00,NA,NA,NA
"12447",10401,"Mount Pearl","NL",47.50513,-52.79476,2018-06-03 11:00:00,NA,NA,NA
"12448",10401,"Mount Pearl","NL",47.50513,-52.79476,2018-06-03 12:00:00,NA,NA,NA
"12449",10401,"Mount Pearl","NL",47.50513,-52.79476,2018-06-03 13:00:00,NA,NA,NA
"12450",10401,"Mount Pearl","NL",47.50513,-52.79476,2018-06-03 14:00:00,NA,NA,NA
"12451",10401,"Mount Pearl","NL",47.50513,-52.79476,2018-06-03 15:00:00,NA,NA,NA
"12452",10401,"Mount Pearl","NL",47.50513,-52.79476,2018-06-03 16:00:00,NA,NA,NA
"12453",10401,"Mount Pearl","NL",47.50513,-52.79476,2018-06-03 17:00:00,NA,NA,NA
"12454",10401,"Mount Pearl","NL",47.50513,-52.79476,2018-06-03 18:00:00,NA,NA,NA
"12455",10401,"Mount Pearl","NL",47.50513,-52.79476,2018-06-03 19:00:00,NA,NA,NA
"12456",10401,"Mount Pearl","NL",47.50513,-52.79476,2018-06-03 20:00:00,NA,NA,NA
"12457",10401,"Mount Pearl","NL",47.50513,-52.79476,2018-06-03 21:00:00,NA,NA,NA
"12458",10401,"Mount Pearl","NL",47.50513,-52.79476,2018-06-03 22:00:00,NA,NA,NA
"12459",10401,"Mount Pearl","NL",47.50513,-52.79476,2018-06-03 23:00:00,NA,NA,NA
"12460",10401,"Mount Pearl","NL",47.50513,-52.79476,2018-06-04 00:00:00,NA,NA,NA
"12461",10401,"Mount Pearl","NL",47.50513,-52.79476,2018-06-04 01:00:00,NA,NA,NA
"12462",10401,"Mount Pearl","NL",47.50513,-52.79476,2018-06-04 02:00:00,NA,NA,NA
"12463",10401,"Mount Pearl","NL",47.50513,-52.79476,2018-06-04 03:00:00,NA,NA,NA
"12464",10401,"Mount Pearl","NL",47.50513,-52.79476,2018-06-04 04:00:00,NA,NA,NA
"12465",10401,"Mount Pearl","NL",47.50513,-52.79476,2018-06-04 05:00:00,NA,NA,NA
"12466",10401,"Mount Pearl","NL",47.50513,-52.79476,2018-06-04 06:00:00,NA,NA,NA
"12467",10401,"Mount Pearl","NL",47.50513,-52.79476,2018-06-04 07:00:00,NA,NA,NA
"12468",10401,"Mount Pearl","NL",47.50513,-52.79476,2018-06-04 08:00:00,NA,NA,NA
"12469",10401,"Mount Pearl","NL",47.50513,-52.79476,2018-06-04 09:00:00,NA,NA,NA
"12470",10401,"Mount Pearl","NL",47.50513,-52.79476,2018-06-04 10:00:00,NA,NA,NA
"12471",10401,"Mount Pearl","NL",47.50513,-52.79476,2018-06-04 11:00:00,NA,NA,NA
"12472",10401,"Mount Pearl","NL",47.50513,-52.79476,2018-06-04 12:00:00,NA,NA,NA
"12473",10401,"Mount Pearl","NL",47.50513,-52.79476,2018-06-04 13:00:00,NA,NA,NA
"12474",10401,"Mount Pearl","NL",47.50513,-52.79476,2018-06-04 14:00:00,NA,NA,NA
"12475",10401,"Mount Pearl","NL",47.50513,-52.79476,2018-06-04 15:00:00,NA,NA,NA
"12476",10401,"Mount Pearl","NL",47.50513,-52.79476,2018-06-04 16:00:00,NA,NA,NA
"12477",10401,"Mount Pearl","NL",47.50513,-52.79476,2018-06-04 17:00:00,NA,NA,NA
"12478",10401,"Mount Pearl","NL",47.50513,-52.79476,2018-06-04 18:00:00,NA,NA,NA
"12479",10401,"Mount Pearl","NL",47.50513,-52.79476,2018-06-04 19:00:00,NA,NA,NA
"12480",10401,"Mount Pearl","NL",47.50513,-52.79476,2018-06-04 20:00:00,NA,NA,NA
"12481",10401,"Mount Pearl","NL",47.50513,-52.79476,2018-06-04 21:00:00,NA,NA,NA
"12482",10401,"Mount Pearl","NL",47.50513,-52.79476,2018-06-04 22:00:00,NA,NA,NA
"12483",10401,"Mount Pearl","NL",47.50513,-52.79476,2018-06-04 23:00:00,NA,NA,NA
"12484",10401,"Mount Pearl","NL",47.50513,-52.79476,2018-06-05 00:00:00,NA,NA,NA
"12485",10401,"Mount Pearl","NL",47.50513,-52.79476,2018-06-05 01:00:00,NA,NA,NA
"12486",10401,"Mount Pearl","NL",47.50513,-52.79476,2018-06-05 02:00:00,NA,NA,NA
"12487",10401,"Mount Pearl","NL",47.50513,-52.79476,2018-06-05 03:00:00,NA,NA,NA
"12488",10401,"Mount Pearl","NL",47.50513,-52.79476,2018-06-05 04:00:00,NA,NA,NA
"12489",10401,"Mount Pearl","NL",47.50513,-52.79476,2018-06-05 05:00:00,NA,NA,NA
"12490",10401,"Mount Pearl","NL",47.50513,-52.79476,2018-06-05 06:00:00,NA,NA,NA
"12491",10401,"Mount Pearl","NL",47.50513,-52.79476,2018-06-05 07:00:00,NA,NA,NA
"12492",10401,"Mount Pearl","NL",47.50513,-52.79476,2018-06-05 08:00:00,NA,NA,NA
"12493",10401,"Mount Pearl","NL",47.50513,-52.79476,2018-06-05 09:00:00,NA,NA,NA
"12494",10401,"Mount Pearl","NL",47.50513,-52.79476,2018-06-05 10:00:00,NA,NA,NA
"12495",10401,"Mount Pearl","NL",47.50513,-52.79476,2018-06-05 11:00:00,NA,NA,NA
"12496",10401,"Mount Pearl","NL",47.50513,-52.79476,2018-06-05 12:00:00,NA,NA,NA
"12497",10401,"Mount Pearl","NL",47.50513,-52.79476,2018-06-05 13:00:00,NA,NA,NA
"12498",10401,"Mount Pearl","NL",47.50513,-52.79476,2018-06-05 14:00:00,NA,NA,NA
"12499",10401,"Mount Pearl","NL",47.50513,-52.79476,2018-06-05 15:00:00,NA,NA,NA
"12500",10401,"Mount Pearl","NL",47.50513,-52.79476,2018-06-05 16:00:00,NA,NA,NA
"12501",10401,"Mount Pearl","NL",47.50513,-52.79476,2018-06-05 17:00:00,NA,NA,NA
"12502",10401,"Mount Pearl","NL",47.50513,-52.79476,2018-06-05 18:00:00,NA,NA,NA
"12503",10401,"Mount Pearl","NL",47.50513,-52.79476,2018-06-05 19:00:00,NA,NA,NA
"12504",10401,"Mount Pearl","NL",47.50513,-52.79476,2018-06-05 20:00:00,NA,NA,NA
"12505",10401,"Mount Pearl","NL",47.50513,-52.79476,2018-06-05 21:00:00,NA,NA,NA
"12506",10401,"Mount Pearl","NL",47.50513,-52.79476,2018-06-05 22:00:00,NA,NA,NA
"12507",10401,"Mount Pearl","NL",47.50513,-52.79476,2018-06-05 23:00:00,NA,NA,NA
"12508",10401,"Mount Pearl","NL",47.50513,-52.79476,2018-06-06 00:00:00,NA,NA,NA
"12509",10401,"Mount Pearl","NL",47.50513,-52.79476,2018-06-06 01:00:00,NA,NA,NA
"12510",10401,"Mount Pearl","NL",47.50513,-52.79476,2018-06-06 02:00:00,NA,NA,NA
"12511",10401,"Mount Pearl","NL",47.50513,-52.79476,2018-06-06 03:00:00,NA,NA,NA
"12512",10401,"Mount Pearl","NL",47.50513,-52.79476,2018-06-06 04:00:00,NA,NA,NA
"12513",10401,"Mount Pearl","NL",47.50513,-52.79476,2018-06-06 05:00:00,NA,NA,NA
"12514",10401,"Mount Pearl","NL",47.50513,-52.79476,2018-06-06 06:00:00,NA,NA,NA
"12515",10401,"Mount Pearl","NL",47.50513,-52.79476,2018-06-06 07:00:00,NA,NA,NA
"12516",10401,"Mount Pearl","NL",47.50513,-52.79476,2018-06-06 08:00:00,NA,NA,NA
"12517",10401,"Mount Pearl","NL",47.50513,-52.79476,2018-06-06 09:00:00,NA,NA,NA
"12518",10401,"Mount Pearl","NL",47.50513,-52.79476,2018-06-06 10:00:00,NA,NA,NA
"12519",10401,"Mount Pearl","NL",47.50513,-52.79476,2018-06-06 11:00:00,NA,NA,NA
"12520",10401,"Mount Pearl","NL",47.50513,-52.79476,2018-06-06 12:00:00,NA,NA,NA
"12521",10401,"Mount Pearl","NL",47.50513,-52.79476,2018-06-06 13:00:00,NA,NA,NA
"12522",10401,"Mount Pearl","NL",47.50513,-52.79476,2018-06-06 14:00:00,NA,NA,NA
"12523",10401,"Mount Pearl","NL",47.50513,-52.79476,2018-06-06 15:00:00,31,1,32
"12524",10401,"Mount Pearl","NL",47.50513,-52.79476,2018-06-06 16:00:00,31,1,32
"12525",10401,"Mount Pearl","NL",47.50513,-52.79476,2018-06-06 17:00:00,31,2,33
"12526",10401,"Mount Pearl","NL",47.50513,-52.79476,2018-06-06 18:00:00,31,1,32
"12527",10401,"Mount Pearl","NL",47.50513,-52.79476,2018-06-06 19:00:00,31,1,32
"12528",10401,"Mount Pearl","NL",47.50513,-52.79476,2018-06-06 20:00:00,30,1,31
"12529",10401,"Mount Pearl","NL",47.50513,-52.79476,2018-06-06 21:00:00,30,1,31
"12530",10401,"Mount Pearl","NL",47.50513,-52.79476,2018-06-06 22:00:00,29,1,30
"12531",10401,"Mount Pearl","NL",47.50513,-52.79476,2018-06-06 23:00:00,29,0,29
"12532",10401,"Mount Pearl","NL",47.50513,-52.79476,2018-06-07 00:00:00,30,0,30
"12533",10401,"Mount Pearl","NL",47.50513,-52.79476,2018-06-07 01:00:00,32,0,32
"12534",10401,"Mount Pearl","NL",47.50513,-52.79476,2018-06-07 02:00:00,32,1,33
"12535",10401,"Mount Pearl","NL",47.50513,-52.79476,2018-06-07 03:00:00,33,1,34
"12536",10401,"Mount Pearl","NL",47.50513,-52.79476,2018-06-07 04:00:00,33,1,34
"12537",10401,"Mount Pearl","NL",47.50513,-52.79476,2018-06-07 05:00:00,34,1,35
"12538",10401,"Mount Pearl","NL",47.50513,-52.79476,2018-06-07 06:00:00,36,1,37
"12539",10401,"Mount Pearl","NL",47.50513,-52.79476,2018-06-07 07:00:00,34,3,37
"12540",10401,"Mount Pearl","NL",47.50513,-52.79476,2018-06-07 08:00:00,33,2,35
"12541",10401,"Mount Pearl","NL",47.50513,-52.79476,2018-06-07 09:00:00,32,2,34
"12542",10401,"Mount Pearl","NL",47.50513,-52.79476,2018-06-07 10:00:00,30,4,34
"12543",10401,"Mount Pearl","NL",47.50513,-52.79476,2018-06-07 11:00:00,32,4,36
"12544",10401,"Mount Pearl","NL",47.50513,-52.79476,2018-06-07 12:00:00,36,2,38
"12545",10401,"Mount Pearl","NL",47.50513,-52.79476,2018-06-07 13:00:00,36,2,38
"12546",10401,"Mount Pearl","NL",47.50513,-52.79476,2018-06-07 14:00:00,39,1,40
"12547",10401,"Mount Pearl","NL",47.50513,-52.79476,2018-06-07 15:00:00,39,1,40
"12548",10401,"Mount Pearl","NL",47.50513,-52.79476,2018-06-07 16:00:00,38,2,40
"12549",10401,"Mount Pearl","NL",47.50513,-52.79476,2018-06-07 17:00:00,37,1,38
"12550",10401,"Mount Pearl","NL",47.50513,-52.79476,2018-06-07 18:00:00,35,1,36
"12551",10401,"Mount Pearl","NL",47.50513,-52.79476,2018-06-07 19:00:00,36,1,37
"12552",10401,"Mount Pearl","NL",47.50513,-52.79476,2018-06-07 20:00:00,33,1,34
"12553",10401,"Mount Pearl","NL",47.50513,-52.79476,2018-06-07 21:00:00,28,1,29
"12554",10401,"Mount Pearl","NL",47.50513,-52.79476,2018-06-07 22:00:00,25,2,27
"12555",10401,"Mount Pearl","NL",47.50513,-52.79476,2018-06-07 23:00:00,27,2,29
"12556",10401,"Mount Pearl","NL",47.50513,-52.79476,2018-06-08 00:00:00,27,1,28
"12557",10401,"Mount Pearl","NL",47.50513,-52.79476,2018-06-08 01:00:00,20,1,21
"12558",10401,"Mount Pearl","NL",47.50513,-52.79476,2018-06-08 02:00:00,20,1,21
"12559",10401,"Mount Pearl","NL",47.50513,-52.79476,2018-06-08 03:00:00,22,1,23
"12560",10401,"Mount Pearl","NL",47.50513,-52.79476,2018-06-08 04:00:00,14,2,16
"12561",10401,"Mount Pearl","NL",47.50513,-52.79476,2018-06-08 05:00:00,15,1,16
"12562",10401,"Mount Pearl","NL",47.50513,-52.79476,2018-06-08 06:00:00,22,2,24
"12563",10401,"Mount Pearl","NL",47.50513,-52.79476,2018-06-08 07:00:00,28,2,30
"12564",10401,"Mount Pearl","NL",47.50513,-52.79476,2018-06-08 08:00:00,31,2,33
"12565",10401,"Mount Pearl","NL",47.50513,-52.79476,2018-06-08 09:00:00,30,1,31
"12566",10401,"Mount Pearl","NL",47.50513,-52.79476,2018-06-08 10:00:00,29,1,30
"12567",10401,"Mount Pearl","NL",47.50513,-52.79476,2018-06-08 11:00:00,28,1,29
"12568",10401,"Mount Pearl","NL",47.50513,-52.79476,2018-06-08 12:00:00,28,1,29
"12569",10401,"Mount Pearl","NL",47.50513,-52.79476,2018-06-08 13:00:00,29,1,30
"12570",10401,"Mount Pearl","NL",47.50513,-52.79476,2018-06-08 14:00:00,30,0,30
"12571",10401,"Mount Pearl","NL",47.50513,-52.79476,2018-06-08 15:00:00,31,1,32
"12572",10401,"Mount Pearl","NL",47.50513,-52.79476,2018-06-08 16:00:00,31,1,32
"12573",10401,"Mount Pearl","NL",47.50513,-52.79476,2018-06-08 17:00:00,32,1,33
"12574",10401,"Mount Pearl","NL",47.50513,-52.79476,2018-06-08 18:00:00,31,0,31
"12575",10401,"Mount Pearl","NL",47.50513,-52.79476,2018-06-08 19:00:00,31,1,32
"12576",10401,"Mount Pearl","NL",47.50513,-52.79476,2018-06-08 20:00:00,35,1,36
"12577",10401,"Mount Pearl","NL",47.50513,-52.79476,2018-06-08 21:00:00,33,1,34
"12578",10401,"Mount Pearl","NL",47.50513,-52.79476,2018-06-08 22:00:00,29,1,30
"12579",10401,"Mount Pearl","NL",47.50513,-52.79476,2018-06-08 23:00:00,29,0,29
"12580",10401,"Mount Pearl","NL",47.50513,-52.79476,2018-06-09 00:00:00,29,0,29
"12581",10401,"Mount Pearl","NL",47.50513,-52.79476,2018-06-09 01:00:00,26,0,26
"12582",10401,"Mount Pearl","NL",47.50513,-52.79476,2018-06-09 02:00:00,25,1,26
"12583",10401,"Mount Pearl","NL",47.50513,-52.79476,2018-06-09 03:00:00,24,1,25
"12584",10401,"Mount Pearl","NL",47.50513,-52.79476,2018-06-09 04:00:00,24,1,25
"12585",10401,"Mount Pearl","NL",47.50513,-52.79476,2018-06-09 05:00:00,28,0,28
"12586",10401,"Mount Pearl","NL",47.50513,-52.79476,2018-06-09 06:00:00,31,0,31
"12587",10401,"Mount Pearl","NL",47.50513,-52.79476,2018-06-09 07:00:00,34,1,35
"12588",10401,"Mount Pearl","NL",47.50513,-52.79476,2018-06-09 08:00:00,35,0,35
"12589",10401,"Mount Pearl","NL",47.50513,-52.79476,2018-06-09 09:00:00,33,0,33
"12590",10401,"Mount Pearl","NL",47.50513,-52.79476,2018-06-09 10:00:00,33,0,33
"12591",10401,"Mount Pearl","NL",47.50513,-52.79476,2018-06-09 11:00:00,32,0,32
"12592",10401,"Mount Pearl","NL",47.50513,-52.79476,2018-06-09 12:00:00,32,1,33
"12593",10401,"Mount Pearl","NL",47.50513,-52.79476,2018-06-09 13:00:00,32,1,33
"12594",10401,"Mount Pearl","NL",47.50513,-52.79476,2018-06-09 14:00:00,32,1,33
"12595",10401,"Mount Pearl","NL",47.50513,-52.79476,2018-06-09 15:00:00,32,0,32
"12596",10401,"Mount Pearl","NL",47.50513,-52.79476,2018-06-09 16:00:00,33,1,34
"12597",10401,"Mount Pearl","NL",47.50513,-52.79476,2018-06-09 17:00:00,31,1,32
"12598",10401,"Mount Pearl","NL",47.50513,-52.79476,2018-06-09 18:00:00,30,1,31
"12599",10401,"Mount Pearl","NL",47.50513,-52.79476,2018-06-09 19:00:00,29,1,30
"12600",10401,"Mount Pearl","NL",47.50513,-52.79476,2018-06-09 20:00:00,25,1,26
"12601",10401,"Mount Pearl","NL",47.50513,-52.79476,2018-06-09 21:00:00,19,1,20
"12602",10401,"Mount Pearl","NL",47.50513,-52.79476,2018-06-09 22:00:00,19,1,20
"12603",10401,"Mount Pearl","NL",47.50513,-52.79476,2018-06-09 23:00:00,28,0,28
"12604",10401,"Mount Pearl","NL",47.50513,-52.79476,2018-06-10 00:00:00,28,0,28
"12605",10401,"Mount Pearl","NL",47.50513,-52.79476,2018-06-10 01:00:00,28,1,29
"12606",10401,"Mount Pearl","NL",47.50513,-52.79476,2018-06-10 02:00:00,28,0,28
"12607",10401,"Mount Pearl","NL",47.50513,-52.79476,2018-06-10 03:00:00,27,0,27
"12608",10401,"Mount Pearl","NL",47.50513,-52.79476,2018-06-10 04:00:00,25,0,25
"12609",10401,"Mount Pearl","NL",47.50513,-52.79476,2018-06-10 05:00:00,26,0,26
"12610",10401,"Mount Pearl","NL",47.50513,-52.79476,2018-06-10 06:00:00,27,1,28
"12611",10401,"Mount Pearl","NL",47.50513,-52.79476,2018-06-10 07:00:00,25,1,26
"12612",10401,"Mount Pearl","NL",47.50513,-52.79476,2018-06-10 08:00:00,24,0,24
"12613",10401,"Mount Pearl","NL",47.50513,-52.79476,2018-06-10 09:00:00,21,0,21
"12614",10401,"Mount Pearl","NL",47.50513,-52.79476,2018-06-10 10:00:00,22,0,22
"12615",10401,"Mount Pearl","NL",47.50513,-52.79476,2018-06-10 11:00:00,24,0,24
"12616",10401,"Mount Pearl","NL",47.50513,-52.79476,2018-06-10 12:00:00,23,0,23
"12617",10401,"Mount Pearl","NL",47.50513,-52.79476,2018-06-10 13:00:00,24,0,24
"12618",10401,"Mount Pearl","NL",47.50513,-52.79476,2018-06-10 14:00:00,25,1,26
"12619",10401,"Mount Pearl","NL",47.50513,-52.79476,2018-06-10 15:00:00,27,0,27
"12620",10401,"Mount Pearl","NL",47.50513,-52.79476,2018-06-10 16:00:00,28,0,28
"12621",10401,"Mount Pearl","NL",47.50513,-52.79476,2018-06-10 17:00:00,29,0,29
"12622",10401,"Mount Pearl","NL",47.50513,-52.79476,2018-06-10 18:00:00,30,0,30
"12623",10401,"Mount Pearl","NL",47.50513,-52.79476,2018-06-10 19:00:00,31,0,31
"12624",10401,"Mount Pearl","NL",47.50513,-52.79476,2018-06-10 20:00:00,31,1,32
"12625",10401,"Mount Pearl","NL",47.50513,-52.79476,2018-06-10 21:00:00,33,0,33
"12626",10401,"Mount Pearl","NL",47.50513,-52.79476,2018-06-10 22:00:00,32,0,32
"12627",10401,"Mount Pearl","NL",47.50513,-52.79476,2018-06-10 23:00:00,29,0,29
"12628",10401,"Mount Pearl","NL",47.50513,-52.79476,2018-06-11 00:00:00,28,0,28
"12629",10401,"Mount Pearl","NL",47.50513,-52.79476,2018-06-11 01:00:00,26,0,26
"12630",10401,"Mount Pearl","NL",47.50513,-52.79476,2018-06-11 02:00:00,25,1,26
"12631",10401,"Mount Pearl","NL",47.50513,-52.79476,2018-06-11 03:00:00,24,1,25
"12632",10401,"Mount Pearl","NL",47.50513,-52.79476,2018-06-11 04:00:00,25,0,25
"12633",10401,"Mount Pearl","NL",47.50513,-52.79476,2018-06-11 05:00:00,24,0,24
"12634",10401,"Mount Pearl","NL",47.50513,-52.79476,2018-06-11 06:00:00,23,1,24
"12635",10401,"Mount Pearl","NL",47.50513,-52.79476,2018-06-11 07:00:00,22,2,24
"12636",10401,"Mount Pearl","NL",47.50513,-52.79476,2018-06-11 08:00:00,22,2,24
"12637",10401,"Mount Pearl","NL",47.50513,-52.79476,2018-06-11 09:00:00,22,1,23
"12638",10401,"Mount Pearl","NL",47.50513,-52.79476,2018-06-11 10:00:00,22,1,23
"12639",10401,"Mount Pearl","NL",47.50513,-52.79476,2018-06-11 11:00:00,19,3,22
"12640",10401,"Mount Pearl","NL",47.50513,-52.79476,2018-06-11 12:00:00,22,2,24
"12641",10401,"Mount Pearl","NL",47.50513,-52.79476,2018-06-11 13:00:00,25,2,27
"12642",10401,"Mount Pearl","NL",47.50513,-52.79476,2018-06-11 14:00:00,26,2,28
"12643",10401,"Mount Pearl","NL",47.50513,-52.79476,2018-06-11 15:00:00,25,1,26
"12644",10401,"Mount Pearl","NL",47.50513,-52.79476,2018-06-11 16:00:00,21,4,25
"12645",10401,"Mount Pearl","NL",47.50513,-52.79476,2018-06-11 17:00:00,21,2,23
"12646",10401,"Mount Pearl","NL",47.50513,-52.79476,2018-06-11 18:00:00,19,1,20
"12647",10401,"Mount Pearl","NL",47.50513,-52.79476,2018-06-11 19:00:00,18,3,21
"12648",10401,"Mount Pearl","NL",47.50513,-52.79476,2018-06-11 20:00:00,19,2,21
"12649",10401,"Mount Pearl","NL",47.50513,-52.79476,2018-06-11 21:00:00,20,3,23
"12650",10401,"Mount Pearl","NL",47.50513,-52.79476,2018-06-11 22:00:00,22,1,23
"12651",10401,"Mount Pearl","NL",47.50513,-52.79476,2018-06-11 23:00:00,23,1,24
"12652",10401,"Mount Pearl","NL",47.50513,-52.79476,2018-06-12 00:00:00,24,1,25
"12653",10401,"Mount Pearl","NL",47.50513,-52.79476,2018-06-12 01:00:00,23,1,24
"12654",10401,"Mount Pearl","NL",47.50513,-52.79476,2018-06-12 02:00:00,22,1,23
"12655",10401,"Mount Pearl","NL",47.50513,-52.79476,2018-06-12 03:00:00,24,1,25
"12656",10401,"Mount Pearl","NL",47.50513,-52.79476,2018-06-12 04:00:00,26,1,27
"12657",10401,"Mount Pearl","NL",47.50513,-52.79476,2018-06-12 05:00:00,27,1,28
"12658",10401,"Mount Pearl","NL",47.50513,-52.79476,2018-06-12 06:00:00,25,1,26
"12659",10401,"Mount Pearl","NL",47.50513,-52.79476,2018-06-12 07:00:00,26,1,27
"12660",10401,"Mount Pearl","NL",47.50513,-52.79476,2018-06-12 08:00:00,26,1,27
"12661",10401,"Mount Pearl","NL",47.50513,-52.79476,2018-06-12 09:00:00,26,2,28
"12662",10401,"Mount Pearl","NL",47.50513,-52.79476,2018-06-12 10:00:00,26,1,27
"12663",10401,"Mount Pearl","NL",47.50513,-52.79476,2018-06-12 11:00:00,25,1,26
"12664",10401,"Mount Pearl","NL",47.50513,-52.79476,2018-06-12 12:00:00,24,2,26
"12665",10401,"Mount Pearl","NL",47.50513,-52.79476,2018-06-12 13:00:00,24,2,26
"12666",10401,"Mount Pearl","NL",47.50513,-52.79476,2018-06-12 14:00:00,24,1,25
"12667",10401,"Mount Pearl","NL",47.50513,-52.79476,2018-06-12 15:00:00,25,1,26
"12668",10401,"Mount Pearl","NL",47.50513,-52.79476,2018-06-12 16:00:00,25,2,27
"12669",10401,"Mount Pearl","NL",47.50513,-52.79476,2018-06-12 17:00:00,23,2,25
"12670",10401,"Mount Pearl","NL",47.50513,-52.79476,2018-06-12 18:00:00,23,1,24
"12671",10401,"Mount Pearl","NL",47.50513,-52.79476,2018-06-12 19:00:00,23,2,25
"12672",10401,"Mount Pearl","NL",47.50513,-52.79476,2018-06-12 20:00:00,21,3,24
"12673",10401,"Mount Pearl","NL",47.50513,-52.79476,2018-06-12 21:00:00,16,3,19
"12674",10401,"Mount Pearl","NL",47.50513,-52.79476,2018-06-12 22:00:00,18,2,20
"12675",10401,"Mount Pearl","NL",47.50513,-52.79476,2018-06-12 23:00:00,20,2,22
"12676",10401,"Mount Pearl","NL",47.50513,-52.79476,2018-06-13 00:00:00,16,1,17
"12677",10401,"Mount Pearl","NL",47.50513,-52.79476,2018-06-13 01:00:00,18,1,19
"12678",10401,"Mount Pearl","NL",47.50513,-52.79476,2018-06-13 02:00:00,20,1,21
"12679",10401,"Mount Pearl","NL",47.50513,-52.79476,2018-06-13 03:00:00,20,2,22
"12680",10401,"Mount Pearl","NL",47.50513,-52.79476,2018-06-13 04:00:00,20,1,21
"12681",10401,"Mount Pearl","NL",47.50513,-52.79476,2018-06-13 05:00:00,20,2,22
"12682",10401,"Mount Pearl","NL",47.50513,-52.79476,2018-06-13 06:00:00,23,2,25
"12683",10401,"Mount Pearl","NL",47.50513,-52.79476,2018-06-13 07:00:00,23,2,25
"12684",10401,"Mount Pearl","NL",47.50513,-52.79476,2018-06-13 08:00:00,23,2,25
"12685",10401,"Mount Pearl","NL",47.50513,-52.79476,2018-06-13 09:00:00,27,2,29
"12686",10401,"Mount Pearl","NL",47.50513,-52.79476,2018-06-13 10:00:00,32,1,33
"12687",10401,"Mount Pearl","NL",47.50513,-52.79476,2018-06-13 11:00:00,35,2,37
"12688",10401,"Mount Pearl","NL",47.50513,-52.79476,2018-06-13 12:00:00,33,0,33
"12689",10401,"Mount Pearl","NL",47.50513,-52.79476,2018-06-13 13:00:00,32,0,32
"12690",10401,"Mount Pearl","NL",47.50513,-52.79476,2018-06-13 14:00:00,33,0,33
"12691",10401,"Mount Pearl","NL",47.50513,-52.79476,2018-06-13 15:00:00,33,0,33
"12692",10401,"Mount Pearl","NL",47.50513,-52.79476,2018-06-13 16:00:00,32,0,32
"12693",10401,"Mount Pearl","NL",47.50513,-52.79476,2018-06-13 17:00:00,32,1,33
"12694",10401,"Mount Pearl","NL",47.50513,-52.79476,2018-06-13 18:00:00,31,1,32
"12695",10401,"Mount Pearl","NL",47.50513,-52.79476,2018-06-13 19:00:00,30,1,31
"12696",10401,"Mount Pearl","NL",47.50513,-52.79476,2018-06-13 20:00:00,29,1,30
"12697",10401,"Mount Pearl","NL",47.50513,-52.79476,2018-06-13 21:00:00,27,0,27
"12698",10401,"Mount Pearl","NL",47.50513,-52.79476,2018-06-13 22:00:00,25,1,26
"12699",10401,"Mount Pearl","NL",47.50513,-52.79476,2018-06-13 23:00:00,24,1,25
"12700",10401,"Mount Pearl","NL",47.50513,-52.79476,2018-06-14 00:00:00,22,1,23
"12701",10401,"Mount Pearl","NL",47.50513,-52.79476,2018-06-14 01:00:00,23,0,23
"12702",10401,"Mount Pearl","NL",47.50513,-52.79476,2018-06-14 02:00:00,23,0,23
"12703",10401,"Mount Pearl","NL",47.50513,-52.79476,2018-06-14 03:00:00,23,0,23
"12704",10401,"Mount Pearl","NL",47.50513,-52.79476,2018-06-14 04:00:00,23,0,23
"12705",10401,"Mount Pearl","NL",47.50513,-52.79476,2018-06-14 05:00:00,23,0,23
"12706",10401,"Mount Pearl","NL",47.50513,-52.79476,2018-06-14 06:00:00,24,0,24
"12707",10401,"Mount Pearl","NL",47.50513,-52.79476,2018-06-14 07:00:00,24,1,25
"12708",10401,"Mount Pearl","NL",47.50513,-52.79476,2018-06-14 08:00:00,25,0,25
"12709",10401,"Mount Pearl","NL",47.50513,-52.79476,2018-06-14 09:00:00,26,1,27
"12710",10401,"Mount Pearl","NL",47.50513,-52.79476,2018-06-14 10:00:00,26,0,26
"12711",10401,"Mount Pearl","NL",47.50513,-52.79476,2018-06-14 11:00:00,27,1,28
"12712",10401,"Mount Pearl","NL",47.50513,-52.79476,2018-06-14 12:00:00,26,1,27
"12713",10401,"Mount Pearl","NL",47.50513,-52.79476,2018-06-14 13:00:00,26,1,27
"12714",10401,"Mount Pearl","NL",47.50513,-52.79476,2018-06-14 14:00:00,25,2,27
"12715",10401,"Mount Pearl","NL",47.50513,-52.79476,2018-06-14 15:00:00,25,1,26
"12716",10401,"Mount Pearl","NL",47.50513,-52.79476,2018-06-14 16:00:00,26,1,27
"12717",10401,"Mount Pearl","NL",47.50513,-52.79476,2018-06-14 17:00:00,25,1,26
"12718",10401,"Mount Pearl","NL",47.50513,-52.79476,2018-06-14 18:00:00,26,0,26
"12719",10401,"Mount Pearl","NL",47.50513,-52.79476,2018-06-14 19:00:00,25,1,26
"12720",10401,"Mount Pearl","NL",47.50513,-52.79476,2018-06-14 20:00:00,26,1,27
"12721",10401,"Mount Pearl","NL",47.50513,-52.79476,2018-06-14 21:00:00,26,1,27
"12722",10401,"Mount Pearl","NL",47.50513,-52.79476,2018-06-14 22:00:00,26,0,26
"12723",10401,"Mount Pearl","NL",47.50513,-52.79476,2018-06-14 23:00:00,26,0,26
"12724",10401,"Mount Pearl","NL",47.50513,-52.79476,2018-06-15 00:00:00,25,0,25
"12725",10401,"Mount Pearl","NL",47.50513,-52.79476,2018-06-15 01:00:00,25,1,26
"12726",10401,"Mount Pearl","NL",47.50513,-52.79476,2018-06-15 02:00:00,24,0,24
"12727",10401,"Mount Pearl","NL",47.50513,-52.79476,2018-06-15 03:00:00,23,1,24
"12728",10401,"Mount Pearl","NL",47.50513,-52.79476,2018-06-15 04:00:00,24,1,25
"12729",10401,"Mount Pearl","NL",47.50513,-52.79476,2018-06-15 05:00:00,24,1,25
"12730",10401,"Mount Pearl","NL",47.50513,-52.79476,2018-06-15 06:00:00,23,1,24
"12731",10401,"Mount Pearl","NL",47.50513,-52.79476,2018-06-15 07:00:00,18,5,23
"12732",10401,"Mount Pearl","NL",47.50513,-52.79476,2018-06-15 08:00:00,21,2,23
"12733",10401,"Mount Pearl","NL",47.50513,-52.79476,2018-06-15 09:00:00,17,4,21
"12734",10401,"Mount Pearl","NL",47.50513,-52.79476,2018-06-15 10:00:00,20,3,23
"12735",10401,"Mount Pearl","NL",47.50513,-52.79476,2018-06-15 11:00:00,22,1,23
"12736",10401,"Mount Pearl","NL",47.50513,-52.79476,2018-06-15 12:00:00,20,2,22
"12737",10401,"Mount Pearl","NL",47.50513,-52.79476,2018-06-15 13:00:00,19,2,21
"12738",10401,"Mount Pearl","NL",47.50513,-52.79476,2018-06-15 14:00:00,20,1,21
"12739",10401,"Mount Pearl","NL",47.50513,-52.79476,2018-06-15 15:00:00,20,1,21
"12740",10401,"Mount Pearl","NL",47.50513,-52.79476,2018-06-15 16:00:00,22,1,23
"12741",10401,"Mount Pearl","NL",47.50513,-52.79476,2018-06-15 17:00:00,20,4,24
"12742",10401,"Mount Pearl","NL",47.50513,-52.79476,2018-06-15 18:00:00,23,1,24
"12743",10401,"Mount Pearl","NL",47.50513,-52.79476,2018-06-15 19:00:00,18,4,22
"12744",10401,"Mount Pearl","NL",47.50513,-52.79476,2018-06-15 20:00:00,18,4,22
"12745",10401,"Mount Pearl","NL",47.50513,-52.79476,2018-06-15 21:00:00,12,6,18
"12746",10401,"Mount Pearl","NL",47.50513,-52.79476,2018-06-15 22:00:00,9,7,16
"12747",10401,"Mount Pearl","NL",47.50513,-52.79476,2018-06-15 23:00:00,15,3,18
"12748",10401,"Mount Pearl","NL",47.50513,-52.79476,2018-06-16 00:00:00,21,0,21
"12749",10401,"Mount Pearl","NL",47.50513,-52.79476,2018-06-16 01:00:00,19,0,19
"12750",10401,"Mount Pearl","NL",47.50513,-52.79476,2018-06-16 02:00:00,15,0,15
"12751",10401,"Mount Pearl","NL",47.50513,-52.79476,2018-06-16 03:00:00,11,1,12
"12752",10401,"Mount Pearl","NL",47.50513,-52.79476,2018-06-16 04:00:00,9,1,10
"12753",10401,"Mount Pearl","NL",47.50513,-52.79476,2018-06-16 05:00:00,9,3,12
"12754",10401,"Mount Pearl","NL",47.50513,-52.79476,2018-06-16 06:00:00,11,1,12
"12755",10401,"Mount Pearl","NL",47.50513,-52.79476,2018-06-16 07:00:00,12,1,13
"12756",10401,"Mount Pearl","NL",47.50513,-52.79476,2018-06-16 08:00:00,20,0,20
"12757",10401,"Mount Pearl","NL",47.50513,-52.79476,2018-06-16 09:00:00,22,0,22
"12758",10401,"Mount Pearl","NL",47.50513,-52.79476,2018-06-16 10:00:00,25,0,25
"12759",10401,"Mount Pearl","NL",47.50513,-52.79476,2018-06-16 11:00:00,27,0,27
"12760",10401,"Mount Pearl","NL",47.50513,-52.79476,2018-06-16 12:00:00,30,1,31
"12761",10401,"Mount Pearl","NL",47.50513,-52.79476,2018-06-16 13:00:00,26,1,27
"12762",10401,"Mount Pearl","NL",47.50513,-52.79476,2018-06-16 14:00:00,27,1,28
"12763",10401,"Mount Pearl","NL",47.50513,-52.79476,2018-06-16 15:00:00,28,1,29
"12764",10401,"Mount Pearl","NL",47.50513,-52.79476,2018-06-16 16:00:00,28,1,29
"12765",10401,"Mount Pearl","NL",47.50513,-52.79476,2018-06-16 17:00:00,29,1,30
"12766",10401,"Mount Pearl","NL",47.50513,-52.79476,2018-06-16 18:00:00,26,1,27
"12767",10401,"Mount Pearl","NL",47.50513,-52.79476,2018-06-16 19:00:00,24,1,25
"12768",10401,"Mount Pearl","NL",47.50513,-52.79476,2018-06-16 20:00:00,23,1,24
"12769",10401,"Mount Pearl","NL",47.50513,-52.79476,2018-06-16 21:00:00,23,0,23
"12770",10401,"Mount Pearl","NL",47.50513,-52.79476,2018-06-16 22:00:00,23,0,23
"12771",10401,"Mount Pearl","NL",47.50513,-52.79476,2018-06-16 23:00:00,23,1,24
"12772",10401,"Mount Pearl","NL",47.50513,-52.79476,2018-06-17 00:00:00,23,0,23
"12773",10401,"Mount Pearl","NL",47.50513,-52.79476,2018-06-17 01:00:00,24,0,24
"12774",10401,"Mount Pearl","NL",47.50513,-52.79476,2018-06-17 02:00:00,23,1,24
"12775",10401,"Mount Pearl","NL",47.50513,-52.79476,2018-06-17 03:00:00,22,1,23
"12776",10401,"Mount Pearl","NL",47.50513,-52.79476,2018-06-17 04:00:00,23,1,24
"12777",10401,"Mount Pearl","NL",47.50513,-52.79476,2018-06-17 05:00:00,24,1,25
"12778",10401,"Mount Pearl","NL",47.50513,-52.79476,2018-06-17 06:00:00,25,1,26
"12779",10401,"Mount Pearl","NL",47.50513,-52.79476,2018-06-17 07:00:00,23,2,25
"12780",10401,"Mount Pearl","NL",47.50513,-52.79476,2018-06-17 08:00:00,25,1,26
"12781",10401,"Mount Pearl","NL",47.50513,-52.79476,2018-06-17 09:00:00,25,1,26
"12782",10401,"Mount Pearl","NL",47.50513,-52.79476,2018-06-17 10:00:00,26,1,27
"12783",10401,"Mount Pearl","NL",47.50513,-52.79476,2018-06-17 11:00:00,26,2,28
"12784",10401,"Mount Pearl","NL",47.50513,-52.79476,2018-06-17 12:00:00,26,1,27
"12785",10401,"Mount Pearl","NL",47.50513,-52.79476,2018-06-17 13:00:00,27,1,28
"12786",10401,"Mount Pearl","NL",47.50513,-52.79476,2018-06-17 14:00:00,27,1,28
"12787",10401,"Mount Pearl","NL",47.50513,-52.79476,2018-06-17 15:00:00,26,2,28
"12788",10401,"Mount Pearl","NL",47.50513,-52.79476,2018-06-17 16:00:00,24,4,28
"12789",10401,"Mount Pearl","NL",47.50513,-52.79476,2018-06-17 17:00:00,25,3,28
"12790",10401,"Mount Pearl","NL",47.50513,-52.79476,2018-06-17 18:00:00,26,1,27
"12791",10401,"Mount Pearl","NL",47.50513,-52.79476,2018-06-17 19:00:00,25,2,27
"12792",10401,"Mount Pearl","NL",47.50513,-52.79476,2018-06-17 20:00:00,23,3,26
"12793",10401,"Mount Pearl","NL",47.50513,-52.79476,2018-06-17 21:00:00,23,3,26
"12794",10401,"Mount Pearl","NL",47.50513,-52.79476,2018-06-17 22:00:00,21,3,24
"12795",10401,"Mount Pearl","NL",47.50513,-52.79476,2018-06-17 23:00:00,21,4,25
"12796",10401,"Mount Pearl","NL",47.50513,-52.79476,2018-06-18 00:00:00,21,2,23
"12797",10401,"Mount Pearl","NL",47.50513,-52.79476,2018-06-18 01:00:00,20,2,22
"12798",10401,"Mount Pearl","NL",47.50513,-52.79476,2018-06-18 02:00:00,19,1,20
"12799",10401,"Mount Pearl","NL",47.50513,-52.79476,2018-06-18 03:00:00,17,2,19
"12800",10401,"Mount Pearl","NL",47.50513,-52.79476,2018-06-18 04:00:00,14,4,18
"12801",10401,"Mount Pearl","NL",47.50513,-52.79476,2018-06-18 05:00:00,13,4,17
"12802",10401,"Mount Pearl","NL",47.50513,-52.79476,2018-06-18 06:00:00,10,3,13
"12803",10401,"Mount Pearl","NL",47.50513,-52.79476,2018-06-18 07:00:00,8,4,12
"12804",10401,"Mount Pearl","NL",47.50513,-52.79476,2018-06-18 08:00:00,13,3,16
"12805",10401,"Mount Pearl","NL",47.50513,-52.79476,2018-06-18 09:00:00,17,1,18
"12806",10401,"Mount Pearl","NL",47.50513,-52.79476,2018-06-18 10:00:00,21,1,22
"12807",10401,"Mount Pearl","NL",47.50513,-52.79476,2018-06-18 11:00:00,21,1,22
"12808",10401,"Mount Pearl","NL",47.50513,-52.79476,2018-06-18 12:00:00,21,0,21
"12809",10401,"Mount Pearl","NL",47.50513,-52.79476,2018-06-18 13:00:00,23,0,23
"12810",10401,"Mount Pearl","NL",47.50513,-52.79476,2018-06-18 14:00:00,25,0,25
"12811",10401,"Mount Pearl","NL",47.50513,-52.79476,2018-06-18 15:00:00,26,1,27
"12812",10401,"Mount Pearl","NL",47.50513,-52.79476,2018-06-18 16:00:00,24,1,25
"12813",10401,"Mount Pearl","NL",47.50513,-52.79476,2018-06-18 17:00:00,25,0,25
"12814",10401,"Mount Pearl","NL",47.50513,-52.79476,2018-06-18 18:00:00,25,0,25
"12815",10401,"Mount Pearl","NL",47.50513,-52.79476,2018-06-18 19:00:00,24,1,25
"12816",10401,"Mount Pearl","NL",47.50513,-52.79476,2018-06-18 20:00:00,24,1,25
"12817",10401,"Mount Pearl","NL",47.50513,-52.79476,2018-06-18 21:00:00,24,1,25
"12818",10401,"Mount Pearl","NL",47.50513,-52.79476,2018-06-18 22:00:00,21,0,21
"12819",10401,"Mount Pearl","NL",47.50513,-52.79476,2018-06-18 23:00:00,21,0,21
"12820",10401,"Mount Pearl","NL",47.50513,-52.79476,2018-06-19 00:00:00,23,1,24
"12821",10401,"Mount Pearl","NL",47.50513,-52.79476,2018-06-19 01:00:00,22,1,23
"12822",10401,"Mount Pearl","NL",47.50513,-52.79476,2018-06-19 02:00:00,22,0,22
"12823",10401,"Mount Pearl","NL",47.50513,-52.79476,2018-06-19 03:00:00,23,0,23
"12824",10401,"Mount Pearl","NL",47.50513,-52.79476,2018-06-19 04:00:00,24,0,24
"12825",10401,"Mount Pearl","NL",47.50513,-52.79476,2018-06-19 05:00:00,26,1,27
"12826",10401,"Mount Pearl","NL",47.50513,-52.79476,2018-06-19 06:00:00,26,0,26
"12827",10401,"Mount Pearl","NL",47.50513,-52.79476,2018-06-19 07:00:00,26,1,27
"12828",10401,"Mount Pearl","NL",47.50513,-52.79476,2018-06-19 08:00:00,29,1,30
"12829",10401,"Mount Pearl","NL",47.50513,-52.79476,2018-06-19 09:00:00,29,0,29
"12830",10401,"Mount Pearl","NL",47.50513,-52.79476,2018-06-19 10:00:00,31,0,31
"12831",10401,"Mount Pearl","NL",47.50513,-52.79476,2018-06-19 11:00:00,32,1,33
"12832",10401,"Mount Pearl","NL",47.50513,-52.79476,2018-06-19 12:00:00,33,0,33
"12833",10401,"Mount Pearl","NL",47.50513,-52.79476,2018-06-19 13:00:00,34,0,34
"12834",10401,"Mount Pearl","NL",47.50513,-52.79476,2018-06-19 14:00:00,33,1,34
"12835",10401,"Mount Pearl","NL",47.50513,-52.79476,2018-06-19 15:00:00,32,0,32
"12836",10401,"Mount Pearl","NL",47.50513,-52.79476,2018-06-19 16:00:00,33,0,33
"12837",10401,"Mount Pearl","NL",47.50513,-52.79476,2018-06-19 17:00:00,35,0,35
"12838",10401,"Mount Pearl","NL",47.50513,-52.79476,2018-06-19 18:00:00,36,0,36
"12839",10401,"Mount Pearl","NL",47.50513,-52.79476,2018-06-19 19:00:00,33,1,34
"12840",10401,"Mount Pearl","NL",47.50513,-52.79476,2018-06-19 20:00:00,33,0,33
"12841",10401,"Mount Pearl","NL",47.50513,-52.79476,2018-06-19 21:00:00,33,1,34
"12842",10401,"Mount Pearl","NL",47.50513,-52.79476,2018-06-19 22:00:00,32,1,33
"12843",10401,"Mount Pearl","NL",47.50513,-52.79476,2018-06-19 23:00:00,31,1,32
"12844",10401,"Mount Pearl","NL",47.50513,-52.79476,2018-06-20 00:00:00,30,0,30
"12845",10401,"Mount Pearl","NL",47.50513,-52.79476,2018-06-20 01:00:00,30,0,30
"12846",10401,"Mount Pearl","NL",47.50513,-52.79476,2018-06-20 02:00:00,28,1,29
"12847",10401,"Mount Pearl","NL",47.50513,-52.79476,2018-06-20 03:00:00,26,0,26
"12848",10401,"Mount Pearl","NL",47.50513,-52.79476,2018-06-20 04:00:00,25,1,26
"12849",10401,"Mount Pearl","NL",47.50513,-52.79476,2018-06-20 05:00:00,25,1,26
"12850",10401,"Mount Pearl","NL",47.50513,-52.79476,2018-06-20 06:00:00,22,2,24
"12851",10401,"Mount Pearl","NL",47.50513,-52.79476,2018-06-20 07:00:00,20,3,23
"12852",10401,"Mount Pearl","NL",47.50513,-52.79476,2018-06-20 08:00:00,18,4,22
"12853",10401,"Mount Pearl","NL",47.50513,-52.79476,2018-06-20 09:00:00,18,3,21
"12854",10401,"Mount Pearl","NL",47.50513,-52.79476,2018-06-20 10:00:00,18,3,21
"12855",10401,"Mount Pearl","NL",47.50513,-52.79476,2018-06-20 11:00:00,18,2,20
"12856",10401,"Mount Pearl","NL",47.50513,-52.79476,2018-06-20 12:00:00,20,1,21
"12857",10401,"Mount Pearl","NL",47.50513,-52.79476,2018-06-20 13:00:00,22,1,23
"12858",10401,"Mount Pearl","NL",47.50513,-52.79476,2018-06-20 14:00:00,25,1,26
"12859",10401,"Mount Pearl","NL",47.50513,-52.79476,2018-06-20 15:00:00,26,1,27
"12860",10401,"Mount Pearl","NL",47.50513,-52.79476,2018-06-20 16:00:00,27,1,28
"12861",10401,"Mount Pearl","NL",47.50513,-52.79476,2018-06-20 17:00:00,26,1,27
"12862",10401,"Mount Pearl","NL",47.50513,-52.79476,2018-06-20 18:00:00,22,1,23
"12863",10401,"Mount Pearl","NL",47.50513,-52.79476,2018-06-20 19:00:00,26,0,26
"12864",10401,"Mount Pearl","NL",47.50513,-52.79476,2018-06-20 20:00:00,21,1,22
"12865",10401,"Mount Pearl","NL",47.50513,-52.79476,2018-06-20 21:00:00,19,1,20
"12866",10401,"Mount Pearl","NL",47.50513,-52.79476,2018-06-20 22:00:00,17,0,17
"12867",10401,"Mount Pearl","NL",47.50513,-52.79476,2018-06-20 23:00:00,21,1,22
"12868",10401,"Mount Pearl","NL",47.50513,-52.79476,2018-06-21 00:00:00,24,0,24
"12869",10401,"Mount Pearl","NL",47.50513,-52.79476,2018-06-21 01:00:00,22,0,22
"12870",10401,"Mount Pearl","NL",47.50513,-52.79476,2018-06-21 02:00:00,21,0,21
"12871",10401,"Mount Pearl","NL",47.50513,-52.79476,2018-06-21 03:00:00,17,1,18
"12872",10401,"Mount Pearl","NL",47.50513,-52.79476,2018-06-21 04:00:00,15,0,15
"12873",10401,"Mount Pearl","NL",47.50513,-52.79476,2018-06-21 05:00:00,18,0,18
"12874",10401,"Mount Pearl","NL",47.50513,-52.79476,2018-06-21 06:00:00,19,0,19
"12875",10401,"Mount Pearl","NL",47.50513,-52.79476,2018-06-21 07:00:00,20,0,20
"12876",10401,"Mount Pearl","NL",47.50513,-52.79476,2018-06-21 08:00:00,22,1,23
"12877",10401,"Mount Pearl","NL",47.50513,-52.79476,2018-06-21 09:00:00,25,1,26
"12878",10401,"Mount Pearl","NL",47.50513,-52.79476,2018-06-21 10:00:00,27,0,27
"12879",10401,"Mount Pearl","NL",47.50513,-52.79476,2018-06-21 11:00:00,30,0,30
"12880",10401,"Mount Pearl","NL",47.50513,-52.79476,2018-06-21 12:00:00,33,1,34
"12881",10401,"Mount Pearl","NL",47.50513,-52.79476,2018-06-21 13:00:00,33,1,34
"12882",10401,"Mount Pearl","NL",47.50513,-52.79476,2018-06-21 14:00:00,33,1,34
"12883",10401,"Mount Pearl","NL",47.50513,-52.79476,2018-06-21 15:00:00,32,1,33
"12884",10401,"Mount Pearl","NL",47.50513,-52.79476,2018-06-21 16:00:00,33,1,34
"12885",10401,"Mount Pearl","NL",47.50513,-52.79476,2018-06-21 17:00:00,32,1,33
"12886",10401,"Mount Pearl","NL",47.50513,-52.79476,2018-06-21 18:00:00,32,1,33
"12887",10401,"Mount Pearl","NL",47.50513,-52.79476,2018-06-21 19:00:00,32,1,33
"12888",10401,"Mount Pearl","NL",47.50513,-52.79476,2018-06-21 20:00:00,30,1,31
"12889",10401,"Mount Pearl","NL",47.50513,-52.79476,2018-06-21 21:00:00,30,1,31
"12890",10401,"Mount Pearl","NL",47.50513,-52.79476,2018-06-21 22:00:00,27,1,28
"12891",10401,"Mount Pearl","NL",47.50513,-52.79476,2018-06-21 23:00:00,25,1,26
"12892",10401,"Mount Pearl","NL",47.50513,-52.79476,2018-06-22 00:00:00,26,1,27
"12893",10401,"Mount Pearl","NL",47.50513,-52.79476,2018-06-22 01:00:00,25,1,26
"12894",10401,"Mount Pearl","NL",47.50513,-52.79476,2018-06-22 02:00:00,24,1,25
"12895",10401,"Mount Pearl","NL",47.50513,-52.79476,2018-06-22 03:00:00,23,1,24
"12896",10401,"Mount Pearl","NL",47.50513,-52.79476,2018-06-22 04:00:00,25,1,26
"12897",10401,"Mount Pearl","NL",47.50513,-52.79476,2018-06-22 05:00:00,26,1,27
"12898",10401,"Mount Pearl","NL",47.50513,-52.79476,2018-06-22 06:00:00,24,2,26
"12899",10401,"Mount Pearl","NL",47.50513,-52.79476,2018-06-22 07:00:00,20,4,24
"12900",10401,"Mount Pearl","NL",47.50513,-52.79476,2018-06-22 08:00:00,21,3,24
"12901",10401,"Mount Pearl","NL",47.50513,-52.79476,2018-06-22 09:00:00,20,2,22
"12902",10401,"Mount Pearl","NL",47.50513,-52.79476,2018-06-22 10:00:00,20,2,22
"12903",10401,"Mount Pearl","NL",47.50513,-52.79476,2018-06-22 11:00:00,20,3,23
"12904",10401,"Mount Pearl","NL",47.50513,-52.79476,2018-06-22 12:00:00,20,1,21
"12905",10401,"Mount Pearl","NL",47.50513,-52.79476,2018-06-22 13:00:00,19,4,23
"12906",10401,"Mount Pearl","NL",47.50513,-52.79476,2018-06-22 14:00:00,18,3,21
"12907",10401,"Mount Pearl","NL",47.50513,-52.79476,2018-06-22 15:00:00,17,3,20
"12908",10401,"Mount Pearl","NL",47.50513,-52.79476,2018-06-22 16:00:00,16,3,19
"12909",10401,"Mount Pearl","NL",47.50513,-52.79476,2018-06-22 17:00:00,18,2,20
"12910",10401,"Mount Pearl","NL",47.50513,-52.79476,2018-06-22 18:00:00,17,4,21
"12911",10401,"Mount Pearl","NL",47.50513,-52.79476,2018-06-22 19:00:00,16,5,21
"12912",10401,"Mount Pearl","NL",47.50513,-52.79476,2018-06-22 20:00:00,16,1,17
"12913",10401,"Mount Pearl","NL",47.50513,-52.79476,2018-06-22 21:00:00,14,2,16
"12914",10401,"Mount Pearl","NL",47.50513,-52.79476,2018-06-22 22:00:00,12,2,14
"12915",10401,"Mount Pearl","NL",47.50513,-52.79476,2018-06-22 23:00:00,14,1,15
"12916",10401,"Mount Pearl","NL",47.50513,-52.79476,2018-06-23 00:00:00,14,1,15
"12917",10401,"Mount Pearl","NL",47.50513,-52.79476,2018-06-23 01:00:00,15,0,15
"12918",10401,"Mount Pearl","NL",47.50513,-52.79476,2018-06-23 02:00:00,12,0,12
"12919",10401,"Mount Pearl","NL",47.50513,-52.79476,2018-06-23 03:00:00,10,1,11
"12920",10401,"Mount Pearl","NL",47.50513,-52.79476,2018-06-23 04:00:00,18,1,19
"12921",10401,"Mount Pearl","NL",47.50513,-52.79476,2018-06-23 05:00:00,19,1,20
"12922",10401,"Mount Pearl","NL",47.50513,-52.79476,2018-06-23 06:00:00,20,1,21
"12923",10401,"Mount Pearl","NL",47.50513,-52.79476,2018-06-23 07:00:00,20,1,21
"12924",10401,"Mount Pearl","NL",47.50513,-52.79476,2018-06-23 08:00:00,24,1,25
"12925",10401,"Mount Pearl","NL",47.50513,-52.79476,2018-06-23 09:00:00,25,0,25
"12926",10401,"Mount Pearl","NL",47.50513,-52.79476,2018-06-23 10:00:00,27,1,28
"12927",10401,"Mount Pearl","NL",47.50513,-52.79476,2018-06-23 11:00:00,27,1,28
"12928",10401,"Mount Pearl","NL",47.50513,-52.79476,2018-06-23 12:00:00,29,1,30
"12929",10401,"Mount Pearl","NL",47.50513,-52.79476,2018-06-23 13:00:00,31,1,32
"12930",10401,"Mount Pearl","NL",47.50513,-52.79476,2018-06-23 14:00:00,31,1,32
"12931",10401,"Mount Pearl","NL",47.50513,-52.79476,2018-06-23 15:00:00,30,0,30
"12932",10401,"Mount Pearl","NL",47.50513,-52.79476,2018-06-23 16:00:00,31,1,32
"12933",10401,"Mount Pearl","NL",47.50513,-52.79476,2018-06-23 17:00:00,31,0,31
"12934",10401,"Mount Pearl","NL",47.50513,-52.79476,2018-06-23 18:00:00,31,1,32
"12935",10401,"Mount Pearl","NL",47.50513,-52.79476,2018-06-23 19:00:00,31,1,32
"12936",10401,"Mount Pearl","NL",47.50513,-52.79476,2018-06-23 20:00:00,31,1,32
"12937",10401,"Mount Pearl","NL",47.50513,-52.79476,2018-06-23 21:00:00,31,0,31
"12938",10401,"Mount Pearl","NL",47.50513,-52.79476,2018-06-23 22:00:00,31,1,32
"12939",10401,"Mount Pearl","NL",47.50513,-52.79476,2018-06-23 23:00:00,31,0,31
"12940",10401,"Mount Pearl","NL",47.50513,-52.79476,2018-06-24 00:00:00,28,0,28
"12941",10401,"Mount Pearl","NL",47.50513,-52.79476,2018-06-24 01:00:00,26,1,27
"12942",10401,"Mount Pearl","NL",47.50513,-52.79476,2018-06-24 02:00:00,25,0,25
"12943",10401,"Mount Pearl","NL",47.50513,-52.79476,2018-06-24 03:00:00,24,1,25
"12944",10401,"Mount Pearl","NL",47.50513,-52.79476,2018-06-24 04:00:00,22,0,22
"12945",10401,"Mount Pearl","NL",47.50513,-52.79476,2018-06-24 05:00:00,23,0,23
"12946",10401,"Mount Pearl","NL",47.50513,-52.79476,2018-06-24 06:00:00,22,0,22
"12947",10401,"Mount Pearl","NL",47.50513,-52.79476,2018-06-24 07:00:00,23,0,23
"12948",10401,"Mount Pearl","NL",47.50513,-52.79476,2018-06-24 08:00:00,23,1,24
"12949",10401,"Mount Pearl","NL",47.50513,-52.79476,2018-06-24 09:00:00,24,1,25
"12950",10401,"Mount Pearl","NL",47.50513,-52.79476,2018-06-24 10:00:00,25,1,26
"12951",10401,"Mount Pearl","NL",47.50513,-52.79476,2018-06-24 11:00:00,24,1,25
"12952",10401,"Mount Pearl","NL",47.50513,-52.79476,2018-06-24 12:00:00,24,1,25
"12953",10401,"Mount Pearl","NL",47.50513,-52.79476,2018-06-24 13:00:00,19,1,20
"12954",10401,"Mount Pearl","NL",47.50513,-52.79476,2018-06-24 14:00:00,10,6,16
"12955",10401,"Mount Pearl","NL",47.50513,-52.79476,2018-06-24 15:00:00,12,7,19
"12956",10401,"Mount Pearl","NL",47.50513,-52.79476,2018-06-24 16:00:00,18,4,22
"12957",10401,"Mount Pearl","NL",47.50513,-52.79476,2018-06-24 17:00:00,17,7,24
"12958",10401,"Mount Pearl","NL",47.50513,-52.79476,2018-06-24 18:00:00,33,3,36
"12959",10401,"Mount Pearl","NL",47.50513,-52.79476,2018-06-24 19:00:00,27,5,32
"12960",10401,"Mount Pearl","NL",47.50513,-52.79476,2018-06-24 20:00:00,27,4,31
"12961",10401,"Mount Pearl","NL",47.50513,-52.79476,2018-06-24 21:00:00,25,4,29
"12962",10401,"Mount Pearl","NL",47.50513,-52.79476,2018-06-24 22:00:00,28,2,30
"12963",10401,"Mount Pearl","NL",47.50513,-52.79476,2018-06-24 23:00:00,27,3,30
"12964",10401,"Mount Pearl","NL",47.50513,-52.79476,2018-06-25 00:00:00,29,2,31
"12965",10401,"Mount Pearl","NL",47.50513,-52.79476,2018-06-25 01:00:00,30,1,31
"12966",10401,"Mount Pearl","NL",47.50513,-52.79476,2018-06-25 02:00:00,20,1,21
"12967",10401,"Mount Pearl","NL",47.50513,-52.79476,2018-06-25 03:00:00,20,0,20
"12968",10401,"Mount Pearl","NL",47.50513,-52.79476,2018-06-25 04:00:00,21,0,21
"12969",10401,"Mount Pearl","NL",47.50513,-52.79476,2018-06-25 05:00:00,20,0,20
"12970",10401,"Mount Pearl","NL",47.50513,-52.79476,2018-06-25 06:00:00,20,0,20
"12971",10401,"Mount Pearl","NL",47.50513,-52.79476,2018-06-25 07:00:00,21,1,22
"12972",10401,"Mount Pearl","NL",47.50513,-52.79476,2018-06-25 08:00:00,20,1,21
"12973",10401,"Mount Pearl","NL",47.50513,-52.79476,2018-06-25 09:00:00,21,1,22
"12974",10401,"Mount Pearl","NL",47.50513,-52.79476,2018-06-25 10:00:00,22,1,23
"12975",10401,"Mount Pearl","NL",47.50513,-52.79476,2018-06-25 11:00:00,22,1,23
"12976",10401,"Mount Pearl","NL",47.50513,-52.79476,2018-06-25 12:00:00,22,1,23
"12977",10401,"Mount Pearl","NL",47.50513,-52.79476,2018-06-25 13:00:00,21,2,23
"12978",10401,"Mount Pearl","NL",47.50513,-52.79476,2018-06-25 14:00:00,22,2,24
"12979",10401,"Mount Pearl","NL",47.50513,-52.79476,2018-06-25 15:00:00,20,2,22
"12980",10401,"Mount Pearl","NL",47.50513,-52.79476,2018-06-25 16:00:00,19,2,21
"12981",10401,"Mount Pearl","NL",47.50513,-52.79476,2018-06-25 17:00:00,18,3,21
"12982",10401,"Mount Pearl","NL",47.50513,-52.79476,2018-06-25 18:00:00,20,2,22
"12983",10401,"Mount Pearl","NL",47.50513,-52.79476,2018-06-25 19:00:00,18,2,20
"12984",10401,"Mount Pearl","NL",47.50513,-52.79476,2018-06-25 20:00:00,18,2,20
"12985",10401,"Mount Pearl","NL",47.50513,-52.79476,2018-06-25 21:00:00,19,1,20
"12986",10401,"Mount Pearl","NL",47.50513,-52.79476,2018-06-25 22:00:00,19,2,21
"12987",10401,"Mount Pearl","NL",47.50513,-52.79476,2018-06-25 23:00:00,20,1,21
"12988",10401,"Mount Pearl","NL",47.50513,-52.79476,2018-06-26 00:00:00,21,0,21
"12989",10401,"Mount Pearl","NL",47.50513,-52.79476,2018-06-26 01:00:00,21,0,21
"12990",10401,"Mount Pearl","NL",47.50513,-52.79476,2018-06-26 02:00:00,22,0,22
"12991",10401,"Mount Pearl","NL",47.50513,-52.79476,2018-06-26 03:00:00,22,0,22
"12992",10401,"Mount Pearl","NL",47.50513,-52.79476,2018-06-26 04:00:00,23,0,23
"12993",10401,"Mount Pearl","NL",47.50513,-52.79476,2018-06-26 05:00:00,23,0,23
"12994",10401,"Mount Pearl","NL",47.50513,-52.79476,2018-06-26 06:00:00,23,0,23
"12995",10401,"Mount Pearl","NL",47.50513,-52.79476,2018-06-26 07:00:00,22,2,24
"12996",10401,"Mount Pearl","NL",47.50513,-52.79476,2018-06-26 08:00:00,24,1,25
"12997",10401,"Mount Pearl","NL",47.50513,-52.79476,2018-06-26 09:00:00,23,2,25
"12998",10401,"Mount Pearl","NL",47.50513,-52.79476,2018-06-26 10:00:00,25,2,27
"12999",10401,"Mount Pearl","NL",47.50513,-52.79476,2018-06-26 11:00:00,26,1,27
"13000",10401,"Mount Pearl","NL",47.50513,-52.79476,2018-06-26 12:00:00,23,2,25
"13001",10401,"Mount Pearl","NL",47.50513,-52.79476,2018-06-26 13:00:00,24,1,25
"13002",10401,"Mount Pearl","NL",47.50513,-52.79476,2018-06-26 14:00:00,25,1,26
"13003",10401,"Mount Pearl","NL",47.50513,-52.79476,2018-06-26 15:00:00,26,1,27
"13004",10401,"Mount Pearl","NL",47.50513,-52.79476,2018-06-26 16:00:00,26,1,27
"13005",10401,"Mount Pearl","NL",47.50513,-52.79476,2018-06-26 17:00:00,26,1,27
"13006",10401,"Mount Pearl","NL",47.50513,-52.79476,2018-06-26 18:00:00,25,1,26
"13007",10401,"Mount Pearl","NL",47.50513,-52.79476,2018-06-26 19:00:00,23,1,24
"13008",10401,"Mount Pearl","NL",47.50513,-52.79476,2018-06-26 20:00:00,19,2,21
"13009",10401,"Mount Pearl","NL",47.50513,-52.79476,2018-06-26 21:00:00,24,0,24
"13010",10401,"Mount Pearl","NL",47.50513,-52.79476,2018-06-26 22:00:00,27,1,28
"13011",10401,"Mount Pearl","NL",47.50513,-52.79476,2018-06-26 23:00:00,28,1,29
"13012",10401,"Mount Pearl","NL",47.50513,-52.79476,2018-06-27 00:00:00,26,1,27
"13013",10401,"Mount Pearl","NL",47.50513,-52.79476,2018-06-27 01:00:00,27,1,28
"13014",10401,"Mount Pearl","NL",47.50513,-52.79476,2018-06-27 02:00:00,27,0,27
"13015",10401,"Mount Pearl","NL",47.50513,-52.79476,2018-06-27 03:00:00,26,1,27
"13016",10401,"Mount Pearl","NL",47.50513,-52.79476,2018-06-27 04:00:00,23,1,24
"13017",10401,"Mount Pearl","NL",47.50513,-52.79476,2018-06-27 05:00:00,20,1,21
"13018",10401,"Mount Pearl","NL",47.50513,-52.79476,2018-06-27 06:00:00,19,2,21
"13019",10401,"Mount Pearl","NL",47.50513,-52.79476,2018-06-27 07:00:00,16,2,18
"13020",10401,"Mount Pearl","NL",47.50513,-52.79476,2018-06-27 08:00:00,16,2,18
"13021",10401,"Mount Pearl","NL",47.50513,-52.79476,2018-06-27 09:00:00,17,2,19
"13022",10401,"Mount Pearl","NL",47.50513,-52.79476,2018-06-27 10:00:00,18,1,19
"13023",10401,"Mount Pearl","NL",47.50513,-52.79476,2018-06-27 11:00:00,19,1,20
"13024",10401,"Mount Pearl","NL",47.50513,-52.79476,2018-06-27 12:00:00,20,1,21
"13025",10401,"Mount Pearl","NL",47.50513,-52.79476,2018-06-27 13:00:00,20,1,21
"13026",10401,"Mount Pearl","NL",47.50513,-52.79476,2018-06-27 14:00:00,20,1,21
"13027",10401,"Mount Pearl","NL",47.50513,-52.79476,2018-06-27 15:00:00,23,1,24
"13028",10401,"Mount Pearl","NL",47.50513,-52.79476,2018-06-27 16:00:00,24,1,25
"13029",10401,"Mount Pearl","NL",47.50513,-52.79476,2018-06-27 17:00:00,26,1,27
"13030",10401,"Mount Pearl","NL",47.50513,-52.79476,2018-06-27 18:00:00,25,1,26
"13031",10401,"Mount Pearl","NL",47.50513,-52.79476,2018-06-27 19:00:00,25,2,27
"13032",10401,"Mount Pearl","NL",47.50513,-52.79476,2018-06-27 20:00:00,26,1,27
"13033",10401,"Mount Pearl","NL",47.50513,-52.79476,2018-06-27 21:00:00,28,1,29
"13034",10401,"Mount Pearl","NL",47.50513,-52.79476,2018-06-27 22:00:00,28,1,29
"13035",10401,"Mount Pearl","NL",47.50513,-52.79476,2018-06-27 23:00:00,30,1,31
"13036",10401,"Mount Pearl","NL",47.50513,-52.79476,2018-06-28 00:00:00,31,2,33
"13037",10401,"Mount Pearl","NL",47.50513,-52.79476,2018-06-28 01:00:00,31,1,32
"13038",10401,"Mount Pearl","NL",47.50513,-52.79476,2018-06-28 02:00:00,30,1,31
"13039",10401,"Mount Pearl","NL",47.50513,-52.79476,2018-06-28 03:00:00,24,1,25
"13040",10401,"Mount Pearl","NL",47.50513,-52.79476,2018-06-28 04:00:00,22,2,24
"13041",10401,"Mount Pearl","NL",47.50513,-52.79476,2018-06-28 05:00:00,24,2,26
"13042",10401,"Mount Pearl","NL",47.50513,-52.79476,2018-06-28 06:00:00,21,3,24
"13043",10401,"Mount Pearl","NL",47.50513,-52.79476,2018-06-28 07:00:00,20,3,23
"13044",10401,"Mount Pearl","NL",47.50513,-52.79476,2018-06-28 08:00:00,20,3,23
"13045",10401,"Mount Pearl","NL",47.50513,-52.79476,2018-06-28 09:00:00,21,1,22
"13046",10401,"Mount Pearl","NL",47.50513,-52.79476,2018-06-28 10:00:00,22,1,23
"13047",10401,"Mount Pearl","NL",47.50513,-52.79476,2018-06-28 11:00:00,21,2,23
"13048",10401,"Mount Pearl","NL",47.50513,-52.79476,2018-06-28 12:00:00,23,1,24
"13049",10401,"Mount Pearl","NL",47.50513,-52.79476,2018-06-28 13:00:00,29,1,30
"13050",10401,"Mount Pearl","NL",47.50513,-52.79476,2018-06-28 14:00:00,34,1,35
"13051",10401,"Mount Pearl","NL",47.50513,-52.79476,2018-06-28 15:00:00,43,1,44
"13052",10401,"Mount Pearl","NL",47.50513,-52.79476,2018-06-28 16:00:00,42,2,44
"13053",10401,"Mount Pearl","NL",47.50513,-52.79476,2018-06-28 17:00:00,41,1,42
"13054",10401,"Mount Pearl","NL",47.50513,-52.79476,2018-06-28 18:00:00,32,1,33
"13055",10401,"Mount Pearl","NL",47.50513,-52.79476,2018-06-28 19:00:00,31,1,32
"13056",10401,"Mount Pearl","NL",47.50513,-52.79476,2018-06-28 20:00:00,28,1,29
"13057",10401,"Mount Pearl","NL",47.50513,-52.79476,2018-06-28 21:00:00,27,0,27
"13058",10401,"Mount Pearl","NL",47.50513,-52.79476,2018-06-28 22:00:00,26,1,27
"13059",10401,"Mount Pearl","NL",47.50513,-52.79476,2018-06-28 23:00:00,27,1,28
"13060",10401,"Mount Pearl","NL",47.50513,-52.79476,2018-06-29 00:00:00,27,1,28
"13061",10401,"Mount Pearl","NL",47.50513,-52.79476,2018-06-29 01:00:00,27,1,28
"13062",10401,"Mount Pearl","NL",47.50513,-52.79476,2018-06-29 02:00:00,25,0,25
"13063",10401,"Mount Pearl","NL",47.50513,-52.79476,2018-06-29 03:00:00,25,1,26
"13064",10401,"Mount Pearl","NL",47.50513,-52.79476,2018-06-29 04:00:00,24,1,25
"13065",10401,"Mount Pearl","NL",47.50513,-52.79476,2018-06-29 05:00:00,25,1,26
"13066",10401,"Mount Pearl","NL",47.50513,-52.79476,2018-06-29 06:00:00,24,1,25
"13067",10401,"Mount Pearl","NL",47.50513,-52.79476,2018-06-29 07:00:00,23,1,24
"13068",10401,"Mount Pearl","NL",47.50513,-52.79476,2018-06-29 08:00:00,23,1,24
"13069",10401,"Mount Pearl","NL",47.50513,-52.79476,2018-06-29 09:00:00,24,1,25
"13070",10401,"Mount Pearl","NL",47.50513,-52.79476,2018-06-29 10:00:00,24,1,25
"13071",10401,"Mount Pearl","NL",47.50513,-52.79476,2018-06-29 11:00:00,25,1,26
"13072",10401,"Mount Pearl","NL",47.50513,-52.79476,2018-06-29 12:00:00,24,1,25
"13073",10401,"Mount Pearl","NL",47.50513,-52.79476,2018-06-29 13:00:00,26,2,28
"13074",10401,"Mount Pearl","NL",47.50513,-52.79476,2018-06-29 14:00:00,26,1,27
"13075",10401,"Mount Pearl","NL",47.50513,-52.79476,2018-06-29 15:00:00,27,2,29
"13076",10401,"Mount Pearl","NL",47.50513,-52.79476,2018-06-29 16:00:00,29,2,31
"13077",10401,"Mount Pearl","NL",47.50513,-52.79476,2018-06-29 17:00:00,29,1,30
"13078",10401,"Mount Pearl","NL",47.50513,-52.79476,2018-06-29 18:00:00,29,1,30
"13079",10401,"Mount Pearl","NL",47.50513,-52.79476,2018-06-29 19:00:00,28,1,29
"13080",10401,"Mount Pearl","NL",47.50513,-52.79476,2018-06-29 20:00:00,27,1,28
"13081",10401,"Mount Pearl","NL",47.50513,-52.79476,2018-06-29 21:00:00,27,2,29
"13082",10401,"Mount Pearl","NL",47.50513,-52.79476,2018-06-29 22:00:00,27,1,28
"13083",10401,"Mount Pearl","NL",47.50513,-52.79476,2018-06-29 23:00:00,25,1,26
"13084",10401,"Mount Pearl","NL",47.50513,-52.79476,2018-06-30 00:00:00,23,1,24
"13085",10401,"Mount Pearl","NL",47.50513,-52.79476,2018-06-30 01:00:00,25,1,26
"13086",10401,"Mount Pearl","NL",47.50513,-52.79476,2018-06-30 02:00:00,25,1,26
"13087",10401,"Mount Pearl","NL",47.50513,-52.79476,2018-06-30 03:00:00,24,1,25
"13088",10401,"Mount Pearl","NL",47.50513,-52.79476,2018-06-30 04:00:00,25,1,26
"13089",10401,"Mount Pearl","NL",47.50513,-52.79476,2018-06-30 05:00:00,25,1,26
"13090",10401,"Mount Pearl","NL",47.50513,-52.79476,2018-06-30 06:00:00,22,1,23
"13091",10401,"Mount Pearl","NL",47.50513,-52.79476,2018-06-30 07:00:00,19,2,21
"13092",10401,"Mount Pearl","NL",47.50513,-52.79476,2018-06-30 08:00:00,19,2,21
"13093",10401,"Mount Pearl","NL",47.50513,-52.79476,2018-06-30 09:00:00,17,1,18
"13094",10401,"Mount Pearl","NL",47.50513,-52.79476,2018-06-30 10:00:00,15,1,16
"13095",10401,"Mount Pearl","NL",47.50513,-52.79476,2018-06-30 11:00:00,12,1,13
"13096",10401,"Mount Pearl","NL",47.50513,-52.79476,2018-06-30 12:00:00,12,1,13
"13097",10401,"Mount Pearl","NL",47.50513,-52.79476,2018-06-30 13:00:00,12,1,13
"13098",10401,"Mount Pearl","NL",47.50513,-52.79476,2018-06-30 14:00:00,11,2,13
"13099",10401,"Mount Pearl","NL",47.50513,-52.79476,2018-06-30 15:00:00,14,1,15
"13100",10401,"Mount Pearl","NL",47.50513,-52.79476,2018-06-30 16:00:00,16,2,18
"13101",10401,"Mount Pearl","NL",47.50513,-52.79476,2018-06-30 17:00:00,16,1,17
"13102",10401,"Mount Pearl","NL",47.50513,-52.79476,2018-06-30 18:00:00,16,1,17
"13103",10401,"Mount Pearl","NL",47.50513,-52.79476,2018-06-30 19:00:00,20,2,22
"13104",10401,"Mount Pearl","NL",47.50513,-52.79476,2018-06-30 20:00:00,22,1,23
"13105",10401,"Mount Pearl","NL",47.50513,-52.79476,2018-06-30 21:00:00,24,2,26
"13106",10401,"Mount Pearl","NL",47.50513,-52.79476,2018-06-30 22:00:00,23,1,24
"13107",10401,"Mount Pearl","NL",47.50513,-52.79476,2018-06-30 23:00:00,23,2,25
"13108",10401,"Mount Pearl","NL",47.50513,-52.79476,2018-07-01 00:00:00,21,1,22
"13109",10401,"Mount Pearl","NL",47.50513,-52.79476,2018-07-01 01:00:00,21,2,23
"13110",10401,"Mount Pearl","NL",47.50513,-52.79476,2018-07-01 02:00:00,17,2,19
"13111",10401,"Mount Pearl","NL",47.50513,-52.79476,2018-07-01 03:00:00,15,1,16
"13112",10401,"Mount Pearl","NL",47.50513,-52.79476,2018-07-01 04:00:00,14,2,16
"13113",10401,"Mount Pearl","NL",47.50513,-52.79476,2018-07-01 05:00:00,16,1,17
"13114",10401,"Mount Pearl","NL",47.50513,-52.79476,2018-07-01 06:00:00,13,2,15
"13115",10401,"Mount Pearl","NL",47.50513,-52.79476,2018-07-01 07:00:00,13,2,15
"13116",10401,"Mount Pearl","NL",47.50513,-52.79476,2018-07-01 08:00:00,11,2,13
"13117",10401,"Mount Pearl","NL",47.50513,-52.79476,2018-07-01 09:00:00,10,3,13
"13118",10401,"Mount Pearl","NL",47.50513,-52.79476,2018-07-01 10:00:00,13,2,15
"13119",10401,"Mount Pearl","NL",47.50513,-52.79476,2018-07-01 11:00:00,15,3,18
"13120",10401,"Mount Pearl","NL",47.50513,-52.79476,2018-07-01 12:00:00,16,2,18
"13121",10401,"Mount Pearl","NL",47.50513,-52.79476,2018-07-01 13:00:00,13,2,15
"13122",10401,"Mount Pearl","NL",47.50513,-52.79476,2018-07-01 14:00:00,13,1,14
"13123",10401,"Mount Pearl","NL",47.50513,-52.79476,2018-07-01 15:00:00,12,1,13
"13124",10401,"Mount Pearl","NL",47.50513,-52.79476,2018-07-01 16:00:00,15,1,16
"13125",10401,"Mount Pearl","NL",47.50513,-52.79476,2018-07-01 17:00:00,13,1,14
"13126",10401,"Mount Pearl","NL",47.50513,-52.79476,2018-07-01 18:00:00,12,1,13
"13127",10401,"Mount Pearl","NL",47.50513,-52.79476,2018-07-01 19:00:00,17,0,17
"13128",10401,"Mount Pearl","NL",47.50513,-52.79476,2018-07-01 20:00:00,19,1,20
"13129",10401,"Mount Pearl","NL",47.50513,-52.79476,2018-07-01 21:00:00,17,0,17
"13130",10401,"Mount Pearl","NL",47.50513,-52.79476,2018-07-01 22:00:00,14,0,14
"13131",10401,"Mount Pearl","NL",47.50513,-52.79476,2018-07-01 23:00:00,3,9,12
"13132",10401,"Mount Pearl","NL",47.50513,-52.79476,2018-07-02 00:00:00,5,8,13
"13133",10401,"Mount Pearl","NL",47.50513,-52.79476,2018-07-02 01:00:00,6,5,11
"13134",10401,"Mount Pearl","NL",47.50513,-52.79476,2018-07-02 02:00:00,6,4,10
"13135",10401,"Mount Pearl","NL",47.50513,-52.79476,2018-07-02 03:00:00,10,2,12
"13136",10401,"Mount Pearl","NL",47.50513,-52.79476,2018-07-02 04:00:00,9,5,14
"13137",10401,"Mount Pearl","NL",47.50513,-52.79476,2018-07-02 05:00:00,10,3,13
"13138",10401,"Mount Pearl","NL",47.50513,-52.79476,2018-07-02 06:00:00,15,1,16
"13139",10401,"Mount Pearl","NL",47.50513,-52.79476,2018-07-02 07:00:00,15,1,16
"13140",10401,"Mount Pearl","NL",47.50513,-52.79476,2018-07-02 08:00:00,15,1,16
"13141",10401,"Mount Pearl","NL",47.50513,-52.79476,2018-07-02 09:00:00,14,2,16
"13142",10401,"Mount Pearl","NL",47.50513,-52.79476,2018-07-02 10:00:00,15,2,17
"13143",10401,"Mount Pearl","NL",47.50513,-52.79476,2018-07-02 11:00:00,16,2,18
"13144",10401,"Mount Pearl","NL",47.50513,-52.79476,2018-07-02 12:00:00,19,2,21
"13145",10401,"Mount Pearl","NL",47.50513,-52.79476,2018-07-02 13:00:00,20,2,22
"13146",10401,"Mount Pearl","NL",47.50513,-52.79476,2018-07-02 14:00:00,16,2,18
"13147",10401,"Mount Pearl","NL",47.50513,-52.79476,2018-07-02 15:00:00,18,1,19
"13148",10401,"Mount Pearl","NL",47.50513,-52.79476,2018-07-02 16:00:00,18,1,19
"13149",10401,"Mount Pearl","NL",47.50513,-52.79476,2018-07-02 17:00:00,19,1,20
"13150",10401,"Mount Pearl","NL",47.50513,-52.79476,2018-07-02 18:00:00,20,3,23
"13151",10401,"Mount Pearl","NL",47.50513,-52.79476,2018-07-02 19:00:00,25,2,27
"13152",10401,"Mount Pearl","NL",47.50513,-52.79476,2018-07-02 20:00:00,27,2,29
"13153",10401,"Mount Pearl","NL",47.50513,-52.79476,2018-07-02 21:00:00,27,1,28
"13154",10401,"Mount Pearl","NL",47.50513,-52.79476,2018-07-02 22:00:00,27,1,28
"13155",10401,"Mount Pearl","NL",47.50513,-52.79476,2018-07-02 23:00:00,24,1,25
"13156",10401,"Mount Pearl","NL",47.50513,-52.79476,2018-07-03 00:00:00,27,0,27
"13157",10401,"Mount Pearl","NL",47.50513,-52.79476,2018-07-03 01:00:00,28,1,29
"13158",10401,"Mount Pearl","NL",47.50513,-52.79476,2018-07-03 02:00:00,26,0,26
"13159",10401,"Mount Pearl","NL",47.50513,-52.79476,2018-07-03 03:00:00,22,1,23
"13160",10401,"Mount Pearl","NL",47.50513,-52.79476,2018-07-03 04:00:00,17,1,18
"13161",10401,"Mount Pearl","NL",47.50513,-52.79476,2018-07-03 05:00:00,14,1,15
"13162",10401,"Mount Pearl","NL",47.50513,-52.79476,2018-07-03 06:00:00,11,1,12
"13163",10401,"Mount Pearl","NL",47.50513,-52.79476,2018-07-03 07:00:00,11,2,13
"13164",10401,"Mount Pearl","NL",47.50513,-52.79476,2018-07-03 08:00:00,8,2,10
"13165",10401,"Mount Pearl","NL",47.50513,-52.79476,2018-07-03 09:00:00,12,2,14
"13166",10401,"Mount Pearl","NL",47.50513,-52.79476,2018-07-03 10:00:00,14,1,15
"13167",10401,"Mount Pearl","NL",47.50513,-52.79476,2018-07-03 11:00:00,17,0,17
"13168",10401,"Mount Pearl","NL",47.50513,-52.79476,2018-07-03 12:00:00,19,1,20
"13169",10401,"Mount Pearl","NL",47.50513,-52.79476,2018-07-03 13:00:00,21,2,23
"13170",10401,"Mount Pearl","NL",47.50513,-52.79476,2018-07-03 14:00:00,24,2,26
"13171",10401,"Mount Pearl","NL",47.50513,-52.79476,2018-07-03 15:00:00,24,2,26
"13172",10401,"Mount Pearl","NL",47.50513,-52.79476,2018-07-03 16:00:00,27,1,28
"13173",10401,"Mount Pearl","NL",47.50513,-52.79476,2018-07-03 17:00:00,27,3,30
"13174",10401,"Mount Pearl","NL",47.50513,-52.79476,2018-07-03 18:00:00,25,2,27
"13175",10401,"Mount Pearl","NL",47.50513,-52.79476,2018-07-03 19:00:00,22,2,24
"13176",10401,"Mount Pearl","NL",47.50513,-52.79476,2018-07-03 20:00:00,22,1,23
"13177",10401,"Mount Pearl","NL",47.50513,-52.79476,2018-07-03 21:00:00,23,2,25
"13178",10401,"Mount Pearl","NL",47.50513,-52.79476,2018-07-03 22:00:00,23,1,24
"13179",10401,"Mount Pearl","NL",47.50513,-52.79476,2018-07-03 23:00:00,21,1,22
"13180",10401,"Mount Pearl","NL",47.50513,-52.79476,2018-07-04 00:00:00,23,2,25
"13181",10401,"Mount Pearl","NL",47.50513,-52.79476,2018-07-04 01:00:00,26,1,27
"13182",10401,"Mount Pearl","NL",47.50513,-52.79476,2018-07-04 02:00:00,29,1,30
"13183",10401,"Mount Pearl","NL",47.50513,-52.79476,2018-07-04 03:00:00,29,1,30
"13184",10401,"Mount Pearl","NL",47.50513,-52.79476,2018-07-04 04:00:00,26,2,28
"13185",10401,"Mount Pearl","NL",47.50513,-52.79476,2018-07-04 05:00:00,26,1,27
"13186",10401,"Mount Pearl","NL",47.50513,-52.79476,2018-07-04 06:00:00,24,2,26
"13187",10401,"Mount Pearl","NL",47.50513,-52.79476,2018-07-04 07:00:00,23,2,25
"13188",10401,"Mount Pearl","NL",47.50513,-52.79476,2018-07-04 08:00:00,21,2,23
"13189",10401,"Mount Pearl","NL",47.50513,-52.79476,2018-07-04 09:00:00,20,2,22
"13190",10401,"Mount Pearl","NL",47.50513,-52.79476,2018-07-04 10:00:00,21,2,23
"13191",10401,"Mount Pearl","NL",47.50513,-52.79476,2018-07-04 11:00:00,22,2,24
"13192",10401,"Mount Pearl","NL",47.50513,-52.79476,2018-07-04 12:00:00,24,0,24
"13193",10401,"Mount Pearl","NL",47.50513,-52.79476,2018-07-04 13:00:00,27,1,28
"13194",10401,"Mount Pearl","NL",47.50513,-52.79476,2018-07-04 14:00:00,27,0,27
"13195",10401,"Mount Pearl","NL",47.50513,-52.79476,2018-07-04 15:00:00,28,0,28
"13196",10401,"Mount Pearl","NL",47.50513,-52.79476,2018-07-04 16:00:00,28,1,29
"13197",10401,"Mount Pearl","NL",47.50513,-52.79476,2018-07-04 17:00:00,27,1,28
"13198",10401,"Mount Pearl","NL",47.50513,-52.79476,2018-07-04 18:00:00,27,1,28
"13199",10401,"Mount Pearl","NL",47.50513,-52.79476,2018-07-04 19:00:00,28,2,30
"13200",10401,"Mount Pearl","NL",47.50513,-52.79476,2018-07-04 20:00:00,29,3,32
"13201",10401,"Mount Pearl","NL",47.50513,-52.79476,2018-07-04 21:00:00,28,3,31
"13202",10401,"Mount Pearl","NL",47.50513,-52.79476,2018-07-04 22:00:00,28,2,30
"13203",10401,"Mount Pearl","NL",47.50513,-52.79476,2018-07-04 23:00:00,27,2,29
"13204",10401,"Mount Pearl","NL",47.50513,-52.79476,2018-07-05 00:00:00,26,1,27
"13205",10401,"Mount Pearl","NL",47.50513,-52.79476,2018-07-05 01:00:00,24,1,25
"13206",10401,"Mount Pearl","NL",47.50513,-52.79476,2018-07-05 02:00:00,23,2,25
"13207",10401,"Mount Pearl","NL",47.50513,-52.79476,2018-07-05 03:00:00,22,1,23
"13208",10401,"Mount Pearl","NL",47.50513,-52.79476,2018-07-05 04:00:00,22,1,23
"13209",10401,"Mount Pearl","NL",47.50513,-52.79476,2018-07-05 05:00:00,21,1,22
"13210",10401,"Mount Pearl","NL",47.50513,-52.79476,2018-07-05 06:00:00,20,1,21
"13211",10401,"Mount Pearl","NL",47.50513,-52.79476,2018-07-05 07:00:00,20,1,21
"13212",10401,"Mount Pearl","NL",47.50513,-52.79476,2018-07-05 08:00:00,22,2,24
"13213",10401,"Mount Pearl","NL",47.50513,-52.79476,2018-07-05 09:00:00,22,0,22
"13214",10401,"Mount Pearl","NL",47.50513,-52.79476,2018-07-05 10:00:00,22,1,23
"13215",10401,"Mount Pearl","NL",47.50513,-52.79476,2018-07-05 11:00:00,24,0,24
"13216",10401,"Mount Pearl","NL",47.50513,-52.79476,2018-07-05 12:00:00,23,0,23
"13217",10401,"Mount Pearl","NL",47.50513,-52.79476,2018-07-05 13:00:00,25,0,25
"13218",10401,"Mount Pearl","NL",47.50513,-52.79476,2018-07-05 14:00:00,24,1,25
"13219",10401,"Mount Pearl","NL",47.50513,-52.79476,2018-07-05 15:00:00,25,0,25
"13220",10401,"Mount Pearl","NL",47.50513,-52.79476,2018-07-05 16:00:00,27,1,28
"13221",10401,"Mount Pearl","NL",47.50513,-52.79476,2018-07-05 17:00:00,25,1,26
"13222",10401,"Mount Pearl","NL",47.50513,-52.79476,2018-07-05 18:00:00,25,0,25
"13223",10401,"Mount Pearl","NL",47.50513,-52.79476,2018-07-05 19:00:00,26,0,26
"13224",10401,"Mount Pearl","NL",47.50513,-52.79476,2018-07-05 20:00:00,23,1,24
"13225",10401,"Mount Pearl","NL",47.50513,-52.79476,2018-07-05 21:00:00,17,3,20
"13226",10401,"Mount Pearl","NL",47.50513,-52.79476,2018-07-05 22:00:00,20,2,22
"13227",10401,"Mount Pearl","NL",47.50513,-52.79476,2018-07-05 23:00:00,24,1,25
"13228",10401,"Mount Pearl","NL",47.50513,-52.79476,2018-07-06 00:00:00,23,1,24
"13229",10401,"Mount Pearl","NL",47.50513,-52.79476,2018-07-06 01:00:00,21,0,21
"13230",10401,"Mount Pearl","NL",47.50513,-52.79476,2018-07-06 02:00:00,18,0,18
"13231",10401,"Mount Pearl","NL",47.50513,-52.79476,2018-07-06 03:00:00,14,1,15
"13232",10401,"Mount Pearl","NL",47.50513,-52.79476,2018-07-06 04:00:00,15,1,16
"13233",10401,"Mount Pearl","NL",47.50513,-52.79476,2018-07-06 05:00:00,13,1,14
"13234",10401,"Mount Pearl","NL",47.50513,-52.79476,2018-07-06 06:00:00,14,2,16
"13235",10401,"Mount Pearl","NL",47.50513,-52.79476,2018-07-06 07:00:00,16,2,18
"13236",10401,"Mount Pearl","NL",47.50513,-52.79476,2018-07-06 08:00:00,23,1,24
"13237",10401,"Mount Pearl","NL",47.50513,-52.79476,2018-07-06 09:00:00,26,1,27
"13238",10401,"Mount Pearl","NL",47.50513,-52.79476,2018-07-06 10:00:00,27,1,28
"13239",10401,"Mount Pearl","NL",47.50513,-52.79476,2018-07-06 11:00:00,28,0,28
"13240",10401,"Mount Pearl","NL",47.50513,-52.79476,2018-07-06 12:00:00,28,1,29
"13241",10401,"Mount Pearl","NL",47.50513,-52.79476,2018-07-06 13:00:00,29,1,30
"13242",10401,"Mount Pearl","NL",47.50513,-52.79476,2018-07-06 14:00:00,32,1,33
"13243",10401,"Mount Pearl","NL",47.50513,-52.79476,2018-07-06 15:00:00,29,0,29
"13244",10401,"Mount Pearl","NL",47.50513,-52.79476,2018-07-06 16:00:00,26,1,27
"13245",10401,"Mount Pearl","NL",47.50513,-52.79476,2018-07-06 17:00:00,17,1,18
"13246",10401,"Mount Pearl","NL",47.50513,-52.79476,2018-07-06 18:00:00,14,1,15
"13247",10401,"Mount Pearl","NL",47.50513,-52.79476,2018-07-06 19:00:00,12,1,13
"13248",10401,"Mount Pearl","NL",47.50513,-52.79476,2018-07-06 20:00:00,13,1,14
"13249",10401,"Mount Pearl","NL",47.50513,-52.79476,2018-07-06 21:00:00,13,1,14
"13250",10401,"Mount Pearl","NL",47.50513,-52.79476,2018-07-06 22:00:00,13,1,14
"13251",10401,"Mount Pearl","NL",47.50513,-52.79476,2018-07-06 23:00:00,13,1,14
"13252",10401,"Mount Pearl","NL",47.50513,-52.79476,2018-07-07 00:00:00,12,1,13
"13253",10401,"Mount Pearl","NL",47.50513,-52.79476,2018-07-07 01:00:00,11,1,12
"13254",10401,"Mount Pearl","NL",47.50513,-52.79476,2018-07-07 02:00:00,11,0,11
"13255",10401,"Mount Pearl","NL",47.50513,-52.79476,2018-07-07 03:00:00,12,1,13
"13256",10401,"Mount Pearl","NL",47.50513,-52.79476,2018-07-07 04:00:00,11,0,11
"13257",10401,"Mount Pearl","NL",47.50513,-52.79476,2018-07-07 05:00:00,11,1,12
"13258",10401,"Mount Pearl","NL",47.50513,-52.79476,2018-07-07 06:00:00,11,1,12
"13259",10401,"Mount Pearl","NL",47.50513,-52.79476,2018-07-07 07:00:00,12,1,13
"13260",10401,"Mount Pearl","NL",47.50513,-52.79476,2018-07-07 08:00:00,14,1,15
"13261",10401,"Mount Pearl","NL",47.50513,-52.79476,2018-07-07 09:00:00,16,1,17
"13262",10401,"Mount Pearl","NL",47.50513,-52.79476,2018-07-07 10:00:00,16,1,17
"13263",10401,"Mount Pearl","NL",47.50513,-52.79476,2018-07-07 11:00:00,15,1,16
"13264",10401,"Mount Pearl","NL",47.50513,-52.79476,2018-07-07 12:00:00,14,1,15
"13265",10401,"Mount Pearl","NL",47.50513,-52.79476,2018-07-07 13:00:00,16,1,17
"13266",10401,"Mount Pearl","NL",47.50513,-52.79476,2018-07-07 14:00:00,19,1,20
"13267",10401,"Mount Pearl","NL",47.50513,-52.79476,2018-07-07 15:00:00,19,1,20
"13268",10401,"Mount Pearl","NL",47.50513,-52.79476,2018-07-07 16:00:00,17,1,18
"13269",10401,"Mount Pearl","NL",47.50513,-52.79476,2018-07-07 17:00:00,17,1,18
"13270",10401,"Mount Pearl","NL",47.50513,-52.79476,2018-07-07 18:00:00,19,1,20
"13271",10401,"Mount Pearl","NL",47.50513,-52.79476,2018-07-07 19:00:00,22,1,23
"13272",10401,"Mount Pearl","NL",47.50513,-52.79476,2018-07-07 20:00:00,25,1,26
"13273",10401,"Mount Pearl","NL",47.50513,-52.79476,2018-07-07 21:00:00,26,1,27
"13274",10401,"Mount Pearl","NL",47.50513,-52.79476,2018-07-07 22:00:00,27,2,29
"13275",10401,"Mount Pearl","NL",47.50513,-52.79476,2018-07-07 23:00:00,26,1,27
"13276",10401,"Mount Pearl","NL",47.50513,-52.79476,2018-07-08 00:00:00,25,0,25
"13277",10401,"Mount Pearl","NL",47.50513,-52.79476,2018-07-08 01:00:00,26,1,27
"13278",10401,"Mount Pearl","NL",47.50513,-52.79476,2018-07-08 02:00:00,25,1,26
"13279",10401,"Mount Pearl","NL",47.50513,-52.79476,2018-07-08 03:00:00,25,0,25
"13280",10401,"Mount Pearl","NL",47.50513,-52.79476,2018-07-08 04:00:00,24,1,25
"13281",10401,"Mount Pearl","NL",47.50513,-52.79476,2018-07-08 05:00:00,23,1,24
"13282",10401,"Mount Pearl","NL",47.50513,-52.79476,2018-07-08 06:00:00,21,0,21
"13283",10401,"Mount Pearl","NL",47.50513,-52.79476,2018-07-08 07:00:00,20,0,20
"13284",10401,"Mount Pearl","NL",47.50513,-52.79476,2018-07-08 08:00:00,20,1,21
"13285",10401,"Mount Pearl","NL",47.50513,-52.79476,2018-07-08 09:00:00,21,1,22
"13286",10401,"Mount Pearl","NL",47.50513,-52.79476,2018-07-08 10:00:00,23,0,23
"13287",10401,"Mount Pearl","NL",47.50513,-52.79476,2018-07-08 11:00:00,25,1,26
"13288",10401,"Mount Pearl","NL",47.50513,-52.79476,2018-07-08 12:00:00,25,0,25
"13289",10401,"Mount Pearl","NL",47.50513,-52.79476,2018-07-08 13:00:00,26,1,27
"13290",10401,"Mount Pearl","NL",47.50513,-52.79476,2018-07-08 14:00:00,26,1,27
"13291",10401,"Mount Pearl","NL",47.50513,-52.79476,2018-07-08 15:00:00,25,1,26
"13292",10401,"Mount Pearl","NL",47.50513,-52.79476,2018-07-08 16:00:00,24,1,25
"13293",10401,"Mount Pearl","NL",47.50513,-52.79476,2018-07-08 17:00:00,24,1,25
"13294",10401,"Mount Pearl","NL",47.50513,-52.79476,2018-07-08 18:00:00,24,0,24
"13295",10401,"Mount Pearl","NL",47.50513,-52.79476,2018-07-08 19:00:00,26,0,26
"13296",10401,"Mount Pearl","NL",47.50513,-52.79476,2018-07-08 20:00:00,25,1,26
"13297",10401,"Mount Pearl","NL",47.50513,-52.79476,2018-07-08 21:00:00,25,1,26
"13298",10401,"Mount Pearl","NL",47.50513,-52.79476,2018-07-08 22:00:00,25,1,26
"13299",10401,"Mount Pearl","NL",47.50513,-52.79476,2018-07-08 23:00:00,24,1,25
"13300",10401,"Mount Pearl","NL",47.50513,-52.79476,2018-07-09 00:00:00,24,1,25
"13301",10401,"Mount Pearl","NL",47.50513,-52.79476,2018-07-09 01:00:00,24,1,25
"13302",10401,"Mount Pearl","NL",47.50513,-52.79476,2018-07-09 02:00:00,24,1,25
"13303",10401,"Mount Pearl","NL",47.50513,-52.79476,2018-07-09 03:00:00,24,1,25
"13304",10401,"Mount Pearl","NL",47.50513,-52.79476,2018-07-09 04:00:00,23,1,24
"13305",10401,"Mount Pearl","NL",47.50513,-52.79476,2018-07-09 05:00:00,23,1,24
"13306",10401,"Mount Pearl","NL",47.50513,-52.79476,2018-07-09 06:00:00,23,1,24
"13307",10401,"Mount Pearl","NL",47.50513,-52.79476,2018-07-09 07:00:00,23,1,24
"13308",10401,"Mount Pearl","NL",47.50513,-52.79476,2018-07-09 08:00:00,24,1,25
"13309",10401,"Mount Pearl","NL",47.50513,-52.79476,2018-07-09 09:00:00,24,1,25
"13310",10401,"Mount Pearl","NL",47.50513,-52.79476,2018-07-09 10:00:00,25,1,26
"13311",10401,"Mount Pearl","NL",47.50513,-52.79476,2018-07-09 11:00:00,25,1,26
"13312",10401,"Mount Pearl","NL",47.50513,-52.79476,2018-07-09 12:00:00,24,1,25
"13313",10401,"Mount Pearl","NL",47.50513,-52.79476,2018-07-09 13:00:00,26,1,27
"13314",10401,"Mount Pearl","NL",47.50513,-52.79476,2018-07-09 14:00:00,26,0,26
"13315",10401,"Mount Pearl","NL",47.50513,-52.79476,2018-07-09 15:00:00,27,1,28
"13316",10401,"Mount Pearl","NL",47.50513,-52.79476,2018-07-09 16:00:00,28,1,29
"13317",10401,"Mount Pearl","NL",47.50513,-52.79476,2018-07-09 17:00:00,28,1,29
"13318",10401,"Mount Pearl","NL",47.50513,-52.79476,2018-07-09 18:00:00,27,1,28
"13319",10401,"Mount Pearl","NL",47.50513,-52.79476,2018-07-09 19:00:00,26,1,27
"13320",10401,"Mount Pearl","NL",47.50513,-52.79476,2018-07-09 20:00:00,28,0,28
"13321",10401,"Mount Pearl","NL",47.50513,-52.79476,2018-07-09 21:00:00,32,0,32
"13322",10401,"Mount Pearl","NL",47.50513,-52.79476,2018-07-09 22:00:00,28,1,29
"13323",10401,"Mount Pearl","NL",47.50513,-52.79476,2018-07-09 23:00:00,26,0,26
"13324",10401,"Mount Pearl","NL",47.50513,-52.79476,2018-07-10 00:00:00,28,0,28
"13325",10401,"Mount Pearl","NL",47.50513,-52.79476,2018-07-10 01:00:00,31,0,31
"13326",10401,"Mount Pearl","NL",47.50513,-52.79476,2018-07-10 02:00:00,33,0,33
"13327",10401,"Mount Pearl","NL",47.50513,-52.79476,2018-07-10 03:00:00,33,0,33
"13328",10401,"Mount Pearl","NL",47.50513,-52.79476,2018-07-10 04:00:00,32,0,32
"13329",10401,"Mount Pearl","NL",47.50513,-52.79476,2018-07-10 05:00:00,31,1,32
"13330",10401,"Mount Pearl","NL",47.50513,-52.79476,2018-07-10 06:00:00,29,1,30
"13331",10401,"Mount Pearl","NL",47.50513,-52.79476,2018-07-10 07:00:00,29,1,30
"13332",10401,"Mount Pearl","NL",47.50513,-52.79476,2018-07-10 08:00:00,29,1,30
"13333",10401,"Mount Pearl","NL",47.50513,-52.79476,2018-07-10 09:00:00,30,1,31
"13334",10401,"Mount Pearl","NL",47.50513,-52.79476,2018-07-10 10:00:00,30,1,31
"13335",10401,"Mount Pearl","NL",47.50513,-52.79476,2018-07-10 11:00:00,30,1,31
"13336",10401,"Mount Pearl","NL",47.50513,-52.79476,2018-07-10 12:00:00,34,3,37
"13337",10401,"Mount Pearl","NL",47.50513,-52.79476,2018-07-10 13:00:00,39,2,41
"13338",10401,"Mount Pearl","NL",47.50513,-52.79476,2018-07-10 14:00:00,38,2,40
"13339",10401,"Mount Pearl","NL",47.50513,-52.79476,2018-07-10 15:00:00,25,2,27
"13340",10401,"Mount Pearl","NL",47.50513,-52.79476,2018-07-10 16:00:00,20,1,21
"13341",10401,"Mount Pearl","NL",47.50513,-52.79476,2018-07-10 17:00:00,16,2,18
"13342",10401,"Mount Pearl","NL",47.50513,-52.79476,2018-07-10 18:00:00,15,1,16
"13343",10401,"Mount Pearl","NL",47.50513,-52.79476,2018-07-10 19:00:00,13,2,15
"13344",10401,"Mount Pearl","NL",47.50513,-52.79476,2018-07-10 20:00:00,13,2,15
"13345",10401,"Mount Pearl","NL",47.50513,-52.79476,2018-07-10 21:00:00,12,2,14
"13346",10401,"Mount Pearl","NL",47.50513,-52.79476,2018-07-10 22:00:00,11,2,13
"13347",10401,"Mount Pearl","NL",47.50513,-52.79476,2018-07-10 23:00:00,12,1,13
"13348",10401,"Mount Pearl","NL",47.50513,-52.79476,2018-07-11 00:00:00,14,1,15
"13349",10401,"Mount Pearl","NL",47.50513,-52.79476,2018-07-11 01:00:00,16,2,18
"13350",10401,"Mount Pearl","NL",47.50513,-52.79476,2018-07-11 02:00:00,18,2,20
"13351",10401,"Mount Pearl","NL",47.50513,-52.79476,2018-07-11 03:00:00,17,2,19
"13352",10401,"Mount Pearl","NL",47.50513,-52.79476,2018-07-11 04:00:00,19,2,21
"13353",10401,"Mount Pearl","NL",47.50513,-52.79476,2018-07-11 05:00:00,21,2,23
"13354",10401,"Mount Pearl","NL",47.50513,-52.79476,2018-07-11 06:00:00,21,2,23
"13355",10401,"Mount Pearl","NL",47.50513,-52.79476,2018-07-11 07:00:00,19,2,21
"13356",10401,"Mount Pearl","NL",47.50513,-52.79476,2018-07-11 08:00:00,20,2,22
"13357",10401,"Mount Pearl","NL",47.50513,-52.79476,2018-07-11 09:00:00,21,2,23
"13358",10401,"Mount Pearl","NL",47.50513,-52.79476,2018-07-11 10:00:00,19,2,21
"13359",10401,"Mount Pearl","NL",47.50513,-52.79476,2018-07-11 11:00:00,19,2,21
"13360",10401,"Mount Pearl","NL",47.50513,-52.79476,2018-07-11 12:00:00,20,3,23
"13361",10401,"Mount Pearl","NL",47.50513,-52.79476,2018-07-11 13:00:00,23,3,26
"13362",10401,"Mount Pearl","NL",47.50513,-52.79476,2018-07-11 14:00:00,23,NA,NA
"13363",10401,"Mount Pearl","NL",47.50513,-52.79476,2018-07-11 15:00:00,23,NA,NA
"13364",10401,"Mount Pearl","NL",47.50513,-52.79476,2018-07-11 16:00:00,24,NA,NA
"13365",10401,"Mount Pearl","NL",47.50513,-52.79476,2018-07-11 17:00:00,24,NA,NA
"13366",10401,"Mount Pearl","NL",47.50513,-52.79476,2018-07-11 18:00:00,24,NA,NA
"13367",10401,"Mount Pearl","NL",47.50513,-52.79476,2018-07-11 19:00:00,22,NA,NA
"13368",10401,"Mount Pearl","NL",47.50513,-52.79476,2018-07-11 20:00:00,17,NA,NA
"13369",10401,"Mount Pearl","NL",47.50513,-52.79476,2018-07-11 21:00:00,13,NA,NA
"13370",10401,"Mount Pearl","NL",47.50513,-52.79476,2018-07-11 22:00:00,13,NA,NA
"13371",10401,"Mount Pearl","NL",47.50513,-52.79476,2018-07-11 23:00:00,14,NA,NA
"13372",10401,"Mount Pearl","NL",47.50513,-52.79476,2018-07-12 00:00:00,14,NA,NA
"13373",10401,"Mount Pearl","NL",47.50513,-52.79476,2018-07-12 01:00:00,13,NA,NA
"13374",10401,"Mount Pearl","NL",47.50513,-52.79476,2018-07-12 02:00:00,14,NA,NA
"13375",10401,"Mount Pearl","NL",47.50513,-52.79476,2018-07-12 03:00:00,14,NA,NA
"13376",10401,"Mount Pearl","NL",47.50513,-52.79476,2018-07-12 04:00:00,16,NA,NA
"13377",10401,"Mount Pearl","NL",47.50513,-52.79476,2018-07-12 05:00:00,18,NA,NA
"13378",10401,"Mount Pearl","NL",47.50513,-52.79476,2018-07-12 06:00:00,16,NA,NA
"13379",10401,"Mount Pearl","NL",47.50513,-52.79476,2018-07-12 07:00:00,14,NA,NA
"13380",10401,"Mount Pearl","NL",47.50513,-52.79476,2018-07-12 08:00:00,15,NA,NA
"13381",10401,"Mount Pearl","NL",47.50513,-52.79476,2018-07-12 09:00:00,15,NA,NA
"13382",10401,"Mount Pearl","NL",47.50513,-52.79476,2018-07-12 10:00:00,20,NA,NA
"13383",10401,"Mount Pearl","NL",47.50513,-52.79476,2018-07-12 11:00:00,20,NA,NA
"13384",10401,"Mount Pearl","NL",47.50513,-52.79476,2018-07-12 12:00:00,14,1,15
"13385",10401,"Mount Pearl","NL",47.50513,-52.79476,2018-07-12 13:00:00,12,0,12
"13386",10401,"Mount Pearl","NL",47.50513,-52.79476,2018-07-12 14:00:00,8,1,9
"13387",10401,"Mount Pearl","NL",47.50513,-52.79476,2018-07-12 15:00:00,9,0,9
"13388",10401,"Mount Pearl","NL",47.50513,-52.79476,2018-07-12 16:00:00,12,0,12
"13389",10401,"Mount Pearl","NL",47.50513,-52.79476,2018-07-12 17:00:00,15,1,16
"13390",10401,"Mount Pearl","NL",47.50513,-52.79476,2018-07-12 18:00:00,20,0,20
"13391",10401,"Mount Pearl","NL",47.50513,-52.79476,2018-07-12 19:00:00,34,1,35
"13392",10401,"Mount Pearl","NL",47.50513,-52.79476,2018-07-12 20:00:00,30,1,31
"13393",10401,"Mount Pearl","NL",47.50513,-52.79476,2018-07-12 21:00:00,26,1,27
"13394",10401,"Mount Pearl","NL",47.50513,-52.79476,2018-07-12 22:00:00,29,0,29
"13395",10401,"Mount Pearl","NL",47.50513,-52.79476,2018-07-12 23:00:00,22,0,22
"13396",10401,"Mount Pearl","NL",47.50513,-52.79476,2018-07-13 00:00:00,22,1,23
"13397",10401,"Mount Pearl","NL",47.50513,-52.79476,2018-07-13 01:00:00,23,0,23
"13398",10401,"Mount Pearl","NL",47.50513,-52.79476,2018-07-13 02:00:00,25,1,26
"13399",10401,"Mount Pearl","NL",47.50513,-52.79476,2018-07-13 03:00:00,22,1,23
"13400",10401,"Mount Pearl","NL",47.50513,-52.79476,2018-07-13 04:00:00,20,1,21
"13401",10401,"Mount Pearl","NL",47.50513,-52.79476,2018-07-13 05:00:00,19,1,20
"13402",10401,"Mount Pearl","NL",47.50513,-52.79476,2018-07-13 06:00:00,18,1,19
"13403",10401,"Mount Pearl","NL",47.50513,-52.79476,2018-07-13 07:00:00,17,2,19
"13404",10401,"Mount Pearl","NL",47.50513,-52.79476,2018-07-13 08:00:00,18,1,19
"13405",10401,"Mount Pearl","NL",47.50513,-52.79476,2018-07-13 09:00:00,18,2,20
"13406",10401,"Mount Pearl","NL",47.50513,-52.79476,2018-07-13 10:00:00,16,1,17
"13407",10401,"Mount Pearl","NL",47.50513,-52.79476,2018-07-13 11:00:00,15,1,16
"13408",10401,"Mount Pearl","NL",47.50513,-52.79476,2018-07-13 12:00:00,16,0,16
"13409",10401,"Mount Pearl","NL",47.50513,-52.79476,2018-07-13 13:00:00,16,0,16
"13410",10401,"Mount Pearl","NL",47.50513,-52.79476,2018-07-13 14:00:00,18,0,18
"13411",10401,"Mount Pearl","NL",47.50513,-52.79476,2018-07-13 15:00:00,18,1,19
"13412",10401,"Mount Pearl","NL",47.50513,-52.79476,2018-07-13 16:00:00,17,2,19
"13413",10401,"Mount Pearl","NL",47.50513,-52.79476,2018-07-13 17:00:00,16,2,18
"13414",10401,"Mount Pearl","NL",47.50513,-52.79476,2018-07-13 18:00:00,15,1,16
"13415",10401,"Mount Pearl","NL",47.50513,-52.79476,2018-07-13 19:00:00,15,1,16
"13416",10401,"Mount Pearl","NL",47.50513,-52.79476,2018-07-13 20:00:00,13,2,15
"13417",10401,"Mount Pearl","NL",47.50513,-52.79476,2018-07-13 21:00:00,13,1,14
"13418",10401,"Mount Pearl","NL",47.50513,-52.79476,2018-07-13 22:00:00,14,1,15
"13419",10401,"Mount Pearl","NL",47.50513,-52.79476,2018-07-13 23:00:00,13,1,14
"13420",10401,"Mount Pearl","NL",47.50513,-52.79476,2018-07-14 00:00:00,13,0,13
"13421",10401,"Mount Pearl","NL",47.50513,-52.79476,2018-07-14 01:00:00,13,1,14
"13422",10401,"Mount Pearl","NL",47.50513,-52.79476,2018-07-14 02:00:00,13,0,13
"13423",10401,"Mount Pearl","NL",47.50513,-52.79476,2018-07-14 03:00:00,13,0,13
"13424",10401,"Mount Pearl","NL",47.50513,-52.79476,2018-07-14 04:00:00,12,0,12
"13425",10401,"Mount Pearl","NL",47.50513,-52.79476,2018-07-14 05:00:00,14,0,14
"13426",10401,"Mount Pearl","NL",47.50513,-52.79476,2018-07-14 06:00:00,13,0,13
"13427",10401,"Mount Pearl","NL",47.50513,-52.79476,2018-07-14 07:00:00,14,0,14
"13428",10401,"Mount Pearl","NL",47.50513,-52.79476,2018-07-14 08:00:00,12,1,13
"13429",10401,"Mount Pearl","NL",47.50513,-52.79476,2018-07-14 09:00:00,12,2,14
"13430",10401,"Mount Pearl","NL",47.50513,-52.79476,2018-07-14 10:00:00,15,1,16
"13431",10401,"Mount Pearl","NL",47.50513,-52.79476,2018-07-14 11:00:00,17,1,18
"13432",10401,"Mount Pearl","NL",47.50513,-52.79476,2018-07-14 12:00:00,19,0,19
"13433",10401,"Mount Pearl","NL",47.50513,-52.79476,2018-07-14 13:00:00,20,0,20
"13434",10401,"Mount Pearl","NL",47.50513,-52.79476,2018-07-14 14:00:00,18,0,18
"13435",10401,"Mount Pearl","NL",47.50513,-52.79476,2018-07-14 15:00:00,17,1,18
"13436",10401,"Mount Pearl","NL",47.50513,-52.79476,2018-07-14 16:00:00,17,1,18
"13437",10401,"Mount Pearl","NL",47.50513,-52.79476,2018-07-14 17:00:00,16,1,17
"13438",10401,"Mount Pearl","NL",47.50513,-52.79476,2018-07-14 18:00:00,17,0,17
"13439",10401,"Mount Pearl","NL",47.50513,-52.79476,2018-07-14 19:00:00,16,1,17
"13440",10401,"Mount Pearl","NL",47.50513,-52.79476,2018-07-14 20:00:00,16,1,17
"13441",10401,"Mount Pearl","NL",47.50513,-52.79476,2018-07-14 21:00:00,17,1,18
"13442",10401,"Mount Pearl","NL",47.50513,-52.79476,2018-07-14 22:00:00,16,0,16
"13443",10401,"Mount Pearl","NL",47.50513,-52.79476,2018-07-14 23:00:00,16,1,17
"13444",10401,"Mount Pearl","NL",47.50513,-52.79476,2018-07-15 00:00:00,13,1,14
"13445",10401,"Mount Pearl","NL",47.50513,-52.79476,2018-07-15 01:00:00,11,0,11
"13446",10401,"Mount Pearl","NL",47.50513,-52.79476,2018-07-15 02:00:00,12,0,12
"13447",10401,"Mount Pearl","NL",47.50513,-52.79476,2018-07-15 03:00:00,9,0,9
"13448",10401,"Mount Pearl","NL",47.50513,-52.79476,2018-07-15 04:00:00,7,1,8
"13449",10401,"Mount Pearl","NL",47.50513,-52.79476,2018-07-15 05:00:00,7,0,7
"13450",10401,"Mount Pearl","NL",47.50513,-52.79476,2018-07-15 06:00:00,5,0,5
"13451",10401,"Mount Pearl","NL",47.50513,-52.79476,2018-07-15 07:00:00,9,0,9
"13452",10401,"Mount Pearl","NL",47.50513,-52.79476,2018-07-15 08:00:00,16,0,16
"13453",10401,"Mount Pearl","NL",47.50513,-52.79476,2018-07-15 09:00:00,19,0,19
"13454",10401,"Mount Pearl","NL",47.50513,-52.79476,2018-07-15 10:00:00,17,0,17
"13455",10401,"Mount Pearl","NL",47.50513,-52.79476,2018-07-15 11:00:00,13,0,13
"13456",10401,"Mount Pearl","NL",47.50513,-52.79476,2018-07-15 12:00:00,13,1,14
"13457",10401,"Mount Pearl","NL",47.50513,-52.79476,2018-07-15 13:00:00,16,1,17
"13458",10401,"Mount Pearl","NL",47.50513,-52.79476,2018-07-15 14:00:00,16,1,17
"13459",10401,"Mount Pearl","NL",47.50513,-52.79476,2018-07-15 15:00:00,19,1,20
"13460",10401,"Mount Pearl","NL",47.50513,-52.79476,2018-07-15 16:00:00,15,1,16
"13461",10401,"Mount Pearl","NL",47.50513,-52.79476,2018-07-15 17:00:00,13,1,14
"13462",10401,"Mount Pearl","NL",47.50513,-52.79476,2018-07-15 18:00:00,16,1,17
"13463",10401,"Mount Pearl","NL",47.50513,-52.79476,2018-07-15 19:00:00,18,1,19
"13464",10401,"Mount Pearl","NL",47.50513,-52.79476,2018-07-15 20:00:00,19,1,20
"13465",10401,"Mount Pearl","NL",47.50513,-52.79476,2018-07-15 21:00:00,19,0,19
"13466",10401,"Mount Pearl","NL",47.50513,-52.79476,2018-07-15 22:00:00,20,1,21
"13467",10401,"Mount Pearl","NL",47.50513,-52.79476,2018-07-15 23:00:00,21,0,21
"13468",10401,"Mount Pearl","NL",47.50513,-52.79476,2018-07-16 00:00:00,22,0,22
"13469",10401,"Mount Pearl","NL",47.50513,-52.79476,2018-07-16 01:00:00,23,1,24
"13470",10401,"Mount Pearl","NL",47.50513,-52.79476,2018-07-16 02:00:00,23,0,23
"13471",10401,"Mount Pearl","NL",47.50513,-52.79476,2018-07-16 03:00:00,22,0,22
"13472",10401,"Mount Pearl","NL",47.50513,-52.79476,2018-07-16 04:00:00,22,1,23
"13473",10401,"Mount Pearl","NL",47.50513,-52.79476,2018-07-16 05:00:00,22,1,23
"13474",10401,"Mount Pearl","NL",47.50513,-52.79476,2018-07-16 06:00:00,23,0,23
"13475",10401,"Mount Pearl","NL",47.50513,-52.79476,2018-07-16 07:00:00,23,0,23
"13476",10401,"Mount Pearl","NL",47.50513,-52.79476,2018-07-16 08:00:00,23,1,24
"13477",10401,"Mount Pearl","NL",47.50513,-52.79476,2018-07-16 09:00:00,20,1,21
"13478",10401,"Mount Pearl","NL",47.50513,-52.79476,2018-07-16 10:00:00,15,1,16
"13479",10401,"Mount Pearl","NL",47.50513,-52.79476,2018-07-16 11:00:00,12,1,13
"13480",10401,"Mount Pearl","NL",47.50513,-52.79476,2018-07-16 12:00:00,12,1,13
"13481",10401,"Mount Pearl","NL",47.50513,-52.79476,2018-07-16 13:00:00,12,1,13
"13482",10401,"Mount Pearl","NL",47.50513,-52.79476,2018-07-16 14:00:00,12,1,13
"13483",10401,"Mount Pearl","NL",47.50513,-52.79476,2018-07-16 15:00:00,14,0,14
"13484",10401,"Mount Pearl","NL",47.50513,-52.79476,2018-07-16 16:00:00,12,1,13
"13485",10401,"Mount Pearl","NL",47.50513,-52.79476,2018-07-16 17:00:00,10,1,11
"13486",10401,"Mount Pearl","NL",47.50513,-52.79476,2018-07-16 18:00:00,9,0,9
"13487",10401,"Mount Pearl","NL",47.50513,-52.79476,2018-07-16 19:00:00,9,0,9
"13488",10401,"Mount Pearl","NL",47.50513,-52.79476,2018-07-16 20:00:00,11,1,12
"13489",10401,"Mount Pearl","NL",47.50513,-52.79476,2018-07-16 21:00:00,12,0,12
"13490",10401,"Mount Pearl","NL",47.50513,-52.79476,2018-07-16 22:00:00,15,1,16
"13491",10401,"Mount Pearl","NL",47.50513,-52.79476,2018-07-16 23:00:00,17,0,17
"13492",10401,"Mount Pearl","NL",47.50513,-52.79476,2018-07-17 00:00:00,16,1,17
"13493",10401,"Mount Pearl","NL",47.50513,-52.79476,2018-07-17 01:00:00,15,1,16
"13494",10401,"Mount Pearl","NL",47.50513,-52.79476,2018-07-17 02:00:00,16,1,17
"13495",10401,"Mount Pearl","NL",47.50513,-52.79476,2018-07-17 03:00:00,16,0,16
"13496",10401,"Mount Pearl","NL",47.50513,-52.79476,2018-07-17 04:00:00,18,0,18
"13497",10401,"Mount Pearl","NL",47.50513,-52.79476,2018-07-17 05:00:00,19,0,19
"13498",10401,"Mount Pearl","NL",47.50513,-52.79476,2018-07-17 06:00:00,19,1,20
"13499",10401,"Mount Pearl","NL",47.50513,-52.79476,2018-07-17 07:00:00,19,2,21
"13500",10401,"Mount Pearl","NL",47.50513,-52.79476,2018-07-17 08:00:00,22,1,23
"13501",10401,"Mount Pearl","NL",47.50513,-52.79476,2018-07-17 09:00:00,18,1,19
"13502",10401,"Mount Pearl","NL",47.50513,-52.79476,2018-07-17 10:00:00,13,NA,NA
"13503",10401,"Mount Pearl","NL",47.50513,-52.79476,2018-07-17 11:00:00,10,NA,NA
"13504",10401,"Mount Pearl","NL",47.50513,-52.79476,2018-07-17 12:00:00,NA,NA,NA
"13505",10401,"Mount Pearl","NL",47.50513,-52.79476,2018-07-17 13:00:00,15,1,16
"13506",10401,"Mount Pearl","NL",47.50513,-52.79476,2018-07-17 14:00:00,21,1,22
"13507",10401,"Mount Pearl","NL",47.50513,-52.79476,2018-07-17 15:00:00,20,2,22
"13508",10401,"Mount Pearl","NL",47.50513,-52.79476,2018-07-17 16:00:00,24,2,26
"13509",10401,"Mount Pearl","NL",47.50513,-52.79476,2018-07-17 17:00:00,23,2,25
"13510",10401,"Mount Pearl","NL",47.50513,-52.79476,2018-07-17 18:00:00,24,2,26
"13511",10401,"Mount Pearl","NL",47.50513,-52.79476,2018-07-17 19:00:00,22,1,23
"13512",10401,"Mount Pearl","NL",47.50513,-52.79476,2018-07-17 20:00:00,21,2,23
"13513",10401,"Mount Pearl","NL",47.50513,-52.79476,2018-07-17 21:00:00,23,2,25
"13514",10401,"Mount Pearl","NL",47.50513,-52.79476,2018-07-17 22:00:00,22,2,24
"13515",10401,"Mount Pearl","NL",47.50513,-52.79476,2018-07-17 23:00:00,23,1,24
"13516",10401,"Mount Pearl","NL",47.50513,-52.79476,2018-07-18 00:00:00,24,2,26
"13517",10401,"Mount Pearl","NL",47.50513,-52.79476,2018-07-18 01:00:00,25,1,26
"13518",10401,"Mount Pearl","NL",47.50513,-52.79476,2018-07-18 02:00:00,26,2,28
"13519",10401,"Mount Pearl","NL",47.50513,-52.79476,2018-07-18 03:00:00,27,1,28
"13520",10401,"Mount Pearl","NL",47.50513,-52.79476,2018-07-18 04:00:00,35,1,36
"13521",10401,"Mount Pearl","NL",47.50513,-52.79476,2018-07-18 05:00:00,36,1,37
"13522",10401,"Mount Pearl","NL",47.50513,-52.79476,2018-07-18 06:00:00,35,2,37
"13523",10401,"Mount Pearl","NL",47.50513,-52.79476,2018-07-18 07:00:00,32,2,34
"13524",10401,"Mount Pearl","NL",47.50513,-52.79476,2018-07-18 08:00:00,25,2,27
"13525",10401,"Mount Pearl","NL",47.50513,-52.79476,2018-07-18 09:00:00,23,2,25
"13526",10401,"Mount Pearl","NL",47.50513,-52.79476,2018-07-18 10:00:00,26,2,28
"13527",10401,"Mount Pearl","NL",47.50513,-52.79476,2018-07-18 11:00:00,30,2,32
"13528",10401,"Mount Pearl","NL",47.50513,-52.79476,2018-07-18 12:00:00,23,1,24
"13529",10401,"Mount Pearl","NL",47.50513,-52.79476,2018-07-18 13:00:00,19,1,20
"13530",10401,"Mount Pearl","NL",47.50513,-52.79476,2018-07-18 14:00:00,16,1,17
"13531",10401,"Mount Pearl","NL",47.50513,-52.79476,2018-07-18 15:00:00,17,1,18
"13532",10401,"Mount Pearl","NL",47.50513,-52.79476,2018-07-18 16:00:00,18,1,19
"13533",10401,"Mount Pearl","NL",47.50513,-52.79476,2018-07-18 17:00:00,18,1,19
"13534",10401,"Mount Pearl","NL",47.50513,-52.79476,2018-07-18 18:00:00,19,2,21
"13535",10401,"Mount Pearl","NL",47.50513,-52.79476,2018-07-18 19:00:00,21,1,22
"13536",10401,"Mount Pearl","NL",47.50513,-52.79476,2018-07-18 20:00:00,22,1,23
"13537",10401,"Mount Pearl","NL",47.50513,-52.79476,2018-07-18 21:00:00,23,1,24
"13538",10401,"Mount Pearl","NL",47.50513,-52.79476,2018-07-18 22:00:00,22,1,23
"13539",10401,"Mount Pearl","NL",47.50513,-52.79476,2018-07-18 23:00:00,22,1,23
"13540",10401,"Mount Pearl","NL",47.50513,-52.79476,2018-07-19 00:00:00,21,1,22
"13541",10401,"Mount Pearl","NL",47.50513,-52.79476,2018-07-19 01:00:00,25,1,26
"13542",10401,"Mount Pearl","NL",47.50513,-52.79476,2018-07-19 02:00:00,23,1,24
"13543",10401,"Mount Pearl","NL",47.50513,-52.79476,2018-07-19 03:00:00,24,0,24
"13544",10401,"Mount Pearl","NL",47.50513,-52.79476,2018-07-19 04:00:00,23,1,24
"13545",10401,"Mount Pearl","NL",47.50513,-52.79476,2018-07-19 05:00:00,25,1,26
"13546",10401,"Mount Pearl","NL",47.50513,-52.79476,2018-07-19 06:00:00,25,1,26
"13547",10401,"Mount Pearl","NL",47.50513,-52.79476,2018-07-19 07:00:00,21,1,22
"13548",10401,"Mount Pearl","NL",47.50513,-52.79476,2018-07-19 08:00:00,17,2,19
"13549",10401,"Mount Pearl","NL",47.50513,-52.79476,2018-07-19 09:00:00,17,1,18
"13550",10401,"Mount Pearl","NL",47.50513,-52.79476,2018-07-19 10:00:00,17,1,18
"13551",10401,"Mount Pearl","NL",47.50513,-52.79476,2018-07-19 11:00:00,14,1,15
"13552",10401,"Mount Pearl","NL",47.50513,-52.79476,2018-07-19 12:00:00,12,0,12
"13553",10401,"Mount Pearl","NL",47.50513,-52.79476,2018-07-19 13:00:00,13,0,13
"13554",10401,"Mount Pearl","NL",47.50513,-52.79476,2018-07-19 14:00:00,12,0,12
"13555",10401,"Mount Pearl","NL",47.50513,-52.79476,2018-07-19 15:00:00,12,0,12
"13556",10401,"Mount Pearl","NL",47.50513,-52.79476,2018-07-19 16:00:00,15,1,16
"13557",10401,"Mount Pearl","NL",47.50513,-52.79476,2018-07-19 17:00:00,14,1,15
"13558",10401,"Mount Pearl","NL",47.50513,-52.79476,2018-07-19 18:00:00,13,1,14
"13559",10401,"Mount Pearl","NL",47.50513,-52.79476,2018-07-19 19:00:00,15,1,16
"13560",10401,"Mount Pearl","NL",47.50513,-52.79476,2018-07-19 20:00:00,19,0,19
"13561",10401,"Mount Pearl","NL",47.50513,-52.79476,2018-07-19 21:00:00,23,0,23
"13562",10401,"Mount Pearl","NL",47.50513,-52.79476,2018-07-19 22:00:00,22,1,23
"13563",10401,"Mount Pearl","NL",47.50513,-52.79476,2018-07-19 23:00:00,21,0,21
"13564",10401,"Mount Pearl","NL",47.50513,-52.79476,2018-07-20 00:00:00,20,1,21
"13565",10401,"Mount Pearl","NL",47.50513,-52.79476,2018-07-20 01:00:00,17,0,17
"13566",10401,"Mount Pearl","NL",47.50513,-52.79476,2018-07-20 02:00:00,19,0,19
"13567",10401,"Mount Pearl","NL",47.50513,-52.79476,2018-07-20 03:00:00,21,0,21
"13568",10401,"Mount Pearl","NL",47.50513,-52.79476,2018-07-20 04:00:00,20,0,20
"13569",10401,"Mount Pearl","NL",47.50513,-52.79476,2018-07-20 05:00:00,19,0,19
"13570",10401,"Mount Pearl","NL",47.50513,-52.79476,2018-07-20 06:00:00,18,2,20
"13571",10401,"Mount Pearl","NL",47.50513,-52.79476,2018-07-20 07:00:00,15,3,18
"13572",10401,"Mount Pearl","NL",47.50513,-52.79476,2018-07-20 08:00:00,13,3,16
"13573",10401,"Mount Pearl","NL",47.50513,-52.79476,2018-07-20 09:00:00,13,1,14
"13574",10401,"Mount Pearl","NL",47.50513,-52.79476,2018-07-20 10:00:00,13,1,14
"13575",10401,"Mount Pearl","NL",47.50513,-52.79476,2018-07-20 11:00:00,14,2,16
"13576",10401,"Mount Pearl","NL",47.50513,-52.79476,2018-07-20 12:00:00,16,2,18
"13577",10401,"Mount Pearl","NL",47.50513,-52.79476,2018-07-20 13:00:00,17,2,19
"13578",10401,"Mount Pearl","NL",47.50513,-52.79476,2018-07-20 14:00:00,20,1,21
"13579",10401,"Mount Pearl","NL",47.50513,-52.79476,2018-07-20 15:00:00,20,1,21
"13580",10401,"Mount Pearl","NL",47.50513,-52.79476,2018-07-20 16:00:00,21,1,22
"13581",10401,"Mount Pearl","NL",47.50513,-52.79476,2018-07-20 17:00:00,20,0,20
"13582",10401,"Mount Pearl","NL",47.50513,-52.79476,2018-07-20 18:00:00,20,1,21
"13583",10401,"Mount Pearl","NL",47.50513,-52.79476,2018-07-20 19:00:00,20,1,21
"13584",10401,"Mount Pearl","NL",47.50513,-52.79476,2018-07-20 20:00:00,19,2,21
"13585",10401,"Mount Pearl","NL",47.50513,-52.79476,2018-07-20 21:00:00,15,2,17
"13586",10401,"Mount Pearl","NL",47.50513,-52.79476,2018-07-20 22:00:00,11,3,14
"13587",10401,"Mount Pearl","NL",47.50513,-52.79476,2018-07-20 23:00:00,15,2,17
"13588",10401,"Mount Pearl","NL",47.50513,-52.79476,2018-07-21 00:00:00,16,1,17
"13589",10401,"Mount Pearl","NL",47.50513,-52.79476,2018-07-21 01:00:00,16,1,17
"13590",10401,"Mount Pearl","NL",47.50513,-52.79476,2018-07-21 02:00:00,22,0,22
"13591",10401,"Mount Pearl","NL",47.50513,-52.79476,2018-07-21 03:00:00,23,1,24
"13592",10401,"Mount Pearl","NL",47.50513,-52.79476,2018-07-21 04:00:00,22,0,22
"13593",10401,"Mount Pearl","NL",47.50513,-52.79476,2018-07-21 05:00:00,21,1,22
"13594",10401,"Mount Pearl","NL",47.50513,-52.79476,2018-07-21 06:00:00,20,2,22
"13595",10401,"Mount Pearl","NL",47.50513,-52.79476,2018-07-21 07:00:00,18,4,22
"13596",10401,"Mount Pearl","NL",47.50513,-52.79476,2018-07-21 08:00:00,19,4,23
"13597",10401,"Mount Pearl","NL",47.50513,-52.79476,2018-07-21 09:00:00,20,3,23
"13598",10401,"Mount Pearl","NL",47.50513,-52.79476,2018-07-21 10:00:00,22,2,24
"13599",10401,"Mount Pearl","NL",47.50513,-52.79476,2018-07-21 11:00:00,22,1,23
"13600",10401,"Mount Pearl","NL",47.50513,-52.79476,2018-07-21 12:00:00,23,1,24
"13601",10401,"Mount Pearl","NL",47.50513,-52.79476,2018-07-21 13:00:00,22,2,24
"13602",10401,"Mount Pearl","NL",47.50513,-52.79476,2018-07-21 14:00:00,23,1,24
"13603",10401,"Mount Pearl","NL",47.50513,-52.79476,2018-07-21 15:00:00,23,2,25
"13604",10401,"Mount Pearl","NL",47.50513,-52.79476,2018-07-21 16:00:00,23,2,25
"13605",10401,"Mount Pearl","NL",47.50513,-52.79476,2018-07-21 17:00:00,23,1,24
"13606",10401,"Mount Pearl","NL",47.50513,-52.79476,2018-07-21 18:00:00,22,2,24
"13607",10401,"Mount Pearl","NL",47.50513,-52.79476,2018-07-21 19:00:00,23,2,25
"13608",10401,"Mount Pearl","NL",47.50513,-52.79476,2018-07-21 20:00:00,21,2,23
"13609",10401,"Mount Pearl","NL",47.50513,-52.79476,2018-07-21 21:00:00,22,3,25
"13610",10401,"Mount Pearl","NL",47.50513,-52.79476,2018-07-21 22:00:00,23,1,24
"13611",10401,"Mount Pearl","NL",47.50513,-52.79476,2018-07-21 23:00:00,23,1,24
"13612",10401,"Mount Pearl","NL",47.50513,-52.79476,2018-07-22 00:00:00,23,1,24
"13613",10401,"Mount Pearl","NL",47.50513,-52.79476,2018-07-22 01:00:00,25,2,27
"13614",10401,"Mount Pearl","NL",47.50513,-52.79476,2018-07-22 02:00:00,36,1,37
"13615",10401,"Mount Pearl","NL",47.50513,-52.79476,2018-07-22 03:00:00,33,2,35
"13616",10401,"Mount Pearl","NL",47.50513,-52.79476,2018-07-22 04:00:00,22,3,25
"13617",10401,"Mount Pearl","NL",47.50513,-52.79476,2018-07-22 05:00:00,19,2,21
"13618",10401,"Mount Pearl","NL",47.50513,-52.79476,2018-07-22 06:00:00,12,1,13
"13619",10401,"Mount Pearl","NL",47.50513,-52.79476,2018-07-22 07:00:00,13,1,14
"13620",10401,"Mount Pearl","NL",47.50513,-52.79476,2018-07-22 08:00:00,12,1,13
"13621",10401,"Mount Pearl","NL",47.50513,-52.79476,2018-07-22 09:00:00,13,1,14
"13622",10401,"Mount Pearl","NL",47.50513,-52.79476,2018-07-22 10:00:00,15,1,16
"13623",10401,"Mount Pearl","NL",47.50513,-52.79476,2018-07-22 11:00:00,20,1,21
"13624",10401,"Mount Pearl","NL",47.50513,-52.79476,2018-07-22 12:00:00,23,1,24
"13625",10401,"Mount Pearl","NL",47.50513,-52.79476,2018-07-22 13:00:00,25,1,26
"13626",10401,"Mount Pearl","NL",47.50513,-52.79476,2018-07-22 14:00:00,26,0,26
"13627",10401,"Mount Pearl","NL",47.50513,-52.79476,2018-07-22 15:00:00,33,1,34
"13628",10401,"Mount Pearl","NL",47.50513,-52.79476,2018-07-22 16:00:00,35,1,36
"13629",10401,"Mount Pearl","NL",47.50513,-52.79476,2018-07-22 17:00:00,36,1,37
"13630",10401,"Mount Pearl","NL",47.50513,-52.79476,2018-07-22 18:00:00,28,1,29
"13631",10401,"Mount Pearl","NL",47.50513,-52.79476,2018-07-22 19:00:00,22,0,22
"13632",10401,"Mount Pearl","NL",47.50513,-52.79476,2018-07-22 20:00:00,19,1,20
"13633",10401,"Mount Pearl","NL",47.50513,-52.79476,2018-07-22 21:00:00,16,0,16
"13634",10401,"Mount Pearl","NL",47.50513,-52.79476,2018-07-22 22:00:00,15,1,16
"13635",10401,"Mount Pearl","NL",47.50513,-52.79476,2018-07-22 23:00:00,17,0,17
"13636",10401,"Mount Pearl","NL",47.50513,-52.79476,2018-07-23 00:00:00,18,0,18
"13637",10401,"Mount Pearl","NL",47.50513,-52.79476,2018-07-23 01:00:00,18,0,18
"13638",10401,"Mount Pearl","NL",47.50513,-52.79476,2018-07-23 02:00:00,17,0,17
"13639",10401,"Mount Pearl","NL",47.50513,-52.79476,2018-07-23 03:00:00,16,0,16
"13640",10401,"Mount Pearl","NL",47.50513,-52.79476,2018-07-23 04:00:00,18,0,18
"13641",10401,"Mount Pearl","NL",47.50513,-52.79476,2018-07-23 05:00:00,18,0,18
"13642",10401,"Mount Pearl","NL",47.50513,-52.79476,2018-07-23 06:00:00,16,0,16
"13643",10401,"Mount Pearl","NL",47.50513,-52.79476,2018-07-23 07:00:00,15,1,16
"13644",10401,"Mount Pearl","NL",47.50513,-52.79476,2018-07-23 08:00:00,16,1,17
"13645",10401,"Mount Pearl","NL",47.50513,-52.79476,2018-07-23 09:00:00,14,2,16
"13646",10401,"Mount Pearl","NL",47.50513,-52.79476,2018-07-23 10:00:00,14,1,15
"13647",10401,"Mount Pearl","NL",47.50513,-52.79476,2018-07-23 11:00:00,12,0,12
"13648",10401,"Mount Pearl","NL",47.50513,-52.79476,2018-07-23 12:00:00,11,1,12
"13649",10401,"Mount Pearl","NL",47.50513,-52.79476,2018-07-23 13:00:00,12,1,13
"13650",10401,"Mount Pearl","NL",47.50513,-52.79476,2018-07-23 14:00:00,11,1,12
"13651",10401,"Mount Pearl","NL",47.50513,-52.79476,2018-07-23 15:00:00,11,0,11
"13652",10401,"Mount Pearl","NL",47.50513,-52.79476,2018-07-23 16:00:00,12,0,12
"13653",10401,"Mount Pearl","NL",47.50513,-52.79476,2018-07-23 17:00:00,14,0,14
"13654",10401,"Mount Pearl","NL",47.50513,-52.79476,2018-07-23 18:00:00,13,1,14
"13655",10401,"Mount Pearl","NL",47.50513,-52.79476,2018-07-23 19:00:00,12,0,12
"13656",10401,"Mount Pearl","NL",47.50513,-52.79476,2018-07-23 20:00:00,12,0,12
"13657",10401,"Mount Pearl","NL",47.50513,-52.79476,2018-07-23 21:00:00,12,1,13
"13658",10401,"Mount Pearl","NL",47.50513,-52.79476,2018-07-23 22:00:00,11,1,12
"13659",10401,"Mount Pearl","NL",47.50513,-52.79476,2018-07-23 23:00:00,11,1,12
"13660",10401,"Mount Pearl","NL",47.50513,-52.79476,2018-07-24 00:00:00,12,1,13
"13661",10401,"Mount Pearl","NL",47.50513,-52.79476,2018-07-24 01:00:00,17,1,18
"13662",10401,"Mount Pearl","NL",47.50513,-52.79476,2018-07-24 02:00:00,17,0,17
"13663",10401,"Mount Pearl","NL",47.50513,-52.79476,2018-07-24 03:00:00,18,0,18
"13664",10401,"Mount Pearl","NL",47.50513,-52.79476,2018-07-24 04:00:00,19,0,19
"13665",10401,"Mount Pearl","NL",47.50513,-52.79476,2018-07-24 05:00:00,16,0,16
"13666",10401,"Mount Pearl","NL",47.50513,-52.79476,2018-07-24 06:00:00,18,1,19
"13667",10401,"Mount Pearl","NL",47.50513,-52.79476,2018-07-24 07:00:00,17,1,18
"13668",10401,"Mount Pearl","NL",47.50513,-52.79476,2018-07-24 08:00:00,15,3,18
"13669",10401,"Mount Pearl","NL",47.50513,-52.79476,2018-07-24 09:00:00,15,1,16
"13670",10401,"Mount Pearl","NL",47.50513,-52.79476,2018-07-24 10:00:00,17,1,18
"13671",10401,"Mount Pearl","NL",47.50513,-52.79476,2018-07-24 11:00:00,17,0,17
"13672",10401,"Mount Pearl","NL",47.50513,-52.79476,2018-07-24 12:00:00,16,2,18
"13673",10401,"Mount Pearl","NL",47.50513,-52.79476,2018-07-24 13:00:00,18,2,20
"13674",10401,"Mount Pearl","NL",47.50513,-52.79476,2018-07-24 14:00:00,19,2,21
"13675",10401,"Mount Pearl","NL",47.50513,-52.79476,2018-07-24 15:00:00,18,2,20
"13676",10401,"Mount Pearl","NL",47.50513,-52.79476,2018-07-24 16:00:00,15,2,17
"13677",10401,"Mount Pearl","NL",47.50513,-52.79476,2018-07-24 17:00:00,14,2,16
"13678",10401,"Mount Pearl","NL",47.50513,-52.79476,2018-07-24 18:00:00,12,3,15
"13679",10401,"Mount Pearl","NL",47.50513,-52.79476,2018-07-24 19:00:00,11,2,13
"13680",10401,"Mount Pearl","NL",47.50513,-52.79476,2018-07-24 20:00:00,10,2,12
"13681",10401,"Mount Pearl","NL",47.50513,-52.79476,2018-07-24 21:00:00,8,2,10
"13682",10401,"Mount Pearl","NL",47.50513,-52.79476,2018-07-24 22:00:00,13,1,14
"13683",10401,"Mount Pearl","NL",47.50513,-52.79476,2018-07-24 23:00:00,13,1,14
"13684",10401,"Mount Pearl","NL",47.50513,-52.79476,2018-07-25 00:00:00,13,1,14
"13685",10401,"Mount Pearl","NL",47.50513,-52.79476,2018-07-25 01:00:00,13,1,14
"13686",10401,"Mount Pearl","NL",47.50513,-52.79476,2018-07-25 02:00:00,12,2,14
"13687",10401,"Mount Pearl","NL",47.50513,-52.79476,2018-07-25 03:00:00,13,1,14
"13688",10401,"Mount Pearl","NL",47.50513,-52.79476,2018-07-25 04:00:00,13,2,15
"13689",10401,"Mount Pearl","NL",47.50513,-52.79476,2018-07-25 05:00:00,13,2,15
"13690",10401,"Mount Pearl","NL",47.50513,-52.79476,2018-07-25 06:00:00,13,2,15
"13691",10401,"Mount Pearl","NL",47.50513,-52.79476,2018-07-25 07:00:00,11,2,13
"13692",10401,"Mount Pearl","NL",47.50513,-52.79476,2018-07-25 08:00:00,11,2,13
"13693",10401,"Mount Pearl","NL",47.50513,-52.79476,2018-07-25 09:00:00,12,2,14
"13694",10401,"Mount Pearl","NL",47.50513,-52.79476,2018-07-25 10:00:00,13,2,15
"13695",10401,"Mount Pearl","NL",47.50513,-52.79476,2018-07-25 11:00:00,14,2,16
"13696",10401,"Mount Pearl","NL",47.50513,-52.79476,2018-07-25 12:00:00,16,1,17
"13697",10401,"Mount Pearl","NL",47.50513,-52.79476,2018-07-25 13:00:00,16,1,17
"13698",10401,"Mount Pearl","NL",47.50513,-52.79476,2018-07-25 14:00:00,17,0,17
"13699",10401,"Mount Pearl","NL",47.50513,-52.79476,2018-07-25 15:00:00,18,0,18
"13700",10401,"Mount Pearl","NL",47.50513,-52.79476,2018-07-25 16:00:00,17,0,17
"13701",10401,"Mount Pearl","NL",47.50513,-52.79476,2018-07-25 17:00:00,17,0,17
"13702",10401,"Mount Pearl","NL",47.50513,-52.79476,2018-07-25 18:00:00,17,0,17
"13703",10401,"Mount Pearl","NL",47.50513,-52.79476,2018-07-25 19:00:00,17,0,17
"13704",10401,"Mount Pearl","NL",47.50513,-52.79476,2018-07-25 20:00:00,17,0,17
"13705",10401,"Mount Pearl","NL",47.50513,-52.79476,2018-07-25 21:00:00,17,0,17
"13706",10401,"Mount Pearl","NL",47.50513,-52.79476,2018-07-25 22:00:00,17,0,17
"13707",10401,"Mount Pearl","NL",47.50513,-52.79476,2018-07-25 23:00:00,16,0,16
"13708",10401,"Mount Pearl","NL",47.50513,-52.79476,2018-07-26 00:00:00,16,0,16
"13709",10401,"Mount Pearl","NL",47.50513,-52.79476,2018-07-26 01:00:00,16,0,16
"13710",10401,"Mount Pearl","NL",47.50513,-52.79476,2018-07-26 02:00:00,15,0,15
"13711",10401,"Mount Pearl","NL",47.50513,-52.79476,2018-07-26 03:00:00,13,0,13
"13712",10401,"Mount Pearl","NL",47.50513,-52.79476,2018-07-26 04:00:00,12,0,12
"13713",10401,"Mount Pearl","NL",47.50513,-52.79476,2018-07-26 05:00:00,12,0,12
"13714",10401,"Mount Pearl","NL",47.50513,-52.79476,2018-07-26 06:00:00,11,1,12
"13715",10401,"Mount Pearl","NL",47.50513,-52.79476,2018-07-26 07:00:00,10,1,11
"13716",10401,"Mount Pearl","NL",47.50513,-52.79476,2018-07-26 08:00:00,9,1,10
"13717",10401,"Mount Pearl","NL",47.50513,-52.79476,2018-07-26 09:00:00,10,1,11
"13718",10401,"Mount Pearl","NL",47.50513,-52.79476,2018-07-26 10:00:00,14,1,15
"13719",10401,"Mount Pearl","NL",47.50513,-52.79476,2018-07-26 11:00:00,18,1,19
"13720",10401,"Mount Pearl","NL",47.50513,-52.79476,2018-07-26 12:00:00,20,2,22
"13721",10401,"Mount Pearl","NL",47.50513,-52.79476,2018-07-26 13:00:00,20,2,22
"13722",10401,"Mount Pearl","NL",47.50513,-52.79476,2018-07-26 14:00:00,18,1,19
"13723",10401,"Mount Pearl","NL",47.50513,-52.79476,2018-07-26 15:00:00,18,2,20
"13724",10401,"Mount Pearl","NL",47.50513,-52.79476,2018-07-26 16:00:00,17,2,19
"13725",10401,"Mount Pearl","NL",47.50513,-52.79476,2018-07-26 17:00:00,17,1,18
"13726",10401,"Mount Pearl","NL",47.50513,-52.79476,2018-07-26 18:00:00,17,2,19
"13727",10401,"Mount Pearl","NL",47.50513,-52.79476,2018-07-26 19:00:00,16,1,17
"13728",10401,"Mount Pearl","NL",47.50513,-52.79476,2018-07-26 20:00:00,15,2,17
"13729",10401,"Mount Pearl","NL",47.50513,-52.79476,2018-07-26 21:00:00,15,1,16
"13730",10401,"Mount Pearl","NL",47.50513,-52.79476,2018-07-26 22:00:00,15,1,16
"13731",10401,"Mount Pearl","NL",47.50513,-52.79476,2018-07-26 23:00:00,15,1,16
"13732",10401,"Mount Pearl","NL",47.50513,-52.79476,2018-07-27 00:00:00,15,1,16
"13733",10401,"Mount Pearl","NL",47.50513,-52.79476,2018-07-27 01:00:00,15,0,15
"13734",10401,"Mount Pearl","NL",47.50513,-52.79476,2018-07-27 02:00:00,15,1,16
"13735",10401,"Mount Pearl","NL",47.50513,-52.79476,2018-07-27 03:00:00,15,1,16
"13736",10401,"Mount Pearl","NL",47.50513,-52.79476,2018-07-27 04:00:00,16,1,17
"13737",10401,"Mount Pearl","NL",47.50513,-52.79476,2018-07-27 05:00:00,16,1,17
"13738",10401,"Mount Pearl","NL",47.50513,-52.79476,2018-07-27 06:00:00,16,1,17
"13739",10401,"Mount Pearl","NL",47.50513,-52.79476,2018-07-27 07:00:00,16,1,17
"13740",10401,"Mount Pearl","NL",47.50513,-52.79476,2018-07-27 08:00:00,16,2,18
"13741",10401,"Mount Pearl","NL",47.50513,-52.79476,2018-07-27 09:00:00,16,1,17
"13742",10401,"Mount Pearl","NL",47.50513,-52.79476,2018-07-27 10:00:00,15,1,16
"13743",10401,"Mount Pearl","NL",47.50513,-52.79476,2018-07-27 11:00:00,15,2,17
"13744",10401,"Mount Pearl","NL",47.50513,-52.79476,2018-07-27 12:00:00,16,0,16
"13745",10401,"Mount Pearl","NL",47.50513,-52.79476,2018-07-27 13:00:00,16,0,16
"13746",10401,"Mount Pearl","NL",47.50513,-52.79476,2018-07-27 14:00:00,16,0,16
"13747",10401,"Mount Pearl","NL",47.50513,-52.79476,2018-07-27 15:00:00,16,0,16
"13748",10401,"Mount Pearl","NL",47.50513,-52.79476,2018-07-27 16:00:00,19,0,19
"13749",10401,"Mount Pearl","NL",47.50513,-52.79476,2018-07-27 17:00:00,23,0,23
"13750",10401,"Mount Pearl","NL",47.50513,-52.79476,2018-07-27 18:00:00,27,0,27
"13751",10401,"Mount Pearl","NL",47.50513,-52.79476,2018-07-27 19:00:00,28,1,29
"13752",10401,"Mount Pearl","NL",47.50513,-52.79476,2018-07-27 20:00:00,27,0,27
"13753",10401,"Mount Pearl","NL",47.50513,-52.79476,2018-07-27 21:00:00,20,1,21
"13754",10401,"Mount Pearl","NL",47.50513,-52.79476,2018-07-27 22:00:00,15,0,15
"13755",10401,"Mount Pearl","NL",47.50513,-52.79476,2018-07-27 23:00:00,14,0,14
"13756",10401,"Mount Pearl","NL",47.50513,-52.79476,2018-07-28 00:00:00,14,1,15
"13757",10401,"Mount Pearl","NL",47.50513,-52.79476,2018-07-28 01:00:00,14,1,15
"13758",10401,"Mount Pearl","NL",47.50513,-52.79476,2018-07-28 02:00:00,15,1,16
"13759",10401,"Mount Pearl","NL",47.50513,-52.79476,2018-07-28 03:00:00,16,0,16
"13760",10401,"Mount Pearl","NL",47.50513,-52.79476,2018-07-28 04:00:00,16,0,16
"13761",10401,"Mount Pearl","NL",47.50513,-52.79476,2018-07-28 05:00:00,16,1,17
"13762",10401,"Mount Pearl","NL",47.50513,-52.79476,2018-07-28 06:00:00,18,1,19
"13763",10401,"Mount Pearl","NL",47.50513,-52.79476,2018-07-28 07:00:00,19,1,20
"13764",10401,"Mount Pearl","NL",47.50513,-52.79476,2018-07-28 08:00:00,20,0,20
"13765",10401,"Mount Pearl","NL",47.50513,-52.79476,2018-07-28 09:00:00,20,1,21
"13766",10401,"Mount Pearl","NL",47.50513,-52.79476,2018-07-28 10:00:00,20,0,20
"13767",10401,"Mount Pearl","NL",47.50513,-52.79476,2018-07-28 11:00:00,20,0,20
"13768",10401,"Mount Pearl","NL",47.50513,-52.79476,2018-07-28 12:00:00,20,1,21
"13769",10401,"Mount Pearl","NL",47.50513,-52.79476,2018-07-28 13:00:00,20,1,21
"13770",10401,"Mount Pearl","NL",47.50513,-52.79476,2018-07-28 14:00:00,19,0,19
"13771",10401,"Mount Pearl","NL",47.50513,-52.79476,2018-07-28 15:00:00,19,1,20
"13772",10401,"Mount Pearl","NL",47.50513,-52.79476,2018-07-28 16:00:00,18,0,18
"13773",10401,"Mount Pearl","NL",47.50513,-52.79476,2018-07-28 17:00:00,17,1,18
"13774",10401,"Mount Pearl","NL",47.50513,-52.79476,2018-07-28 18:00:00,15,1,16
"13775",10401,"Mount Pearl","NL",47.50513,-52.79476,2018-07-28 19:00:00,15,1,16
"13776",10401,"Mount Pearl","NL",47.50513,-52.79476,2018-07-28 20:00:00,12,1,13
"13777",10401,"Mount Pearl","NL",47.50513,-52.79476,2018-07-28 21:00:00,10,1,11
"13778",10401,"Mount Pearl","NL",47.50513,-52.79476,2018-07-28 22:00:00,9,0,9
"13779",10401,"Mount Pearl","NL",47.50513,-52.79476,2018-07-28 23:00:00,7,1,8
"13780",10401,"Mount Pearl","NL",47.50513,-52.79476,2018-07-29 00:00:00,6,1,7
"13781",10401,"Mount Pearl","NL",47.50513,-52.79476,2018-07-29 01:00:00,6,1,7
"13782",10401,"Mount Pearl","NL",47.50513,-52.79476,2018-07-29 02:00:00,8,0,8
"13783",10401,"Mount Pearl","NL",47.50513,-52.79476,2018-07-29 03:00:00,8,1,9
"13784",10401,"Mount Pearl","NL",47.50513,-52.79476,2018-07-29 04:00:00,14,1,15
"13785",10401,"Mount Pearl","NL",47.50513,-52.79476,2018-07-29 05:00:00,11,1,12
"13786",10401,"Mount Pearl","NL",47.50513,-52.79476,2018-07-29 06:00:00,14,0,14
"13787",10401,"Mount Pearl","NL",47.50513,-52.79476,2018-07-29 07:00:00,15,0,15
"13788",10401,"Mount Pearl","NL",47.50513,-52.79476,2018-07-29 08:00:00,13,0,13
"13789",10401,"Mount Pearl","NL",47.50513,-52.79476,2018-07-29 09:00:00,12,0,12
"13790",10401,"Mount Pearl","NL",47.50513,-52.79476,2018-07-29 10:00:00,12,0,12
"13791",10401,"Mount Pearl","NL",47.50513,-52.79476,2018-07-29 11:00:00,12,0,12
"13792",10401,"Mount Pearl","NL",47.50513,-52.79476,2018-07-29 12:00:00,14,1,15
"13793",10401,"Mount Pearl","NL",47.50513,-52.79476,2018-07-29 13:00:00,16,0,16
"13794",10401,"Mount Pearl","NL",47.50513,-52.79476,2018-07-29 14:00:00,19,1,20
"13795",10401,"Mount Pearl","NL",47.50513,-52.79476,2018-07-29 15:00:00,19,0,19
"13796",10401,"Mount Pearl","NL",47.50513,-52.79476,2018-07-29 16:00:00,18,1,19
"13797",10401,"Mount Pearl","NL",47.50513,-52.79476,2018-07-29 17:00:00,18,1,19
"13798",10401,"Mount Pearl","NL",47.50513,-52.79476,2018-07-29 18:00:00,22,1,23
"13799",10401,"Mount Pearl","NL",47.50513,-52.79476,2018-07-29 19:00:00,20,1,21
"13800",10401,"Mount Pearl","NL",47.50513,-52.79476,2018-07-29 20:00:00,22,1,23
"13801",10401,"Mount Pearl","NL",47.50513,-52.79476,2018-07-29 21:00:00,17,0,17
"13802",10401,"Mount Pearl","NL",47.50513,-52.79476,2018-07-29 22:00:00,17,1,18
"13803",10401,"Mount Pearl","NL",47.50513,-52.79476,2018-07-29 23:00:00,17,0,17
"13804",10401,"Mount Pearl","NL",47.50513,-52.79476,2018-07-30 00:00:00,28,0,28
"13805",10401,"Mount Pearl","NL",47.50513,-52.79476,2018-07-30 01:00:00,28,1,29
"13806",10401,"Mount Pearl","NL",47.50513,-52.79476,2018-07-30 02:00:00,26,0,26
"13807",10401,"Mount Pearl","NL",47.50513,-52.79476,2018-07-30 03:00:00,27,0,27
"13808",10401,"Mount Pearl","NL",47.50513,-52.79476,2018-07-30 04:00:00,26,0,26
"13809",10401,"Mount Pearl","NL",47.50513,-52.79476,2018-07-30 05:00:00,28,1,29
"13810",10401,"Mount Pearl","NL",47.50513,-52.79476,2018-07-30 06:00:00,26,0,26
"13811",10401,"Mount Pearl","NL",47.50513,-52.79476,2018-07-30 07:00:00,26,1,27
"13812",10401,"Mount Pearl","NL",47.50513,-52.79476,2018-07-30 08:00:00,25,1,26
"13813",10401,"Mount Pearl","NL",47.50513,-52.79476,2018-07-30 09:00:00,23,2,25
"13814",10401,"Mount Pearl","NL",47.50513,-52.79476,2018-07-30 10:00:00,21,2,23
"13815",10401,"Mount Pearl","NL",47.50513,-52.79476,2018-07-30 11:00:00,25,1,26
"13816",10401,"Mount Pearl","NL",47.50513,-52.79476,2018-07-30 12:00:00,26,1,27
"13817",10401,"Mount Pearl","NL",47.50513,-52.79476,2018-07-30 13:00:00,29,1,30
"13818",10401,"Mount Pearl","NL",47.50513,-52.79476,2018-07-30 14:00:00,29,1,30
"13819",10401,"Mount Pearl","NL",47.50513,-52.79476,2018-07-30 15:00:00,29,1,30
"13820",10401,"Mount Pearl","NL",47.50513,-52.79476,2018-07-30 16:00:00,29,1,30
"13821",10401,"Mount Pearl","NL",47.50513,-52.79476,2018-07-30 17:00:00,28,1,29
"13822",10401,"Mount Pearl","NL",47.50513,-52.79476,2018-07-30 18:00:00,27,1,28
"13823",10401,"Mount Pearl","NL",47.50513,-52.79476,2018-07-30 19:00:00,26,1,27
"13824",10401,"Mount Pearl","NL",47.50513,-52.79476,2018-07-30 20:00:00,26,0,26
"13825",10401,"Mount Pearl","NL",47.50513,-52.79476,2018-07-30 21:00:00,26,1,27
"13826",10401,"Mount Pearl","NL",47.50513,-52.79476,2018-07-30 22:00:00,24,1,25
"13827",10401,"Mount Pearl","NL",47.50513,-52.79476,2018-07-30 23:00:00,23,0,23
"13828",10401,"Mount Pearl","NL",47.50513,-52.79476,2018-07-31 00:00:00,20,0,20
"13829",10401,"Mount Pearl","NL",47.50513,-52.79476,2018-07-31 01:00:00,19,1,20
"13830",10401,"Mount Pearl","NL",47.50513,-52.79476,2018-07-31 02:00:00,19,1,20
"13831",10401,"Mount Pearl","NL",47.50513,-52.79476,2018-07-31 03:00:00,18,1,19
"13832",10401,"Mount Pearl","NL",47.50513,-52.79476,2018-07-31 04:00:00,17,1,18
"13833",10401,"Mount Pearl","NL",47.50513,-52.79476,2018-07-31 05:00:00,15,1,16
"13834",10401,"Mount Pearl","NL",47.50513,-52.79476,2018-07-31 06:00:00,14,2,16
"13835",10401,"Mount Pearl","NL",47.50513,-52.79476,2018-07-31 07:00:00,14,2,16
"13836",10401,"Mount Pearl","NL",47.50513,-52.79476,2018-07-31 08:00:00,14,2,16
"13837",10401,"Mount Pearl","NL",47.50513,-52.79476,2018-07-31 09:00:00,16,0,16
"13838",10401,"Mount Pearl","NL",47.50513,-52.79476,2018-07-31 10:00:00,18,1,19
"13839",10401,"Mount Pearl","NL",47.50513,-52.79476,2018-07-31 11:00:00,20,1,21
"13840",10401,"Mount Pearl","NL",47.50513,-52.79476,2018-07-31 12:00:00,21,1,22
"13841",10401,"Mount Pearl","NL",47.50513,-52.79476,2018-07-31 13:00:00,22,0,22
"13842",10401,"Mount Pearl","NL",47.50513,-52.79476,2018-07-31 14:00:00,22,0,22
"13843",10401,"Mount Pearl","NL",47.50513,-52.79476,2018-07-31 15:00:00,21,1,22
"13844",10401,"Mount Pearl","NL",47.50513,-52.79476,2018-07-31 16:00:00,21,1,22
"13845",10401,"Mount Pearl","NL",47.50513,-52.79476,2018-07-31 17:00:00,22,1,23
"13846",10401,"Mount Pearl","NL",47.50513,-52.79476,2018-07-31 18:00:00,23,1,24
"13847",10401,"Mount Pearl","NL",47.50513,-52.79476,2018-07-31 19:00:00,22,1,23
"13848",10401,"Mount Pearl","NL",47.50513,-52.79476,2018-07-31 20:00:00,20,1,21
"13849",10401,"Mount Pearl","NL",47.50513,-52.79476,2018-07-31 21:00:00,19,2,21
"13850",10401,"Mount Pearl","NL",47.50513,-52.79476,2018-07-31 22:00:00,21,2,23
"13851",10401,"Mount Pearl","NL",47.50513,-52.79476,2018-07-31 23:00:00,20,1,21
"13852",10401,"Mount Pearl","NL",47.50513,-52.79476,2018-08-01 00:00:00,21,1,22
"13853",10401,"Mount Pearl","NL",47.50513,-52.79476,2018-08-01 01:00:00,19,1,20
"13854",10401,"Mount Pearl","NL",47.50513,-52.79476,2018-08-01 02:00:00,16,1,17
"13855",10401,"Mount Pearl","NL",47.50513,-52.79476,2018-08-01 03:00:00,17,1,18
"13856",10401,"Mount Pearl","NL",47.50513,-52.79476,2018-08-01 04:00:00,17,1,18
"13857",10401,"Mount Pearl","NL",47.50513,-52.79476,2018-08-01 05:00:00,17,1,18
"13858",10401,"Mount Pearl","NL",47.50513,-52.79476,2018-08-01 06:00:00,13,2,15
"13859",10401,"Mount Pearl","NL",47.50513,-52.79476,2018-08-01 07:00:00,15,4,19
"13860",10401,"Mount Pearl","NL",47.50513,-52.79476,2018-08-01 08:00:00,17,3,20
"13861",10401,"Mount Pearl","NL",47.50513,-52.79476,2018-08-01 09:00:00,21,1,22
"13862",10401,"Mount Pearl","NL",47.50513,-52.79476,2018-08-01 10:00:00,25,1,26
"13863",10401,"Mount Pearl","NL",47.50513,-52.79476,2018-08-01 11:00:00,27,1,28
"13864",10401,"Mount Pearl","NL",47.50513,-52.79476,2018-08-01 12:00:00,26,0,26
"13865",10401,"Mount Pearl","NL",47.50513,-52.79476,2018-08-01 13:00:00,26,0,26
"13866",10401,"Mount Pearl","NL",47.50513,-52.79476,2018-08-01 14:00:00,25,0,25
"13867",10401,"Mount Pearl","NL",47.50513,-52.79476,2018-08-01 15:00:00,25,0,25
"13868",10401,"Mount Pearl","NL",47.50513,-52.79476,2018-08-01 16:00:00,25,1,26
"13869",10401,"Mount Pearl","NL",47.50513,-52.79476,2018-08-01 17:00:00,24,1,25
"13870",10401,"Mount Pearl","NL",47.50513,-52.79476,2018-08-01 18:00:00,23,1,24
"13871",10401,"Mount Pearl","NL",47.50513,-52.79476,2018-08-01 19:00:00,22,1,23
"13872",10401,"Mount Pearl","NL",47.50513,-52.79476,2018-08-01 20:00:00,22,2,24
"13873",10401,"Mount Pearl","NL",47.50513,-52.79476,2018-08-01 21:00:00,22,2,24
"13874",10401,"Mount Pearl","NL",47.50513,-52.79476,2018-08-01 22:00:00,26,1,27
"13875",10401,"Mount Pearl","NL",47.50513,-52.79476,2018-08-01 23:00:00,29,1,30
"13876",10401,"Mount Pearl","NL",47.50513,-52.79476,2018-08-02 00:00:00,29,1,30
"13877",10401,"Mount Pearl","NL",47.50513,-52.79476,2018-08-02 01:00:00,29,1,30
"13878",10401,"Mount Pearl","NL",47.50513,-52.79476,2018-08-02 02:00:00,30,1,31
"13879",10401,"Mount Pearl","NL",47.50513,-52.79476,2018-08-02 03:00:00,30,1,31
"13880",10401,"Mount Pearl","NL",47.50513,-52.79476,2018-08-02 04:00:00,31,1,32
"13881",10401,"Mount Pearl","NL",47.50513,-52.79476,2018-08-02 05:00:00,32,1,33
"13882",10401,"Mount Pearl","NL",47.50513,-52.79476,2018-08-02 06:00:00,32,1,33
"13883",10401,"Mount Pearl","NL",47.50513,-52.79476,2018-08-02 07:00:00,31,2,33
"13884",10401,"Mount Pearl","NL",47.50513,-52.79476,2018-08-02 08:00:00,30,3,33
"13885",10401,"Mount Pearl","NL",47.50513,-52.79476,2018-08-02 09:00:00,29,2,31
"13886",10401,"Mount Pearl","NL",47.50513,-52.79476,2018-08-02 10:00:00,29,2,31
"13887",10401,"Mount Pearl","NL",47.50513,-52.79476,2018-08-02 11:00:00,29,2,31
"13888",10401,"Mount Pearl","NL",47.50513,-52.79476,2018-08-02 12:00:00,30,1,31
"13889",10401,"Mount Pearl","NL",47.50513,-52.79476,2018-08-02 13:00:00,30,1,31
"13890",10401,"Mount Pearl","NL",47.50513,-52.79476,2018-08-02 14:00:00,30,1,31
"13891",10401,"Mount Pearl","NL",47.50513,-52.79476,2018-08-02 15:00:00,31,1,32
"13892",10401,"Mount Pearl","NL",47.50513,-52.79476,2018-08-02 16:00:00,31,1,32
"13893",10401,"Mount Pearl","NL",47.50513,-52.79476,2018-08-02 17:00:00,31,1,32
"13894",10401,"Mount Pearl","NL",47.50513,-52.79476,2018-08-02 18:00:00,30,1,31
"13895",10401,"Mount Pearl","NL",47.50513,-52.79476,2018-08-02 19:00:00,28,1,29
"13896",10401,"Mount Pearl","NL",47.50513,-52.79476,2018-08-02 20:00:00,27,1,28
"13897",10401,"Mount Pearl","NL",47.50513,-52.79476,2018-08-02 21:00:00,26,1,27
"13898",10401,"Mount Pearl","NL",47.50513,-52.79476,2018-08-02 22:00:00,26,0,26
"13899",10401,"Mount Pearl","NL",47.50513,-52.79476,2018-08-02 23:00:00,29,1,30
"13900",10401,"Mount Pearl","NL",47.50513,-52.79476,2018-08-03 00:00:00,29,0,29
"13901",10401,"Mount Pearl","NL",47.50513,-52.79476,2018-08-03 01:00:00,27,1,28
"13902",10401,"Mount Pearl","NL",47.50513,-52.79476,2018-08-03 02:00:00,25,0,25
"13903",10401,"Mount Pearl","NL",47.50513,-52.79476,2018-08-03 03:00:00,23,0,23
"13904",10401,"Mount Pearl","NL",47.50513,-52.79476,2018-08-03 04:00:00,22,0,22
"13905",10401,"Mount Pearl","NL",47.50513,-52.79476,2018-08-03 05:00:00,21,0,21
"13906",10401,"Mount Pearl","NL",47.50513,-52.79476,2018-08-03 06:00:00,20,0,20
"13907",10401,"Mount Pearl","NL",47.50513,-52.79476,2018-08-03 07:00:00,18,1,19
"13908",10401,"Mount Pearl","NL",47.50513,-52.79476,2018-08-03 08:00:00,17,1,18
"13909",10401,"Mount Pearl","NL",47.50513,-52.79476,2018-08-03 09:00:00,17,0,17
"13910",10401,"Mount Pearl","NL",47.50513,-52.79476,2018-08-03 10:00:00,20,0,20
"13911",10401,"Mount Pearl","NL",47.50513,-52.79476,2018-08-03 11:00:00,21,0,21
"13912",10401,"Mount Pearl","NL",47.50513,-52.79476,2018-08-03 12:00:00,26,1,27
"13913",10401,"Mount Pearl","NL",47.50513,-52.79476,2018-08-03 13:00:00,28,1,29
"13914",10401,"Mount Pearl","NL",47.50513,-52.79476,2018-08-03 14:00:00,27,1,28
"13915",10401,"Mount Pearl","NL",47.50513,-52.79476,2018-08-03 15:00:00,22,2,24
"13916",10401,"Mount Pearl","NL",47.50513,-52.79476,2018-08-03 16:00:00,19,2,21
"13917",10401,"Mount Pearl","NL",47.50513,-52.79476,2018-08-03 17:00:00,18,3,21
"13918",10401,"Mount Pearl","NL",47.50513,-52.79476,2018-08-03 18:00:00,18,1,19
"13919",10401,"Mount Pearl","NL",47.50513,-52.79476,2018-08-03 19:00:00,16,1,17
"13920",10401,"Mount Pearl","NL",47.50513,-52.79476,2018-08-03 20:00:00,15,1,16
"13921",10401,"Mount Pearl","NL",47.50513,-52.79476,2018-08-03 21:00:00,15,1,16
"13922",10401,"Mount Pearl","NL",47.50513,-52.79476,2018-08-03 22:00:00,15,1,16
"13923",10401,"Mount Pearl","NL",47.50513,-52.79476,2018-08-03 23:00:00,15,0,15
"13924",10401,"Mount Pearl","NL",47.50513,-52.79476,2018-08-04 00:00:00,16,0,16
"13925",10401,"Mount Pearl","NL",47.50513,-52.79476,2018-08-04 01:00:00,16,1,17
"13926",10401,"Mount Pearl","NL",47.50513,-52.79476,2018-08-04 02:00:00,17,0,17
"13927",10401,"Mount Pearl","NL",47.50513,-52.79476,2018-08-04 03:00:00,18,1,19
"13928",10401,"Mount Pearl","NL",47.50513,-52.79476,2018-08-04 04:00:00,18,0,18
"13929",10401,"Mount Pearl","NL",47.50513,-52.79476,2018-08-04 05:00:00,19,0,19
"13930",10401,"Mount Pearl","NL",47.50513,-52.79476,2018-08-04 06:00:00,17,1,18
"13931",10401,"Mount Pearl","NL",47.50513,-52.79476,2018-08-04 07:00:00,17,1,18
"13932",10401,"Mount Pearl","NL",47.50513,-52.79476,2018-08-04 08:00:00,16,2,18
"13933",10401,"Mount Pearl","NL",47.50513,-52.79476,2018-08-04 09:00:00,16,2,18
"13934",10401,"Mount Pearl","NL",47.50513,-52.79476,2018-08-04 10:00:00,17,1,18
"13935",10401,"Mount Pearl","NL",47.50513,-52.79476,2018-08-04 11:00:00,18,1,19
"13936",10401,"Mount Pearl","NL",47.50513,-52.79476,2018-08-04 12:00:00,17,2,19
"13937",10401,"Mount Pearl","NL",47.50513,-52.79476,2018-08-04 13:00:00,17,2,19
"13938",10401,"Mount Pearl","NL",47.50513,-52.79476,2018-08-04 14:00:00,17,2,19
"13939",10401,"Mount Pearl","NL",47.50513,-52.79476,2018-08-04 15:00:00,18,2,20
"13940",10401,"Mount Pearl","NL",47.50513,-52.79476,2018-08-04 16:00:00,18,1,19
"13941",10401,"Mount Pearl","NL",47.50513,-52.79476,2018-08-04 17:00:00,17,2,19
"13942",10401,"Mount Pearl","NL",47.50513,-52.79476,2018-08-04 18:00:00,17,2,19
"13943",10401,"Mount Pearl","NL",47.50513,-52.79476,2018-08-04 19:00:00,16,1,17
"13944",10401,"Mount Pearl","NL",47.50513,-52.79476,2018-08-04 20:00:00,16,2,18
"13945",10401,"Mount Pearl","NL",47.50513,-52.79476,2018-08-04 21:00:00,16,2,18
"13946",10401,"Mount Pearl","NL",47.50513,-52.79476,2018-08-04 22:00:00,16,2,18
"13947",10401,"Mount Pearl","NL",47.50513,-52.79476,2018-08-04 23:00:00,16,2,18
"13948",10401,"Mount Pearl","NL",47.50513,-52.79476,2018-08-05 00:00:00,16,2,18
"13949",10401,"Mount Pearl","NL",47.50513,-52.79476,2018-08-05 01:00:00,16,2,18
"13950",10401,"Mount Pearl","NL",47.50513,-52.79476,2018-08-05 02:00:00,14,1,15
"13951",10401,"Mount Pearl","NL",47.50513,-52.79476,2018-08-05 03:00:00,15,1,16
"13952",10401,"Mount Pearl","NL",47.50513,-52.79476,2018-08-05 04:00:00,14,2,16
"13953",10401,"Mount Pearl","NL",47.50513,-52.79476,2018-08-05 05:00:00,14,2,16
"13954",10401,"Mount Pearl","NL",47.50513,-52.79476,2018-08-05 06:00:00,15,1,16
"13955",10401,"Mount Pearl","NL",47.50513,-52.79476,2018-08-05 07:00:00,15,2,17
"13956",10401,"Mount Pearl","NL",47.50513,-52.79476,2018-08-05 08:00:00,16,2,18
"13957",10401,"Mount Pearl","NL",47.50513,-52.79476,2018-08-05 09:00:00,16,2,18
"13958",10401,"Mount Pearl","NL",47.50513,-52.79476,2018-08-05 10:00:00,18,1,19
"13959",10401,"Mount Pearl","NL",47.50513,-52.79476,2018-08-05 11:00:00,18,1,19
"13960",10401,"Mount Pearl","NL",47.50513,-52.79476,2018-08-05 12:00:00,17,3,20
"13961",10401,"Mount Pearl","NL",47.50513,-52.79476,2018-08-05 13:00:00,18,4,22
"13962",10401,"Mount Pearl","NL",47.50513,-52.79476,2018-08-05 14:00:00,19,4,23
"13963",10401,"Mount Pearl","NL",47.50513,-52.79476,2018-08-05 15:00:00,18,4,22
"13964",10401,"Mount Pearl","NL",47.50513,-52.79476,2018-08-05 16:00:00,20,3,23
"13965",10401,"Mount Pearl","NL",47.50513,-52.79476,2018-08-05 17:00:00,18,4,22
"13966",10401,"Mount Pearl","NL",47.50513,-52.79476,2018-08-05 18:00:00,19,4,23
"13967",10401,"Mount Pearl","NL",47.50513,-52.79476,2018-08-05 19:00:00,18,4,22
"13968",10401,"Mount Pearl","NL",47.50513,-52.79476,2018-08-05 20:00:00,18,4,22
"13969",10401,"Mount Pearl","NL",47.50513,-52.79476,2018-08-05 21:00:00,19,4,23
"13970",10401,"Mount Pearl","NL",47.50513,-52.79476,2018-08-05 22:00:00,20,4,24
"13971",10401,"Mount Pearl","NL",47.50513,-52.79476,2018-08-05 23:00:00,22,4,26
"13972",10401,"Mount Pearl","NL",47.50513,-52.79476,2018-08-06 00:00:00,18,4,22
"13973",10401,"Mount Pearl","NL",47.50513,-52.79476,2018-08-06 01:00:00,17,4,21
"13974",10401,"Mount Pearl","NL",47.50513,-52.79476,2018-08-06 02:00:00,17,4,21
"13975",10401,"Mount Pearl","NL",47.50513,-52.79476,2018-08-06 03:00:00,20,4,24
"13976",10401,"Mount Pearl","NL",47.50513,-52.79476,2018-08-06 04:00:00,18,4,22
"13977",10401,"Mount Pearl","NL",47.50513,-52.79476,2018-08-06 05:00:00,18,4,22
"13978",10401,"Mount Pearl","NL",47.50513,-52.79476,2018-08-06 06:00:00,18,4,22
"13979",10401,"Mount Pearl","NL",47.50513,-52.79476,2018-08-06 07:00:00,19,5,24
"13980",10401,"Mount Pearl","NL",47.50513,-52.79476,2018-08-06 08:00:00,19,5,24
"13981",10401,"Mount Pearl","NL",47.50513,-52.79476,2018-08-06 09:00:00,20,4,24
"13982",10401,"Mount Pearl","NL",47.50513,-52.79476,2018-08-06 10:00:00,20,4,24
"13983",10401,"Mount Pearl","NL",47.50513,-52.79476,2018-08-06 11:00:00,21,4,25
"13984",10401,"Mount Pearl","NL",47.50513,-52.79476,2018-08-06 12:00:00,17,1,18
"13985",10401,"Mount Pearl","NL",47.50513,-52.79476,2018-08-06 13:00:00,20,0,20
"13986",10401,"Mount Pearl","NL",47.50513,-52.79476,2018-08-06 14:00:00,24,0,24
"13987",10401,"Mount Pearl","NL",47.50513,-52.79476,2018-08-06 15:00:00,25,0,25
"13988",10401,"Mount Pearl","NL",47.50513,-52.79476,2018-08-06 16:00:00,25,0,25
"13989",10401,"Mount Pearl","NL",47.50513,-52.79476,2018-08-06 17:00:00,24,0,24
"13990",10401,"Mount Pearl","NL",47.50513,-52.79476,2018-08-06 18:00:00,24,0,24
"13991",10401,"Mount Pearl","NL",47.50513,-52.79476,2018-08-06 19:00:00,23,1,24
"13992",10401,"Mount Pearl","NL",47.50513,-52.79476,2018-08-06 20:00:00,24,1,25
"13993",10401,"Mount Pearl","NL",47.50513,-52.79476,2018-08-06 21:00:00,24,0,24
"13994",10401,"Mount Pearl","NL",47.50513,-52.79476,2018-08-06 22:00:00,23,0,23
"13995",10401,"Mount Pearl","NL",47.50513,-52.79476,2018-08-06 23:00:00,20,0,20
"13996",10401,"Mount Pearl","NL",47.50513,-52.79476,2018-08-07 00:00:00,17,0,17
"13997",10401,"Mount Pearl","NL",47.50513,-52.79476,2018-08-07 01:00:00,16,0,16
"13998",10401,"Mount Pearl","NL",47.50513,-52.79476,2018-08-07 02:00:00,16,0,16
"13999",10401,"Mount Pearl","NL",47.50513,-52.79476,2018-08-07 03:00:00,14,0,14
"14000",10401,"Mount Pearl","NL",47.50513,-52.79476,2018-08-07 04:00:00,14,0,14
"14001",10401,"Mount Pearl","NL",47.50513,-52.79476,2018-08-07 05:00:00,12,0,12
"14002",10401,"Mount Pearl","NL",47.50513,-52.79476,2018-08-07 06:00:00,13,1,14
"14003",10401,"Mount Pearl","NL",47.50513,-52.79476,2018-08-07 07:00:00,11,3,14
"14004",10401,"Mount Pearl","NL",47.50513,-52.79476,2018-08-07 08:00:00,12,2,14
"14005",10401,"Mount Pearl","NL",47.50513,-52.79476,2018-08-07 09:00:00,15,0,15
"14006",10401,"Mount Pearl","NL",47.50513,-52.79476,2018-08-07 10:00:00,15,0,15
"14007",10401,"Mount Pearl","NL",47.50513,-52.79476,2018-08-07 11:00:00,18,1,19
"14008",10401,"Mount Pearl","NL",47.50513,-52.79476,2018-08-07 12:00:00,19,0,19
"14009",10401,"Mount Pearl","NL",47.50513,-52.79476,2018-08-07 13:00:00,20,1,21
"14010",10401,"Mount Pearl","NL",47.50513,-52.79476,2018-08-07 14:00:00,20,1,21
"14011",10401,"Mount Pearl","NL",47.50513,-52.79476,2018-08-07 15:00:00,19,1,20
"14012",10401,"Mount Pearl","NL",47.50513,-52.79476,2018-08-07 16:00:00,18,0,18
"14013",10401,"Mount Pearl","NL",47.50513,-52.79476,2018-08-07 17:00:00,18,0,18
"14014",10401,"Mount Pearl","NL",47.50513,-52.79476,2018-08-07 18:00:00,17,1,18
"14015",10401,"Mount Pearl","NL",47.50513,-52.79476,2018-08-07 19:00:00,17,0,17
"14016",10401,"Mount Pearl","NL",47.50513,-52.79476,2018-08-07 20:00:00,15,0,15
"14017",10401,"Mount Pearl","NL",47.50513,-52.79476,2018-08-07 21:00:00,10,2,12
"14018",10401,"Mount Pearl","NL",47.50513,-52.79476,2018-08-07 22:00:00,9,1,10
"14019",10401,"Mount Pearl","NL",47.50513,-52.79476,2018-08-07 23:00:00,9,1,10
"14020",10401,"Mount Pearl","NL",47.50513,-52.79476,2018-08-08 00:00:00,8,1,9
"14021",10401,"Mount Pearl","NL",47.50513,-52.79476,2018-08-08 01:00:00,6,1,7
"14022",10401,"Mount Pearl","NL",47.50513,-52.79476,2018-08-08 02:00:00,7,1,8
"14023",10401,"Mount Pearl","NL",47.50513,-52.79476,2018-08-08 03:00:00,9,0,9
"14024",10401,"Mount Pearl","NL",47.50513,-52.79476,2018-08-08 04:00:00,7,0,7
"14025",10401,"Mount Pearl","NL",47.50513,-52.79476,2018-08-08 05:00:00,7,0,7
"14026",10401,"Mount Pearl","NL",47.50513,-52.79476,2018-08-08 06:00:00,9,1,10
"14027",10401,"Mount Pearl","NL",47.50513,-52.79476,2018-08-08 07:00:00,10,1,11
"14028",10401,"Mount Pearl","NL",47.50513,-52.79476,2018-08-08 08:00:00,10,1,11
"14029",10401,"Mount Pearl","NL",47.50513,-52.79476,2018-08-08 09:00:00,11,1,12
"14030",10401,"Mount Pearl","NL",47.50513,-52.79476,2018-08-08 10:00:00,13,0,13
"14031",10401,"Mount Pearl","NL",47.50513,-52.79476,2018-08-08 11:00:00,14,0,14
"14032",10401,"Mount Pearl","NL",47.50513,-52.79476,2018-08-08 12:00:00,16,0,16
"14033",10401,"Mount Pearl","NL",47.50513,-52.79476,2018-08-08 13:00:00,18,1,19
"14034",10401,"Mount Pearl","NL",47.50513,-52.79476,2018-08-08 14:00:00,20,0,20
"14035",10401,"Mount Pearl","NL",47.50513,-52.79476,2018-08-08 15:00:00,20,0,20
"14036",10401,"Mount Pearl","NL",47.50513,-52.79476,2018-08-08 16:00:00,20,1,21
"14037",10401,"Mount Pearl","NL",47.50513,-52.79476,2018-08-08 17:00:00,20,0,20
"14038",10401,"Mount Pearl","NL",47.50513,-52.79476,2018-08-08 18:00:00,21,1,22
"14039",10401,"Mount Pearl","NL",47.50513,-52.79476,2018-08-08 19:00:00,30,1,31
"14040",10401,"Mount Pearl","NL",47.50513,-52.79476,2018-08-08 20:00:00,35,1,36
"14041",10401,"Mount Pearl","NL",47.50513,-52.79476,2018-08-08 21:00:00,33,1,34
"14042",10401,"Mount Pearl","NL",47.50513,-52.79476,2018-08-08 22:00:00,31,1,32
"14043",10401,"Mount Pearl","NL",47.50513,-52.79476,2018-08-08 23:00:00,31,1,32
"14044",10401,"Mount Pearl","NL",47.50513,-52.79476,2018-08-09 00:00:00,29,0,29
"14045",10401,"Mount Pearl","NL",47.50513,-52.79476,2018-08-09 01:00:00,28,0,28
"14046",10401,"Mount Pearl","NL",47.50513,-52.79476,2018-08-09 02:00:00,26,1,27
"14047",10401,"Mount Pearl","NL",47.50513,-52.79476,2018-08-09 03:00:00,16,0,16
"14048",10401,"Mount Pearl","NL",47.50513,-52.79476,2018-08-09 04:00:00,18,0,18
"14049",10401,"Mount Pearl","NL",47.50513,-52.79476,2018-08-09 05:00:00,19,0,19
"14050",10401,"Mount Pearl","NL",47.50513,-52.79476,2018-08-09 06:00:00,20,0,20
"14051",10401,"Mount Pearl","NL",47.50513,-52.79476,2018-08-09 07:00:00,22,1,23
"14052",10401,"Mount Pearl","NL",47.50513,-52.79476,2018-08-09 08:00:00,23,1,24
"14053",10401,"Mount Pearl","NL",47.50513,-52.79476,2018-08-09 09:00:00,23,1,24
"14054",10401,"Mount Pearl","NL",47.50513,-52.79476,2018-08-09 10:00:00,24,1,25
"14055",10401,"Mount Pearl","NL",47.50513,-52.79476,2018-08-09 11:00:00,24,1,25
"14056",10401,"Mount Pearl","NL",47.50513,-52.79476,2018-08-09 12:00:00,23,0,23
"14057",10401,"Mount Pearl","NL",47.50513,-52.79476,2018-08-09 13:00:00,24,0,24
"14058",10401,"Mount Pearl","NL",47.50513,-52.79476,2018-08-09 14:00:00,23,0,23
"14059",10401,"Mount Pearl","NL",47.50513,-52.79476,2018-08-09 15:00:00,22,1,23
"14060",10401,"Mount Pearl","NL",47.50513,-52.79476,2018-08-09 16:00:00,24,0,24
"14061",10401,"Mount Pearl","NL",47.50513,-52.79476,2018-08-09 17:00:00,24,0,24
"14062",10401,"Mount Pearl","NL",47.50513,-52.79476,2018-08-09 18:00:00,24,0,24
"14063",10401,"Mount Pearl","NL",47.50513,-52.79476,2018-08-09 19:00:00,24,0,24
"14064",10401,"Mount Pearl","NL",47.50513,-52.79476,2018-08-09 20:00:00,24,0,24
"14065",10401,"Mount Pearl","NL",47.50513,-52.79476,2018-08-09 21:00:00,25,0,25
"14066",10401,"Mount Pearl","NL",47.50513,-52.79476,2018-08-09 22:00:00,25,1,26
"14067",10401,"Mount Pearl","NL",47.50513,-52.79476,2018-08-09 23:00:00,22,0,22
"14068",10401,"Mount Pearl","NL",47.50513,-52.79476,2018-08-10 00:00:00,23,0,23
"14069",10401,"Mount Pearl","NL",47.50513,-52.79476,2018-08-10 01:00:00,21,0,21
"14070",10401,"Mount Pearl","NL",47.50513,-52.79476,2018-08-10 02:00:00,19,0,19
"14071",10401,"Mount Pearl","NL",47.50513,-52.79476,2018-08-10 03:00:00,18,0,18
"14072",10401,"Mount Pearl","NL",47.50513,-52.79476,2018-08-10 04:00:00,18,1,19
"14073",10401,"Mount Pearl","NL",47.50513,-52.79476,2018-08-10 05:00:00,17,1,18
"14074",10401,"Mount Pearl","NL",47.50513,-52.79476,2018-08-10 06:00:00,15,1,16
"14075",10401,"Mount Pearl","NL",47.50513,-52.79476,2018-08-10 07:00:00,13,3,16
"14076",10401,"Mount Pearl","NL",47.50513,-52.79476,2018-08-10 08:00:00,17,1,18
"14077",10401,"Mount Pearl","NL",47.50513,-52.79476,2018-08-10 09:00:00,18,2,20
"14078",10401,"Mount Pearl","NL",47.50513,-52.79476,2018-08-10 10:00:00,21,0,21
"14079",10401,"Mount Pearl","NL",47.50513,-52.79476,2018-08-10 11:00:00,22,0,22
"14080",10401,"Mount Pearl","NL",47.50513,-52.79476,2018-08-10 12:00:00,25,0,25
"14081",10401,"Mount Pearl","NL",47.50513,-52.79476,2018-08-10 13:00:00,25,1,26
"14082",10401,"Mount Pearl","NL",47.50513,-52.79476,2018-08-10 14:00:00,25,1,26
"14083",10401,"Mount Pearl","NL",47.50513,-52.79476,2018-08-10 15:00:00,26,1,27
"14084",10401,"Mount Pearl","NL",47.50513,-52.79476,2018-08-10 16:00:00,27,1,28
"14085",10401,"Mount Pearl","NL",47.50513,-52.79476,2018-08-10 17:00:00,29,1,30
"14086",10401,"Mount Pearl","NL",47.50513,-52.79476,2018-08-10 18:00:00,30,1,31
"14087",10401,"Mount Pearl","NL",47.50513,-52.79476,2018-08-10 19:00:00,33,1,34
"14088",10401,"Mount Pearl","NL",47.50513,-52.79476,2018-08-10 20:00:00,33,1,34
"14089",10401,"Mount Pearl","NL",47.50513,-52.79476,2018-08-10 21:00:00,29,1,30
"14090",10401,"Mount Pearl","NL",47.50513,-52.79476,2018-08-10 22:00:00,31,0,31
"14091",10401,"Mount Pearl","NL",47.50513,-52.79476,2018-08-10 23:00:00,34,0,34
"14092",10401,"Mount Pearl","NL",47.50513,-52.79476,2018-08-11 00:00:00,33,1,34
"14093",10401,"Mount Pearl","NL",47.50513,-52.79476,2018-08-11 01:00:00,34,0,34
"14094",10401,"Mount Pearl","NL",47.50513,-52.79476,2018-08-11 02:00:00,32,0,32
"14095",10401,"Mount Pearl","NL",47.50513,-52.79476,2018-08-11 03:00:00,28,0,28
"14096",10401,"Mount Pearl","NL",47.50513,-52.79476,2018-08-11 04:00:00,30,0,30
"14097",10401,"Mount Pearl","NL",47.50513,-52.79476,2018-08-11 05:00:00,29,1,30
"14098",10401,"Mount Pearl","NL",47.50513,-52.79476,2018-08-11 06:00:00,28,0,28
"14099",10401,"Mount Pearl","NL",47.50513,-52.79476,2018-08-11 07:00:00,31,0,31
"14100",10401,"Mount Pearl","NL",47.50513,-52.79476,2018-08-11 08:00:00,30,1,31
"14101",10401,"Mount Pearl","NL",47.50513,-52.79476,2018-08-11 09:00:00,30,1,31
"14102",10401,"Mount Pearl","NL",47.50513,-52.79476,2018-08-11 10:00:00,30,1,31
"14103",10401,"Mount Pearl","NL",47.50513,-52.79476,2018-08-11 11:00:00,28,1,29
"14104",10401,"Mount Pearl","NL",47.50513,-52.79476,2018-08-11 12:00:00,27,0,27
"14105",10401,"Mount Pearl","NL",47.50513,-52.79476,2018-08-11 13:00:00,23,0,23
"14106",10401,"Mount Pearl","NL",47.50513,-52.79476,2018-08-11 14:00:00,22,1,23
"14107",10401,"Mount Pearl","NL",47.50513,-52.79476,2018-08-11 15:00:00,26,0,26
"14108",10401,"Mount Pearl","NL",47.50513,-52.79476,2018-08-11 16:00:00,28,0,28
"14109",10401,"Mount Pearl","NL",47.50513,-52.79476,2018-08-11 17:00:00,25,1,26
"14110",10401,"Mount Pearl","NL",47.50513,-52.79476,2018-08-11 18:00:00,25,1,26
"14111",10401,"Mount Pearl","NL",47.50513,-52.79476,2018-08-11 19:00:00,23,1,24
"14112",10401,"Mount Pearl","NL",47.50513,-52.79476,2018-08-11 20:00:00,22,1,23
"14113",10401,"Mount Pearl","NL",47.50513,-52.79476,2018-08-11 21:00:00,21,1,22
"14114",10401,"Mount Pearl","NL",47.50513,-52.79476,2018-08-11 22:00:00,22,1,23
"14115",10401,"Mount Pearl","NL",47.50513,-52.79476,2018-08-11 23:00:00,21,1,22
"14116",10401,"Mount Pearl","NL",47.50513,-52.79476,2018-08-12 00:00:00,21,1,22
"14117",10401,"Mount Pearl","NL",47.50513,-52.79476,2018-08-12 01:00:00,21,0,21
"14118",10401,"Mount Pearl","NL",47.50513,-52.79476,2018-08-12 02:00:00,21,0,21
"14119",10401,"Mount Pearl","NL",47.50513,-52.79476,2018-08-12 03:00:00,20,0,20
"14120",10401,"Mount Pearl","NL",47.50513,-52.79476,2018-08-12 04:00:00,20,0,20
"14121",10401,"Mount Pearl","NL",47.50513,-52.79476,2018-08-12 05:00:00,18,0,18
"14122",10401,"Mount Pearl","NL",47.50513,-52.79476,2018-08-12 06:00:00,17,0,17
"14123",10401,"Mount Pearl","NL",47.50513,-52.79476,2018-08-12 07:00:00,15,1,16
"14124",10401,"Mount Pearl","NL",47.50513,-52.79476,2018-08-12 08:00:00,15,0,15
"14125",10401,"Mount Pearl","NL",47.50513,-52.79476,2018-08-12 09:00:00,15,0,15
"14126",10401,"Mount Pearl","NL",47.50513,-52.79476,2018-08-12 10:00:00,15,0,15
"14127",10401,"Mount Pearl","NL",47.50513,-52.79476,2018-08-12 11:00:00,15,0,15
"14128",10401,"Mount Pearl","NL",47.50513,-52.79476,2018-08-12 12:00:00,15,1,16
"14129",10401,"Mount Pearl","NL",47.50513,-52.79476,2018-08-12 13:00:00,16,1,17
"14130",10401,"Mount Pearl","NL",47.50513,-52.79476,2018-08-12 14:00:00,20,1,21
"14131",10401,"Mount Pearl","NL",47.50513,-52.79476,2018-08-12 15:00:00,19,1,20
"14132",10401,"Mount Pearl","NL",47.50513,-52.79476,2018-08-12 16:00:00,17,1,18
"14133",10401,"Mount Pearl","NL",47.50513,-52.79476,2018-08-12 17:00:00,17,2,19
"14134",10401,"Mount Pearl","NL",47.50513,-52.79476,2018-08-12 18:00:00,16,2,18
"14135",10401,"Mount Pearl","NL",47.50513,-52.79476,2018-08-12 19:00:00,15,2,17
"14136",10401,"Mount Pearl","NL",47.50513,-52.79476,2018-08-12 20:00:00,15,2,17
"14137",10401,"Mount Pearl","NL",47.50513,-52.79476,2018-08-12 21:00:00,16,2,18
"14138",10401,"Mount Pearl","NL",47.50513,-52.79476,2018-08-12 22:00:00,15,2,17
"14139",10401,"Mount Pearl","NL",47.50513,-52.79476,2018-08-12 23:00:00,14,3,17
"14140",10401,"Mount Pearl","NL",47.50513,-52.79476,2018-08-13 00:00:00,12,4,16
"14141",10401,"Mount Pearl","NL",47.50513,-52.79476,2018-08-13 01:00:00,10,2,12
"14142",10401,"Mount Pearl","NL",47.50513,-52.79476,2018-08-13 02:00:00,9,2,11
"14143",10401,"Mount Pearl","NL",47.50513,-52.79476,2018-08-13 03:00:00,7,3,10
"14144",10401,"Mount Pearl","NL",47.50513,-52.79476,2018-08-13 04:00:00,4,3,7
"14145",10401,"Mount Pearl","NL",47.50513,-52.79476,2018-08-13 05:00:00,5,5,10
"14146",10401,"Mount Pearl","NL",47.50513,-52.79476,2018-08-13 06:00:00,9,4,13
"14147",10401,"Mount Pearl","NL",47.50513,-52.79476,2018-08-13 07:00:00,12,3,15
"14148",10401,"Mount Pearl","NL",47.50513,-52.79476,2018-08-13 08:00:00,15,3,18
"14149",10401,"Mount Pearl","NL",47.50513,-52.79476,2018-08-13 09:00:00,16,2,18
"14150",10401,"Mount Pearl","NL",47.50513,-52.79476,2018-08-13 10:00:00,17,2,19
"14151",10401,"Mount Pearl","NL",47.50513,-52.79476,2018-08-13 11:00:00,19,1,20
"14152",10401,"Mount Pearl","NL",47.50513,-52.79476,2018-08-13 12:00:00,19,1,20
"14153",10401,"Mount Pearl","NL",47.50513,-52.79476,2018-08-13 13:00:00,20,0,20
"14154",10401,"Mount Pearl","NL",47.50513,-52.79476,2018-08-13 14:00:00,22,0,22
"14155",10401,"Mount Pearl","NL",47.50513,-52.79476,2018-08-13 15:00:00,23,1,24
"14156",10401,"Mount Pearl","NL",47.50513,-52.79476,2018-08-13 16:00:00,22,1,23
"14157",10401,"Mount Pearl","NL",47.50513,-52.79476,2018-08-13 17:00:00,23,1,24
"14158",10401,"Mount Pearl","NL",47.50513,-52.79476,2018-08-13 18:00:00,24,0,24
"14159",10401,"Mount Pearl","NL",47.50513,-52.79476,2018-08-13 19:00:00,24,0,24
"14160",10401,"Mount Pearl","NL",47.50513,-52.79476,2018-08-13 20:00:00,24,1,25
"14161",10401,"Mount Pearl","NL",47.50513,-52.79476,2018-08-13 21:00:00,25,1,26
"14162",10401,"Mount Pearl","NL",47.50513,-52.79476,2018-08-13 22:00:00,26,0,26
"14163",10401,"Mount Pearl","NL",47.50513,-52.79476,2018-08-13 23:00:00,26,0,26
"14164",10401,"Mount Pearl","NL",47.50513,-52.79476,2018-08-14 00:00:00,24,0,24
"14165",10401,"Mount Pearl","NL",47.50513,-52.79476,2018-08-14 01:00:00,23,1,24
"14166",10401,"Mount Pearl","NL",47.50513,-52.79476,2018-08-14 02:00:00,23,0,23
"14167",10401,"Mount Pearl","NL",47.50513,-52.79476,2018-08-14 03:00:00,23,0,23
"14168",10401,"Mount Pearl","NL",47.50513,-52.79476,2018-08-14 04:00:00,25,0,25
"14169",10401,"Mount Pearl","NL",47.50513,-52.79476,2018-08-14 05:00:00,27,0,27
"14170",10401,"Mount Pearl","NL",47.50513,-52.79476,2018-08-14 06:00:00,30,1,31
"14171",10401,"Mount Pearl","NL",47.50513,-52.79476,2018-08-14 07:00:00,26,2,28
"14172",10401,"Mount Pearl","NL",47.50513,-52.79476,2018-08-14 08:00:00,25,1,26
"14173",10401,"Mount Pearl","NL",47.50513,-52.79476,2018-08-14 09:00:00,26,0,26
"14174",10401,"Mount Pearl","NL",47.50513,-52.79476,2018-08-14 10:00:00,25,0,25
"14175",10401,"Mount Pearl","NL",47.50513,-52.79476,2018-08-14 11:00:00,25,0,25
"14176",10401,"Mount Pearl","NL",47.50513,-52.79476,2018-08-14 12:00:00,NA,NA,NA
"14177",10401,"Mount Pearl","NL",47.50513,-52.79476,2018-08-14 13:00:00,25,1,26
"14178",10401,"Mount Pearl","NL",47.50513,-52.79476,2018-08-14 14:00:00,26,1,27
"14179",10401,"Mount Pearl","NL",47.50513,-52.79476,2018-08-14 15:00:00,27,1,28
"14180",10401,"Mount Pearl","NL",47.50513,-52.79476,2018-08-14 16:00:00,25,1,26
"14181",10401,"Mount Pearl","NL",47.50513,-52.79476,2018-08-14 17:00:00,23,0,23
"14182",10401,"Mount Pearl","NL",47.50513,-52.79476,2018-08-14 18:00:00,23,1,24
"14183",10401,"Mount Pearl","NL",47.50513,-52.79476,2018-08-14 19:00:00,25,1,26
"14184",10401,"Mount Pearl","NL",47.50513,-52.79476,2018-08-14 20:00:00,21,1,22
"14185",10401,"Mount Pearl","NL",47.50513,-52.79476,2018-08-14 21:00:00,21,1,22
"14186",10401,"Mount Pearl","NL",47.50513,-52.79476,2018-08-14 22:00:00,20,0,20
"14187",10401,"Mount Pearl","NL",47.50513,-52.79476,2018-08-14 23:00:00,20,0,20
"14188",10401,"Mount Pearl","NL",47.50513,-52.79476,2018-08-15 00:00:00,18,0,18
"14189",10401,"Mount Pearl","NL",47.50513,-52.79476,2018-08-15 01:00:00,15,1,16
"14190",10401,"Mount Pearl","NL",47.50513,-52.79476,2018-08-15 02:00:00,15,0,15
"14191",10401,"Mount Pearl","NL",47.50513,-52.79476,2018-08-15 03:00:00,19,0,19
"14192",10401,"Mount Pearl","NL",47.50513,-52.79476,2018-08-15 04:00:00,20,0,20
"14193",10401,"Mount Pearl","NL",47.50513,-52.79476,2018-08-15 05:00:00,20,0,20
"14194",10401,"Mount Pearl","NL",47.50513,-52.79476,2018-08-15 06:00:00,20,1,21
"14195",10401,"Mount Pearl","NL",47.50513,-52.79476,2018-08-15 07:00:00,20,1,21
"14196",10401,"Mount Pearl","NL",47.50513,-52.79476,2018-08-15 08:00:00,22,1,23
"14197",10401,"Mount Pearl","NL",47.50513,-52.79476,2018-08-15 09:00:00,25,0,25
"14198",10401,"Mount Pearl","NL",47.50513,-52.79476,2018-08-15 10:00:00,24,0,24
"14199",10401,"Mount Pearl","NL",47.50513,-52.79476,2018-08-15 11:00:00,NA,NA,NA
"14200",10401,"Mount Pearl","NL",47.50513,-52.79476,2018-08-15 12:00:00,25,0,25
"14201",10401,"Mount Pearl","NL",47.50513,-52.79476,2018-08-15 13:00:00,25,0,25
"14202",10401,"Mount Pearl","NL",47.50513,-52.79476,2018-08-15 14:00:00,23,0,23
"14203",10401,"Mount Pearl","NL",47.50513,-52.79476,2018-08-15 15:00:00,24,0,24
"14204",10401,"Mount Pearl","NL",47.50513,-52.79476,2018-08-15 16:00:00,23,0,23
"14205",10401,"Mount Pearl","NL",47.50513,-52.79476,2018-08-15 17:00:00,22,0,22
"14206",10401,"Mount Pearl","NL",47.50513,-52.79476,2018-08-15 18:00:00,23,0,23
"14207",10401,"Mount Pearl","NL",47.50513,-52.79476,2018-08-15 19:00:00,21,0,21
"14208",10401,"Mount Pearl","NL",47.50513,-52.79476,2018-08-15 20:00:00,18,1,19
"14209",10401,"Mount Pearl","NL",47.50513,-52.79476,2018-08-15 21:00:00,17,1,18
"14210",10401,"Mount Pearl","NL",47.50513,-52.79476,2018-08-15 22:00:00,18,1,19
"14211",10401,"Mount Pearl","NL",47.50513,-52.79476,2018-08-15 23:00:00,17,1,18
"14212",10401,"Mount Pearl","NL",47.50513,-52.79476,2018-08-16 00:00:00,16,1,17
"14213",10401,"Mount Pearl","NL",47.50513,-52.79476,2018-08-16 01:00:00,20,1,21
"14214",10401,"Mount Pearl","NL",47.50513,-52.79476,2018-08-16 02:00:00,17,0,17
"14215",10401,"Mount Pearl","NL",47.50513,-52.79476,2018-08-16 03:00:00,17,1,18
"14216",10401,"Mount Pearl","NL",47.50513,-52.79476,2018-08-16 04:00:00,16,1,17
"14217",10401,"Mount Pearl","NL",47.50513,-52.79476,2018-08-16 05:00:00,17,0,17
"14218",10401,"Mount Pearl","NL",47.50513,-52.79476,2018-08-16 06:00:00,19,0,19
"14219",10401,"Mount Pearl","NL",47.50513,-52.79476,2018-08-16 07:00:00,24,1,25
"14220",10401,"Mount Pearl","NL",47.50513,-52.79476,2018-08-16 08:00:00,24,1,25
"14221",10401,"Mount Pearl","NL",47.50513,-52.79476,2018-08-16 09:00:00,23,1,24
"14222",10401,"Mount Pearl","NL",47.50513,-52.79476,2018-08-16 10:00:00,22,2,24
"14223",10401,"Mount Pearl","NL",47.50513,-52.79476,2018-08-16 11:00:00,22,2,24
"14224",10401,"Mount Pearl","NL",47.50513,-52.79476,2018-08-16 12:00:00,25,0,25
"14225",10401,"Mount Pearl","NL",47.50513,-52.79476,2018-08-16 13:00:00,25,0,25
"14226",10401,"Mount Pearl","NL",47.50513,-52.79476,2018-08-16 14:00:00,21,1,22
"14227",10401,"Mount Pearl","NL",47.50513,-52.79476,2018-08-16 15:00:00,19,2,21
"14228",10401,"Mount Pearl","NL",47.50513,-52.79476,2018-08-16 16:00:00,22,2,24
"14229",10401,"Mount Pearl","NL",47.50513,-52.79476,2018-08-16 17:00:00,30,3,33
"14230",10401,"Mount Pearl","NL",47.50513,-52.79476,2018-08-16 18:00:00,28,4,32
"14231",10401,"Mount Pearl","NL",47.50513,-52.79476,2018-08-16 19:00:00,33,2,35
"14232",10401,"Mount Pearl","NL",47.50513,-52.79476,2018-08-16 20:00:00,40,2,42
"14233",10401,"Mount Pearl","NL",47.50513,-52.79476,2018-08-16 21:00:00,40,2,42
"14234",10401,"Mount Pearl","NL",47.50513,-52.79476,2018-08-16 22:00:00,23,0,23
"14235",10401,"Mount Pearl","NL",47.50513,-52.79476,2018-08-16 23:00:00,19,0,19
"14236",10401,"Mount Pearl","NL",47.50513,-52.79476,2018-08-17 00:00:00,20,0,20
"14237",10401,"Mount Pearl","NL",47.50513,-52.79476,2018-08-17 01:00:00,21,0,21
"14238",10401,"Mount Pearl","NL",47.50513,-52.79476,2018-08-17 02:00:00,21,0,21
"14239",10401,"Mount Pearl","NL",47.50513,-52.79476,2018-08-17 03:00:00,21,0,21
"14240",10401,"Mount Pearl","NL",47.50513,-52.79476,2018-08-17 04:00:00,22,0,22
"14241",10401,"Mount Pearl","NL",47.50513,-52.79476,2018-08-17 05:00:00,23,0,23
"14242",10401,"Mount Pearl","NL",47.50513,-52.79476,2018-08-17 06:00:00,23,0,23
"14243",10401,"Mount Pearl","NL",47.50513,-52.79476,2018-08-17 07:00:00,22,1,23
"14244",10401,"Mount Pearl","NL",47.50513,-52.79476,2018-08-17 08:00:00,21,2,23
"14245",10401,"Mount Pearl","NL",47.50513,-52.79476,2018-08-17 09:00:00,21,1,22
"14246",10401,"Mount Pearl","NL",47.50513,-52.79476,2018-08-17 10:00:00,20,0,20
"14247",10401,"Mount Pearl","NL",47.50513,-52.79476,2018-08-17 11:00:00,20,0,20
"14248",10401,"Mount Pearl","NL",47.50513,-52.79476,2018-08-17 12:00:00,17,1,18
"14249",10401,"Mount Pearl","NL",47.50513,-52.79476,2018-08-17 13:00:00,17,1,18
"14250",10401,"Mount Pearl","NL",47.50513,-52.79476,2018-08-17 14:00:00,17,0,17
"14251",10401,"Mount Pearl","NL",47.50513,-52.79476,2018-08-17 15:00:00,17,1,18
"14252",10401,"Mount Pearl","NL",47.50513,-52.79476,2018-08-17 16:00:00,19,1,20
"14253",10401,"Mount Pearl","NL",47.50513,-52.79476,2018-08-17 17:00:00,19,2,21
"14254",10401,"Mount Pearl","NL",47.50513,-52.79476,2018-08-17 18:00:00,21,0,21
"14255",10401,"Mount Pearl","NL",47.50513,-52.79476,2018-08-17 19:00:00,21,1,22
"14256",10401,"Mount Pearl","NL",47.50513,-52.79476,2018-08-17 20:00:00,20,1,21
"14257",10401,"Mount Pearl","NL",47.50513,-52.79476,2018-08-17 21:00:00,21,1,22
"14258",10401,"Mount Pearl","NL",47.50513,-52.79476,2018-08-17 22:00:00,20,1,21
"14259",10401,"Mount Pearl","NL",47.50513,-52.79476,2018-08-17 23:00:00,19,0,19
"14260",10401,"Mount Pearl","NL",47.50513,-52.79476,2018-08-18 00:00:00,20,0,20
"14261",10401,"Mount Pearl","NL",47.50513,-52.79476,2018-08-18 01:00:00,20,0,20
"14262",10401,"Mount Pearl","NL",47.50513,-52.79476,2018-08-18 02:00:00,20,1,21
"14263",10401,"Mount Pearl","NL",47.50513,-52.79476,2018-08-18 03:00:00,19,1,20
"14264",10401,"Mount Pearl","NL",47.50513,-52.79476,2018-08-18 04:00:00,19,1,20
"14265",10401,"Mount Pearl","NL",47.50513,-52.79476,2018-08-18 05:00:00,21,0,21
"14266",10401,"Mount Pearl","NL",47.50513,-52.79476,2018-08-18 06:00:00,19,0,19
"14267",10401,"Mount Pearl","NL",47.50513,-52.79476,2018-08-18 07:00:00,18,1,19
"14268",10401,"Mount Pearl","NL",47.50513,-52.79476,2018-08-18 08:00:00,16,0,16
"14269",10401,"Mount Pearl","NL",47.50513,-52.79476,2018-08-18 09:00:00,16,1,17
"14270",10401,"Mount Pearl","NL",47.50513,-52.79476,2018-08-18 10:00:00,17,1,18
"14271",10401,"Mount Pearl","NL",47.50513,-52.79476,2018-08-18 11:00:00,17,1,18
"14272",10401,"Mount Pearl","NL",47.50513,-52.79476,2018-08-18 12:00:00,17,1,18
"14273",10401,"Mount Pearl","NL",47.50513,-52.79476,2018-08-18 13:00:00,15,1,16
"14274",10401,"Mount Pearl","NL",47.50513,-52.79476,2018-08-18 14:00:00,16,1,17
"14275",10401,"Mount Pearl","NL",47.50513,-52.79476,2018-08-18 15:00:00,14,1,15
"14276",10401,"Mount Pearl","NL",47.50513,-52.79476,2018-08-18 16:00:00,15,1,16
"14277",10401,"Mount Pearl","NL",47.50513,-52.79476,2018-08-18 17:00:00,15,1,16
"14278",10401,"Mount Pearl","NL",47.50513,-52.79476,2018-08-18 18:00:00,14,1,15
"14279",10401,"Mount Pearl","NL",47.50513,-52.79476,2018-08-18 19:00:00,16,1,17
"14280",10401,"Mount Pearl","NL",47.50513,-52.79476,2018-08-18 20:00:00,15,1,16
"14281",10401,"Mount Pearl","NL",47.50513,-52.79476,2018-08-18 21:00:00,11,1,12
"14282",10401,"Mount Pearl","NL",47.50513,-52.79476,2018-08-18 22:00:00,13,2,15
"14283",10401,"Mount Pearl","NL",47.50513,-52.79476,2018-08-18 23:00:00,16,1,17
"14284",10401,"Mount Pearl","NL",47.50513,-52.79476,2018-08-19 00:00:00,16,1,17
"14285",10401,"Mount Pearl","NL",47.50513,-52.79476,2018-08-19 01:00:00,15,1,16
"14286",10401,"Mount Pearl","NL",47.50513,-52.79476,2018-08-19 02:00:00,11,1,12
"14287",10401,"Mount Pearl","NL",47.50513,-52.79476,2018-08-19 03:00:00,12,1,13
"14288",10401,"Mount Pearl","NL",47.50513,-52.79476,2018-08-19 04:00:00,13,1,14
"14289",10401,"Mount Pearl","NL",47.50513,-52.79476,2018-08-19 05:00:00,9,1,10
"14290",10401,"Mount Pearl","NL",47.50513,-52.79476,2018-08-19 06:00:00,10,1,11
"14291",10401,"Mount Pearl","NL",47.50513,-52.79476,2018-08-19 07:00:00,10,2,12
"14292",10401,"Mount Pearl","NL",47.50513,-52.79476,2018-08-19 08:00:00,14,0,14
"14293",10401,"Mount Pearl","NL",47.50513,-52.79476,2018-08-19 09:00:00,19,1,20
"14294",10401,"Mount Pearl","NL",47.50513,-52.79476,2018-08-19 10:00:00,22,0,22
"14295",10401,"Mount Pearl","NL",47.50513,-52.79476,2018-08-19 11:00:00,23,1,24
"14296",10401,"Mount Pearl","NL",47.50513,-52.79476,2018-08-19 12:00:00,19,2,21
"14297",10401,"Mount Pearl","NL",47.50513,-52.79476,2018-08-19 13:00:00,19,1,20
"14298",10401,"Mount Pearl","NL",47.50513,-52.79476,2018-08-19 14:00:00,24,1,25
"14299",10401,"Mount Pearl","NL",47.50513,-52.79476,2018-08-19 15:00:00,27,0,27
"14300",10401,"Mount Pearl","NL",47.50513,-52.79476,2018-08-19 16:00:00,24,0,24
"14301",10401,"Mount Pearl","NL",47.50513,-52.79476,2018-08-19 17:00:00,21,2,23
"14302",10401,"Mount Pearl","NL",47.50513,-52.79476,2018-08-19 18:00:00,22,1,23
"14303",10401,"Mount Pearl","NL",47.50513,-52.79476,2018-08-19 19:00:00,21,1,22
"14304",10401,"Mount Pearl","NL",47.50513,-52.79476,2018-08-19 20:00:00,21,0,21
"14305",10401,"Mount Pearl","NL",47.50513,-52.79476,2018-08-19 21:00:00,19,0,19
"14306",10401,"Mount Pearl","NL",47.50513,-52.79476,2018-08-19 22:00:00,19,0,19
"14307",10401,"Mount Pearl","NL",47.50513,-52.79476,2018-08-19 23:00:00,19,1,20
"14308",10401,"Mount Pearl","NL",47.50513,-52.79476,2018-08-20 00:00:00,18,0,18
"14309",10401,"Mount Pearl","NL",47.50513,-52.79476,2018-08-20 01:00:00,19,0,19
"14310",10401,"Mount Pearl","NL",47.50513,-52.79476,2018-08-20 02:00:00,20,1,21
"14311",10401,"Mount Pearl","NL",47.50513,-52.79476,2018-08-20 03:00:00,16,0,16
"14312",10401,"Mount Pearl","NL",47.50513,-52.79476,2018-08-20 04:00:00,17,1,18
"14313",10401,"Mount Pearl","NL",47.50513,-52.79476,2018-08-20 05:00:00,15,1,16
"14314",10401,"Mount Pearl","NL",47.50513,-52.79476,2018-08-20 06:00:00,17,0,17
"14315",10401,"Mount Pearl","NL",47.50513,-52.79476,2018-08-20 07:00:00,13,4,17
"14316",10401,"Mount Pearl","NL",47.50513,-52.79476,2018-08-20 08:00:00,16,3,19
"14317",10401,"Mount Pearl","NL",47.50513,-52.79476,2018-08-20 09:00:00,19,1,20
"14318",10401,"Mount Pearl","NL",47.50513,-52.79476,2018-08-20 10:00:00,18,2,20
"14319",10401,"Mount Pearl","NL",47.50513,-52.79476,2018-08-20 11:00:00,17,3,20
"14320",10401,"Mount Pearl","NL",47.50513,-52.79476,2018-08-20 12:00:00,19,3,22
"14321",10401,"Mount Pearl","NL",47.50513,-52.79476,2018-08-20 13:00:00,19,2,21
"14322",10401,"Mount Pearl","NL",47.50513,-52.79476,2018-08-20 14:00:00,19,2,21
"14323",10401,"Mount Pearl","NL",47.50513,-52.79476,2018-08-20 15:00:00,19,2,21
"14324",10401,"Mount Pearl","NL",47.50513,-52.79476,2018-08-20 16:00:00,18,2,20
"14325",10401,"Mount Pearl","NL",47.50513,-52.79476,2018-08-20 17:00:00,18,2,20
"14326",10401,"Mount Pearl","NL",47.50513,-52.79476,2018-08-20 18:00:00,18,2,20
"14327",10401,"Mount Pearl","NL",47.50513,-52.79476,2018-08-20 19:00:00,14,4,18
"14328",10401,"Mount Pearl","NL",47.50513,-52.79476,2018-08-20 20:00:00,14,4,18
"14329",10401,"Mount Pearl","NL",47.50513,-52.79476,2018-08-20 21:00:00,12,3,15
"14330",10401,"Mount Pearl","NL",47.50513,-52.79476,2018-08-20 22:00:00,13,3,16
"14331",10401,"Mount Pearl","NL",47.50513,-52.79476,2018-08-20 23:00:00,13,3,16
"14332",10401,"Mount Pearl","NL",47.50513,-52.79476,2018-08-21 00:00:00,13,2,15
"14333",10401,"Mount Pearl","NL",47.50513,-52.79476,2018-08-21 01:00:00,7,3,10
"14334",10401,"Mount Pearl","NL",47.50513,-52.79476,2018-08-21 02:00:00,14,2,16
"14335",10401,"Mount Pearl","NL",47.50513,-52.79476,2018-08-21 03:00:00,14,2,16
"14336",10401,"Mount Pearl","NL",47.50513,-52.79476,2018-08-21 04:00:00,16,2,18
"14337",10401,"Mount Pearl","NL",47.50513,-52.79476,2018-08-21 05:00:00,16,1,17
"14338",10401,"Mount Pearl","NL",47.50513,-52.79476,2018-08-21 06:00:00,16,2,18
"14339",10401,"Mount Pearl","NL",47.50513,-52.79476,2018-08-21 07:00:00,16,4,20
"14340",10401,"Mount Pearl","NL",47.50513,-52.79476,2018-08-21 08:00:00,19,4,23
"14341",10401,"Mount Pearl","NL",47.50513,-52.79476,2018-08-21 09:00:00,23,3,26
"14342",10401,"Mount Pearl","NL",47.50513,-52.79476,2018-08-21 10:00:00,26,2,28
"14343",10401,"Mount Pearl","NL",47.50513,-52.79476,2018-08-21 11:00:00,24,2,26
"14344",10401,"Mount Pearl","NL",47.50513,-52.79476,2018-08-21 12:00:00,20,0,20
"14345",10401,"Mount Pearl","NL",47.50513,-52.79476,2018-08-21 13:00:00,24,1,25
"14346",10401,"Mount Pearl","NL",47.50513,-52.79476,2018-08-21 14:00:00,23,1,24
"14347",10401,"Mount Pearl","NL",47.50513,-52.79476,2018-08-21 15:00:00,23,1,24
"14348",10401,"Mount Pearl","NL",47.50513,-52.79476,2018-08-21 16:00:00,22,1,23
"14349",10401,"Mount Pearl","NL",47.50513,-52.79476,2018-08-21 17:00:00,21,1,22
"14350",10401,"Mount Pearl","NL",47.50513,-52.79476,2018-08-21 18:00:00,22,0,22
"14351",10401,"Mount Pearl","NL",47.50513,-52.79476,2018-08-21 19:00:00,22,1,23
"14352",10401,"Mount Pearl","NL",47.50513,-52.79476,2018-08-21 20:00:00,21,1,22
"14353",10401,"Mount Pearl","NL",47.50513,-52.79476,2018-08-21 21:00:00,21,1,22
"14354",10401,"Mount Pearl","NL",47.50513,-52.79476,2018-08-21 22:00:00,20,2,22
"14355",10401,"Mount Pearl","NL",47.50513,-52.79476,2018-08-21 23:00:00,21,2,23
"14356",10401,"Mount Pearl","NL",47.50513,-52.79476,2018-08-22 00:00:00,23,2,25
"14357",10401,"Mount Pearl","NL",47.50513,-52.79476,2018-08-22 01:00:00,24,1,25
"14358",10401,"Mount Pearl","NL",47.50513,-52.79476,2018-08-22 02:00:00,24,0,24
"14359",10401,"Mount Pearl","NL",47.50513,-52.79476,2018-08-22 03:00:00,23,0,23
"14360",10401,"Mount Pearl","NL",47.50513,-52.79476,2018-08-22 04:00:00,21,2,23
"14361",10401,"Mount Pearl","NL",47.50513,-52.79476,2018-08-22 05:00:00,22,2,24
"14362",10401,"Mount Pearl","NL",47.50513,-52.79476,2018-08-22 06:00:00,24,2,26
"14363",10401,"Mount Pearl","NL",47.50513,-52.79476,2018-08-22 07:00:00,24,4,28
"14364",10401,"Mount Pearl","NL",47.50513,-52.79476,2018-08-22 08:00:00,23,3,26
"14365",10401,"Mount Pearl","NL",47.50513,-52.79476,2018-08-22 09:00:00,22,2,24
"14366",10401,"Mount Pearl","NL",47.50513,-52.79476,2018-08-22 10:00:00,22,2,24
"14367",10401,"Mount Pearl","NL",47.50513,-52.79476,2018-08-22 11:00:00,22,2,24
"14368",10401,"Mount Pearl","NL",47.50513,-52.79476,2018-08-22 12:00:00,21,2,23
"14369",10401,"Mount Pearl","NL",47.50513,-52.79476,2018-08-22 13:00:00,18,2,20
"14370",10401,"Mount Pearl","NL",47.50513,-52.79476,2018-08-22 14:00:00,22,1,23
"14371",10401,"Mount Pearl","NL",47.50513,-52.79476,2018-08-22 15:00:00,26,1,27
"14372",10401,"Mount Pearl","NL",47.50513,-52.79476,2018-08-22 16:00:00,27,1,28
"14373",10401,"Mount Pearl","NL",47.50513,-52.79476,2018-08-22 17:00:00,27,1,28
"14374",10401,"Mount Pearl","NL",47.50513,-52.79476,2018-08-22 18:00:00,26,2,28
"14375",10401,"Mount Pearl","NL",47.50513,-52.79476,2018-08-22 19:00:00,22,2,24
"14376",10401,"Mount Pearl","NL",47.50513,-52.79476,2018-08-22 20:00:00,15,4,19
"14377",10401,"Mount Pearl","NL",47.50513,-52.79476,2018-08-22 21:00:00,12,4,16
"14378",10401,"Mount Pearl","NL",47.50513,-52.79476,2018-08-22 22:00:00,10,2,12
"14379",10401,"Mount Pearl","NL",47.50513,-52.79476,2018-08-22 23:00:00,13,2,15
"14380",10401,"Mount Pearl","NL",47.50513,-52.79476,2018-08-23 00:00:00,22,1,23
"14381",10401,"Mount Pearl","NL",47.50513,-52.79476,2018-08-23 01:00:00,24,0,24
"14382",10401,"Mount Pearl","NL",47.50513,-52.79476,2018-08-23 02:00:00,21,0,21
"14383",10401,"Mount Pearl","NL",47.50513,-52.79476,2018-08-23 03:00:00,18,1,19
"14384",10401,"Mount Pearl","NL",47.50513,-52.79476,2018-08-23 04:00:00,17,1,18
"14385",10401,"Mount Pearl","NL",47.50513,-52.79476,2018-08-23 05:00:00,18,0,18
"14386",10401,"Mount Pearl","NL",47.50513,-52.79476,2018-08-23 06:00:00,23,1,24
"14387",10401,"Mount Pearl","NL",47.50513,-52.79476,2018-08-23 07:00:00,25,1,26
"14388",10401,"Mount Pearl","NL",47.50513,-52.79476,2018-08-23 08:00:00,22,1,23
"14389",10401,"Mount Pearl","NL",47.50513,-52.79476,2018-08-23 09:00:00,23,1,24
"14390",10401,"Mount Pearl","NL",47.50513,-52.79476,2018-08-23 10:00:00,23,1,24
"14391",10401,"Mount Pearl","NL",47.50513,-52.79476,2018-08-23 11:00:00,24,0,24
"14392",10401,"Mount Pearl","NL",47.50513,-52.79476,2018-08-23 12:00:00,26,0,26
"14393",10401,"Mount Pearl","NL",47.50513,-52.79476,2018-08-23 13:00:00,24,0,24
"14394",10401,"Mount Pearl","NL",47.50513,-52.79476,2018-08-23 14:00:00,24,0,24
"14395",10401,"Mount Pearl","NL",47.50513,-52.79476,2018-08-23 15:00:00,27,0,27
"14396",10401,"Mount Pearl","NL",47.50513,-52.79476,2018-08-23 16:00:00,28,1,29
"14397",10401,"Mount Pearl","NL",47.50513,-52.79476,2018-08-23 17:00:00,23,0,23
"14398",10401,"Mount Pearl","NL",47.50513,-52.79476,2018-08-23 18:00:00,24,0,24
"14399",10401,"Mount Pearl","NL",47.50513,-52.79476,2018-08-23 19:00:00,27,0,27
"14400",10401,"Mount Pearl","NL",47.50513,-52.79476,2018-08-23 20:00:00,29,1,30
"14401",10401,"Mount Pearl","NL",47.50513,-52.79476,2018-08-23 21:00:00,34,0,34
"14402",10401,"Mount Pearl","NL",47.50513,-52.79476,2018-08-23 22:00:00,35,1,36
"14403",10401,"Mount Pearl","NL",47.50513,-52.79476,2018-08-23 23:00:00,38,0,38
"14404",10401,"Mount Pearl","NL",47.50513,-52.79476,2018-08-24 00:00:00,36,0,36
"14405",10401,"Mount Pearl","NL",47.50513,-52.79476,2018-08-24 01:00:00,30,0,30
"14406",10401,"Mount Pearl","NL",47.50513,-52.79476,2018-08-24 02:00:00,31,0,31
"14407",10401,"Mount Pearl","NL",47.50513,-52.79476,2018-08-24 03:00:00,32,0,32
"14408",10401,"Mount Pearl","NL",47.50513,-52.79476,2018-08-24 04:00:00,30,0,30
"14409",10401,"Mount Pearl","NL",47.50513,-52.79476,2018-08-24 05:00:00,26,0,26
"14410",10401,"Mount Pearl","NL",47.50513,-52.79476,2018-08-24 06:00:00,22,0,22
"14411",10401,"Mount Pearl","NL",47.50513,-52.79476,2018-08-24 07:00:00,21,1,22
"14412",10401,"Mount Pearl","NL",47.50513,-52.79476,2018-08-24 08:00:00,24,1,25
"14413",10401,"Mount Pearl","NL",47.50513,-52.79476,2018-08-24 09:00:00,26,1,27
"14414",10401,"Mount Pearl","NL",47.50513,-52.79476,2018-08-24 10:00:00,27,1,28
"14415",10401,"Mount Pearl","NL",47.50513,-52.79476,2018-08-24 11:00:00,29,1,30
"14416",10401,"Mount Pearl","NL",47.50513,-52.79476,2018-08-24 12:00:00,27,1,28
"14417",10401,"Mount Pearl","NL",47.50513,-52.79476,2018-08-24 13:00:00,27,1,28
"14418",10401,"Mount Pearl","NL",47.50513,-52.79476,2018-08-24 14:00:00,25,1,26
"14419",10401,"Mount Pearl","NL",47.50513,-52.79476,2018-08-24 15:00:00,27,1,28
"14420",10401,"Mount Pearl","NL",47.50513,-52.79476,2018-08-24 16:00:00,27,2,29
"14421",10401,"Mount Pearl","NL",47.50513,-52.79476,2018-08-24 17:00:00,26,1,27
"14422",10401,"Mount Pearl","NL",47.50513,-52.79476,2018-08-24 18:00:00,26,1,27
"14423",10401,"Mount Pearl","NL",47.50513,-52.79476,2018-08-24 19:00:00,25,1,26
"14424",10401,"Mount Pearl","NL",47.50513,-52.79476,2018-08-24 20:00:00,25,1,26
"14425",10401,"Mount Pearl","NL",47.50513,-52.79476,2018-08-24 21:00:00,23,1,24
"14426",10401,"Mount Pearl","NL",47.50513,-52.79476,2018-08-24 22:00:00,22,1,23
"14427",10401,"Mount Pearl","NL",47.50513,-52.79476,2018-08-24 23:00:00,22,1,23
"14428",10401,"Mount Pearl","NL",47.50513,-52.79476,2018-08-25 00:00:00,21,1,22
"14429",10401,"Mount Pearl","NL",47.50513,-52.79476,2018-08-25 01:00:00,21,1,22
"14430",10401,"Mount Pearl","NL",47.50513,-52.79476,2018-08-25 02:00:00,19,1,20
"14431",10401,"Mount Pearl","NL",47.50513,-52.79476,2018-08-25 03:00:00,18,1,19
"14432",10401,"Mount Pearl","NL",47.50513,-52.79476,2018-08-25 04:00:00,19,1,20
"14433",10401,"Mount Pearl","NL",47.50513,-52.79476,2018-08-25 05:00:00,15,1,16
"14434",10401,"Mount Pearl","NL",47.50513,-52.79476,2018-08-25 06:00:00,12,2,14
"14435",10401,"Mount Pearl","NL",47.50513,-52.79476,2018-08-25 07:00:00,11,3,14
"14436",10401,"Mount Pearl","NL",47.50513,-52.79476,2018-08-25 08:00:00,17,2,19
"14437",10401,"Mount Pearl","NL",47.50513,-52.79476,2018-08-25 09:00:00,19,2,21
"14438",10401,"Mount Pearl","NL",47.50513,-52.79476,2018-08-25 10:00:00,20,1,21
"14439",10401,"Mount Pearl","NL",47.50513,-52.79476,2018-08-25 11:00:00,21,1,22
"14440",10401,"Mount Pearl","NL",47.50513,-52.79476,2018-08-25 12:00:00,23,0,23
"14441",10401,"Mount Pearl","NL",47.50513,-52.79476,2018-08-25 13:00:00,26,1,27
"14442",10401,"Mount Pearl","NL",47.50513,-52.79476,2018-08-25 14:00:00,26,1,27
"14443",10401,"Mount Pearl","NL",47.50513,-52.79476,2018-08-25 15:00:00,26,1,27
"14444",10401,"Mount Pearl","NL",47.50513,-52.79476,2018-08-25 16:00:00,27,1,28
"14445",10401,"Mount Pearl","NL",47.50513,-52.79476,2018-08-25 17:00:00,25,0,25
"14446",10401,"Mount Pearl","NL",47.50513,-52.79476,2018-08-25 18:00:00,24,1,25
"14447",10401,"Mount Pearl","NL",47.50513,-52.79476,2018-08-25 19:00:00,24,1,25
"14448",10401,"Mount Pearl","NL",47.50513,-52.79476,2018-08-25 20:00:00,25,1,26
"14449",10401,"Mount Pearl","NL",47.50513,-52.79476,2018-08-25 21:00:00,25,1,26
"14450",10401,"Mount Pearl","NL",47.50513,-52.79476,2018-08-25 22:00:00,25,1,26
"14451",10401,"Mount Pearl","NL",47.50513,-52.79476,2018-08-25 23:00:00,25,1,26
"14452",10401,"Mount Pearl","NL",47.50513,-52.79476,2018-08-26 00:00:00,25,1,26
"14453",10401,"Mount Pearl","NL",47.50513,-52.79476,2018-08-26 01:00:00,27,0,27
"14454",10401,"Mount Pearl","NL",47.50513,-52.79476,2018-08-26 02:00:00,26,0,26
"14455",10401,"Mount Pearl","NL",47.50513,-52.79476,2018-08-26 03:00:00,26,1,27
"14456",10401,"Mount Pearl","NL",47.50513,-52.79476,2018-08-26 04:00:00,25,0,25
"14457",10401,"Mount Pearl","NL",47.50513,-52.79476,2018-08-26 05:00:00,25,0,25
"14458",10401,"Mount Pearl","NL",47.50513,-52.79476,2018-08-26 06:00:00,26,1,27
"14459",10401,"Mount Pearl","NL",47.50513,-52.79476,2018-08-26 07:00:00,26,0,26
"14460",10401,"Mount Pearl","NL",47.50513,-52.79476,2018-08-26 08:00:00,27,1,28
"14461",10401,"Mount Pearl","NL",47.50513,-52.79476,2018-08-26 09:00:00,29,0,29
"14462",10401,"Mount Pearl","NL",47.50513,-52.79476,2018-08-26 10:00:00,29,0,29
"14463",10401,"Mount Pearl","NL",47.50513,-52.79476,2018-08-26 11:00:00,29,0,29
"14464",10401,"Mount Pearl","NL",47.50513,-52.79476,2018-08-26 12:00:00,28,1,29
"14465",10401,"Mount Pearl","NL",47.50513,-52.79476,2018-08-26 13:00:00,31,1,32
"14466",10401,"Mount Pearl","NL",47.50513,-52.79476,2018-08-26 14:00:00,32,1,33
"14467",10401,"Mount Pearl","NL",47.50513,-52.79476,2018-08-26 15:00:00,33,1,34
"14468",10401,"Mount Pearl","NL",47.50513,-52.79476,2018-08-26 16:00:00,32,1,33
"14469",10401,"Mount Pearl","NL",47.50513,-52.79476,2018-08-26 17:00:00,32,1,33
"14470",10401,"Mount Pearl","NL",47.50513,-52.79476,2018-08-26 18:00:00,33,1,34
"14471",10401,"Mount Pearl","NL",47.50513,-52.79476,2018-08-26 19:00:00,30,1,31
"14472",10401,"Mount Pearl","NL",47.50513,-52.79476,2018-08-26 20:00:00,28,1,29
"14473",10401,"Mount Pearl","NL",47.50513,-52.79476,2018-08-26 21:00:00,27,1,28
"14474",10401,"Mount Pearl","NL",47.50513,-52.79476,2018-08-26 22:00:00,28,1,29
"14475",10401,"Mount Pearl","NL",47.50513,-52.79476,2018-08-26 23:00:00,24,1,25
"14476",10401,"Mount Pearl","NL",47.50513,-52.79476,2018-08-27 00:00:00,23,0,23
"14477",10401,"Mount Pearl","NL",47.50513,-52.79476,2018-08-27 01:00:00,23,0,23
"14478",10401,"Mount Pearl","NL",47.50513,-52.79476,2018-08-27 02:00:00,23,1,24
"14479",10401,"Mount Pearl","NL",47.50513,-52.79476,2018-08-27 03:00:00,23,1,24
"14480",10401,"Mount Pearl","NL",47.50513,-52.79476,2018-08-27 04:00:00,22,1,23
"14481",10401,"Mount Pearl","NL",47.50513,-52.79476,2018-08-27 05:00:00,20,1,21
"14482",10401,"Mount Pearl","NL",47.50513,-52.79476,2018-08-27 06:00:00,20,1,21
"14483",10401,"Mount Pearl","NL",47.50513,-52.79476,2018-08-27 07:00:00,17,4,21
"14484",10401,"Mount Pearl","NL",47.50513,-52.79476,2018-08-27 08:00:00,19,4,23
"14485",10401,"Mount Pearl","NL",47.50513,-52.79476,2018-08-27 09:00:00,21,3,24
"14486",10401,"Mount Pearl","NL",47.50513,-52.79476,2018-08-27 10:00:00,26,1,27
"14487",10401,"Mount Pearl","NL",47.50513,-52.79476,2018-08-27 11:00:00,28,1,29
"14488",10401,"Mount Pearl","NL",47.50513,-52.79476,2018-08-27 12:00:00,31,2,33
"14489",10401,"Mount Pearl","NL",47.50513,-52.79476,2018-08-27 13:00:00,32,1,33
"14490",10401,"Mount Pearl","NL",47.50513,-52.79476,2018-08-27 14:00:00,32,1,33
"14491",10401,"Mount Pearl","NL",47.50513,-52.79476,2018-08-27 15:00:00,29,2,31
"14492",10401,"Mount Pearl","NL",47.50513,-52.79476,2018-08-27 16:00:00,29,2,31
"14493",10401,"Mount Pearl","NL",47.50513,-52.79476,2018-08-27 17:00:00,29,2,31
"14494",10401,"Mount Pearl","NL",47.50513,-52.79476,2018-08-27 18:00:00,28,1,29
"14495",10401,"Mount Pearl","NL",47.50513,-52.79476,2018-08-27 19:00:00,29,1,30
"14496",10401,"Mount Pearl","NL",47.50513,-52.79476,2018-08-27 20:00:00,25,1,26
"14497",10401,"Mount Pearl","NL",47.50513,-52.79476,2018-08-27 21:00:00,21,3,24
"14498",10401,"Mount Pearl","NL",47.50513,-52.79476,2018-08-27 22:00:00,17,2,19
"14499",10401,"Mount Pearl","NL",47.50513,-52.79476,2018-08-27 23:00:00,16,2,18
"14500",10401,"Mount Pearl","NL",47.50513,-52.79476,2018-08-28 00:00:00,16,2,18
"14501",10401,"Mount Pearl","NL",47.50513,-52.79476,2018-08-28 01:00:00,30,1,31
"14502",10401,"Mount Pearl","NL",47.50513,-52.79476,2018-08-28 02:00:00,30,1,31
"14503",10401,"Mount Pearl","NL",47.50513,-52.79476,2018-08-28 03:00:00,26,1,27
"14504",10401,"Mount Pearl","NL",47.50513,-52.79476,2018-08-28 04:00:00,23,1,24
"14505",10401,"Mount Pearl","NL",47.50513,-52.79476,2018-08-28 05:00:00,23,1,24
"14506",10401,"Mount Pearl","NL",47.50513,-52.79476,2018-08-28 06:00:00,19,2,21
"14507",10401,"Mount Pearl","NL",47.50513,-52.79476,2018-08-28 07:00:00,17,3,20
"14508",10401,"Mount Pearl","NL",47.50513,-52.79476,2018-08-28 08:00:00,21,1,22
"14509",10401,"Mount Pearl","NL",47.50513,-52.79476,2018-08-28 09:00:00,27,1,28
"14510",10401,"Mount Pearl","NL",47.50513,-52.79476,2018-08-28 10:00:00,28,1,29
"14511",10401,"Mount Pearl","NL",47.50513,-52.79476,2018-08-28 11:00:00,30,1,31
"14512",10401,"Mount Pearl","NL",47.50513,-52.79476,2018-08-28 12:00:00,30,1,31
"14513",10401,"Mount Pearl","NL",47.50513,-52.79476,2018-08-28 13:00:00,30,1,31
"14514",10401,"Mount Pearl","NL",47.50513,-52.79476,2018-08-28 14:00:00,30,0,30
"14515",10401,"Mount Pearl","NL",47.50513,-52.79476,2018-08-28 15:00:00,30,1,31
"14516",10401,"Mount Pearl","NL",47.50513,-52.79476,2018-08-28 16:00:00,29,1,30
"14517",10401,"Mount Pearl","NL",47.50513,-52.79476,2018-08-28 17:00:00,30,2,32
"14518",10401,"Mount Pearl","NL",47.50513,-52.79476,2018-08-28 18:00:00,31,1,32
"14519",10401,"Mount Pearl","NL",47.50513,-52.79476,2018-08-28 19:00:00,29,2,31
"14520",10401,"Mount Pearl","NL",47.50513,-52.79476,2018-08-28 20:00:00,27,1,28
"14521",10401,"Mount Pearl","NL",47.50513,-52.79476,2018-08-28 21:00:00,25,1,26
"14522",10401,"Mount Pearl","NL",47.50513,-52.79476,2018-08-28 22:00:00,27,1,28
"14523",10401,"Mount Pearl","NL",47.50513,-52.79476,2018-08-28 23:00:00,29,1,30
"14524",10401,"Mount Pearl","NL",47.50513,-52.79476,2018-08-29 00:00:00,28,1,29
"14525",10401,"Mount Pearl","NL",47.50513,-52.79476,2018-08-29 01:00:00,27,1,28
"14526",10401,"Mount Pearl","NL",47.50513,-52.79476,2018-08-29 02:00:00,28,0,28
"14527",10401,"Mount Pearl","NL",47.50513,-52.79476,2018-08-29 03:00:00,29,1,30
"14528",10401,"Mount Pearl","NL",47.50513,-52.79476,2018-08-29 04:00:00,31,1,32
"14529",10401,"Mount Pearl","NL",47.50513,-52.79476,2018-08-29 05:00:00,31,0,31
"14530",10401,"Mount Pearl","NL",47.50513,-52.79476,2018-08-29 06:00:00,28,1,29
"14531",10401,"Mount Pearl","NL",47.50513,-52.79476,2018-08-29 07:00:00,28,1,29
"14532",10401,"Mount Pearl","NL",47.50513,-52.79476,2018-08-29 08:00:00,28,1,29
"14533",10401,"Mount Pearl","NL",47.50513,-52.79476,2018-08-29 09:00:00,28,1,29
"14534",10401,"Mount Pearl","NL",47.50513,-52.79476,2018-08-29 10:00:00,29,0,29
"14535",10401,"Mount Pearl","NL",47.50513,-52.79476,2018-08-29 11:00:00,30,1,31
"14536",10401,"Mount Pearl","NL",47.50513,-52.79476,2018-08-29 12:00:00,34,2,36
"14537",10401,"Mount Pearl","NL",47.50513,-52.79476,2018-08-29 13:00:00,34,0,34
"14538",10401,"Mount Pearl","NL",47.50513,-52.79476,2018-08-29 14:00:00,34,0,34
"14539",10401,"Mount Pearl","NL",47.50513,-52.79476,2018-08-29 15:00:00,34,1,35
"14540",10401,"Mount Pearl","NL",47.50513,-52.79476,2018-08-29 16:00:00,33,1,34
"14541",10401,"Mount Pearl","NL",47.50513,-52.79476,2018-08-29 17:00:00,32,1,33
"14542",10401,"Mount Pearl","NL",47.50513,-52.79476,2018-08-29 18:00:00,30,2,32
"14543",10401,"Mount Pearl","NL",47.50513,-52.79476,2018-08-29 19:00:00,21,1,22
"14544",10401,"Mount Pearl","NL",47.50513,-52.79476,2018-08-29 20:00:00,17,0,17
"14545",10401,"Mount Pearl","NL",47.50513,-52.79476,2018-08-29 21:00:00,17,0,17
"14546",10401,"Mount Pearl","NL",47.50513,-52.79476,2018-08-29 22:00:00,18,0,18
"14547",10401,"Mount Pearl","NL",47.50513,-52.79476,2018-08-29 23:00:00,20,0,20
"14548",10401,"Mount Pearl","NL",47.50513,-52.79476,2018-08-30 00:00:00,19,1,20
"14549",10401,"Mount Pearl","NL",47.50513,-52.79476,2018-08-30 01:00:00,21,0,21
"14550",10401,"Mount Pearl","NL",47.50513,-52.79476,2018-08-30 02:00:00,21,0,21
"14551",10401,"Mount Pearl","NL",47.50513,-52.79476,2018-08-30 03:00:00,19,1,20
"14552",10401,"Mount Pearl","NL",47.50513,-52.79476,2018-08-30 04:00:00,18,1,19
"14553",10401,"Mount Pearl","NL",47.50513,-52.79476,2018-08-30 05:00:00,17,1,18
"14554",10401,"Mount Pearl","NL",47.50513,-52.79476,2018-08-30 06:00:00,14,2,16
"14555",10401,"Mount Pearl","NL",47.50513,-52.79476,2018-08-30 07:00:00,16,3,19
"14556",10401,"Mount Pearl","NL",47.50513,-52.79476,2018-08-30 08:00:00,20,1,21
"14557",10401,"Mount Pearl","NL",47.50513,-52.79476,2018-08-30 09:00:00,21,1,22
"14558",10401,"Mount Pearl","NL",47.50513,-52.79476,2018-08-30 10:00:00,21,1,22
"14559",10401,"Mount Pearl","NL",47.50513,-52.79476,2018-08-30 11:00:00,22,1,23
"14560",10401,"Mount Pearl","NL",47.50513,-52.79476,2018-08-30 12:00:00,21,1,22
"14561",10401,"Mount Pearl","NL",47.50513,-52.79476,2018-08-30 13:00:00,22,1,23
"14562",10401,"Mount Pearl","NL",47.50513,-52.79476,2018-08-30 14:00:00,22,1,23
"14563",10401,"Mount Pearl","NL",47.50513,-52.79476,2018-08-30 15:00:00,23,1,24
"14564",10401,"Mount Pearl","NL",47.50513,-52.79476,2018-08-30 16:00:00,23,1,24
"14565",10401,"Mount Pearl","NL",47.50513,-52.79476,2018-08-30 17:00:00,23,1,24
"14566",10401,"Mount Pearl","NL",47.50513,-52.79476,2018-08-30 18:00:00,23,1,24
"14567",10401,"Mount Pearl","NL",47.50513,-52.79476,2018-08-30 19:00:00,23,1,24
"14568",10401,"Mount Pearl","NL",47.50513,-52.79476,2018-08-30 20:00:00,24,1,25
"14569",10401,"Mount Pearl","NL",47.50513,-52.79476,2018-08-30 21:00:00,24,1,25
"14570",10401,"Mount Pearl","NL",47.50513,-52.79476,2018-08-30 22:00:00,23,1,24
"14571",10401,"Mount Pearl","NL",47.50513,-52.79476,2018-08-30 23:00:00,23,1,24
"14572",10401,"Mount Pearl","NL",47.50513,-52.79476,2018-08-31 00:00:00,22,1,23
"14573",10401,"Mount Pearl","NL",47.50513,-52.79476,2018-08-31 01:00:00,19,1,20
"14574",10401,"Mount Pearl","NL",47.50513,-52.79476,2018-08-31 02:00:00,22,0,22
"14575",10401,"Mount Pearl","NL",47.50513,-52.79476,2018-08-31 03:00:00,25,1,26
"14576",10401,"Mount Pearl","NL",47.50513,-52.79476,2018-08-31 04:00:00,25,0,25
"14577",10401,"Mount Pearl","NL",47.50513,-52.79476,2018-08-31 05:00:00,24,0,24
"14578",10401,"Mount Pearl","NL",47.50513,-52.79476,2018-08-31 06:00:00,23,1,24
"14579",10401,"Mount Pearl","NL",47.50513,-52.79476,2018-08-31 07:00:00,12,1,13
"14580",10401,"Mount Pearl","NL",47.50513,-52.79476,2018-08-31 08:00:00,13,1,14
"14581",10401,"Mount Pearl","NL",47.50513,-52.79476,2018-08-31 09:00:00,14,1,15
"14582",10401,"Mount Pearl","NL",47.50513,-52.79476,2018-08-31 10:00:00,13,1,14
"14583",10401,"Mount Pearl","NL",47.50513,-52.79476,2018-08-31 11:00:00,17,1,18
"14584",10401,"Mount Pearl","NL",47.50513,-52.79476,2018-08-31 12:00:00,20,1,21
"14585",10401,"Mount Pearl","NL",47.50513,-52.79476,2018-08-31 13:00:00,21,0,21
"14586",10401,"Mount Pearl","NL",47.50513,-52.79476,2018-08-31 14:00:00,21,1,22
"14587",10401,"Mount Pearl","NL",47.50513,-52.79476,2018-08-31 15:00:00,20,1,21
"14588",10401,"Mount Pearl","NL",47.50513,-52.79476,2018-08-31 16:00:00,21,1,22
"14589",10401,"Mount Pearl","NL",47.50513,-52.79476,2018-08-31 17:00:00,23,1,24
"14590",10401,"Mount Pearl","NL",47.50513,-52.79476,2018-08-31 18:00:00,25,1,26
"14591",10401,"Mount Pearl","NL",47.50513,-52.79476,2018-08-31 19:00:00,24,1,25
"14592",10401,"Mount Pearl","NL",47.50513,-52.79476,2018-08-31 20:00:00,25,1,26
"14593",10401,"Mount Pearl","NL",47.50513,-52.79476,2018-08-31 21:00:00,24,0,24
"14594",10401,"Mount Pearl","NL",47.50513,-52.79476,2018-08-31 22:00:00,23,1,24
"14595",10401,"Mount Pearl","NL",47.50513,-52.79476,2018-08-31 23:00:00,23,1,24
"14596",10401,"Mount Pearl","NL",47.50513,-52.79476,2018-09-01 00:00:00,23,1,24
"14597",10401,"Mount Pearl","NL",47.50513,-52.79476,2018-09-01 01:00:00,22,1,23
"14598",10401,"Mount Pearl","NL",47.50513,-52.79476,2018-09-01 02:00:00,18,1,19
"14599",10401,"Mount Pearl","NL",47.50513,-52.79476,2018-09-01 03:00:00,15,1,16
"14600",10401,"Mount Pearl","NL",47.50513,-52.79476,2018-09-01 04:00:00,13,1,14
"14601",10401,"Mount Pearl","NL",47.50513,-52.79476,2018-09-01 05:00:00,12,1,13
"14602",10401,"Mount Pearl","NL",47.50513,-52.79476,2018-09-01 06:00:00,11,2,13
"14603",10401,"Mount Pearl","NL",47.50513,-52.79476,2018-09-01 07:00:00,13,2,15
"14604",10401,"Mount Pearl","NL",47.50513,-52.79476,2018-09-01 08:00:00,16,1,17
"14605",10401,"Mount Pearl","NL",47.50513,-52.79476,2018-09-01 09:00:00,20,1,21
"14606",10401,"Mount Pearl","NL",47.50513,-52.79476,2018-09-01 10:00:00,20,1,21
"14607",10401,"Mount Pearl","NL",47.50513,-52.79476,2018-09-01 11:00:00,21,1,22
"14608",10401,"Mount Pearl","NL",47.50513,-52.79476,2018-09-01 12:00:00,21,0,21
"14609",10401,"Mount Pearl","NL",47.50513,-52.79476,2018-09-01 13:00:00,21,0,21
"14610",10401,"Mount Pearl","NL",47.50513,-52.79476,2018-09-01 14:00:00,20,0,20
"14611",10401,"Mount Pearl","NL",47.50513,-52.79476,2018-09-01 15:00:00,21,0,21
"14612",10401,"Mount Pearl","NL",47.50513,-52.79476,2018-09-01 16:00:00,21,0,21
"14613",10401,"Mount Pearl","NL",47.50513,-52.79476,2018-09-01 17:00:00,22,0,22
"14614",10401,"Mount Pearl","NL",47.50513,-52.79476,2018-09-01 18:00:00,22,0,22
"14615",10401,"Mount Pearl","NL",47.50513,-52.79476,2018-09-01 19:00:00,21,1,22
"14616",10401,"Mount Pearl","NL",47.50513,-52.79476,2018-09-01 20:00:00,18,1,19
"14617",10401,"Mount Pearl","NL",47.50513,-52.79476,2018-09-01 21:00:00,16,1,17
"14618",10401,"Mount Pearl","NL",47.50513,-52.79476,2018-09-01 22:00:00,16,0,16
"14619",10401,"Mount Pearl","NL",47.50513,-52.79476,2018-09-01 23:00:00,16,1,17
"14620",10401,"Mount Pearl","NL",47.50513,-52.79476,2018-09-02 00:00:00,17,0,17
"14621",10401,"Mount Pearl","NL",47.50513,-52.79476,2018-09-02 01:00:00,16,1,17
"14622",10401,"Mount Pearl","NL",47.50513,-52.79476,2018-09-02 02:00:00,12,1,13
"14623",10401,"Mount Pearl","NL",47.50513,-52.79476,2018-09-02 03:00:00,11,1,12
"14624",10401,"Mount Pearl","NL",47.50513,-52.79476,2018-09-02 04:00:00,7,2,9
"14625",10401,"Mount Pearl","NL",47.50513,-52.79476,2018-09-02 05:00:00,8,2,10
"14626",10401,"Mount Pearl","NL",47.50513,-52.79476,2018-09-02 06:00:00,8,1,9
"14627",10401,"Mount Pearl","NL",47.50513,-52.79476,2018-09-02 07:00:00,8,2,10
"14628",10401,"Mount Pearl","NL",47.50513,-52.79476,2018-09-02 08:00:00,14,1,15
"14629",10401,"Mount Pearl","NL",47.50513,-52.79476,2018-09-02 09:00:00,18,1,19
"14630",10401,"Mount Pearl","NL",47.50513,-52.79476,2018-09-02 10:00:00,23,1,24
"14631",10401,"Mount Pearl","NL",47.50513,-52.79476,2018-09-02 11:00:00,28,0,28
"14632",10401,"Mount Pearl","NL",47.50513,-52.79476,2018-09-02 12:00:00,28,0,28
"14633",10401,"Mount Pearl","NL",47.50513,-52.79476,2018-09-02 13:00:00,28,0,28
"14634",10401,"Mount Pearl","NL",47.50513,-52.79476,2018-09-02 14:00:00,28,1,29
"14635",10401,"Mount Pearl","NL",47.50513,-52.79476,2018-09-02 15:00:00,28,0,28
"14636",10401,"Mount Pearl","NL",47.50513,-52.79476,2018-09-02 16:00:00,27,1,28
"14637",10401,"Mount Pearl","NL",47.50513,-52.79476,2018-09-02 17:00:00,27,0,27
"14638",10401,"Mount Pearl","NL",47.50513,-52.79476,2018-09-02 18:00:00,24,1,25
"14639",10401,"Mount Pearl","NL",47.50513,-52.79476,2018-09-02 19:00:00,20,1,21
"14640",10401,"Mount Pearl","NL",47.50513,-52.79476,2018-09-02 20:00:00,19,1,20
"14641",10401,"Mount Pearl","NL",47.50513,-52.79476,2018-09-02 21:00:00,18,1,19
"14642",10401,"Mount Pearl","NL",47.50513,-52.79476,2018-09-02 22:00:00,22,1,23
"14643",10401,"Mount Pearl","NL",47.50513,-52.79476,2018-09-02 23:00:00,23,1,24
"14644",10401,"Mount Pearl","NL",47.50513,-52.79476,2018-09-03 00:00:00,23,1,24
"14645",10401,"Mount Pearl","NL",47.50513,-52.79476,2018-09-03 01:00:00,16,1,17
"14646",10401,"Mount Pearl","NL",47.50513,-52.79476,2018-09-03 02:00:00,14,1,15
"14647",10401,"Mount Pearl","NL",47.50513,-52.79476,2018-09-03 03:00:00,21,1,22
"14648",10401,"Mount Pearl","NL",47.50513,-52.79476,2018-09-03 04:00:00,20,1,21
"14649",10401,"Mount Pearl","NL",47.50513,-52.79476,2018-09-03 05:00:00,17,1,18
"14650",10401,"Mount Pearl","NL",47.50513,-52.79476,2018-09-03 06:00:00,18,1,19
"14651",10401,"Mount Pearl","NL",47.50513,-52.79476,2018-09-03 07:00:00,19,1,20
"14652",10401,"Mount Pearl","NL",47.50513,-52.79476,2018-09-03 08:00:00,22,1,23
"14653",10401,"Mount Pearl","NL",47.50513,-52.79476,2018-09-03 09:00:00,23,0,23
"14654",10401,"Mount Pearl","NL",47.50513,-52.79476,2018-09-03 10:00:00,23,0,23
"14655",10401,"Mount Pearl","NL",47.50513,-52.79476,2018-09-03 11:00:00,24,0,24
"14656",10401,"Mount Pearl","NL",47.50513,-52.79476,2018-09-03 12:00:00,24,1,25
"14657",10401,"Mount Pearl","NL",47.50513,-52.79476,2018-09-03 13:00:00,27,1,28
"14658",10401,"Mount Pearl","NL",47.50513,-52.79476,2018-09-03 14:00:00,26,0,26
"14659",10401,"Mount Pearl","NL",47.50513,-52.79476,2018-09-03 15:00:00,28,0,28
"14660",10401,"Mount Pearl","NL",47.50513,-52.79476,2018-09-03 16:00:00,30,0,30
"14661",10401,"Mount Pearl","NL",47.50513,-52.79476,2018-09-03 17:00:00,32,1,33
"14662",10401,"Mount Pearl","NL",47.50513,-52.79476,2018-09-03 18:00:00,30,1,31
"14663",10401,"Mount Pearl","NL",47.50513,-52.79476,2018-09-03 19:00:00,25,1,26
"14664",10401,"Mount Pearl","NL",47.50513,-52.79476,2018-09-03 20:00:00,21,2,23
"14665",10401,"Mount Pearl","NL",47.50513,-52.79476,2018-09-03 21:00:00,20,1,21
"14666",10401,"Mount Pearl","NL",47.50513,-52.79476,2018-09-03 22:00:00,16,1,17
"14667",10401,"Mount Pearl","NL",47.50513,-52.79476,2018-09-03 23:00:00,20,1,21
"14668",10401,"Mount Pearl","NL",47.50513,-52.79476,2018-09-04 00:00:00,22,1,23
"14669",10401,"Mount Pearl","NL",47.50513,-52.79476,2018-09-04 01:00:00,27,0,27
"14670",10401,"Mount Pearl","NL",47.50513,-52.79476,2018-09-04 02:00:00,28,0,28
"14671",10401,"Mount Pearl","NL",47.50513,-52.79476,2018-09-04 03:00:00,28,0,28
"14672",10401,"Mount Pearl","NL",47.50513,-52.79476,2018-09-04 04:00:00,27,1,28
"14673",10401,"Mount Pearl","NL",47.50513,-52.79476,2018-09-04 05:00:00,24,0,24
"14674",10401,"Mount Pearl","NL",47.50513,-52.79476,2018-09-04 06:00:00,24,0,24
"14675",10401,"Mount Pearl","NL",47.50513,-52.79476,2018-09-04 07:00:00,26,1,27
"14676",10401,"Mount Pearl","NL",47.50513,-52.79476,2018-09-04 08:00:00,27,1,28
"14677",10401,"Mount Pearl","NL",47.50513,-52.79476,2018-09-04 09:00:00,28,1,29
"14678",10401,"Mount Pearl","NL",47.50513,-52.79476,2018-09-04 10:00:00,29,1,30
"14679",10401,"Mount Pearl","NL",47.50513,-52.79476,2018-09-04 11:00:00,30,1,31
"14680",10401,"Mount Pearl","NL",47.50513,-52.79476,2018-09-04 12:00:00,31,0,31
"14681",10401,"Mount Pearl","NL",47.50513,-52.79476,2018-09-04 13:00:00,32,0,32
"14682",10401,"Mount Pearl","NL",47.50513,-52.79476,2018-09-04 14:00:00,32,0,32
"14683",10401,"Mount Pearl","NL",47.50513,-52.79476,2018-09-04 15:00:00,31,0,31
"14684",10401,"Mount Pearl","NL",47.50513,-52.79476,2018-09-04 16:00:00,30,0,30
"14685",10401,"Mount Pearl","NL",47.50513,-52.79476,2018-09-04 17:00:00,27,0,27
"14686",10401,"Mount Pearl","NL",47.50513,-52.79476,2018-09-04 18:00:00,26,0,26
"14687",10401,"Mount Pearl","NL",47.50513,-52.79476,2018-09-04 19:00:00,26,0,26
"14688",10401,"Mount Pearl","NL",47.50513,-52.79476,2018-09-04 20:00:00,25,0,25
"14689",10401,"Mount Pearl","NL",47.50513,-52.79476,2018-09-04 21:00:00,25,0,25
"14690",10401,"Mount Pearl","NL",47.50513,-52.79476,2018-09-04 22:00:00,24,0,24
"14691",10401,"Mount Pearl","NL",47.50513,-52.79476,2018-09-04 23:00:00,23,0,23
"14692",10401,"Mount Pearl","NL",47.50513,-52.79476,2018-09-05 00:00:00,22,0,22
"14693",10401,"Mount Pearl","NL",47.50513,-52.79476,2018-09-05 01:00:00,21,0,21
"14694",10401,"Mount Pearl","NL",47.50513,-52.79476,2018-09-05 02:00:00,21,0,21
"14695",10401,"Mount Pearl","NL",47.50513,-52.79476,2018-09-05 03:00:00,19,1,20
"14696",10401,"Mount Pearl","NL",47.50513,-52.79476,2018-09-05 04:00:00,19,0,19
"14697",10401,"Mount Pearl","NL",47.50513,-52.79476,2018-09-05 05:00:00,18,1,19
"14698",10401,"Mount Pearl","NL",47.50513,-52.79476,2018-09-05 06:00:00,16,3,19
"14699",10401,"Mount Pearl","NL",47.50513,-52.79476,2018-09-05 07:00:00,12,5,17
"14700",10401,"Mount Pearl","NL",47.50513,-52.79476,2018-09-05 08:00:00,13,4,17
"14701",10401,"Mount Pearl","NL",47.50513,-52.79476,2018-09-05 09:00:00,17,1,18
"14702",10401,"Mount Pearl","NL",47.50513,-52.79476,2018-09-05 10:00:00,17,0,17
"14703",10401,"Mount Pearl","NL",47.50513,-52.79476,2018-09-05 11:00:00,19,0,19
"14704",10401,"Mount Pearl","NL",47.50513,-52.79476,2018-09-05 12:00:00,19,0,19
"14705",10401,"Mount Pearl","NL",47.50513,-52.79476,2018-09-05 13:00:00,20,0,20
"14706",10401,"Mount Pearl","NL",47.50513,-52.79476,2018-09-05 14:00:00,20,0,20
"14707",10401,"Mount Pearl","NL",47.50513,-52.79476,2018-09-05 15:00:00,19,0,19
"14708",10401,"Mount Pearl","NL",47.50513,-52.79476,2018-09-05 16:00:00,16,0,16
"14709",10401,"Mount Pearl","NL",47.50513,-52.79476,2018-09-05 17:00:00,16,0,16
"14710",10401,"Mount Pearl","NL",47.50513,-52.79476,2018-09-05 18:00:00,16,1,17
"14711",10401,"Mount Pearl","NL",47.50513,-52.79476,2018-09-05 19:00:00,16,1,17
"14712",10401,"Mount Pearl","NL",47.50513,-52.79476,2018-09-05 20:00:00,16,1,17
"14713",10401,"Mount Pearl","NL",47.50513,-52.79476,2018-09-05 21:00:00,14,1,15
"14714",10401,"Mount Pearl","NL",47.50513,-52.79476,2018-09-05 22:00:00,13,1,14
"14715",10401,"Mount Pearl","NL",47.50513,-52.79476,2018-09-05 23:00:00,10,1,11
"14716",10401,"Mount Pearl","NL",47.50513,-52.79476,2018-09-06 00:00:00,4,5,9
"14717",10401,"Mount Pearl","NL",47.50513,-52.79476,2018-09-06 01:00:00,3,5,8
"14718",10401,"Mount Pearl","NL",47.50513,-52.79476,2018-09-06 02:00:00,6,1,7
"14719",10401,"Mount Pearl","NL",47.50513,-52.79476,2018-09-06 03:00:00,11,0,11
"14720",10401,"Mount Pearl","NL",47.50513,-52.79476,2018-09-06 04:00:00,9,1,10
"14721",10401,"Mount Pearl","NL",47.50513,-52.79476,2018-09-06 05:00:00,5,2,7
"14722",10401,"Mount Pearl","NL",47.50513,-52.79476,2018-09-06 06:00:00,6,1,7
"14723",10401,"Mount Pearl","NL",47.50513,-52.79476,2018-09-06 07:00:00,10,2,12
"14724",10401,"Mount Pearl","NL",47.50513,-52.79476,2018-09-06 08:00:00,14,0,14
"14725",10401,"Mount Pearl","NL",47.50513,-52.79476,2018-09-06 09:00:00,17,0,17
"14726",10401,"Mount Pearl","NL",47.50513,-52.79476,2018-09-06 10:00:00,18,0,18
"14727",10401,"Mount Pearl","NL",47.50513,-52.79476,2018-09-06 11:00:00,20,0,20
"14728",10401,"Mount Pearl","NL",47.50513,-52.79476,2018-09-06 12:00:00,20,1,21
"14729",10401,"Mount Pearl","NL",47.50513,-52.79476,2018-09-06 13:00:00,21,1,22
"14730",10401,"Mount Pearl","NL",47.50513,-52.79476,2018-09-06 14:00:00,22,1,23
"14731",10401,"Mount Pearl","NL",47.50513,-52.79476,2018-09-06 15:00:00,23,1,24
"14732",10401,"Mount Pearl","NL",47.50513,-52.79476,2018-09-06 16:00:00,26,1,27
"14733",10401,"Mount Pearl","NL",47.50513,-52.79476,2018-09-06 17:00:00,25,2,27
"14734",10401,"Mount Pearl","NL",47.50513,-52.79476,2018-09-06 18:00:00,24,1,25
"14735",10401,"Mount Pearl","NL",47.50513,-52.79476,2018-09-06 19:00:00,24,1,25
"14736",10401,"Mount Pearl","NL",47.50513,-52.79476,2018-09-06 20:00:00,24,1,25
"14737",10401,"Mount Pearl","NL",47.50513,-52.79476,2018-09-06 21:00:00,24,1,25
"14738",10401,"Mount Pearl","NL",47.50513,-52.79476,2018-09-06 22:00:00,25,1,26
"14739",10401,"Mount Pearl","NL",47.50513,-52.79476,2018-09-06 23:00:00,24,1,25
"14740",10401,"Mount Pearl","NL",47.50513,-52.79476,2018-09-07 00:00:00,24,1,25
"14741",10401,"Mount Pearl","NL",47.50513,-52.79476,2018-09-07 01:00:00,22,1,23
"14742",10401,"Mount Pearl","NL",47.50513,-52.79476,2018-09-07 02:00:00,19,2,21
"14743",10401,"Mount Pearl","NL",47.50513,-52.79476,2018-09-07 03:00:00,17,1,18
"14744",10401,"Mount Pearl","NL",47.50513,-52.79476,2018-09-07 04:00:00,14,2,16
"14745",10401,"Mount Pearl","NL",47.50513,-52.79476,2018-09-07 05:00:00,13,1,14
"14746",10401,"Mount Pearl","NL",47.50513,-52.79476,2018-09-07 06:00:00,11,2,13
"14747",10401,"Mount Pearl","NL",47.50513,-52.79476,2018-09-07 07:00:00,10,3,13
"14748",10401,"Mount Pearl","NL",47.50513,-52.79476,2018-09-07 08:00:00,10,2,12
"14749",10401,"Mount Pearl","NL",47.50513,-52.79476,2018-09-07 09:00:00,12,2,14
"14750",10401,"Mount Pearl","NL",47.50513,-52.79476,2018-09-07 10:00:00,18,2,20
"14751",10401,"Mount Pearl","NL",47.50513,-52.79476,2018-09-07 11:00:00,21,2,23
"14752",10401,"Mount Pearl","NL",47.50513,-52.79476,2018-09-07 12:00:00,23,1,24
"14753",10401,"Mount Pearl","NL",47.50513,-52.79476,2018-09-07 13:00:00,23,1,24
"14754",10401,"Mount Pearl","NL",47.50513,-52.79476,2018-09-07 14:00:00,22,0,22
"14755",10401,"Mount Pearl","NL",47.50513,-52.79476,2018-09-07 15:00:00,25,0,25
"14756",10401,"Mount Pearl","NL",47.50513,-52.79476,2018-09-07 16:00:00,24,0,24
"14757",10401,"Mount Pearl","NL",47.50513,-52.79476,2018-09-07 17:00:00,20,1,21
"14758",10401,"Mount Pearl","NL",47.50513,-52.79476,2018-09-07 18:00:00,19,1,20
"14759",10401,"Mount Pearl","NL",47.50513,-52.79476,2018-09-07 19:00:00,17,1,18
"14760",10401,"Mount Pearl","NL",47.50513,-52.79476,2018-09-07 20:00:00,14,2,16
"14761",10401,"Mount Pearl","NL",47.50513,-52.79476,2018-09-07 21:00:00,14,0,14
"14762",10401,"Mount Pearl","NL",47.50513,-52.79476,2018-09-07 22:00:00,12,1,13
"14763",10401,"Mount Pearl","NL",47.50513,-52.79476,2018-09-07 23:00:00,10,2,12
"14764",10401,"Mount Pearl","NL",47.50513,-52.79476,2018-09-08 00:00:00,16,2,18
"14765",10401,"Mount Pearl","NL",47.50513,-52.79476,2018-09-08 01:00:00,18,1,19
"14766",10401,"Mount Pearl","NL",47.50513,-52.79476,2018-09-08 02:00:00,16,1,17
"14767",10401,"Mount Pearl","NL",47.50513,-52.79476,2018-09-08 03:00:00,15,0,15
"14768",10401,"Mount Pearl","NL",47.50513,-52.79476,2018-09-08 04:00:00,15,0,15
"14769",10401,"Mount Pearl","NL",47.50513,-52.79476,2018-09-08 05:00:00,15,0,15
"14770",10401,"Mount Pearl","NL",47.50513,-52.79476,2018-09-08 06:00:00,16,0,16
"14771",10401,"Mount Pearl","NL",47.50513,-52.79476,2018-09-08 07:00:00,15,1,16
"14772",10401,"Mount Pearl","NL",47.50513,-52.79476,2018-09-08 08:00:00,15,0,15
"14773",10401,"Mount Pearl","NL",47.50513,-52.79476,2018-09-08 09:00:00,22,1,23
"14774",10401,"Mount Pearl","NL",47.50513,-52.79476,2018-09-08 10:00:00,22,0,22
"14775",10401,"Mount Pearl","NL",47.50513,-52.79476,2018-09-08 11:00:00,23,1,24
"14776",10401,"Mount Pearl","NL",47.50513,-52.79476,2018-09-08 12:00:00,24,1,25
"14777",10401,"Mount Pearl","NL",47.50513,-52.79476,2018-09-08 13:00:00,26,1,27
"14778",10401,"Mount Pearl","NL",47.50513,-52.79476,2018-09-08 14:00:00,27,1,28
"14779",10401,"Mount Pearl","NL",47.50513,-52.79476,2018-09-08 15:00:00,28,1,29
"14780",10401,"Mount Pearl","NL",47.50513,-52.79476,2018-09-08 16:00:00,26,1,27
"14781",10401,"Mount Pearl","NL",47.50513,-52.79476,2018-09-08 17:00:00,26,2,28
"14782",10401,"Mount Pearl","NL",47.50513,-52.79476,2018-09-08 18:00:00,27,2,29
"14783",10401,"Mount Pearl","NL",47.50513,-52.79476,2018-09-08 19:00:00,27,2,29
"14784",10401,"Mount Pearl","NL",47.50513,-52.79476,2018-09-08 20:00:00,25,1,26
"14785",10401,"Mount Pearl","NL",47.50513,-52.79476,2018-09-08 21:00:00,23,1,24
"14786",10401,"Mount Pearl","NL",47.50513,-52.79476,2018-09-08 22:00:00,19,2,21
"14787",10401,"Mount Pearl","NL",47.50513,-52.79476,2018-09-08 23:00:00,15,3,18
"14788",10401,"Mount Pearl","NL",47.50513,-52.79476,2018-09-09 00:00:00,13,3,16
"14789",10401,"Mount Pearl","NL",47.50513,-52.79476,2018-09-09 01:00:00,13,2,15
"14790",10401,"Mount Pearl","NL",47.50513,-52.79476,2018-09-09 02:00:00,10,3,13
"14791",10401,"Mount Pearl","NL",47.50513,-52.79476,2018-09-09 03:00:00,13,2,15
"14792",10401,"Mount Pearl","NL",47.50513,-52.79476,2018-09-09 04:00:00,9,2,11
"14793",10401,"Mount Pearl","NL",47.50513,-52.79476,2018-09-09 05:00:00,3,2,5
"14794",10401,"Mount Pearl","NL",47.50513,-52.79476,2018-09-09 06:00:00,14,2,16
"14795",10401,"Mount Pearl","NL",47.50513,-52.79476,2018-09-09 07:00:00,12,2,14
"14796",10401,"Mount Pearl","NL",47.50513,-52.79476,2018-09-09 08:00:00,16,1,17
"14797",10401,"Mount Pearl","NL",47.50513,-52.79476,2018-09-09 09:00:00,14,1,15
"14798",10401,"Mount Pearl","NL",47.50513,-52.79476,2018-09-09 10:00:00,17,1,18
"14799",10401,"Mount Pearl","NL",47.50513,-52.79476,2018-09-09 11:00:00,20,1,21
"14800",10401,"Mount Pearl","NL",47.50513,-52.79476,2018-09-09 12:00:00,21,1,22
"14801",10401,"Mount Pearl","NL",47.50513,-52.79476,2018-09-09 13:00:00,22,1,23
"14802",10401,"Mount Pearl","NL",47.50513,-52.79476,2018-09-09 14:00:00,22,1,23
"14803",10401,"Mount Pearl","NL",47.50513,-52.79476,2018-09-09 15:00:00,21,1,22
"14804",10401,"Mount Pearl","NL",47.50513,-52.79476,2018-09-09 16:00:00,21,1,22
"14805",10401,"Mount Pearl","NL",47.50513,-52.79476,2018-09-09 17:00:00,22,2,24
"14806",10401,"Mount Pearl","NL",47.50513,-52.79476,2018-09-09 18:00:00,20,2,22
"14807",10401,"Mount Pearl","NL",47.50513,-52.79476,2018-09-09 19:00:00,17,2,19
"14808",10401,"Mount Pearl","NL",47.50513,-52.79476,2018-09-09 20:00:00,13,2,15
"14809",10401,"Mount Pearl","NL",47.50513,-52.79476,2018-09-09 21:00:00,13,3,16
"14810",10401,"Mount Pearl","NL",47.50513,-52.79476,2018-09-09 22:00:00,14,2,16
"14811",10401,"Mount Pearl","NL",47.50513,-52.79476,2018-09-09 23:00:00,14,2,16
"14812",10401,"Mount Pearl","NL",47.50513,-52.79476,2018-09-10 00:00:00,14,1,15
"14813",10401,"Mount Pearl","NL",47.50513,-52.79476,2018-09-10 01:00:00,14,2,16
"14814",10401,"Mount Pearl","NL",47.50513,-52.79476,2018-09-10 02:00:00,10,1,11
"14815",10401,"Mount Pearl","NL",47.50513,-52.79476,2018-09-10 03:00:00,9,2,11
"14816",10401,"Mount Pearl","NL",47.50513,-52.79476,2018-09-10 04:00:00,9,3,12
"14817",10401,"Mount Pearl","NL",47.50513,-52.79476,2018-09-10 05:00:00,10,2,12
"14818",10401,"Mount Pearl","NL",47.50513,-52.79476,2018-09-10 06:00:00,9,3,12
"14819",10401,"Mount Pearl","NL",47.50513,-52.79476,2018-09-10 07:00:00,7,8,15
"14820",10401,"Mount Pearl","NL",47.50513,-52.79476,2018-09-10 08:00:00,13,4,17
"14821",10401,"Mount Pearl","NL",47.50513,-52.79476,2018-09-10 09:00:00,17,1,18
"14822",10401,"Mount Pearl","NL",47.50513,-52.79476,2018-09-10 10:00:00,17,2,19
"14823",10401,"Mount Pearl","NL",47.50513,-52.79476,2018-09-10 11:00:00,19,2,21
"14824",10401,"Mount Pearl","NL",47.50513,-52.79476,2018-09-10 12:00:00,22,1,23
"14825",10401,"Mount Pearl","NL",47.50513,-52.79476,2018-09-10 13:00:00,22,2,24
"14826",10401,"Mount Pearl","NL",47.50513,-52.79476,2018-09-10 14:00:00,21,2,23
"14827",10401,"Mount Pearl","NL",47.50513,-52.79476,2018-09-10 15:00:00,19,1,20
"14828",10401,"Mount Pearl","NL",47.50513,-52.79476,2018-09-10 16:00:00,19,1,20
"14829",10401,"Mount Pearl","NL",47.50513,-52.79476,2018-09-10 17:00:00,19,2,21
"14830",10401,"Mount Pearl","NL",47.50513,-52.79476,2018-09-10 18:00:00,19,2,21
"14831",10401,"Mount Pearl","NL",47.50513,-52.79476,2018-09-10 19:00:00,16,3,19
"14832",10401,"Mount Pearl","NL",47.50513,-52.79476,2018-09-10 20:00:00,15,2,17
"14833",10401,"Mount Pearl","NL",47.50513,-52.79476,2018-09-10 21:00:00,16,1,17
"14834",10401,"Mount Pearl","NL",47.50513,-52.79476,2018-09-10 22:00:00,18,1,19
"14835",10401,"Mount Pearl","NL",47.50513,-52.79476,2018-09-10 23:00:00,17,1,18
"14836",10401,"Mount Pearl","NL",47.50513,-52.79476,2018-09-11 00:00:00,18,1,19
"14837",10401,"Mount Pearl","NL",47.50513,-52.79476,2018-09-11 01:00:00,18,1,19
"14838",10401,"Mount Pearl","NL",47.50513,-52.79476,2018-09-11 02:00:00,18,1,19
"14839",10401,"Mount Pearl","NL",47.50513,-52.79476,2018-09-11 03:00:00,19,1,20
"14840",10401,"Mount Pearl","NL",47.50513,-52.79476,2018-09-11 04:00:00,18,1,19
"14841",10401,"Mount Pearl","NL",47.50513,-52.79476,2018-09-11 05:00:00,19,1,20
"14842",10401,"Mount Pearl","NL",47.50513,-52.79476,2018-09-11 06:00:00,19,2,21
"14843",10401,"Mount Pearl","NL",47.50513,-52.79476,2018-09-11 07:00:00,17,4,21
"14844",10401,"Mount Pearl","NL",47.50513,-52.79476,2018-09-11 08:00:00,20,3,23
"14845",10401,"Mount Pearl","NL",47.50513,-52.79476,2018-09-11 09:00:00,21,2,23
"14846",10401,"Mount Pearl","NL",47.50513,-52.79476,2018-09-11 10:00:00,22,1,23
"14847",10401,"Mount Pearl","NL",47.50513,-52.79476,2018-09-11 11:00:00,23,1,24
"14848",10401,"Mount Pearl","NL",47.50513,-52.79476,2018-09-11 12:00:00,25,1,26
"14849",10401,"Mount Pearl","NL",47.50513,-52.79476,2018-09-11 13:00:00,25,1,26
"14850",10401,"Mount Pearl","NL",47.50513,-52.79476,2018-09-11 14:00:00,25,1,26
"14851",10401,"Mount Pearl","NL",47.50513,-52.79476,2018-09-11 15:00:00,25,1,26
"14852",10401,"Mount Pearl","NL",47.50513,-52.79476,2018-09-11 16:00:00,25,2,27
"14853",10401,"Mount Pearl","NL",47.50513,-52.79476,2018-09-11 17:00:00,25,1,26
"14854",10401,"Mount Pearl","NL",47.50513,-52.79476,2018-09-11 18:00:00,24,2,26
"14855",10401,"Mount Pearl","NL",47.50513,-52.79476,2018-09-11 19:00:00,24,1,25
"14856",10401,"Mount Pearl","NL",47.50513,-52.79476,2018-09-11 20:00:00,24,2,26
"14857",10401,"Mount Pearl","NL",47.50513,-52.79476,2018-09-11 21:00:00,24,1,25
"14858",10401,"Mount Pearl","NL",47.50513,-52.79476,2018-09-11 22:00:00,23,1,24
"14859",10401,"Mount Pearl","NL",47.50513,-52.79476,2018-09-11 23:00:00,23,1,24
"14860",10401,"Mount Pearl","NL",47.50513,-52.79476,2018-09-12 00:00:00,24,1,25
"14861",10401,"Mount Pearl","NL",47.50513,-52.79476,2018-09-12 01:00:00,23,1,24
"14862",10401,"Mount Pearl","NL",47.50513,-52.79476,2018-09-12 02:00:00,24,1,25
"14863",10401,"Mount Pearl","NL",47.50513,-52.79476,2018-09-12 03:00:00,24,1,25
"14864",10401,"Mount Pearl","NL",47.50513,-52.79476,2018-09-12 04:00:00,24,1,25
"14865",10401,"Mount Pearl","NL",47.50513,-52.79476,2018-09-12 05:00:00,24,1,25
"14866",10401,"Mount Pearl","NL",47.50513,-52.79476,2018-09-12 06:00:00,22,1,23
"14867",10401,"Mount Pearl","NL",47.50513,-52.79476,2018-09-12 07:00:00,21,3,24
"14868",10401,"Mount Pearl","NL",47.50513,-52.79476,2018-09-12 08:00:00,24,2,26
"14869",10401,"Mount Pearl","NL",47.50513,-52.79476,2018-09-12 09:00:00,26,2,28
"14870",10401,"Mount Pearl","NL",47.50513,-52.79476,2018-09-12 10:00:00,25,2,27
"14871",10401,"Mount Pearl","NL",47.50513,-52.79476,2018-09-12 11:00:00,23,2,25
"14872",10401,"Mount Pearl","NL",47.50513,-52.79476,2018-09-12 12:00:00,25,1,26
"14873",10401,"Mount Pearl","NL",47.50513,-52.79476,2018-09-12 13:00:00,25,1,26
"14874",10401,"Mount Pearl","NL",47.50513,-52.79476,2018-09-12 14:00:00,25,1,26
"14875",10401,"Mount Pearl","NL",47.50513,-52.79476,2018-09-12 15:00:00,26,1,27
"14876",10401,"Mount Pearl","NL",47.50513,-52.79476,2018-09-12 16:00:00,23,3,26
"14877",10401,"Mount Pearl","NL",47.50513,-52.79476,2018-09-12 17:00:00,28,1,29
"14878",10401,"Mount Pearl","NL",47.50513,-52.79476,2018-09-12 18:00:00,29,1,30
"14879",10401,"Mount Pearl","NL",47.50513,-52.79476,2018-09-12 19:00:00,29,1,30
"14880",10401,"Mount Pearl","NL",47.50513,-52.79476,2018-09-12 20:00:00,27,2,29
"14881",10401,"Mount Pearl","NL",47.50513,-52.79476,2018-09-12 21:00:00,27,1,28
"14882",10401,"Mount Pearl","NL",47.50513,-52.79476,2018-09-12 22:00:00,27,1,28
"14883",10401,"Mount Pearl","NL",47.50513,-52.79476,2018-09-12 23:00:00,24,0,24
"14884",10401,"Mount Pearl","NL",47.50513,-52.79476,2018-09-13 00:00:00,26,0,26
"14885",10401,"Mount Pearl","NL",47.50513,-52.79476,2018-09-13 01:00:00,27,0,27
"14886",10401,"Mount Pearl","NL",47.50513,-52.79476,2018-09-13 02:00:00,28,0,28
"14887",10401,"Mount Pearl","NL",47.50513,-52.79476,2018-09-13 03:00:00,29,0,29
"14888",10401,"Mount Pearl","NL",47.50513,-52.79476,2018-09-13 04:00:00,27,0,27
"14889",10401,"Mount Pearl","NL",47.50513,-52.79476,2018-09-13 05:00:00,27,0,27
"14890",10401,"Mount Pearl","NL",47.50513,-52.79476,2018-09-13 06:00:00,27,0,27
"14891",10401,"Mount Pearl","NL",47.50513,-52.79476,2018-09-13 07:00:00,27,0,27
"14892",10401,"Mount Pearl","NL",47.50513,-52.79476,2018-09-13 08:00:00,27,1,28
"14893",10401,"Mount Pearl","NL",47.50513,-52.79476,2018-09-13 09:00:00,28,1,29
"14894",10401,"Mount Pearl","NL",47.50513,-52.79476,2018-09-13 10:00:00,27,1,28
"14895",10401,"Mount Pearl","NL",47.50513,-52.79476,2018-09-13 11:00:00,27,1,28
"14896",10401,"Mount Pearl","NL",47.50513,-52.79476,2018-09-13 12:00:00,26,1,27
"14897",10401,"Mount Pearl","NL",47.50513,-52.79476,2018-09-13 13:00:00,27,1,28
"14898",10401,"Mount Pearl","NL",47.50513,-52.79476,2018-09-13 14:00:00,27,1,28
"14899",10401,"Mount Pearl","NL",47.50513,-52.79476,2018-09-13 15:00:00,28,1,29
"14900",10401,"Mount Pearl","NL",47.50513,-52.79476,2018-09-13 16:00:00,26,1,27
"14901",10401,"Mount Pearl","NL",47.50513,-52.79476,2018-09-13 17:00:00,26,1,27
"14902",10401,"Mount Pearl","NL",47.50513,-52.79476,2018-09-13 18:00:00,26,1,27
"14903",10401,"Mount Pearl","NL",47.50513,-52.79476,2018-09-13 19:00:00,28,1,29
"14904",10401,"Mount Pearl","NL",47.50513,-52.79476,2018-09-13 20:00:00,26,2,28
"14905",10401,"Mount Pearl","NL",47.50513,-52.79476,2018-09-13 21:00:00,26,2,28
"14906",10401,"Mount Pearl","NL",47.50513,-52.79476,2018-09-13 22:00:00,25,2,27
"14907",10401,"Mount Pearl","NL",47.50513,-52.79476,2018-09-13 23:00:00,24,4,28
"14908",10401,"Mount Pearl","NL",47.50513,-52.79476,2018-09-14 00:00:00,24,2,26
"14909",10401,"Mount Pearl","NL",47.50513,-52.79476,2018-09-14 01:00:00,18,1,19
"14910",10401,"Mount Pearl","NL",47.50513,-52.79476,2018-09-14 02:00:00,22,0,22
"14911",10401,"Mount Pearl","NL",47.50513,-52.79476,2018-09-14 03:00:00,20,0,20
"14912",10401,"Mount Pearl","NL",47.50513,-52.79476,2018-09-14 04:00:00,21,0,21
"14913",10401,"Mount Pearl","NL",47.50513,-52.79476,2018-09-14 05:00:00,21,0,21
"14914",10401,"Mount Pearl","NL",47.50513,-52.79476,2018-09-14 06:00:00,18,0,18
"14915",10401,"Mount Pearl","NL",47.50513,-52.79476,2018-09-14 07:00:00,16,0,16
"14916",10401,"Mount Pearl","NL",47.50513,-52.79476,2018-09-14 08:00:00,16,1,17
"14917",10401,"Mount Pearl","NL",47.50513,-52.79476,2018-09-14 09:00:00,17,0,17
"14918",10401,"Mount Pearl","NL",47.50513,-52.79476,2018-09-14 10:00:00,16,1,17
"14919",10401,"Mount Pearl","NL",47.50513,-52.79476,2018-09-14 11:00:00,16,1,17
"14920",10401,"Mount Pearl","NL",47.50513,-52.79476,2018-09-14 12:00:00,16,1,17
"14921",10401,"Mount Pearl","NL",47.50513,-52.79476,2018-09-14 13:00:00,17,1,18
"14922",10401,"Mount Pearl","NL",47.50513,-52.79476,2018-09-14 14:00:00,17,0,17
"14923",10401,"Mount Pearl","NL",47.50513,-52.79476,2018-09-14 15:00:00,17,2,19
"14924",10401,"Mount Pearl","NL",47.50513,-52.79476,2018-09-14 16:00:00,17,1,18
"14925",10401,"Mount Pearl","NL",47.50513,-52.79476,2018-09-14 17:00:00,17,1,18
"14926",10401,"Mount Pearl","NL",47.50513,-52.79476,2018-09-14 18:00:00,17,1,18
"14927",10401,"Mount Pearl","NL",47.50513,-52.79476,2018-09-14 19:00:00,16,2,18
"14928",10401,"Mount Pearl","NL",47.50513,-52.79476,2018-09-14 20:00:00,16,2,18
"14929",10401,"Mount Pearl","NL",47.50513,-52.79476,2018-09-14 21:00:00,13,1,14
"14930",10401,"Mount Pearl","NL",47.50513,-52.79476,2018-09-14 22:00:00,12,1,13
"14931",10401,"Mount Pearl","NL",47.50513,-52.79476,2018-09-14 23:00:00,11,1,12
"14932",10401,"Mount Pearl","NL",47.50513,-52.79476,2018-09-15 00:00:00,9,0,9
"14933",10401,"Mount Pearl","NL",47.50513,-52.79476,2018-09-15 01:00:00,11,0,11
"14934",10401,"Mount Pearl","NL",47.50513,-52.79476,2018-09-15 02:00:00,16,0,16
"14935",10401,"Mount Pearl","NL",47.50513,-52.79476,2018-09-15 03:00:00,16,0,16
"14936",10401,"Mount Pearl","NL",47.50513,-52.79476,2018-09-15 04:00:00,15,0,15
"14937",10401,"Mount Pearl","NL",47.50513,-52.79476,2018-09-15 05:00:00,17,0,17
"14938",10401,"Mount Pearl","NL",47.50513,-52.79476,2018-09-15 06:00:00,17,0,17
"14939",10401,"Mount Pearl","NL",47.50513,-52.79476,2018-09-15 07:00:00,17,2,19
"14940",10401,"Mount Pearl","NL",47.50513,-52.79476,2018-09-15 08:00:00,16,1,17
"14941",10401,"Mount Pearl","NL",47.50513,-52.79476,2018-09-15 09:00:00,17,0,17
"14942",10401,"Mount Pearl","NL",47.50513,-52.79476,2018-09-15 10:00:00,18,1,19
"14943",10401,"Mount Pearl","NL",47.50513,-52.79476,2018-09-15 11:00:00,19,0,19
"14944",10401,"Mount Pearl","NL",47.50513,-52.79476,2018-09-15 12:00:00,20,0,20
"14945",10401,"Mount Pearl","NL",47.50513,-52.79476,2018-09-15 13:00:00,21,0,21
"14946",10401,"Mount Pearl","NL",47.50513,-52.79476,2018-09-15 14:00:00,21,1,22
"14947",10401,"Mount Pearl","NL",47.50513,-52.79476,2018-09-15 15:00:00,22,1,23
"14948",10401,"Mount Pearl","NL",47.50513,-52.79476,2018-09-15 16:00:00,23,0,23
"14949",10401,"Mount Pearl","NL",47.50513,-52.79476,2018-09-15 17:00:00,23,1,24
"14950",10401,"Mount Pearl","NL",47.50513,-52.79476,2018-09-15 18:00:00,23,1,24
"14951",10401,"Mount Pearl","NL",47.50513,-52.79476,2018-09-15 19:00:00,23,0,23
"14952",10401,"Mount Pearl","NL",47.50513,-52.79476,2018-09-15 20:00:00,24,1,25
"14953",10401,"Mount Pearl","NL",47.50513,-52.79476,2018-09-15 21:00:00,24,0,24
"14954",10401,"Mount Pearl","NL",47.50513,-52.79476,2018-09-15 22:00:00,24,1,25
"14955",10401,"Mount Pearl","NL",47.50513,-52.79476,2018-09-15 23:00:00,24,0,24
"14956",10401,"Mount Pearl","NL",47.50513,-52.79476,2018-09-16 00:00:00,23,0,23
"14957",10401,"Mount Pearl","NL",47.50513,-52.79476,2018-09-16 01:00:00,23,0,23
"14958",10401,"Mount Pearl","NL",47.50513,-52.79476,2018-09-16 02:00:00,22,1,23
"14959",10401,"Mount Pearl","NL",47.50513,-52.79476,2018-09-16 03:00:00,22,1,23
"14960",10401,"Mount Pearl","NL",47.50513,-52.79476,2018-09-16 04:00:00,22,1,23
"14961",10401,"Mount Pearl","NL",47.50513,-52.79476,2018-09-16 05:00:00,22,0,22
"14962",10401,"Mount Pearl","NL",47.50513,-52.79476,2018-09-16 06:00:00,21,0,21
"14963",10401,"Mount Pearl","NL",47.50513,-52.79476,2018-09-16 07:00:00,18,1,19
"14964",10401,"Mount Pearl","NL",47.50513,-52.79476,2018-09-16 08:00:00,15,2,17
"14965",10401,"Mount Pearl","NL",47.50513,-52.79476,2018-09-16 09:00:00,17,0,17
"14966",10401,"Mount Pearl","NL",47.50513,-52.79476,2018-09-16 10:00:00,16,0,16
"14967",10401,"Mount Pearl","NL",47.50513,-52.79476,2018-09-16 11:00:00,14,3,17
"14968",10401,"Mount Pearl","NL",47.50513,-52.79476,2018-09-16 12:00:00,17,1,18
"14969",10401,"Mount Pearl","NL",47.50513,-52.79476,2018-09-16 13:00:00,18,1,19
"14970",10401,"Mount Pearl","NL",47.50513,-52.79476,2018-09-16 14:00:00,17,1,18
"14971",10401,"Mount Pearl","NL",47.50513,-52.79476,2018-09-16 15:00:00,19,1,20
"14972",10401,"Mount Pearl","NL",47.50513,-52.79476,2018-09-16 16:00:00,19,0,19
"14973",10401,"Mount Pearl","NL",47.50513,-52.79476,2018-09-16 17:00:00,18,1,19
"14974",10401,"Mount Pearl","NL",47.50513,-52.79476,2018-09-16 18:00:00,18,2,20
"14975",10401,"Mount Pearl","NL",47.50513,-52.79476,2018-09-16 19:00:00,21,1,22
"14976",10401,"Mount Pearl","NL",47.50513,-52.79476,2018-09-16 20:00:00,14,1,15
"14977",10401,"Mount Pearl","NL",47.50513,-52.79476,2018-09-16 21:00:00,13,2,15
"14978",10401,"Mount Pearl","NL",47.50513,-52.79476,2018-09-16 22:00:00,16,2,18
"14979",10401,"Mount Pearl","NL",47.50513,-52.79476,2018-09-16 23:00:00,17,1,18
"14980",10401,"Mount Pearl","NL",47.50513,-52.79476,2018-09-17 00:00:00,14,2,16
"14981",10401,"Mount Pearl","NL",47.50513,-52.79476,2018-09-17 01:00:00,12,1,13
"14982",10401,"Mount Pearl","NL",47.50513,-52.79476,2018-09-17 02:00:00,8,1,9
"14983",10401,"Mount Pearl","NL",47.50513,-52.79476,2018-09-17 03:00:00,11,1,12
"14984",10401,"Mount Pearl","NL",47.50513,-52.79476,2018-09-17 04:00:00,13,0,13
"14985",10401,"Mount Pearl","NL",47.50513,-52.79476,2018-09-17 05:00:00,12,0,12
"14986",10401,"Mount Pearl","NL",47.50513,-52.79476,2018-09-17 06:00:00,14,0,14
"14987",10401,"Mount Pearl","NL",47.50513,-52.79476,2018-09-17 07:00:00,14,2,16
"14988",10401,"Mount Pearl","NL",47.50513,-52.79476,2018-09-17 08:00:00,16,1,17
"14989",10401,"Mount Pearl","NL",47.50513,-52.79476,2018-09-17 09:00:00,18,1,19
"14990",10401,"Mount Pearl","NL",47.50513,-52.79476,2018-09-17 10:00:00,18,0,18
"14991",10401,"Mount Pearl","NL",47.50513,-52.79476,2018-09-17 11:00:00,18,0,18
"14992",10401,"Mount Pearl","NL",47.50513,-52.79476,2018-09-17 12:00:00,19,1,20
"14993",10401,"Mount Pearl","NL",47.50513,-52.79476,2018-09-17 13:00:00,17,3,20
"14994",10401,"Mount Pearl","NL",47.50513,-52.79476,2018-09-17 14:00:00,19,1,20
"14995",10401,"Mount Pearl","NL",47.50513,-52.79476,2018-09-17 15:00:00,21,0,21
"14996",10401,"Mount Pearl","NL",47.50513,-52.79476,2018-09-17 16:00:00,22,1,23
"14997",10401,"Mount Pearl","NL",47.50513,-52.79476,2018-09-17 17:00:00,22,1,23
"14998",10401,"Mount Pearl","NL",47.50513,-52.79476,2018-09-17 18:00:00,23,1,24
"14999",10401,"Mount Pearl","NL",47.50513,-52.79476,2018-09-17 19:00:00,24,1,25
"15000",10401,"Mount Pearl","NL",47.50513,-52.79476,2018-09-17 20:00:00,24,0,24
"15001",10401,"Mount Pearl","NL",47.50513,-52.79476,2018-09-17 21:00:00,24,0,24
"15002",10401,"Mount Pearl","NL",47.50513,-52.79476,2018-09-17 22:00:00,26,0,26
"15003",10401,"Mount Pearl","NL",47.50513,-52.79476,2018-09-17 23:00:00,25,0,25
"15004",10401,"Mount Pearl","NL",47.50513,-52.79476,2018-09-18 00:00:00,27,0,27
"15005",10401,"Mount Pearl","NL",47.50513,-52.79476,2018-09-18 01:00:00,31,0,31
"15006",10401,"Mount Pearl","NL",47.50513,-52.79476,2018-09-18 02:00:00,29,0,29
"15007",10401,"Mount Pearl","NL",47.50513,-52.79476,2018-09-18 03:00:00,26,0,26
"15008",10401,"Mount Pearl","NL",47.50513,-52.79476,2018-09-18 04:00:00,25,0,25
"15009",10401,"Mount Pearl","NL",47.50513,-52.79476,2018-09-18 05:00:00,25,0,25
"15010",10401,"Mount Pearl","NL",47.50513,-52.79476,2018-09-18 06:00:00,25,1,26
"15011",10401,"Mount Pearl","NL",47.50513,-52.79476,2018-09-18 07:00:00,23,2,25
"15012",10401,"Mount Pearl","NL",47.50513,-52.79476,2018-09-18 08:00:00,23,2,25
"15013",10401,"Mount Pearl","NL",47.50513,-52.79476,2018-09-18 09:00:00,24,1,25
"15014",10401,"Mount Pearl","NL",47.50513,-52.79476,2018-09-18 10:00:00,25,2,27
"15015",10401,"Mount Pearl","NL",47.50513,-52.79476,2018-09-18 11:00:00,25,1,26
"15016",10401,"Mount Pearl","NL",47.50513,-52.79476,2018-09-18 12:00:00,25,0,25
"15017",10401,"Mount Pearl","NL",47.50513,-52.79476,2018-09-18 13:00:00,26,1,27
"15018",10401,"Mount Pearl","NL",47.50513,-52.79476,2018-09-18 14:00:00,29,0,29
"15019",10401,"Mount Pearl","NL",47.50513,-52.79476,2018-09-18 15:00:00,25,1,26
"15020",10401,"Mount Pearl","NL",47.50513,-52.79476,2018-09-18 16:00:00,24,2,26
"15021",10401,"Mount Pearl","NL",47.50513,-52.79476,2018-09-18 17:00:00,23,4,27
"15022",10401,"Mount Pearl","NL",47.50513,-52.79476,2018-09-18 18:00:00,22,6,28
"15023",10401,"Mount Pearl","NL",47.50513,-52.79476,2018-09-18 19:00:00,27,3,30
"15024",10401,"Mount Pearl","NL",47.50513,-52.79476,2018-09-18 20:00:00,24,3,27
"15025",10401,"Mount Pearl","NL",47.50513,-52.79476,2018-09-18 21:00:00,27,1,28
"15026",10401,"Mount Pearl","NL",47.50513,-52.79476,2018-09-18 22:00:00,28,0,28
"15027",10401,"Mount Pearl","NL",47.50513,-52.79476,2018-09-18 23:00:00,27,0,27
"15028",10401,"Mount Pearl","NL",47.50513,-52.79476,2018-09-19 00:00:00,26,0,26
"15029",10401,"Mount Pearl","NL",47.50513,-52.79476,2018-09-19 01:00:00,26,1,27
"15030",10401,"Mount Pearl","NL",47.50513,-52.79476,2018-09-19 02:00:00,25,0,25
"15031",10401,"Mount Pearl","NL",47.50513,-52.79476,2018-09-19 03:00:00,24,0,24
"15032",10401,"Mount Pearl","NL",47.50513,-52.79476,2018-09-19 04:00:00,24,0,24
"15033",10401,"Mount Pearl","NL",47.50513,-52.79476,2018-09-19 05:00:00,24,0,24
"15034",10401,"Mount Pearl","NL",47.50513,-52.79476,2018-09-19 06:00:00,25,1,26
"15035",10401,"Mount Pearl","NL",47.50513,-52.79476,2018-09-19 07:00:00,25,2,27
"15036",10401,"Mount Pearl","NL",47.50513,-52.79476,2018-09-19 08:00:00,25,1,26
"15037",10401,"Mount Pearl","NL",47.50513,-52.79476,2018-09-19 09:00:00,22,4,26
"15038",10401,"Mount Pearl","NL",47.50513,-52.79476,2018-09-19 10:00:00,19,4,23
"15039",10401,"Mount Pearl","NL",47.50513,-52.79476,2018-09-19 11:00:00,22,1,23
"15040",10401,"Mount Pearl","NL",47.50513,-52.79476,2018-09-19 12:00:00,22,1,23
"15041",10401,"Mount Pearl","NL",47.50513,-52.79476,2018-09-19 13:00:00,22,1,23
"15042",10401,"Mount Pearl","NL",47.50513,-52.79476,2018-09-19 14:00:00,23,1,24
"15043",10401,"Mount Pearl","NL",47.50513,-52.79476,2018-09-19 15:00:00,25,1,26
"15044",10401,"Mount Pearl","NL",47.50513,-52.79476,2018-09-19 16:00:00,26,1,27
"15045",10401,"Mount Pearl","NL",47.50513,-52.79476,2018-09-19 17:00:00,27,2,29
"15046",10401,"Mount Pearl","NL",47.50513,-52.79476,2018-09-19 18:00:00,27,2,29
"15047",10401,"Mount Pearl","NL",47.50513,-52.79476,2018-09-19 19:00:00,25,2,27
"15048",10401,"Mount Pearl","NL",47.50513,-52.79476,2018-09-19 20:00:00,27,1,28
"15049",10401,"Mount Pearl","NL",47.50513,-52.79476,2018-09-19 21:00:00,28,2,30
"15050",10401,"Mount Pearl","NL",47.50513,-52.79476,2018-09-19 22:00:00,28,0,28
"15051",10401,"Mount Pearl","NL",47.50513,-52.79476,2018-09-19 23:00:00,29,1,30
"15052",10401,"Mount Pearl","NL",47.50513,-52.79476,2018-09-20 00:00:00,29,1,30
"15053",10401,"Mount Pearl","NL",47.50513,-52.79476,2018-09-20 01:00:00,30,1,31
"15054",10401,"Mount Pearl","NL",47.50513,-52.79476,2018-09-20 02:00:00,31,0,31
"15055",10401,"Mount Pearl","NL",47.50513,-52.79476,2018-09-20 03:00:00,31,1,32
"15056",10401,"Mount Pearl","NL",47.50513,-52.79476,2018-09-20 04:00:00,32,1,33
"15057",10401,"Mount Pearl","NL",47.50513,-52.79476,2018-09-20 05:00:00,30,2,32
"15058",10401,"Mount Pearl","NL",47.50513,-52.79476,2018-09-20 06:00:00,30,1,31
"15059",10401,"Mount Pearl","NL",47.50513,-52.79476,2018-09-20 07:00:00,28,2,30
"15060",10401,"Mount Pearl","NL",47.50513,-52.79476,2018-09-20 08:00:00,28,3,31
"15061",10401,"Mount Pearl","NL",47.50513,-52.79476,2018-09-20 09:00:00,28,2,30
"15062",10401,"Mount Pearl","NL",47.50513,-52.79476,2018-09-20 10:00:00,29,1,30
"15063",10401,"Mount Pearl","NL",47.50513,-52.79476,2018-09-20 11:00:00,29,1,30
"15064",10401,"Mount Pearl","NL",47.50513,-52.79476,2018-09-20 12:00:00,30,0,30
"15065",10401,"Mount Pearl","NL",47.50513,-52.79476,2018-09-20 13:00:00,30,1,31
"15066",10401,"Mount Pearl","NL",47.50513,-52.79476,2018-09-20 14:00:00,30,0,30
"15067",10401,"Mount Pearl","NL",47.50513,-52.79476,2018-09-20 15:00:00,30,1,31
"15068",10401,"Mount Pearl","NL",47.50513,-52.79476,2018-09-20 16:00:00,30,1,31
"15069",10401,"Mount Pearl","NL",47.50513,-52.79476,2018-09-20 17:00:00,29,1,30
"15070",10401,"Mount Pearl","NL",47.50513,-52.79476,2018-09-20 18:00:00,30,0,30
"15071",10401,"Mount Pearl","NL",47.50513,-52.79476,2018-09-20 19:00:00,29,1,30
"15072",10401,"Mount Pearl","NL",47.50513,-52.79476,2018-09-20 20:00:00,28,0,28
"15073",10401,"Mount Pearl","NL",47.50513,-52.79476,2018-09-20 21:00:00,28,1,29
"15074",10401,"Mount Pearl","NL",47.50513,-52.79476,2018-09-20 22:00:00,28,0,28
"15075",10401,"Mount Pearl","NL",47.50513,-52.79476,2018-09-20 23:00:00,28,0,28
"15076",10401,"Mount Pearl","NL",47.50513,-52.79476,2018-09-21 00:00:00,28,0,28
"15077",10401,"Mount Pearl","NL",47.50513,-52.79476,2018-09-21 01:00:00,28,0,28
"15078",10401,"Mount Pearl","NL",47.50513,-52.79476,2018-09-21 02:00:00,28,0,28
"15079",10401,"Mount Pearl","NL",47.50513,-52.79476,2018-09-21 03:00:00,28,0,28
"15080",10401,"Mount Pearl","NL",47.50513,-52.79476,2018-09-21 04:00:00,28,0,28
"15081",10401,"Mount Pearl","NL",47.50513,-52.79476,2018-09-21 05:00:00,29,0,29
"15082",10401,"Mount Pearl","NL",47.50513,-52.79476,2018-09-21 06:00:00,29,1,30
"15083",10401,"Mount Pearl","NL",47.50513,-52.79476,2018-09-21 07:00:00,26,1,27
"15084",10401,"Mount Pearl","NL",47.50513,-52.79476,2018-09-21 08:00:00,26,2,28
"15085",10401,"Mount Pearl","NL",47.50513,-52.79476,2018-09-21 09:00:00,28,1,29
"15086",10401,"Mount Pearl","NL",47.50513,-52.79476,2018-09-21 10:00:00,27,2,29
"15087",10401,"Mount Pearl","NL",47.50513,-52.79476,2018-09-21 11:00:00,27,1,28
"15088",10401,"Mount Pearl","NL",47.50513,-52.79476,2018-09-21 12:00:00,27,2,29
"15089",10401,"Mount Pearl","NL",47.50513,-52.79476,2018-09-21 13:00:00,27,2,29
"15090",10401,"Mount Pearl","NL",47.50513,-52.79476,2018-09-21 14:00:00,26,2,28
"15091",10401,"Mount Pearl","NL",47.50513,-52.79476,2018-09-21 15:00:00,25,2,27
"15092",10401,"Mount Pearl","NL",47.50513,-52.79476,2018-09-21 16:00:00,26,2,28
"15093",10401,"Mount Pearl","NL",47.50513,-52.79476,2018-09-21 17:00:00,26,1,27
"15094",10401,"Mount Pearl","NL",47.50513,-52.79476,2018-09-21 18:00:00,23,2,25
"15095",10401,"Mount Pearl","NL",47.50513,-52.79476,2018-09-21 19:00:00,16,5,21
"15096",10401,"Mount Pearl","NL",47.50513,-52.79476,2018-09-21 20:00:00,7,9,16
"15097",10401,"Mount Pearl","NL",47.50513,-52.79476,2018-09-21 21:00:00,8,8,16
"15098",10401,"Mount Pearl","NL",47.50513,-52.79476,2018-09-21 22:00:00,9,6,15
"15099",10401,"Mount Pearl","NL",47.50513,-52.79476,2018-09-21 23:00:00,11,5,16
"15100",10401,"Mount Pearl","NL",47.50513,-52.79476,2018-09-22 00:00:00,10,4,14
"15101",10401,"Mount Pearl","NL",47.50513,-52.79476,2018-09-22 01:00:00,12,4,16
"15102",10401,"Mount Pearl","NL",47.50513,-52.79476,2018-09-22 02:00:00,15,2,17
"15103",10401,"Mount Pearl","NL",47.50513,-52.79476,2018-09-22 03:00:00,14,1,15
"15104",10401,"Mount Pearl","NL",47.50513,-52.79476,2018-09-22 04:00:00,13,2,15
"15105",10401,"Mount Pearl","NL",47.50513,-52.79476,2018-09-22 05:00:00,12,2,14
"15106",10401,"Mount Pearl","NL",47.50513,-52.79476,2018-09-22 06:00:00,17,2,19
"15107",10401,"Mount Pearl","NL",47.50513,-52.79476,2018-09-22 07:00:00,14,19,33
"15108",10401,"Mount Pearl","NL",47.50513,-52.79476,2018-09-22 08:00:00,12,NA,NA
"15109",10401,"Mount Pearl","NL",47.50513,-52.79476,2018-09-22 09:00:00,23,6,29
"15110",10401,"Mount Pearl","NL",47.50513,-52.79476,2018-09-22 10:00:00,24,6,30
"15111",10401,"Mount Pearl","NL",47.50513,-52.79476,2018-09-22 11:00:00,23,8,31
"15112",10401,"Mount Pearl","NL",47.50513,-52.79476,2018-09-22 12:00:00,28,4,32
"15113",10401,"Mount Pearl","NL",47.50513,-52.79476,2018-09-22 13:00:00,25,8,33
"15114",10401,"Mount Pearl","NL",47.50513,-52.79476,2018-09-22 14:00:00,28,4,32
"15115",10401,"Mount Pearl","NL",47.50513,-52.79476,2018-09-22 15:00:00,31,0,31
"15116",10401,"Mount Pearl","NL",47.50513,-52.79476,2018-09-22 16:00:00,32,1,33
"15117",10401,"Mount Pearl","NL",47.50513,-52.79476,2018-09-22 17:00:00,32,1,33
"15118",10401,"Mount Pearl","NL",47.50513,-52.79476,2018-09-22 18:00:00,33,0,33
"15119",10401,"Mount Pearl","NL",47.50513,-52.79476,2018-09-22 19:00:00,34,0,34
"15120",10401,"Mount Pearl","NL",47.50513,-52.79476,2018-09-22 20:00:00,35,0,35
"15121",10401,"Mount Pearl","NL",47.50513,-52.79476,2018-09-22 21:00:00,30,1,31
"15122",10401,"Mount Pearl","NL",47.50513,-52.79476,2018-09-22 22:00:00,21,1,22
"15123",10401,"Mount Pearl","NL",47.50513,-52.79476,2018-09-22 23:00:00,20,0,20
"15124",10401,"Mount Pearl","NL",47.50513,-52.79476,2018-09-23 00:00:00,23,1,24
"15125",10401,"Mount Pearl","NL",47.50513,-52.79476,2018-09-23 01:00:00,23,1,24
"15126",10401,"Mount Pearl","NL",47.50513,-52.79476,2018-09-23 02:00:00,23,1,24
"15127",10401,"Mount Pearl","NL",47.50513,-52.79476,2018-09-23 03:00:00,23,1,24
"15128",10401,"Mount Pearl","NL",47.50513,-52.79476,2018-09-23 04:00:00,23,0,23
"15129",10401,"Mount Pearl","NL",47.50513,-52.79476,2018-09-23 05:00:00,23,1,24
"15130",10401,"Mount Pearl","NL",47.50513,-52.79476,2018-09-23 06:00:00,24,0,24
"15131",10401,"Mount Pearl","NL",47.50513,-52.79476,2018-09-23 07:00:00,24,1,25
"15132",10401,"Mount Pearl","NL",47.50513,-52.79476,2018-09-23 08:00:00,23,1,24
"15133",10401,"Mount Pearl","NL",47.50513,-52.79476,2018-09-23 09:00:00,24,1,25
"15134",10401,"Mount Pearl","NL",47.50513,-52.79476,2018-09-23 10:00:00,25,0,25
"15135",10401,"Mount Pearl","NL",47.50513,-52.79476,2018-09-23 11:00:00,25,0,25
"15136",10401,"Mount Pearl","NL",47.50513,-52.79476,2018-09-23 12:00:00,26,0,26
"15137",10401,"Mount Pearl","NL",47.50513,-52.79476,2018-09-23 13:00:00,28,1,29
"15138",10401,"Mount Pearl","NL",47.50513,-52.79476,2018-09-23 14:00:00,28,0,28
"15139",10401,"Mount Pearl","NL",47.50513,-52.79476,2018-09-23 15:00:00,27,0,27
"15140",10401,"Mount Pearl","NL",47.50513,-52.79476,2018-09-23 16:00:00,25,0,25
"15141",10401,"Mount Pearl","NL",47.50513,-52.79476,2018-09-23 17:00:00,28,1,29
"15142",10401,"Mount Pearl","NL",47.50513,-52.79476,2018-09-23 18:00:00,27,1,28
"15143",10401,"Mount Pearl","NL",47.50513,-52.79476,2018-09-23 19:00:00,24,1,25
"15144",10401,"Mount Pearl","NL",47.50513,-52.79476,2018-09-23 20:00:00,24,1,25
"15145",10401,"Mount Pearl","NL",47.50513,-52.79476,2018-09-23 21:00:00,25,1,26
"15146",10401,"Mount Pearl","NL",47.50513,-52.79476,2018-09-23 22:00:00,26,1,27
"15147",10401,"Mount Pearl","NL",47.50513,-52.79476,2018-09-23 23:00:00,27,1,28
"15148",10401,"Mount Pearl","NL",47.50513,-52.79476,2018-09-24 00:00:00,26,0,26
"15149",10401,"Mount Pearl","NL",47.50513,-52.79476,2018-09-24 01:00:00,26,0,26
"15150",10401,"Mount Pearl","NL",47.50513,-52.79476,2018-09-24 02:00:00,27,0,27
"15151",10401,"Mount Pearl","NL",47.50513,-52.79476,2018-09-24 03:00:00,27,0,27
"15152",10401,"Mount Pearl","NL",47.50513,-52.79476,2018-09-24 04:00:00,27,0,27
"15153",10401,"Mount Pearl","NL",47.50513,-52.79476,2018-09-24 05:00:00,24,0,24
"15154",10401,"Mount Pearl","NL",47.50513,-52.79476,2018-09-24 06:00:00,24,0,24
"15155",10401,"Mount Pearl","NL",47.50513,-52.79476,2018-09-24 07:00:00,24,3,27
"15156",10401,"Mount Pearl","NL",47.50513,-52.79476,2018-09-24 08:00:00,22,3,25
"15157",10401,"Mount Pearl","NL",47.50513,-52.79476,2018-09-24 09:00:00,21,2,23
"15158",10401,"Mount Pearl","NL",47.50513,-52.79476,2018-09-24 10:00:00,21,2,23
"15159",10401,"Mount Pearl","NL",47.50513,-52.79476,2018-09-24 11:00:00,22,1,23
"15160",10401,"Mount Pearl","NL",47.50513,-52.79476,2018-09-24 12:00:00,23,1,24
"15161",10401,"Mount Pearl","NL",47.50513,-52.79476,2018-09-24 13:00:00,23,1,24
"15162",10401,"Mount Pearl","NL",47.50513,-52.79476,2018-09-24 14:00:00,23,2,25
"15163",10401,"Mount Pearl","NL",47.50513,-52.79476,2018-09-24 15:00:00,24,1,25
"15164",10401,"Mount Pearl","NL",47.50513,-52.79476,2018-09-24 16:00:00,24,0,24
"15165",10401,"Mount Pearl","NL",47.50513,-52.79476,2018-09-24 17:00:00,23,2,25
"15166",10401,"Mount Pearl","NL",47.50513,-52.79476,2018-09-24 18:00:00,23,2,25
"15167",10401,"Mount Pearl","NL",47.50513,-52.79476,2018-09-24 19:00:00,20,2,22
"15168",10401,"Mount Pearl","NL",47.50513,-52.79476,2018-09-24 20:00:00,19,2,21
"15169",10401,"Mount Pearl","NL",47.50513,-52.79476,2018-09-24 21:00:00,17,2,19
"15170",10401,"Mount Pearl","NL",47.50513,-52.79476,2018-09-24 22:00:00,20,1,21
"15171",10401,"Mount Pearl","NL",47.50513,-52.79476,2018-09-24 23:00:00,20,0,20
"15172",10401,"Mount Pearl","NL",47.50513,-52.79476,2018-09-25 00:00:00,21,0,21
"15173",10401,"Mount Pearl","NL",47.50513,-52.79476,2018-09-25 01:00:00,19,0,19
"15174",10401,"Mount Pearl","NL",47.50513,-52.79476,2018-09-25 02:00:00,20,1,21
"15175",10401,"Mount Pearl","NL",47.50513,-52.79476,2018-09-25 03:00:00,19,0,19
"15176",10401,"Mount Pearl","NL",47.50513,-52.79476,2018-09-25 04:00:00,16,1,17
"15177",10401,"Mount Pearl","NL",47.50513,-52.79476,2018-09-25 05:00:00,14,2,16
"15178",10401,"Mount Pearl","NL",47.50513,-52.79476,2018-09-25 06:00:00,16,2,18
"15179",10401,"Mount Pearl","NL",47.50513,-52.79476,2018-09-25 07:00:00,17,3,20
"15180",10401,"Mount Pearl","NL",47.50513,-52.79476,2018-09-25 08:00:00,19,2,21
"15181",10401,"Mount Pearl","NL",47.50513,-52.79476,2018-09-25 09:00:00,20,1,21
"15182",10401,"Mount Pearl","NL",47.50513,-52.79476,2018-09-25 10:00:00,22,1,23
"15183",10401,"Mount Pearl","NL",47.50513,-52.79476,2018-09-25 11:00:00,23,1,24
"15184",10401,"Mount Pearl","NL",47.50513,-52.79476,2018-09-25 12:00:00,24,0,24
"15185",10401,"Mount Pearl","NL",47.50513,-52.79476,2018-09-25 13:00:00,24,0,24
"15186",10401,"Mount Pearl","NL",47.50513,-52.79476,2018-09-25 14:00:00,24,0,24
"15187",10401,"Mount Pearl","NL",47.50513,-52.79476,2018-09-25 15:00:00,24,0,24
"15188",10401,"Mount Pearl","NL",47.50513,-52.79476,2018-09-25 16:00:00,23,0,23
"15189",10401,"Mount Pearl","NL",47.50513,-52.79476,2018-09-25 17:00:00,24,1,25
"15190",10401,"Mount Pearl","NL",47.50513,-52.79476,2018-09-25 18:00:00,23,2,25
"15191",10401,"Mount Pearl","NL",47.50513,-52.79476,2018-09-25 19:00:00,16,3,19
"15192",10401,"Mount Pearl","NL",47.50513,-52.79476,2018-09-25 20:00:00,5,11,16
"15193",10401,"Mount Pearl","NL",47.50513,-52.79476,2018-09-25 21:00:00,11,6,17
"15194",10401,"Mount Pearl","NL",47.50513,-52.79476,2018-09-25 22:00:00,15,4,19
"15195",10401,"Mount Pearl","NL",47.50513,-52.79476,2018-09-25 23:00:00,16,2,18
"15196",10401,"Mount Pearl","NL",47.50513,-52.79476,2018-09-26 00:00:00,12,2,14
"15197",10401,"Mount Pearl","NL",47.50513,-52.79476,2018-09-26 01:00:00,17,2,19
"15198",10401,"Mount Pearl","NL",47.50513,-52.79476,2018-09-26 02:00:00,16,1,17
"15199",10401,"Mount Pearl","NL",47.50513,-52.79476,2018-09-26 03:00:00,19,0,19
"15200",10401,"Mount Pearl","NL",47.50513,-52.79476,2018-09-26 04:00:00,16,0,16
"15201",10401,"Mount Pearl","NL",47.50513,-52.79476,2018-09-26 05:00:00,13,2,15
"15202",10401,"Mount Pearl","NL",47.50513,-52.79476,2018-09-26 06:00:00,12,3,15
"15203",10401,"Mount Pearl","NL",47.50513,-52.79476,2018-09-26 07:00:00,6,10,16
"15204",10401,"Mount Pearl","NL",47.50513,-52.79476,2018-09-26 08:00:00,18,4,22
"15205",10401,"Mount Pearl","NL",47.50513,-52.79476,2018-09-26 09:00:00,24,1,25
"15206",10401,"Mount Pearl","NL",47.50513,-52.79476,2018-09-26 10:00:00,25,0,25
"15207",10401,"Mount Pearl","NL",47.50513,-52.79476,2018-09-26 11:00:00,25,0,25
"15208",10401,"Mount Pearl","NL",47.50513,-52.79476,2018-09-26 12:00:00,25,1,26
"15209",10401,"Mount Pearl","NL",47.50513,-52.79476,2018-09-26 13:00:00,21,10,31
"15210",10401,"Mount Pearl","NL",47.50513,-52.79476,2018-09-26 14:00:00,25,5,30
"15211",10401,"Mount Pearl","NL",47.50513,-52.79476,2018-09-26 15:00:00,29,2,31
"15212",10401,"Mount Pearl","NL",47.50513,-52.79476,2018-09-26 16:00:00,29,1,30
"15213",10401,"Mount Pearl","NL",47.50513,-52.79476,2018-09-26 17:00:00,26,1,27
"15214",10401,"Mount Pearl","NL",47.50513,-52.79476,2018-09-26 18:00:00,27,1,28
"15215",10401,"Mount Pearl","NL",47.50513,-52.79476,2018-09-26 19:00:00,27,0,27
"15216",10401,"Mount Pearl","NL",47.50513,-52.79476,2018-09-26 20:00:00,23,1,24
"15217",10401,"Mount Pearl","NL",47.50513,-52.79476,2018-09-26 21:00:00,21,1,22
"15218",10401,"Mount Pearl","NL",47.50513,-52.79476,2018-09-26 22:00:00,23,0,23
"15219",10401,"Mount Pearl","NL",47.50513,-52.79476,2018-09-26 23:00:00,24,1,25
"15220",10401,"Mount Pearl","NL",47.50513,-52.79476,2018-09-27 00:00:00,25,1,26
"15221",10401,"Mount Pearl","NL",47.50513,-52.79476,2018-09-27 01:00:00,24,0,24
"15222",10401,"Mount Pearl","NL",47.50513,-52.79476,2018-09-27 02:00:00,24,0,24
"15223",10401,"Mount Pearl","NL",47.50513,-52.79476,2018-09-27 03:00:00,25,0,25
"15224",10401,"Mount Pearl","NL",47.50513,-52.79476,2018-09-27 04:00:00,26,0,26
"15225",10401,"Mount Pearl","NL",47.50513,-52.79476,2018-09-27 05:00:00,27,0,27
"15226",10401,"Mount Pearl","NL",47.50513,-52.79476,2018-09-27 06:00:00,26,1,27
"15227",10401,"Mount Pearl","NL",47.50513,-52.79476,2018-09-27 07:00:00,23,9,32
"15228",10401,"Mount Pearl","NL",47.50513,-52.79476,2018-09-27 08:00:00,24,11,35
"15229",10401,"Mount Pearl","NL",47.50513,-52.79476,2018-09-27 09:00:00,24,7,31
"15230",10401,"Mount Pearl","NL",47.50513,-52.79476,2018-09-27 10:00:00,20,16,36
"15231",10401,"Mount Pearl","NL",47.50513,-52.79476,2018-09-27 11:00:00,23,9,32
"15232",10401,"Mount Pearl","NL",47.50513,-52.79476,2018-09-27 12:00:00,25,1,26
"15233",10401,"Mount Pearl","NL",47.50513,-52.79476,2018-09-27 13:00:00,24,7,31
"15234",10401,"Mount Pearl","NL",47.50513,-52.79476,2018-09-27 14:00:00,24,2,26
"15235",10401,"Mount Pearl","NL",47.50513,-52.79476,2018-09-27 15:00:00,25,0,25
"15236",10401,"Mount Pearl","NL",47.50513,-52.79476,2018-09-27 16:00:00,26,3,29
"15237",10401,"Mount Pearl","NL",47.50513,-52.79476,2018-09-27 17:00:00,26,0,26
"15238",10401,"Mount Pearl","NL",47.50513,-52.79476,2018-09-27 18:00:00,20,10,30
"15239",10401,"Mount Pearl","NL",47.50513,-52.79476,2018-09-27 19:00:00,22,4,26
"15240",10401,"Mount Pearl","NL",47.50513,-52.79476,2018-09-27 20:00:00,22,1,23
"15241",10401,"Mount Pearl","NL",47.50513,-52.79476,2018-09-27 21:00:00,21,0,21
"15242",10401,"Mount Pearl","NL",47.50513,-52.79476,2018-09-27 22:00:00,25,0,25
"15243",10401,"Mount Pearl","NL",47.50513,-52.79476,2018-09-27 23:00:00,22,0,22
"15244",10401,"Mount Pearl","NL",47.50513,-52.79476,2018-09-28 00:00:00,16,0,16
"15245",10401,"Mount Pearl","NL",47.50513,-52.79476,2018-09-28 01:00:00,18,1,19
"15246",10401,"Mount Pearl","NL",47.50513,-52.79476,2018-09-28 02:00:00,25,0,25
"15247",10401,"Mount Pearl","NL",47.50513,-52.79476,2018-09-28 03:00:00,27,0,27
"15248",10401,"Mount Pearl","NL",47.50513,-52.79476,2018-09-28 04:00:00,27,0,27
"15249",10401,"Mount Pearl","NL",47.50513,-52.79476,2018-09-28 05:00:00,26,0,26
"15250",10401,"Mount Pearl","NL",47.50513,-52.79476,2018-09-28 06:00:00,26,0,26
"15251",10401,"Mount Pearl","NL",47.50513,-52.79476,2018-09-28 07:00:00,26,1,27
"15252",10401,"Mount Pearl","NL",47.50513,-52.79476,2018-09-28 08:00:00,21,5,26
"15253",10401,"Mount Pearl","NL",47.50513,-52.79476,2018-09-28 09:00:00,21,4,25
"15254",10401,"Mount Pearl","NL",47.50513,-52.79476,2018-09-28 10:00:00,24,1,25
"15255",10401,"Mount Pearl","NL",47.50513,-52.79476,2018-09-28 11:00:00,22,2,24
"15256",10401,"Mount Pearl","NL",47.50513,-52.79476,2018-09-28 12:00:00,23,3,26
"15257",10401,"Mount Pearl","NL",47.50513,-52.79476,2018-09-28 13:00:00,24,1,25
"15258",10401,"Mount Pearl","NL",47.50513,-52.79476,2018-09-28 14:00:00,24,2,26
"15259",10401,"Mount Pearl","NL",47.50513,-52.79476,2018-09-28 15:00:00,24,2,26
"15260",10401,"Mount Pearl","NL",47.50513,-52.79476,2018-09-28 16:00:00,27,3,30
"15261",10401,"Mount Pearl","NL",47.50513,-52.79476,2018-09-28 17:00:00,30,3,33
"15262",10401,"Mount Pearl","NL",47.50513,-52.79476,2018-09-28 18:00:00,32,1,33
"15263",10401,"Mount Pearl","NL",47.50513,-52.79476,2018-09-28 19:00:00,33,1,34
"15264",10401,"Mount Pearl","NL",47.50513,-52.79476,2018-09-28 20:00:00,33,1,34
"15265",10401,"Mount Pearl","NL",47.50513,-52.79476,2018-09-28 21:00:00,32,1,33
"15266",10401,"Mount Pearl","NL",47.50513,-52.79476,2018-09-28 22:00:00,31,0,31
"15267",10401,"Mount Pearl","NL",47.50513,-52.79476,2018-09-28 23:00:00,29,1,30
"15268",10401,"Mount Pearl","NL",47.50513,-52.79476,2018-09-29 00:00:00,23,0,23
"15269",10401,"Mount Pearl","NL",47.50513,-52.79476,2018-09-29 01:00:00,24,0,24
"15270",10401,"Mount Pearl","NL",47.50513,-52.79476,2018-09-29 02:00:00,26,1,27
"15271",10401,"Mount Pearl","NL",47.50513,-52.79476,2018-09-29 03:00:00,24,1,25
"15272",10401,"Mount Pearl","NL",47.50513,-52.79476,2018-09-29 04:00:00,21,1,22
"15273",10401,"Mount Pearl","NL",47.50513,-52.79476,2018-09-29 05:00:00,21,1,22
"15274",10401,"Mount Pearl","NL",47.50513,-52.79476,2018-09-29 06:00:00,23,0,23
"15275",10401,"Mount Pearl","NL",47.50513,-52.79476,2018-09-29 07:00:00,25,1,26
"15276",10401,"Mount Pearl","NL",47.50513,-52.79476,2018-09-29 08:00:00,25,0,25
"15277",10401,"Mount Pearl","NL",47.50513,-52.79476,2018-09-29 09:00:00,24,1,25
"15278",10401,"Mount Pearl","NL",47.50513,-52.79476,2018-09-29 10:00:00,23,0,23
"15279",10401,"Mount Pearl","NL",47.50513,-52.79476,2018-09-29 11:00:00,23,0,23
"15280",10401,"Mount Pearl","NL",47.50513,-52.79476,2018-09-29 12:00:00,21,0,21
"15281",10401,"Mount Pearl","NL",47.50513,-52.79476,2018-09-29 13:00:00,21,0,21
"15282",10401,"Mount Pearl","NL",47.50513,-52.79476,2018-09-29 14:00:00,21,0,21
"15283",10401,"Mount Pearl","NL",47.50513,-52.79476,2018-09-29 15:00:00,24,0,24
"15284",10401,"Mount Pearl","NL",47.50513,-52.79476,2018-09-29 16:00:00,26,0,26
"15285",10401,"Mount Pearl","NL",47.50513,-52.79476,2018-09-29 17:00:00,25,0,25
"15286",10401,"Mount Pearl","NL",47.50513,-52.79476,2018-09-29 18:00:00,22,1,23
"15287",10401,"Mount Pearl","NL",47.50513,-52.79476,2018-09-29 19:00:00,21,1,22
"15288",10401,"Mount Pearl","NL",47.50513,-52.79476,2018-09-29 20:00:00,22,0,22
"15289",10401,"Mount Pearl","NL",47.50513,-52.79476,2018-09-29 21:00:00,21,0,21
"15290",10401,"Mount Pearl","NL",47.50513,-52.79476,2018-09-29 22:00:00,20,1,21
"15291",10401,"Mount Pearl","NL",47.50513,-52.79476,2018-09-29 23:00:00,21,0,21
"15292",10401,"Mount Pearl","NL",47.50513,-52.79476,2018-09-30 00:00:00,21,0,21
"15293",10401,"Mount Pearl","NL",47.50513,-52.79476,2018-09-30 01:00:00,21,1,22
"15294",10401,"Mount Pearl","NL",47.50513,-52.79476,2018-09-30 02:00:00,22,0,22
"15295",10401,"Mount Pearl","NL",47.50513,-52.79476,2018-09-30 03:00:00,19,1,20
"15296",10401,"Mount Pearl","NL",47.50513,-52.79476,2018-09-30 04:00:00,18,1,19
"15297",10401,"Mount Pearl","NL",47.50513,-52.79476,2018-09-30 05:00:00,18,1,19
"15298",10401,"Mount Pearl","NL",47.50513,-52.79476,2018-09-30 06:00:00,21,1,22
"15299",10401,"Mount Pearl","NL",47.50513,-52.79476,2018-09-30 07:00:00,22,1,23
"15300",10401,"Mount Pearl","NL",47.50513,-52.79476,2018-09-30 08:00:00,25,1,26
"15301",10401,"Mount Pearl","NL",47.50513,-52.79476,2018-09-30 09:00:00,23,0,23
"15302",10401,"Mount Pearl","NL",47.50513,-52.79476,2018-09-30 10:00:00,21,0,21
"15303",10401,"Mount Pearl","NL",47.50513,-52.79476,2018-09-30 11:00:00,20,0,20
"15304",10401,"Mount Pearl","NL",47.50513,-52.79476,2018-09-30 12:00:00,18,0,18
"15305",10401,"Mount Pearl","NL",47.50513,-52.79476,2018-09-30 13:00:00,19,1,20
"15306",10401,"Mount Pearl","NL",47.50513,-52.79476,2018-09-30 14:00:00,20,1,21
"15307",10401,"Mount Pearl","NL",47.50513,-52.79476,2018-09-30 15:00:00,21,0,21
"15308",10401,"Mount Pearl","NL",47.50513,-52.79476,2018-09-30 16:00:00,21,1,22
"15309",10401,"Mount Pearl","NL",47.50513,-52.79476,2018-09-30 17:00:00,21,1,22
"15310",10401,"Mount Pearl","NL",47.50513,-52.79476,2018-09-30 18:00:00,20,0,20
"15311",10401,"Mount Pearl","NL",47.50513,-52.79476,2018-09-30 19:00:00,17,0,17
"15312",10401,"Mount Pearl","NL",47.50513,-52.79476,2018-09-30 20:00:00,18,1,19
"15313",10401,"Mount Pearl","NL",47.50513,-52.79476,2018-09-30 21:00:00,18,1,19
"15314",10401,"Mount Pearl","NL",47.50513,-52.79476,2018-09-30 22:00:00,21,0,21
"15315",10401,"Mount Pearl","NL",47.50513,-52.79476,2018-09-30 23:00:00,21,1,22
"15316",10401,"Mount Pearl","NL",47.50513,-52.79476,2018-10-01 00:00:00,20,0,20
"15317",10401,"Mount Pearl","NL",47.50513,-52.79476,2018-10-01 01:00:00,19,0,19
"15318",10401,"Mount Pearl","NL",47.50513,-52.79476,2018-10-01 02:00:00,19,1,20
"15319",10401,"Mount Pearl","NL",47.50513,-52.79476,2018-10-01 03:00:00,17,1,18
"15320",10401,"Mount Pearl","NL",47.50513,-52.79476,2018-10-01 04:00:00,14,1,15
"15321",10401,"Mount Pearl","NL",47.50513,-52.79476,2018-10-01 05:00:00,13,2,15
"15322",10401,"Mount Pearl","NL",47.50513,-52.79476,2018-10-01 06:00:00,15,2,17
"15323",10401,"Mount Pearl","NL",47.50513,-52.79476,2018-10-01 07:00:00,15,3,18
"15324",10401,"Mount Pearl","NL",47.50513,-52.79476,2018-10-01 08:00:00,15,3,18
"15325",10401,"Mount Pearl","NL",47.50513,-52.79476,2018-10-01 09:00:00,18,1,19
"15326",10401,"Mount Pearl","NL",47.50513,-52.79476,2018-10-01 10:00:00,18,1,19
"15327",10401,"Mount Pearl","NL",47.50513,-52.79476,2018-10-01 11:00:00,18,0,18
"15328",10401,"Mount Pearl","NL",47.50513,-52.79476,2018-10-01 12:00:00,19,2,21
"15329",10401,"Mount Pearl","NL",47.50513,-52.79476,2018-10-01 13:00:00,19,10,29
"15330",10401,"Mount Pearl","NL",47.50513,-52.79476,2018-10-01 14:00:00,19,4,23
"15331",10401,"Mount Pearl","NL",47.50513,-52.79476,2018-10-01 15:00:00,20,7,27
"15332",10401,"Mount Pearl","NL",47.50513,-52.79476,2018-10-01 16:00:00,18,2,20
"15333",10401,"Mount Pearl","NL",47.50513,-52.79476,2018-10-01 17:00:00,15,5,20
"15334",10401,"Mount Pearl","NL",47.50513,-52.79476,2018-10-01 18:00:00,14,3,17
"15335",10401,"Mount Pearl","NL",47.50513,-52.79476,2018-10-01 19:00:00,11,2,13
"15336",10401,"Mount Pearl","NL",47.50513,-52.79476,2018-10-01 20:00:00,14,3,17
"15337",10401,"Mount Pearl","NL",47.50513,-52.79476,2018-10-01 21:00:00,17,3,20
"15338",10401,"Mount Pearl","NL",47.50513,-52.79476,2018-10-01 22:00:00,18,2,20
"15339",10401,"Mount Pearl","NL",47.50513,-52.79476,2018-10-01 23:00:00,17,2,19
"15340",10401,"Mount Pearl","NL",47.50513,-52.79476,2018-10-02 00:00:00,19,1,20
"15341",10401,"Mount Pearl","NL",47.50513,-52.79476,2018-10-02 01:00:00,21,1,22
"15342",10401,"Mount Pearl","NL",47.50513,-52.79476,2018-10-02 02:00:00,21,1,22
"15343",10401,"Mount Pearl","NL",47.50513,-52.79476,2018-10-02 03:00:00,21,1,22
"15344",10401,"Mount Pearl","NL",47.50513,-52.79476,2018-10-02 04:00:00,19,1,20
"15345",10401,"Mount Pearl","NL",47.50513,-52.79476,2018-10-02 05:00:00,16,1,17
"15346",10401,"Mount Pearl","NL",47.50513,-52.79476,2018-10-02 06:00:00,18,2,20
"15347",10401,"Mount Pearl","NL",47.50513,-52.79476,2018-10-02 07:00:00,13,7,20
"15348",10401,"Mount Pearl","NL",47.50513,-52.79476,2018-10-02 08:00:00,16,5,21
"15349",10401,"Mount Pearl","NL",47.50513,-52.79476,2018-10-02 09:00:00,19,2,21
"15350",10401,"Mount Pearl","NL",47.50513,-52.79476,2018-10-02 10:00:00,21,1,22
"15351",10401,"Mount Pearl","NL",47.50513,-52.79476,2018-10-02 11:00:00,23,2,25
"15352",10401,"Mount Pearl","NL",47.50513,-52.79476,2018-10-02 12:00:00,24,1,25
"15353",10401,"Mount Pearl","NL",47.50513,-52.79476,2018-10-02 13:00:00,23,1,24
"15354",10401,"Mount Pearl","NL",47.50513,-52.79476,2018-10-02 14:00:00,23,1,24
"15355",10401,"Mount Pearl","NL",47.50513,-52.79476,2018-10-02 15:00:00,22,1,23
"15356",10401,"Mount Pearl","NL",47.50513,-52.79476,2018-10-02 16:00:00,23,1,24
"15357",10401,"Mount Pearl","NL",47.50513,-52.79476,2018-10-02 17:00:00,21,2,23
"15358",10401,"Mount Pearl","NL",47.50513,-52.79476,2018-10-02 18:00:00,20,2,22
"15359",10401,"Mount Pearl","NL",47.50513,-52.79476,2018-10-02 19:00:00,14,4,18
"15360",10401,"Mount Pearl","NL",47.50513,-52.79476,2018-10-02 20:00:00,10,7,17
"15361",10401,"Mount Pearl","NL",47.50513,-52.79476,2018-10-02 21:00:00,12,5,17
"15362",10401,"Mount Pearl","NL",47.50513,-52.79476,2018-10-02 22:00:00,15,4,19
"15363",10401,"Mount Pearl","NL",47.50513,-52.79476,2018-10-02 23:00:00,9,6,15
"15364",10401,"Mount Pearl","NL",47.50513,-52.79476,2018-10-03 00:00:00,2,10,12
"15365",10401,"Mount Pearl","NL",47.50513,-52.79476,2018-10-03 01:00:00,5,6,11
"15366",10401,"Mount Pearl","NL",47.50513,-52.79476,2018-10-03 02:00:00,8,3,11
"15367",10401,"Mount Pearl","NL",47.50513,-52.79476,2018-10-03 03:00:00,9,3,12
"15368",10401,"Mount Pearl","NL",47.50513,-52.79476,2018-10-03 04:00:00,8,3,11
"15369",10401,"Mount Pearl","NL",47.50513,-52.79476,2018-10-03 05:00:00,5,5,10
"15370",10401,"Mount Pearl","NL",47.50513,-52.79476,2018-10-03 06:00:00,1,9,10
"15371",10401,"Mount Pearl","NL",47.50513,-52.79476,2018-10-03 07:00:00,1,15,16
"15372",10401,"Mount Pearl","NL",47.50513,-52.79476,2018-10-03 08:00:00,7,10,17
"15373",10401,"Mount Pearl","NL",47.50513,-52.79476,2018-10-03 09:00:00,19,5,24
"15374",10401,"Mount Pearl","NL",47.50513,-52.79476,2018-10-03 10:00:00,27,1,28
"15375",10401,"Mount Pearl","NL",47.50513,-52.79476,2018-10-03 11:00:00,26,2,28
"15376",10401,"Mount Pearl","NL",47.50513,-52.79476,2018-10-03 12:00:00,26,1,27
"15377",10401,"Mount Pearl","NL",47.50513,-52.79476,2018-10-03 13:00:00,26,2,28
"15378",10401,"Mount Pearl","NL",47.50513,-52.79476,2018-10-03 14:00:00,27,1,28
"15379",10401,"Mount Pearl","NL",47.50513,-52.79476,2018-10-03 15:00:00,26,3,29
"15380",10401,"Mount Pearl","NL",47.50513,-52.79476,2018-10-03 16:00:00,26,1,27
"15381",10401,"Mount Pearl","NL",47.50513,-52.79476,2018-10-03 17:00:00,25,1,26
"15382",10401,"Mount Pearl","NL",47.50513,-52.79476,2018-10-03 18:00:00,21,3,24
"15383",10401,"Mount Pearl","NL",47.50513,-52.79476,2018-10-03 19:00:00,20,2,22
"15384",10401,"Mount Pearl","NL",47.50513,-52.79476,2018-10-03 20:00:00,23,1,24
"15385",10401,"Mount Pearl","NL",47.50513,-52.79476,2018-10-03 21:00:00,24,1,25
"15386",10401,"Mount Pearl","NL",47.50513,-52.79476,2018-10-03 22:00:00,25,0,25
"15387",10401,"Mount Pearl","NL",47.50513,-52.79476,2018-10-03 23:00:00,25,0,25
"15388",10401,"Mount Pearl","NL",47.50513,-52.79476,2018-10-04 00:00:00,25,0,25
"15389",10401,"Mount Pearl","NL",47.50513,-52.79476,2018-10-04 01:00:00,25,0,25
"15390",10401,"Mount Pearl","NL",47.50513,-52.79476,2018-10-04 02:00:00,25,0,25
"15391",10401,"Mount Pearl","NL",47.50513,-52.79476,2018-10-04 03:00:00,25,1,26
"15392",10401,"Mount Pearl","NL",47.50513,-52.79476,2018-10-04 04:00:00,24,1,25
"15393",10401,"Mount Pearl","NL",47.50513,-52.79476,2018-10-04 05:00:00,24,0,24
"15394",10401,"Mount Pearl","NL",47.50513,-52.79476,2018-10-04 06:00:00,22,1,23
"15395",10401,"Mount Pearl","NL",47.50513,-52.79476,2018-10-04 07:00:00,17,6,23
"15396",10401,"Mount Pearl","NL",47.50513,-52.79476,2018-10-04 08:00:00,24,2,26
"15397",10401,"Mount Pearl","NL",47.50513,-52.79476,2018-10-04 09:00:00,24,10,34
"15398",10401,"Mount Pearl","NL",47.50513,-52.79476,2018-10-04 10:00:00,25,6,31
"15399",10401,"Mount Pearl","NL",47.50513,-52.79476,2018-10-04 11:00:00,27,3,30
"15400",10401,"Mount Pearl","NL",47.50513,-52.79476,2018-10-04 12:00:00,27,0,27
"15401",10401,"Mount Pearl","NL",47.50513,-52.79476,2018-10-04 13:00:00,26,6,32
"15402",10401,"Mount Pearl","NL",47.50513,-52.79476,2018-10-04 14:00:00,24,13,37
"15403",10401,"Mount Pearl","NL",47.50513,-52.79476,2018-10-04 15:00:00,25,5,30
"15404",10401,"Mount Pearl","NL",47.50513,-52.79476,2018-10-04 16:00:00,23,7,30
"15405",10401,"Mount Pearl","NL",47.50513,-52.79476,2018-10-04 17:00:00,25,8,33
"15406",10401,"Mount Pearl","NL",47.50513,-52.79476,2018-10-04 18:00:00,29,0,29
"15407",10401,"Mount Pearl","NL",47.50513,-52.79476,2018-10-04 19:00:00,28,0,28
"15408",10401,"Mount Pearl","NL",47.50513,-52.79476,2018-10-04 20:00:00,29,0,29
"15409",10401,"Mount Pearl","NL",47.50513,-52.79476,2018-10-04 21:00:00,30,0,30
"15410",10401,"Mount Pearl","NL",47.50513,-52.79476,2018-10-04 22:00:00,30,0,30
"15411",10401,"Mount Pearl","NL",47.50513,-52.79476,2018-10-04 23:00:00,31,0,31
"15412",10401,"Mount Pearl","NL",47.50513,-52.79476,2018-10-05 00:00:00,28,0,28
"15413",10401,"Mount Pearl","NL",47.50513,-52.79476,2018-10-05 01:00:00,25,0,25
"15414",10401,"Mount Pearl","NL",47.50513,-52.79476,2018-10-05 02:00:00,27,0,27
"15415",10401,"Mount Pearl","NL",47.50513,-52.79476,2018-10-05 03:00:00,26,0,26
"15416",10401,"Mount Pearl","NL",47.50513,-52.79476,2018-10-05 04:00:00,24,0,24
"15417",10401,"Mount Pearl","NL",47.50513,-52.79476,2018-10-05 05:00:00,24,0,24
"15418",10401,"Mount Pearl","NL",47.50513,-52.79476,2018-10-05 06:00:00,23,0,23
"15419",10401,"Mount Pearl","NL",47.50513,-52.79476,2018-10-05 07:00:00,15,20,35
"15420",10401,"Mount Pearl","NL",47.50513,-52.79476,2018-10-05 08:00:00,14,21,35
"15421",10401,"Mount Pearl","NL",47.50513,-52.79476,2018-10-05 09:00:00,18,10,28
"15422",10401,"Mount Pearl","NL",47.50513,-52.79476,2018-10-05 10:00:00,19,17,36
"15423",10401,"Mount Pearl","NL",47.50513,-52.79476,2018-10-05 11:00:00,23,12,35
"15424",10401,"Mount Pearl","NL",47.50513,-52.79476,2018-10-05 12:00:00,21,14,35
"15425",10401,"Mount Pearl","NL",47.50513,-52.79476,2018-10-05 13:00:00,19,18,37
"15426",10401,"Mount Pearl","NL",47.50513,-52.79476,2018-10-05 14:00:00,24,6,30
"15427",10401,"Mount Pearl","NL",47.50513,-52.79476,2018-10-05 15:00:00,21,8,29
"15428",10401,"Mount Pearl","NL",47.50513,-52.79476,2018-10-05 16:00:00,20,8,28
"15429",10401,"Mount Pearl","NL",47.50513,-52.79476,2018-10-05 17:00:00,20,5,25
"15430",10401,"Mount Pearl","NL",47.50513,-52.79476,2018-10-05 18:00:00,20,1,21
"15431",10401,"Mount Pearl","NL",47.50513,-52.79476,2018-10-05 19:00:00,21,2,23
"15432",10401,"Mount Pearl","NL",47.50513,-52.79476,2018-10-05 20:00:00,21,0,21
"15433",10401,"Mount Pearl","NL",47.50513,-52.79476,2018-10-05 21:00:00,22,1,23
"15434",10401,"Mount Pearl","NL",47.50513,-52.79476,2018-10-05 22:00:00,20,1,21
"15435",10401,"Mount Pearl","NL",47.50513,-52.79476,2018-10-05 23:00:00,20,1,21
"15436",10401,"Mount Pearl","NL",47.50513,-52.79476,2018-10-06 00:00:00,20,0,20
"15437",10401,"Mount Pearl","NL",47.50513,-52.79476,2018-10-06 01:00:00,20,0,20
"15438",10401,"Mount Pearl","NL",47.50513,-52.79476,2018-10-06 02:00:00,20,0,20
"15439",10401,"Mount Pearl","NL",47.50513,-52.79476,2018-10-06 03:00:00,22,0,22
"15440",10401,"Mount Pearl","NL",47.50513,-52.79476,2018-10-06 04:00:00,21,0,21
"15441",10401,"Mount Pearl","NL",47.50513,-52.79476,2018-10-06 05:00:00,20,0,20
"15442",10401,"Mount Pearl","NL",47.50513,-52.79476,2018-10-06 06:00:00,18,0,18
"15443",10401,"Mount Pearl","NL",47.50513,-52.79476,2018-10-06 07:00:00,8,10,18
"15444",10401,"Mount Pearl","NL",47.50513,-52.79476,2018-10-06 08:00:00,11,6,17
"15445",10401,"Mount Pearl","NL",47.50513,-52.79476,2018-10-06 09:00:00,23,0,23
"15446",10401,"Mount Pearl","NL",47.50513,-52.79476,2018-10-06 10:00:00,22,3,25
"15447",10401,"Mount Pearl","NL",47.50513,-52.79476,2018-10-06 11:00:00,21,4,25
"15448",10401,"Mount Pearl","NL",47.50513,-52.79476,2018-10-06 12:00:00,23,3,26
"15449",10401,"Mount Pearl","NL",47.50513,-52.79476,2018-10-06 13:00:00,22,1,23
"15450",10401,"Mount Pearl","NL",47.50513,-52.79476,2018-10-06 14:00:00,24,0,24
"15451",10401,"Mount Pearl","NL",47.50513,-52.79476,2018-10-06 15:00:00,22,0,22
"15452",10401,"Mount Pearl","NL",47.50513,-52.79476,2018-10-06 16:00:00,25,0,25
"15453",10401,"Mount Pearl","NL",47.50513,-52.79476,2018-10-06 17:00:00,24,0,24
"15454",10401,"Mount Pearl","NL",47.50513,-52.79476,2018-10-06 18:00:00,21,1,22
"15455",10401,"Mount Pearl","NL",47.50513,-52.79476,2018-10-06 19:00:00,18,2,20
"15456",10401,"Mount Pearl","NL",47.50513,-52.79476,2018-10-06 20:00:00,16,2,18
"15457",10401,"Mount Pearl","NL",47.50513,-52.79476,2018-10-06 21:00:00,12,2,14
"15458",10401,"Mount Pearl","NL",47.50513,-52.79476,2018-10-06 22:00:00,10,2,12
"15459",10401,"Mount Pearl","NL",47.50513,-52.79476,2018-10-06 23:00:00,6,4,10
"15460",10401,"Mount Pearl","NL",47.50513,-52.79476,2018-10-07 00:00:00,9,2,11
"15461",10401,"Mount Pearl","NL",47.50513,-52.79476,2018-10-07 01:00:00,9,1,10
"15462",10401,"Mount Pearl","NL",47.50513,-52.79476,2018-10-07 02:00:00,7,2,9
"15463",10401,"Mount Pearl","NL",47.50513,-52.79476,2018-10-07 03:00:00,7,3,10
"15464",10401,"Mount Pearl","NL",47.50513,-52.79476,2018-10-07 04:00:00,6,2,8
"15465",10401,"Mount Pearl","NL",47.50513,-52.79476,2018-10-07 05:00:00,7,2,9
"15466",10401,"Mount Pearl","NL",47.50513,-52.79476,2018-10-07 06:00:00,9,2,11
"15467",10401,"Mount Pearl","NL",47.50513,-52.79476,2018-10-07 07:00:00,14,0,14
"15468",10401,"Mount Pearl","NL",47.50513,-52.79476,2018-10-07 08:00:00,14,1,15
"15469",10401,"Mount Pearl","NL",47.50513,-52.79476,2018-10-07 09:00:00,16,1,17
"15470",10401,"Mount Pearl","NL",47.50513,-52.79476,2018-10-07 10:00:00,18,0,18
"15471",10401,"Mount Pearl","NL",47.50513,-52.79476,2018-10-07 11:00:00,21,0,21
"15472",10401,"Mount Pearl","NL",47.50513,-52.79476,2018-10-07 12:00:00,24,0,24
"15473",10401,"Mount Pearl","NL",47.50513,-52.79476,2018-10-07 13:00:00,24,0,24
"15474",10401,"Mount Pearl","NL",47.50513,-52.79476,2018-10-07 14:00:00,21,0,21
"15475",10401,"Mount Pearl","NL",47.50513,-52.79476,2018-10-07 15:00:00,23,0,23
"15476",10401,"Mount Pearl","NL",47.50513,-52.79476,2018-10-07 16:00:00,30,1,31
"15477",10401,"Mount Pearl","NL",47.50513,-52.79476,2018-10-07 17:00:00,30,1,31
"15478",10401,"Mount Pearl","NL",47.50513,-52.79476,2018-10-07 18:00:00,28,1,29
"15479",10401,"Mount Pearl","NL",47.50513,-52.79476,2018-10-07 19:00:00,26,1,27
"15480",10401,"Mount Pearl","NL",47.50513,-52.79476,2018-10-07 20:00:00,24,0,24
"15481",10401,"Mount Pearl","NL",47.50513,-52.79476,2018-10-07 21:00:00,24,1,25
"15482",10401,"Mount Pearl","NL",47.50513,-52.79476,2018-10-07 22:00:00,24,0,24
"15483",10401,"Mount Pearl","NL",47.50513,-52.79476,2018-10-07 23:00:00,23,0,23
"15484",10401,"Mount Pearl","NL",47.50513,-52.79476,2018-10-08 00:00:00,24,0,24
"15485",10401,"Mount Pearl","NL",47.50513,-52.79476,2018-10-08 01:00:00,24,0,24
"15486",10401,"Mount Pearl","NL",47.50513,-52.79476,2018-10-08 02:00:00,26,0,26
"15487",10401,"Mount Pearl","NL",47.50513,-52.79476,2018-10-08 03:00:00,26,0,26
"15488",10401,"Mount Pearl","NL",47.50513,-52.79476,2018-10-08 04:00:00,26,1,27
"15489",10401,"Mount Pearl","NL",47.50513,-52.79476,2018-10-08 05:00:00,25,1,26
"15490",10401,"Mount Pearl","NL",47.50513,-52.79476,2018-10-08 06:00:00,22,1,23
"15491",10401,"Mount Pearl","NL",47.50513,-52.79476,2018-10-08 07:00:00,18,8,26
"15492",10401,"Mount Pearl","NL",47.50513,-52.79476,2018-10-08 08:00:00,22,2,24
"15493",10401,"Mount Pearl","NL",47.50513,-52.79476,2018-10-08 09:00:00,25,1,26
"15494",10401,"Mount Pearl","NL",47.50513,-52.79476,2018-10-08 10:00:00,26,0,26
"15495",10401,"Mount Pearl","NL",47.50513,-52.79476,2018-10-08 11:00:00,25,1,26
"15496",10401,"Mount Pearl","NL",47.50513,-52.79476,2018-10-08 12:00:00,25,1,26
"15497",10401,"Mount Pearl","NL",47.50513,-52.79476,2018-10-08 13:00:00,26,0,26
"15498",10401,"Mount Pearl","NL",47.50513,-52.79476,2018-10-08 14:00:00,25,0,25
"15499",10401,"Mount Pearl","NL",47.50513,-52.79476,2018-10-08 15:00:00,25,0,25
"15500",10401,"Mount Pearl","NL",47.50513,-52.79476,2018-10-08 16:00:00,25,1,26
"15501",10401,"Mount Pearl","NL",47.50513,-52.79476,2018-10-08 17:00:00,25,1,26
"15502",10401,"Mount Pearl","NL",47.50513,-52.79476,2018-10-08 18:00:00,24,1,25
"15503",10401,"Mount Pearl","NL",47.50513,-52.79476,2018-10-08 19:00:00,19,2,21
"15504",10401,"Mount Pearl","NL",47.50513,-52.79476,2018-10-08 20:00:00,9,6,15
"15505",10401,"Mount Pearl","NL",47.50513,-52.79476,2018-10-08 21:00:00,12,4,16
"15506",10401,"Mount Pearl","NL",47.50513,-52.79476,2018-10-08 22:00:00,15,3,18
"15507",10401,"Mount Pearl","NL",47.50513,-52.79476,2018-10-08 23:00:00,18,2,20
"15508",10401,"Mount Pearl","NL",47.50513,-52.79476,2018-10-09 00:00:00,15,2,17
"15509",10401,"Mount Pearl","NL",47.50513,-52.79476,2018-10-09 01:00:00,19,1,20
"15510",10401,"Mount Pearl","NL",47.50513,-52.79476,2018-10-09 02:00:00,23,0,23
"15511",10401,"Mount Pearl","NL",47.50513,-52.79476,2018-10-09 03:00:00,23,0,23
"15512",10401,"Mount Pearl","NL",47.50513,-52.79476,2018-10-09 04:00:00,23,1,24
"15513",10401,"Mount Pearl","NL",47.50513,-52.79476,2018-10-09 05:00:00,22,2,24
"15514",10401,"Mount Pearl","NL",47.50513,-52.79476,2018-10-09 06:00:00,21,2,23
"15515",10401,"Mount Pearl","NL",47.50513,-52.79476,2018-10-09 07:00:00,13,8,21
"15516",10401,"Mount Pearl","NL",47.50513,-52.79476,2018-10-09 08:00:00,17,5,22
"15517",10401,"Mount Pearl","NL",47.50513,-52.79476,2018-10-09 09:00:00,22,1,23
"15518",10401,"Mount Pearl","NL",47.50513,-52.79476,2018-10-09 10:00:00,23,1,24
"15519",10401,"Mount Pearl","NL",47.50513,-52.79476,2018-10-09 11:00:00,24,1,25
"15520",10401,"Mount Pearl","NL",47.50513,-52.79476,2018-10-09 12:00:00,25,1,26
"15521",10401,"Mount Pearl","NL",47.50513,-52.79476,2018-10-09 13:00:00,25,3,28
"15522",10401,"Mount Pearl","NL",47.50513,-52.79476,2018-10-09 14:00:00,19,35,54
"15523",10401,"Mount Pearl","NL",47.50513,-52.79476,2018-10-09 15:00:00,18,31,49
"15524",10401,"Mount Pearl","NL",47.50513,-52.79476,2018-10-09 16:00:00,18,26,44
"15525",10401,"Mount Pearl","NL",47.50513,-52.79476,2018-10-09 17:00:00,20,14,34
"15526",10401,"Mount Pearl","NL",47.50513,-52.79476,2018-10-09 18:00:00,18,5,23
"15527",10401,"Mount Pearl","NL",47.50513,-52.79476,2018-10-09 19:00:00,22,2,24
"15528",10401,"Mount Pearl","NL",47.50513,-52.79476,2018-10-09 20:00:00,20,1,21
"15529",10401,"Mount Pearl","NL",47.50513,-52.79476,2018-10-09 21:00:00,18,2,20
"15530",10401,"Mount Pearl","NL",47.50513,-52.79476,2018-10-09 22:00:00,20,1,21
"15531",10401,"Mount Pearl","NL",47.50513,-52.79476,2018-10-09 23:00:00,18,1,19
"15532",10401,"Mount Pearl","NL",47.50513,-52.79476,2018-10-10 00:00:00,17,1,18
"15533",10401,"Mount Pearl","NL",47.50513,-52.79476,2018-10-10 01:00:00,18,1,19
"15534",10401,"Mount Pearl","NL",47.50513,-52.79476,2018-10-10 02:00:00,21,1,22
"15535",10401,"Mount Pearl","NL",47.50513,-52.79476,2018-10-10 03:00:00,21,1,22
"15536",10401,"Mount Pearl","NL",47.50513,-52.79476,2018-10-10 04:00:00,23,1,24
"15537",10401,"Mount Pearl","NL",47.50513,-52.79476,2018-10-10 05:00:00,26,1,27
"15538",10401,"Mount Pearl","NL",47.50513,-52.79476,2018-10-10 06:00:00,26,3,29
"15539",10401,"Mount Pearl","NL",47.50513,-52.79476,2018-10-10 07:00:00,26,3,29
"15540",10401,"Mount Pearl","NL",47.50513,-52.79476,2018-10-10 08:00:00,24,6,30
"15541",10401,"Mount Pearl","NL",47.50513,-52.79476,2018-10-10 09:00:00,26,4,30
"15542",10401,"Mount Pearl","NL",47.50513,-52.79476,2018-10-10 10:00:00,27,3,30
"15543",10401,"Mount Pearl","NL",47.50513,-52.79476,2018-10-10 11:00:00,25,4,29
"15544",10401,"Mount Pearl","NL",47.50513,-52.79476,2018-10-10 12:00:00,27,1,28
"15545",10401,"Mount Pearl","NL",47.50513,-52.79476,2018-10-10 13:00:00,26,1,27
"15546",10401,"Mount Pearl","NL",47.50513,-52.79476,2018-10-10 14:00:00,26,1,27
"15547",10401,"Mount Pearl","NL",47.50513,-52.79476,2018-10-10 15:00:00,22,2,24
"15548",10401,"Mount Pearl","NL",47.50513,-52.79476,2018-10-10 16:00:00,24,2,26
"15549",10401,"Mount Pearl","NL",47.50513,-52.79476,2018-10-10 17:00:00,27,1,28
"15550",10401,"Mount Pearl","NL",47.50513,-52.79476,2018-10-10 18:00:00,27,1,28
"15551",10401,"Mount Pearl","NL",47.50513,-52.79476,2018-10-10 19:00:00,26,1,27
"15552",10401,"Mount Pearl","NL",47.50513,-52.79476,2018-10-10 20:00:00,23,1,24
"15553",10401,"Mount Pearl","NL",47.50513,-52.79476,2018-10-10 21:00:00,26,1,27
"15554",10401,"Mount Pearl","NL",47.50513,-52.79476,2018-10-10 22:00:00,27,0,27
"15555",10401,"Mount Pearl","NL",47.50513,-52.79476,2018-10-10 23:00:00,28,0,28
"15556",10401,"Mount Pearl","NL",47.50513,-52.79476,2018-10-11 00:00:00,28,0,28
"15557",10401,"Mount Pearl","NL",47.50513,-52.79476,2018-10-11 01:00:00,29,0,29
"15558",10401,"Mount Pearl","NL",47.50513,-52.79476,2018-10-11 02:00:00,30,0,30
"15559",10401,"Mount Pearl","NL",47.50513,-52.79476,2018-10-11 03:00:00,29,0,29
"15560",10401,"Mount Pearl","NL",47.50513,-52.79476,2018-10-11 04:00:00,30,0,30
"15561",10401,"Mount Pearl","NL",47.50513,-52.79476,2018-10-11 05:00:00,30,0,30
"15562",10401,"Mount Pearl","NL",47.50513,-52.79476,2018-10-11 06:00:00,31,0,31
"15563",10401,"Mount Pearl","NL",47.50513,-52.79476,2018-10-11 07:00:00,29,2,31
"15564",10401,"Mount Pearl","NL",47.50513,-52.79476,2018-10-11 08:00:00,28,2,30
"15565",10401,"Mount Pearl","NL",47.50513,-52.79476,2018-10-11 09:00:00,28,1,29
"15566",10401,"Mount Pearl","NL",47.50513,-52.79476,2018-10-11 10:00:00,28,1,29
"15567",10401,"Mount Pearl","NL",47.50513,-52.79476,2018-10-11 11:00:00,28,1,29
"15568",10401,"Mount Pearl","NL",47.50513,-52.79476,2018-10-11 12:00:00,28,0,28
"15569",10401,"Mount Pearl","NL",47.50513,-52.79476,2018-10-11 13:00:00,29,0,29
"15570",10401,"Mount Pearl","NL",47.50513,-52.79476,2018-10-11 14:00:00,30,0,30
"15571",10401,"Mount Pearl","NL",47.50513,-52.79476,2018-10-11 15:00:00,30,0,30
"15572",10401,"Mount Pearl","NL",47.50513,-52.79476,2018-10-11 16:00:00,29,0,29
"15573",10401,"Mount Pearl","NL",47.50513,-52.79476,2018-10-11 17:00:00,29,1,30
"15574",10401,"Mount Pearl","NL",47.50513,-52.79476,2018-10-11 18:00:00,30,0,30
"15575",10401,"Mount Pearl","NL",47.50513,-52.79476,2018-10-11 19:00:00,31,0,31
"15576",10401,"Mount Pearl","NL",47.50513,-52.79476,2018-10-11 20:00:00,31,0,31
"15577",10401,"Mount Pearl","NL",47.50513,-52.79476,2018-10-11 21:00:00,31,0,31
"15578",10401,"Mount Pearl","NL",47.50513,-52.79476,2018-10-11 22:00:00,30,0,30
"15579",10401,"Mount Pearl","NL",47.50513,-52.79476,2018-10-11 23:00:00,29,0,29
"15580",10401,"Mount Pearl","NL",47.50513,-52.79476,2018-10-12 00:00:00,30,0,30
"15581",10401,"Mount Pearl","NL",47.50513,-52.79476,2018-10-12 01:00:00,29,1,30
"15582",10401,"Mount Pearl","NL",47.50513,-52.79476,2018-10-12 02:00:00,28,0,28
"15583",10401,"Mount Pearl","NL",47.50513,-52.79476,2018-10-12 03:00:00,24,2,26
"15584",10401,"Mount Pearl","NL",47.50513,-52.79476,2018-10-12 04:00:00,25,0,25
"15585",10401,"Mount Pearl","NL",47.50513,-52.79476,2018-10-12 05:00:00,23,0,23
"15586",10401,"Mount Pearl","NL",47.50513,-52.79476,2018-10-12 06:00:00,14,3,17
"15587",10401,"Mount Pearl","NL",47.50513,-52.79476,2018-10-12 07:00:00,4,19,23
"15588",10401,"Mount Pearl","NL",47.50513,-52.79476,2018-10-12 08:00:00,5,11,16
"15589",10401,"Mount Pearl","NL",47.50513,-52.79476,2018-10-12 09:00:00,20,5,25
"15590",10401,"Mount Pearl","NL",47.50513,-52.79476,2018-10-12 10:00:00,20,10,30
"15591",10401,"Mount Pearl","NL",47.50513,-52.79476,2018-10-12 11:00:00,18,24,42
"15592",10401,"Mount Pearl","NL",47.50513,-52.79476,2018-10-12 12:00:00,28,6,34
"15593",10401,"Mount Pearl","NL",47.50513,-52.79476,2018-10-12 13:00:00,25,12,37
"15594",10401,"Mount Pearl","NL",47.50513,-52.79476,2018-10-12 14:00:00,28,4,32
"15595",10401,"Mount Pearl","NL",47.50513,-52.79476,2018-10-12 15:00:00,25,13,38
"15596",10401,"Mount Pearl","NL",47.50513,-52.79476,2018-10-12 16:00:00,20,29,49
"15597",10401,"Mount Pearl","NL",47.50513,-52.79476,2018-10-12 17:00:00,28,6,34
"15598",10401,"Mount Pearl","NL",47.50513,-52.79476,2018-10-12 18:00:00,31,1,32
"15599",10401,"Mount Pearl","NL",47.50513,-52.79476,2018-10-12 19:00:00,32,1,33
"15600",10401,"Mount Pearl","NL",47.50513,-52.79476,2018-10-12 20:00:00,34,1,35
"15601",10401,"Mount Pearl","NL",47.50513,-52.79476,2018-10-12 21:00:00,35,1,36
"15602",10401,"Mount Pearl","NL",47.50513,-52.79476,2018-10-12 22:00:00,35,1,36
"15603",10401,"Mount Pearl","NL",47.50513,-52.79476,2018-10-12 23:00:00,38,1,39
"15604",10401,"Mount Pearl","NL",47.50513,-52.79476,2018-10-13 00:00:00,37,1,38
"15605",10401,"Mount Pearl","NL",47.50513,-52.79476,2018-10-13 01:00:00,37,1,38
"15606",10401,"Mount Pearl","NL",47.50513,-52.79476,2018-10-13 02:00:00,37,1,38
"15607",10401,"Mount Pearl","NL",47.50513,-52.79476,2018-10-13 03:00:00,37,1,38
"15608",10401,"Mount Pearl","NL",47.50513,-52.79476,2018-10-13 04:00:00,36,1,37
"15609",10401,"Mount Pearl","NL",47.50513,-52.79476,2018-10-13 05:00:00,34,1,35
"15610",10401,"Mount Pearl","NL",47.50513,-52.79476,2018-10-13 06:00:00,32,2,34
"15611",10401,"Mount Pearl","NL",47.50513,-52.79476,2018-10-13 07:00:00,32,1,33
"15612",10401,"Mount Pearl","NL",47.50513,-52.79476,2018-10-13 08:00:00,31,1,32
"15613",10401,"Mount Pearl","NL",47.50513,-52.79476,2018-10-13 09:00:00,31,2,33
"15614",10401,"Mount Pearl","NL",47.50513,-52.79476,2018-10-13 10:00:00,30,2,32
"15615",10401,"Mount Pearl","NL",47.50513,-52.79476,2018-10-13 11:00:00,30,1,31
"15616",10401,"Mount Pearl","NL",47.50513,-52.79476,2018-10-13 12:00:00,30,1,31
"15617",10401,"Mount Pearl","NL",47.50513,-52.79476,2018-10-13 13:00:00,30,0,30
"15618",10401,"Mount Pearl","NL",47.50513,-52.79476,2018-10-13 14:00:00,31,1,32
"15619",10401,"Mount Pearl","NL",47.50513,-52.79476,2018-10-13 15:00:00,30,2,32
"15620",10401,"Mount Pearl","NL",47.50513,-52.79476,2018-10-13 16:00:00,30,1,31
"15621",10401,"Mount Pearl","NL",47.50513,-52.79476,2018-10-13 17:00:00,30,0,30
"15622",10401,"Mount Pearl","NL",47.50513,-52.79476,2018-10-13 18:00:00,29,1,30
"15623",10401,"Mount Pearl","NL",47.50513,-52.79476,2018-10-13 19:00:00,25,1,26
"15624",10401,"Mount Pearl","NL",47.50513,-52.79476,2018-10-13 20:00:00,26,1,27
"15625",10401,"Mount Pearl","NL",47.50513,-52.79476,2018-10-13 21:00:00,26,1,27
"15626",10401,"Mount Pearl","NL",47.50513,-52.79476,2018-10-13 22:00:00,25,1,26
"15627",10401,"Mount Pearl","NL",47.50513,-52.79476,2018-10-13 23:00:00,23,0,23
"15628",10401,"Mount Pearl","NL",47.50513,-52.79476,2018-10-14 00:00:00,21,0,21
"15629",10401,"Mount Pearl","NL",47.50513,-52.79476,2018-10-14 01:00:00,19,0,19
"15630",10401,"Mount Pearl","NL",47.50513,-52.79476,2018-10-14 02:00:00,17,0,17
"15631",10401,"Mount Pearl","NL",47.50513,-52.79476,2018-10-14 03:00:00,16,1,17
"15632",10401,"Mount Pearl","NL",47.50513,-52.79476,2018-10-14 04:00:00,21,0,21
"15633",10401,"Mount Pearl","NL",47.50513,-52.79476,2018-10-14 05:00:00,20,1,21
"15634",10401,"Mount Pearl","NL",47.50513,-52.79476,2018-10-14 06:00:00,18,0,18
"15635",10401,"Mount Pearl","NL",47.50513,-52.79476,2018-10-14 07:00:00,16,1,17
"15636",10401,"Mount Pearl","NL",47.50513,-52.79476,2018-10-14 08:00:00,21,0,21
"15637",10401,"Mount Pearl","NL",47.50513,-52.79476,2018-10-14 09:00:00,23,1,24
"15638",10401,"Mount Pearl","NL",47.50513,-52.79476,2018-10-14 10:00:00,20,0,20
"15639",10401,"Mount Pearl","NL",47.50513,-52.79476,2018-10-14 11:00:00,21,0,21
"15640",10401,"Mount Pearl","NL",47.50513,-52.79476,2018-10-14 12:00:00,22,1,23
"15641",10401,"Mount Pearl","NL",47.50513,-52.79476,2018-10-14 13:00:00,23,1,24
"15642",10401,"Mount Pearl","NL",47.50513,-52.79476,2018-10-14 14:00:00,24,1,25
"15643",10401,"Mount Pearl","NL",47.50513,-52.79476,2018-10-14 15:00:00,25,0,25
"15644",10401,"Mount Pearl","NL",47.50513,-52.79476,2018-10-14 16:00:00,26,1,27
"15645",10401,"Mount Pearl","NL",47.50513,-52.79476,2018-10-14 17:00:00,27,1,28
"15646",10401,"Mount Pearl","NL",47.50513,-52.79476,2018-10-14 18:00:00,28,1,29
"15647",10401,"Mount Pearl","NL",47.50513,-52.79476,2018-10-14 19:00:00,27,1,28
"15648",10401,"Mount Pearl","NL",47.50513,-52.79476,2018-10-14 20:00:00,23,1,24
"15649",10401,"Mount Pearl","NL",47.50513,-52.79476,2018-10-14 21:00:00,20,1,21
"15650",10401,"Mount Pearl","NL",47.50513,-52.79476,2018-10-14 22:00:00,19,0,19
"15651",10401,"Mount Pearl","NL",47.50513,-52.79476,2018-10-14 23:00:00,21,0,21
"15652",10401,"Mount Pearl","NL",47.50513,-52.79476,2018-10-15 00:00:00,22,0,22
"15653",10401,"Mount Pearl","NL",47.50513,-52.79476,2018-10-15 01:00:00,23,0,23
"15654",10401,"Mount Pearl","NL",47.50513,-52.79476,2018-10-15 02:00:00,23,0,23
"15655",10401,"Mount Pearl","NL",47.50513,-52.79476,2018-10-15 03:00:00,23,0,23
"15656",10401,"Mount Pearl","NL",47.50513,-52.79476,2018-10-15 04:00:00,22,0,22
"15657",10401,"Mount Pearl","NL",47.50513,-52.79476,2018-10-15 05:00:00,21,0,21
"15658",10401,"Mount Pearl","NL",47.50513,-52.79476,2018-10-15 06:00:00,20,1,21
"15659",10401,"Mount Pearl","NL",47.50513,-52.79476,2018-10-15 07:00:00,17,3,20
"15660",10401,"Mount Pearl","NL",47.50513,-52.79476,2018-10-15 08:00:00,16,4,20
"15661",10401,"Mount Pearl","NL",47.50513,-52.79476,2018-10-15 09:00:00,13,27,40
"15662",10401,"Mount Pearl","NL",47.50513,-52.79476,2018-10-15 10:00:00,18,2,20
"15663",10401,"Mount Pearl","NL",47.50513,-52.79476,2018-10-15 11:00:00,18,5,23
"15664",10401,"Mount Pearl","NL",47.50513,-52.79476,2018-10-15 12:00:00,19,2,21
"15665",10401,"Mount Pearl","NL",47.50513,-52.79476,2018-10-15 13:00:00,19,2,21
"15666",10401,"Mount Pearl","NL",47.50513,-52.79476,2018-10-15 14:00:00,18,2,20
"15667",10401,"Mount Pearl","NL",47.50513,-52.79476,2018-10-15 15:00:00,18,2,20
"15668",10401,"Mount Pearl","NL",47.50513,-52.79476,2018-10-15 16:00:00,16,14,30
"15669",10401,"Mount Pearl","NL",47.50513,-52.79476,2018-10-15 17:00:00,17,8,25
"15670",10401,"Mount Pearl","NL",47.50513,-52.79476,2018-10-15 18:00:00,14,5,19
"15671",10401,"Mount Pearl","NL",47.50513,-52.79476,2018-10-15 19:00:00,12,5,17
"15672",10401,"Mount Pearl","NL",47.50513,-52.79476,2018-10-15 20:00:00,13,4,17
"15673",10401,"Mount Pearl","NL",47.50513,-52.79476,2018-10-15 21:00:00,16,2,18
"15674",10401,"Mount Pearl","NL",47.50513,-52.79476,2018-10-15 22:00:00,19,2,21
"15675",10401,"Mount Pearl","NL",47.50513,-52.79476,2018-10-15 23:00:00,21,2,23
"15676",10401,"Mount Pearl","NL",47.50513,-52.79476,2018-10-16 00:00:00,17,2,19
"15677",10401,"Mount Pearl","NL",47.50513,-52.79476,2018-10-16 01:00:00,17,2,19
"15678",10401,"Mount Pearl","NL",47.50513,-52.79476,2018-10-16 02:00:00,18,2,20
"15679",10401,"Mount Pearl","NL",47.50513,-52.79476,2018-10-16 03:00:00,18,2,20
"15680",10401,"Mount Pearl","NL",47.50513,-52.79476,2018-10-16 04:00:00,19,2,21
"15681",10401,"Mount Pearl","NL",47.50513,-52.79476,2018-10-16 05:00:00,19,2,21
"15682",10401,"Mount Pearl","NL",47.50513,-52.79476,2018-10-16 06:00:00,21,2,23
"15683",10401,"Mount Pearl","NL",47.50513,-52.79476,2018-10-16 07:00:00,17,30,47
"15684",10401,"Mount Pearl","NL",47.50513,-52.79476,2018-10-16 08:00:00,24,17,41
"15685",10401,"Mount Pearl","NL",47.50513,-52.79476,2018-10-16 09:00:00,31,3,34
"15686",10401,"Mount Pearl","NL",47.50513,-52.79476,2018-10-16 10:00:00,31,5,36
"15687",10401,"Mount Pearl","NL",47.50513,-52.79476,2018-10-16 11:00:00,31,3,34
"15688",10401,"Mount Pearl","NL",47.50513,-52.79476,2018-10-16 12:00:00,33,1,34
"15689",10401,"Mount Pearl","NL",47.50513,-52.79476,2018-10-16 13:00:00,35,1,36
"15690",10401,"Mount Pearl","NL",47.50513,-52.79476,2018-10-16 14:00:00,36,1,37
"15691",10401,"Mount Pearl","NL",47.50513,-52.79476,2018-10-16 15:00:00,38,1,39
"15692",10401,"Mount Pearl","NL",47.50513,-52.79476,2018-10-16 16:00:00,36,1,37
"15693",10401,"Mount Pearl","NL",47.50513,-52.79476,2018-10-16 17:00:00,33,1,34
"15694",10401,"Mount Pearl","NL",47.50513,-52.79476,2018-10-16 18:00:00,32,1,33
"15695",10401,"Mount Pearl","NL",47.50513,-52.79476,2018-10-16 19:00:00,26,1,27
"15696",10401,"Mount Pearl","NL",47.50513,-52.79476,2018-10-16 20:00:00,25,1,26
"15697",10401,"Mount Pearl","NL",47.50513,-52.79476,2018-10-16 21:00:00,24,1,25
"15698",10401,"Mount Pearl","NL",47.50513,-52.79476,2018-10-16 22:00:00,25,1,26
"15699",10401,"Mount Pearl","NL",47.50513,-52.79476,2018-10-16 23:00:00,26,0,26
"15700",10401,"Mount Pearl","NL",47.50513,-52.79476,2018-10-17 00:00:00,26,1,27
"15701",10401,"Mount Pearl","NL",47.50513,-52.79476,2018-10-17 01:00:00,26,1,27
"15702",10401,"Mount Pearl","NL",47.50513,-52.79476,2018-10-17 02:00:00,25,1,26
"15703",10401,"Mount Pearl","NL",47.50513,-52.79476,2018-10-17 03:00:00,25,1,26
"15704",10401,"Mount Pearl","NL",47.50513,-52.79476,2018-10-17 04:00:00,25,1,26
"15705",10401,"Mount Pearl","NL",47.50513,-52.79476,2018-10-17 05:00:00,25,1,26
"15706",10401,"Mount Pearl","NL",47.50513,-52.79476,2018-10-17 06:00:00,25,1,26
"15707",10401,"Mount Pearl","NL",47.50513,-52.79476,2018-10-17 07:00:00,20,16,36
"15708",10401,"Mount Pearl","NL",47.50513,-52.79476,2018-10-17 08:00:00,18,29,47
"15709",10401,"Mount Pearl","NL",47.50513,-52.79476,2018-10-17 09:00:00,22,6,28
"15710",10401,"Mount Pearl","NL",47.50513,-52.79476,2018-10-17 10:00:00,23,8,31
"15711",10401,"Mount Pearl","NL",47.50513,-52.79476,2018-10-17 11:00:00,24,1,25
"15712",10401,"Mount Pearl","NL",47.50513,-52.79476,2018-10-17 12:00:00,26,1,27
"15713",10401,"Mount Pearl","NL",47.50513,-52.79476,2018-10-17 13:00:00,27,2,29
"15714",10401,"Mount Pearl","NL",47.50513,-52.79476,2018-10-17 14:00:00,29,1,30
"15715",10401,"Mount Pearl","NL",47.50513,-52.79476,2018-10-17 15:00:00,30,1,31
"15716",10401,"Mount Pearl","NL",47.50513,-52.79476,2018-10-17 16:00:00,31,1,32
"15717",10401,"Mount Pearl","NL",47.50513,-52.79476,2018-10-17 17:00:00,30,2,32
"15718",10401,"Mount Pearl","NL",47.50513,-52.79476,2018-10-17 18:00:00,31,1,32
"15719",10401,"Mount Pearl","NL",47.50513,-52.79476,2018-10-17 19:00:00,30,2,32
"15720",10401,"Mount Pearl","NL",47.50513,-52.79476,2018-10-17 20:00:00,28,1,29
"15721",10401,"Mount Pearl","NL",47.50513,-52.79476,2018-10-17 21:00:00,28,1,29
"15722",10401,"Mount Pearl","NL",47.50513,-52.79476,2018-10-17 22:00:00,24,1,25
"15723",10401,"Mount Pearl","NL",47.50513,-52.79476,2018-10-17 23:00:00,21,1,22
"15724",10401,"Mount Pearl","NL",47.50513,-52.79476,2018-10-18 00:00:00,19,1,20
"15725",10401,"Mount Pearl","NL",47.50513,-52.79476,2018-10-18 01:00:00,19,1,20
"15726",10401,"Mount Pearl","NL",47.50513,-52.79476,2018-10-18 02:00:00,15,1,16
"15727",10401,"Mount Pearl","NL",47.50513,-52.79476,2018-10-18 03:00:00,14,1,15
"15728",10401,"Mount Pearl","NL",47.50513,-52.79476,2018-10-18 04:00:00,18,1,19
"15729",10401,"Mount Pearl","NL",47.50513,-52.79476,2018-10-18 05:00:00,18,1,19
"15730",10401,"Mount Pearl","NL",47.50513,-52.79476,2018-10-18 06:00:00,26,1,27
"15731",10401,"Mount Pearl","NL",47.50513,-52.79476,2018-10-18 07:00:00,31,1,32
"15732",10401,"Mount Pearl","NL",47.50513,-52.79476,2018-10-18 08:00:00,32,2,34
"15733",10401,"Mount Pearl","NL",47.50513,-52.79476,2018-10-18 09:00:00,33,1,34
"15734",10401,"Mount Pearl","NL",47.50513,-52.79476,2018-10-18 10:00:00,31,1,32
"15735",10401,"Mount Pearl","NL",47.50513,-52.79476,2018-10-18 11:00:00,30,1,31
"15736",10401,"Mount Pearl","NL",47.50513,-52.79476,2018-10-18 12:00:00,29,0,29
"15737",10401,"Mount Pearl","NL",47.50513,-52.79476,2018-10-18 13:00:00,30,0,30
"15738",10401,"Mount Pearl","NL",47.50513,-52.79476,2018-10-18 14:00:00,31,1,32
"15739",10401,"Mount Pearl","NL",47.50513,-52.79476,2018-10-18 15:00:00,33,1,34
"15740",10401,"Mount Pearl","NL",47.50513,-52.79476,2018-10-18 16:00:00,34,1,35
"15741",10401,"Mount Pearl","NL",47.50513,-52.79476,2018-10-18 17:00:00,33,1,34
"15742",10401,"Mount Pearl","NL",47.50513,-52.79476,2018-10-18 18:00:00,31,0,31
"15743",10401,"Mount Pearl","NL",47.50513,-52.79476,2018-10-18 19:00:00,28,0,28
"15744",10401,"Mount Pearl","NL",47.50513,-52.79476,2018-10-18 20:00:00,26,0,26
"15745",10401,"Mount Pearl","NL",47.50513,-52.79476,2018-10-18 21:00:00,24,0,24
"15746",10401,"Mount Pearl","NL",47.50513,-52.79476,2018-10-18 22:00:00,24,0,24
"15747",10401,"Mount Pearl","NL",47.50513,-52.79476,2018-10-18 23:00:00,21,1,22
"15748",10401,"Mount Pearl","NL",47.50513,-52.79476,2018-10-19 00:00:00,22,0,22
"15749",10401,"Mount Pearl","NL",47.50513,-52.79476,2018-10-19 01:00:00,24,0,24
"15750",10401,"Mount Pearl","NL",47.50513,-52.79476,2018-10-19 02:00:00,25,1,26
"15751",10401,"Mount Pearl","NL",47.50513,-52.79476,2018-10-19 03:00:00,26,1,27
"15752",10401,"Mount Pearl","NL",47.50513,-52.79476,2018-10-19 04:00:00,26,0,26
"15753",10401,"Mount Pearl","NL",47.50513,-52.79476,2018-10-19 05:00:00,26,1,27
"15754",10401,"Mount Pearl","NL",47.50513,-52.79476,2018-10-19 06:00:00,27,1,28
"15755",10401,"Mount Pearl","NL",47.50513,-52.79476,2018-10-19 07:00:00,24,1,25
"15756",10401,"Mount Pearl","NL",47.50513,-52.79476,2018-10-19 08:00:00,23,2,25
"15757",10401,"Mount Pearl","NL",47.50513,-52.79476,2018-10-19 09:00:00,25,2,27
"15758",10401,"Mount Pearl","NL",47.50513,-52.79476,2018-10-19 10:00:00,27,1,28
"15759",10401,"Mount Pearl","NL",47.50513,-52.79476,2018-10-19 11:00:00,28,0,28
"15760",10401,"Mount Pearl","NL",47.50513,-52.79476,2018-10-19 12:00:00,29,1,30
"15761",10401,"Mount Pearl","NL",47.50513,-52.79476,2018-10-19 13:00:00,29,1,30
"15762",10401,"Mount Pearl","NL",47.50513,-52.79476,2018-10-19 14:00:00,29,1,30
"15763",10401,"Mount Pearl","NL",47.50513,-52.79476,2018-10-19 15:00:00,30,0,30
"15764",10401,"Mount Pearl","NL",47.50513,-52.79476,2018-10-19 16:00:00,30,1,31
"15765",10401,"Mount Pearl","NL",47.50513,-52.79476,2018-10-19 17:00:00,28,1,29
"15766",10401,"Mount Pearl","NL",47.50513,-52.79476,2018-10-19 18:00:00,29,1,30
"15767",10401,"Mount Pearl","NL",47.50513,-52.79476,2018-10-19 19:00:00,28,1,29
"15768",10401,"Mount Pearl","NL",47.50513,-52.79476,2018-10-19 20:00:00,22,3,25
"15769",10401,"Mount Pearl","NL",47.50513,-52.79476,2018-10-19 21:00:00,19,2,21
"15770",10401,"Mount Pearl","NL",47.50513,-52.79476,2018-10-19 22:00:00,17,2,19
"15771",10401,"Mount Pearl","NL",47.50513,-52.79476,2018-10-19 23:00:00,22,1,23
"15772",10401,"Mount Pearl","NL",47.50513,-52.79476,2018-10-20 00:00:00,21,0,21
"15773",10401,"Mount Pearl","NL",47.50513,-52.79476,2018-10-20 01:00:00,21,0,21
"15774",10401,"Mount Pearl","NL",47.50513,-52.79476,2018-10-20 02:00:00,20,1,21
"15775",10401,"Mount Pearl","NL",47.50513,-52.79476,2018-10-20 03:00:00,21,1,22
"15776",10401,"Mount Pearl","NL",47.50513,-52.79476,2018-10-20 04:00:00,19,0,19
"15777",10401,"Mount Pearl","NL",47.50513,-52.79476,2018-10-20 05:00:00,18,1,19
"15778",10401,"Mount Pearl","NL",47.50513,-52.79476,2018-10-20 06:00:00,20,0,20
"15779",10401,"Mount Pearl","NL",47.50513,-52.79476,2018-10-20 07:00:00,21,0,21
"15780",10401,"Mount Pearl","NL",47.50513,-52.79476,2018-10-20 08:00:00,23,0,23
"15781",10401,"Mount Pearl","NL",47.50513,-52.79476,2018-10-20 09:00:00,23,0,23
"15782",10401,"Mount Pearl","NL",47.50513,-52.79476,2018-10-20 10:00:00,25,1,26
"15783",10401,"Mount Pearl","NL",47.50513,-52.79476,2018-10-20 11:00:00,31,0,31
"15784",10401,"Mount Pearl","NL",47.50513,-52.79476,2018-10-20 12:00:00,32,1,33
"15785",10401,"Mount Pearl","NL",47.50513,-52.79476,2018-10-20 13:00:00,32,1,33
"15786",10401,"Mount Pearl","NL",47.50513,-52.79476,2018-10-20 14:00:00,32,1,33
"15787",10401,"Mount Pearl","NL",47.50513,-52.79476,2018-10-20 15:00:00,32,1,33
"15788",10401,"Mount Pearl","NL",47.50513,-52.79476,2018-10-20 16:00:00,32,1,33
"15789",10401,"Mount Pearl","NL",47.50513,-52.79476,2018-10-20 17:00:00,31,0,31
"15790",10401,"Mount Pearl","NL",47.50513,-52.79476,2018-10-20 18:00:00,33,0,33
"15791",10401,"Mount Pearl","NL",47.50513,-52.79476,2018-10-20 19:00:00,34,1,35
"15792",10401,"Mount Pearl","NL",47.50513,-52.79476,2018-10-20 20:00:00,34,1,35
"15793",10401,"Mount Pearl","NL",47.50513,-52.79476,2018-10-20 21:00:00,34,0,34
"15794",10401,"Mount Pearl","NL",47.50513,-52.79476,2018-10-20 22:00:00,33,0,33
"15795",10401,"Mount Pearl","NL",47.50513,-52.79476,2018-10-20 23:00:00,32,0,32
"15796",10401,"Mount Pearl","NL",47.50513,-52.79476,2018-10-21 00:00:00,32,0,32
"15797",10401,"Mount Pearl","NL",47.50513,-52.79476,2018-10-21 01:00:00,33,0,33
"15798",10401,"Mount Pearl","NL",47.50513,-52.79476,2018-10-21 02:00:00,33,1,34
"15799",10401,"Mount Pearl","NL",47.50513,-52.79476,2018-10-21 03:00:00,33,0,33
"15800",10401,"Mount Pearl","NL",47.50513,-52.79476,2018-10-21 04:00:00,33,0,33
"15801",10401,"Mount Pearl","NL",47.50513,-52.79476,2018-10-21 05:00:00,33,1,34
"15802",10401,"Mount Pearl","NL",47.50513,-52.79476,2018-10-21 06:00:00,33,0,33
"15803",10401,"Mount Pearl","NL",47.50513,-52.79476,2018-10-21 07:00:00,33,0,33
"15804",10401,"Mount Pearl","NL",47.50513,-52.79476,2018-10-21 08:00:00,32,0,32
"15805",10401,"Mount Pearl","NL",47.50513,-52.79476,2018-10-21 09:00:00,32,0,32
"15806",10401,"Mount Pearl","NL",47.50513,-52.79476,2018-10-21 10:00:00,31,0,31
"15807",10401,"Mount Pearl","NL",47.50513,-52.79476,2018-10-21 11:00:00,31,1,32
"15808",10401,"Mount Pearl","NL",47.50513,-52.79476,2018-10-21 12:00:00,30,0,30
"15809",10401,"Mount Pearl","NL",47.50513,-52.79476,2018-10-21 13:00:00,31,0,31
"15810",10401,"Mount Pearl","NL",47.50513,-52.79476,2018-10-21 14:00:00,32,0,32
"15811",10401,"Mount Pearl","NL",47.50513,-52.79476,2018-10-21 15:00:00,32,0,32
"15812",10401,"Mount Pearl","NL",47.50513,-52.79476,2018-10-21 16:00:00,33,0,33
"15813",10401,"Mount Pearl","NL",47.50513,-52.79476,2018-10-21 17:00:00,33,0,33
"15814",10401,"Mount Pearl","NL",47.50513,-52.79476,2018-10-21 18:00:00,35,0,35
"15815",10401,"Mount Pearl","NL",47.50513,-52.79476,2018-10-21 19:00:00,35,0,35
"15816",10401,"Mount Pearl","NL",47.50513,-52.79476,2018-10-21 20:00:00,35,1,36
"15817",10401,"Mount Pearl","NL",47.50513,-52.79476,2018-10-21 21:00:00,34,0,34
"15818",10401,"Mount Pearl","NL",47.50513,-52.79476,2018-10-21 22:00:00,33,0,33
"15819",10401,"Mount Pearl","NL",47.50513,-52.79476,2018-10-21 23:00:00,33,1,34
"15820",10401,"Mount Pearl","NL",47.50513,-52.79476,2018-10-22 00:00:00,33,0,33
"15821",10401,"Mount Pearl","NL",47.50513,-52.79476,2018-10-22 01:00:00,33,0,33
"15822",10401,"Mount Pearl","NL",47.50513,-52.79476,2018-10-22 02:00:00,33,0,33
"15823",10401,"Mount Pearl","NL",47.50513,-52.79476,2018-10-22 03:00:00,32,0,32
"15824",10401,"Mount Pearl","NL",47.50513,-52.79476,2018-10-22 04:00:00,33,0,33
"15825",10401,"Mount Pearl","NL",47.50513,-52.79476,2018-10-22 05:00:00,32,0,32
"15826",10401,"Mount Pearl","NL",47.50513,-52.79476,2018-10-22 06:00:00,32,0,32
"15827",10401,"Mount Pearl","NL",47.50513,-52.79476,2018-10-22 07:00:00,29,1,30
"15828",10401,"Mount Pearl","NL",47.50513,-52.79476,2018-10-22 08:00:00,31,0,31
"15829",10401,"Mount Pearl","NL",47.50513,-52.79476,2018-10-22 09:00:00,31,1,32
"15830",10401,"Mount Pearl","NL",47.50513,-52.79476,2018-10-22 10:00:00,31,0,31
"15831",10401,"Mount Pearl","NL",47.50513,-52.79476,2018-10-22 11:00:00,28,1,29
"15832",10401,"Mount Pearl","NL",47.50513,-52.79476,2018-10-22 12:00:00,23,2,25
"15833",10401,"Mount Pearl","NL",47.50513,-52.79476,2018-10-22 13:00:00,23,2,25
"15834",10401,"Mount Pearl","NL",47.50513,-52.79476,2018-10-22 14:00:00,23,2,25
"15835",10401,"Mount Pearl","NL",47.50513,-52.79476,2018-10-22 15:00:00,23,1,24
"15836",10401,"Mount Pearl","NL",47.50513,-52.79476,2018-10-22 16:00:00,21,1,22
"15837",10401,"Mount Pearl","NL",47.50513,-52.79476,2018-10-22 17:00:00,19,2,21
"15838",10401,"Mount Pearl","NL",47.50513,-52.79476,2018-10-22 18:00:00,19,2,21
"15839",10401,"Mount Pearl","NL",47.50513,-52.79476,2018-10-22 19:00:00,18,2,20
"15840",10401,"Mount Pearl","NL",47.50513,-52.79476,2018-10-22 20:00:00,22,1,23
"15841",10401,"Mount Pearl","NL",47.50513,-52.79476,2018-10-22 21:00:00,22,1,23
"15842",10401,"Mount Pearl","NL",47.50513,-52.79476,2018-10-22 22:00:00,23,1,24
"15843",10401,"Mount Pearl","NL",47.50513,-52.79476,2018-10-22 23:00:00,21,1,22
"15844",10401,"Mount Pearl","NL",47.50513,-52.79476,2018-10-23 00:00:00,20,0,20
"15845",10401,"Mount Pearl","NL",47.50513,-52.79476,2018-10-23 01:00:00,17,1,18
"15846",10401,"Mount Pearl","NL",47.50513,-52.79476,2018-10-23 02:00:00,20,1,21
"15847",10401,"Mount Pearl","NL",47.50513,-52.79476,2018-10-23 03:00:00,24,0,24
"15848",10401,"Mount Pearl","NL",47.50513,-52.79476,2018-10-23 04:00:00,25,1,26
"15849",10401,"Mount Pearl","NL",47.50513,-52.79476,2018-10-23 05:00:00,23,0,23
"15850",10401,"Mount Pearl","NL",47.50513,-52.79476,2018-10-23 06:00:00,26,1,27
"15851",10401,"Mount Pearl","NL",47.50513,-52.79476,2018-10-23 07:00:00,19,4,23
"15852",10401,"Mount Pearl","NL",47.50513,-52.79476,2018-10-23 08:00:00,22,2,24
"15853",10401,"Mount Pearl","NL",47.50513,-52.79476,2018-10-23 09:00:00,24,1,25
"15854",10401,"Mount Pearl","NL",47.50513,-52.79476,2018-10-23 10:00:00,24,1,25
"15855",10401,"Mount Pearl","NL",47.50513,-52.79476,2018-10-23 11:00:00,26,1,27
"15856",10401,"Mount Pearl","NL",47.50513,-52.79476,2018-10-23 12:00:00,29,1,30
"15857",10401,"Mount Pearl","NL",47.50513,-52.79476,2018-10-23 13:00:00,29,1,30
"15858",10401,"Mount Pearl","NL",47.50513,-52.79476,2018-10-23 14:00:00,28,1,29
"15859",10401,"Mount Pearl","NL",47.50513,-52.79476,2018-10-23 15:00:00,29,1,30
"15860",10401,"Mount Pearl","NL",47.50513,-52.79476,2018-10-23 16:00:00,29,1,30
"15861",10401,"Mount Pearl","NL",47.50513,-52.79476,2018-10-23 17:00:00,29,2,31
"15862",10401,"Mount Pearl","NL",47.50513,-52.79476,2018-10-23 18:00:00,24,3,27
"15863",10401,"Mount Pearl","NL",47.50513,-52.79476,2018-10-23 19:00:00,23,3,26
"15864",10401,"Mount Pearl","NL",47.50513,-52.79476,2018-10-23 20:00:00,24,1,25
"15865",10401,"Mount Pearl","NL",47.50513,-52.79476,2018-10-23 21:00:00,18,2,20
"15866",10401,"Mount Pearl","NL",47.50513,-52.79476,2018-10-23 22:00:00,18,2,20
"15867",10401,"Mount Pearl","NL",47.50513,-52.79476,2018-10-23 23:00:00,24,1,25
"15868",10401,"Mount Pearl","NL",47.50513,-52.79476,2018-10-24 00:00:00,22,1,23
"15869",10401,"Mount Pearl","NL",47.50513,-52.79476,2018-10-24 01:00:00,21,1,22
"15870",10401,"Mount Pearl","NL",47.50513,-52.79476,2018-10-24 02:00:00,15,2,17
"15871",10401,"Mount Pearl","NL",47.50513,-52.79476,2018-10-24 03:00:00,11,1,12
"15872",10401,"Mount Pearl","NL",47.50513,-52.79476,2018-10-24 04:00:00,10,2,12
"15873",10401,"Mount Pearl","NL",47.50513,-52.79476,2018-10-24 05:00:00,6,4,10
"15874",10401,"Mount Pearl","NL",47.50513,-52.79476,2018-10-24 06:00:00,7,4,11
"15875",10401,"Mount Pearl","NL",47.50513,-52.79476,2018-10-24 07:00:00,9,6,15
"15876",10401,"Mount Pearl","NL",47.50513,-52.79476,2018-10-24 08:00:00,7,10,17
"15877",10401,"Mount Pearl","NL",47.50513,-52.79476,2018-10-24 09:00:00,19,5,24
"15878",10401,"Mount Pearl","NL",47.50513,-52.79476,2018-10-24 10:00:00,27,2,29
"15879",10401,"Mount Pearl","NL",47.50513,-52.79476,2018-10-24 11:00:00,31,1,32
"15880",10401,"Mount Pearl","NL",47.50513,-52.79476,2018-10-24 12:00:00,32,1,33
"15881",10401,"Mount Pearl","NL",47.50513,-52.79476,2018-10-24 13:00:00,32,1,33
"15882",10401,"Mount Pearl","NL",47.50513,-52.79476,2018-10-24 14:00:00,33,1,34
"15883",10401,"Mount Pearl","NL",47.50513,-52.79476,2018-10-24 15:00:00,33,1,34
"15884",10401,"Mount Pearl","NL",47.50513,-52.79476,2018-10-24 16:00:00,32,1,33
"15885",10401,"Mount Pearl","NL",47.50513,-52.79476,2018-10-24 17:00:00,32,1,33
"15886",10401,"Mount Pearl","NL",47.50513,-52.79476,2018-10-24 18:00:00,32,2,34
"15887",10401,"Mount Pearl","NL",47.50513,-52.79476,2018-10-24 19:00:00,33,1,34
"15888",10401,"Mount Pearl","NL",47.50513,-52.79476,2018-10-24 20:00:00,34,1,35
"15889",10401,"Mount Pearl","NL",47.50513,-52.79476,2018-10-24 21:00:00,34,1,35
"15890",10401,"Mount Pearl","NL",47.50513,-52.79476,2018-10-24 22:00:00,35,1,36
"15891",10401,"Mount Pearl","NL",47.50513,-52.79476,2018-10-24 23:00:00,35,1,36
"15892",10401,"Mount Pearl","NL",47.50513,-52.79476,2018-10-25 00:00:00,35,1,36
"15893",10401,"Mount Pearl","NL",47.50513,-52.79476,2018-10-25 01:00:00,35,1,36
"15894",10401,"Mount Pearl","NL",47.50513,-52.79476,2018-10-25 02:00:00,35,1,36
"15895",10401,"Mount Pearl","NL",47.50513,-52.79476,2018-10-25 03:00:00,34,0,34
"15896",10401,"Mount Pearl","NL",47.50513,-52.79476,2018-10-25 04:00:00,32,1,33
"15897",10401,"Mount Pearl","NL",47.50513,-52.79476,2018-10-25 05:00:00,32,1,33
"15898",10401,"Mount Pearl","NL",47.50513,-52.79476,2018-10-25 06:00:00,32,1,33
"15899",10401,"Mount Pearl","NL",47.50513,-52.79476,2018-10-25 07:00:00,32,1,33
"15900",10401,"Mount Pearl","NL",47.50513,-52.79476,2018-10-25 08:00:00,31,2,33
"15901",10401,"Mount Pearl","NL",47.50513,-52.79476,2018-10-25 09:00:00,31,2,33
"15902",10401,"Mount Pearl","NL",47.50513,-52.79476,2018-10-25 10:00:00,31,1,32
"15903",10401,"Mount Pearl","NL",47.50513,-52.79476,2018-10-25 11:00:00,31,1,32
"15904",10401,"Mount Pearl","NL",47.50513,-52.79476,2018-10-25 12:00:00,29,0,29
"15905",10401,"Mount Pearl","NL",47.50513,-52.79476,2018-10-25 13:00:00,29,1,30
"15906",10401,"Mount Pearl","NL",47.50513,-52.79476,2018-10-25 14:00:00,28,1,29
"15907",10401,"Mount Pearl","NL",47.50513,-52.79476,2018-10-25 15:00:00,28,1,29
"15908",10401,"Mount Pearl","NL",47.50513,-52.79476,2018-10-25 16:00:00,28,1,29
"15909",10401,"Mount Pearl","NL",47.50513,-52.79476,2018-10-25 17:00:00,27,2,29
"15910",10401,"Mount Pearl","NL",47.50513,-52.79476,2018-10-25 18:00:00,25,1,26
"15911",10401,"Mount Pearl","NL",47.50513,-52.79476,2018-10-25 19:00:00,23,1,24
"15912",10401,"Mount Pearl","NL",47.50513,-52.79476,2018-10-25 20:00:00,19,1,20
"15913",10401,"Mount Pearl","NL",47.50513,-52.79476,2018-10-25 21:00:00,24,1,25
"15914",10401,"Mount Pearl","NL",47.50513,-52.79476,2018-10-25 22:00:00,32,0,32
"15915",10401,"Mount Pearl","NL",47.50513,-52.79476,2018-10-25 23:00:00,29,2,31
"15916",10401,"Mount Pearl","NL",47.50513,-52.79476,2018-10-26 00:00:00,28,2,30
"15917",10401,"Mount Pearl","NL",47.50513,-52.79476,2018-10-26 01:00:00,29,1,30
"15918",10401,"Mount Pearl","NL",47.50513,-52.79476,2018-10-26 02:00:00,29,0,29
"15919",10401,"Mount Pearl","NL",47.50513,-52.79476,2018-10-26 03:00:00,29,1,30
"15920",10401,"Mount Pearl","NL",47.50513,-52.79476,2018-10-26 04:00:00,29,0,29
"15921",10401,"Mount Pearl","NL",47.50513,-52.79476,2018-10-26 05:00:00,28,0,28
"15922",10401,"Mount Pearl","NL",47.50513,-52.79476,2018-10-26 06:00:00,26,0,26
"15923",10401,"Mount Pearl","NL",47.50513,-52.79476,2018-10-26 07:00:00,23,2,25
"15924",10401,"Mount Pearl","NL",47.50513,-52.79476,2018-10-26 08:00:00,21,1,22
"15925",10401,"Mount Pearl","NL",47.50513,-52.79476,2018-10-26 09:00:00,19,8,27
"15926",10401,"Mount Pearl","NL",47.50513,-52.79476,2018-10-26 10:00:00,20,2,22
"15927",10401,"Mount Pearl","NL",47.50513,-52.79476,2018-10-26 11:00:00,21,6,27
"15928",10401,"Mount Pearl","NL",47.50513,-52.79476,2018-10-26 12:00:00,25,2,27
"15929",10401,"Mount Pearl","NL",47.50513,-52.79476,2018-10-26 13:00:00,28,4,32
"15930",10401,"Mount Pearl","NL",47.50513,-52.79476,2018-10-26 14:00:00,28,5,33
"15931",10401,"Mount Pearl","NL",47.50513,-52.79476,2018-10-26 15:00:00,28,5,33
"15932",10401,"Mount Pearl","NL",47.50513,-52.79476,2018-10-26 16:00:00,27,6,33
"15933",10401,"Mount Pearl","NL",47.50513,-52.79476,2018-10-26 17:00:00,26,7,33
"15934",10401,"Mount Pearl","NL",47.50513,-52.79476,2018-10-26 18:00:00,28,1,29
"15935",10401,"Mount Pearl","NL",47.50513,-52.79476,2018-10-26 19:00:00,27,2,29
"15936",10401,"Mount Pearl","NL",47.50513,-52.79476,2018-10-26 20:00:00,27,1,28
"15937",10401,"Mount Pearl","NL",47.50513,-52.79476,2018-10-26 21:00:00,30,1,31
"15938",10401,"Mount Pearl","NL",47.50513,-52.79476,2018-10-26 22:00:00,31,1,32
"15939",10401,"Mount Pearl","NL",47.50513,-52.79476,2018-10-26 23:00:00,27,1,28
"15940",10401,"Mount Pearl","NL",47.50513,-52.79476,2018-10-27 00:00:00,27,1,28
"15941",10401,"Mount Pearl","NL",47.50513,-52.79476,2018-10-27 01:00:00,27,1,28
"15942",10401,"Mount Pearl","NL",47.50513,-52.79476,2018-10-27 02:00:00,27,1,28
"15943",10401,"Mount Pearl","NL",47.50513,-52.79476,2018-10-27 03:00:00,28,1,29
"15944",10401,"Mount Pearl","NL",47.50513,-52.79476,2018-10-27 04:00:00,29,1,30
"15945",10401,"Mount Pearl","NL",47.50513,-52.79476,2018-10-27 05:00:00,26,1,27
"15946",10401,"Mount Pearl","NL",47.50513,-52.79476,2018-10-27 06:00:00,29,1,30
"15947",10401,"Mount Pearl","NL",47.50513,-52.79476,2018-10-27 07:00:00,28,2,30
"15948",10401,"Mount Pearl","NL",47.50513,-52.79476,2018-10-27 08:00:00,29,3,32
"15949",10401,"Mount Pearl","NL",47.50513,-52.79476,2018-10-27 09:00:00,29,4,33
"15950",10401,"Mount Pearl","NL",47.50513,-52.79476,2018-10-27 10:00:00,30,2,32
"15951",10401,"Mount Pearl","NL",47.50513,-52.79476,2018-10-27 11:00:00,31,2,33
"15952",10401,"Mount Pearl","NL",47.50513,-52.79476,2018-10-27 12:00:00,34,0,34
"15953",10401,"Mount Pearl","NL",47.50513,-52.79476,2018-10-27 13:00:00,34,0,34
"15954",10401,"Mount Pearl","NL",47.50513,-52.79476,2018-10-27 14:00:00,34,1,35
"15955",10401,"Mount Pearl","NL",47.50513,-52.79476,2018-10-27 15:00:00,34,0,34
"15956",10401,"Mount Pearl","NL",47.50513,-52.79476,2018-10-27 16:00:00,34,0,34
"15957",10401,"Mount Pearl","NL",47.50513,-52.79476,2018-10-27 17:00:00,34,0,34
"15958",10401,"Mount Pearl","NL",47.50513,-52.79476,2018-10-27 18:00:00,32,1,33
"15959",10401,"Mount Pearl","NL",47.50513,-52.79476,2018-10-27 19:00:00,32,0,32
"15960",10401,"Mount Pearl","NL",47.50513,-52.79476,2018-10-27 20:00:00,29,1,30
"15961",10401,"Mount Pearl","NL",47.50513,-52.79476,2018-10-27 21:00:00,27,1,28
"15962",10401,"Mount Pearl","NL",47.50513,-52.79476,2018-10-27 22:00:00,20,2,22
"15963",10401,"Mount Pearl","NL",47.50513,-52.79476,2018-10-27 23:00:00,22,0,22
"15964",10401,"Mount Pearl","NL",47.50513,-52.79476,2018-10-28 00:00:00,23,0,23
"15965",10401,"Mount Pearl","NL",47.50513,-52.79476,2018-10-28 01:00:00,17,2,19
"15966",10401,"Mount Pearl","NL",47.50513,-52.79476,2018-10-28 02:00:00,13,2,15
"15967",10401,"Mount Pearl","NL",47.50513,-52.79476,2018-10-28 03:00:00,11,3,14
"15968",10401,"Mount Pearl","NL",47.50513,-52.79476,2018-10-28 04:00:00,7,4,11
"15969",10401,"Mount Pearl","NL",47.50513,-52.79476,2018-10-28 05:00:00,10,2,12
"15970",10401,"Mount Pearl","NL",47.50513,-52.79476,2018-10-28 06:00:00,13,2,15
"15971",10401,"Mount Pearl","NL",47.50513,-52.79476,2018-10-28 07:00:00,13,2,15
"15972",10401,"Mount Pearl","NL",47.50513,-52.79476,2018-10-28 08:00:00,10,6,16
"15973",10401,"Mount Pearl","NL",47.50513,-52.79476,2018-10-28 09:00:00,20,4,24
"15974",10401,"Mount Pearl","NL",47.50513,-52.79476,2018-10-28 10:00:00,31,1,32
"15975",10401,"Mount Pearl","NL",47.50513,-52.79476,2018-10-28 11:00:00,31,1,32
"15976",10401,"Mount Pearl","NL",47.50513,-52.79476,2018-10-28 12:00:00,31,0,31
"15977",10401,"Mount Pearl","NL",47.50513,-52.79476,2018-10-28 13:00:00,30,0,30
"15978",10401,"Mount Pearl","NL",47.50513,-52.79476,2018-10-28 14:00:00,29,1,30
"15979",10401,"Mount Pearl","NL",47.50513,-52.79476,2018-10-28 15:00:00,31,1,32
"15980",10401,"Mount Pearl","NL",47.50513,-52.79476,2018-10-28 16:00:00,31,1,32
"15981",10401,"Mount Pearl","NL",47.50513,-52.79476,2018-10-28 17:00:00,32,1,33
"15982",10401,"Mount Pearl","NL",47.50513,-52.79476,2018-10-28 18:00:00,32,0,32
"15983",10401,"Mount Pearl","NL",47.50513,-52.79476,2018-10-28 19:00:00,33,0,33
"15984",10401,"Mount Pearl","NL",47.50513,-52.79476,2018-10-28 20:00:00,34,0,34
"15985",10401,"Mount Pearl","NL",47.50513,-52.79476,2018-10-28 21:00:00,35,0,35
"15986",10401,"Mount Pearl","NL",47.50513,-52.79476,2018-10-28 22:00:00,36,0,36
"15987",10401,"Mount Pearl","NL",47.50513,-52.79476,2018-10-28 23:00:00,36,0,36
"15988",10401,"Mount Pearl","NL",47.50513,-52.79476,2018-10-29 00:00:00,36,1,37
"15989",10401,"Mount Pearl","NL",47.50513,-52.79476,2018-10-29 01:00:00,36,0,36
"15990",10401,"Mount Pearl","NL",47.50513,-52.79476,2018-10-29 02:00:00,36,0,36
"15991",10401,"Mount Pearl","NL",47.50513,-52.79476,2018-10-29 03:00:00,36,0,36
"15992",10401,"Mount Pearl","NL",47.50513,-52.79476,2018-10-29 04:00:00,36,0,36
"15993",10401,"Mount Pearl","NL",47.50513,-52.79476,2018-10-29 05:00:00,34,0,34
"15994",10401,"Mount Pearl","NL",47.50513,-52.79476,2018-10-29 06:00:00,33,1,34
"15995",10401,"Mount Pearl","NL",47.50513,-52.79476,2018-10-29 07:00:00,29,1,30
"15996",10401,"Mount Pearl","NL",47.50513,-52.79476,2018-10-29 08:00:00,24,15,39
"15997",10401,"Mount Pearl","NL",47.50513,-52.79476,2018-10-29 09:00:00,24,5,29
"15998",10401,"Mount Pearl","NL",47.50513,-52.79476,2018-10-29 10:00:00,24,2,26
"15999",10401,"Mount Pearl","NL",47.50513,-52.79476,2018-10-29 11:00:00,25,2,27
"16000",10401,"Mount Pearl","NL",47.50513,-52.79476,2018-10-29 12:00:00,24,3,27
"16001",10401,"Mount Pearl","NL",47.50513,-52.79476,2018-10-29 13:00:00,24,5,29
"16002",10401,"Mount Pearl","NL",47.50513,-52.79476,2018-10-29 14:00:00,23,5,28
"16003",10401,"Mount Pearl","NL",47.50513,-52.79476,2018-10-29 15:00:00,27,1,28
"16004",10401,"Mount Pearl","NL",47.50513,-52.79476,2018-10-29 16:00:00,26,5,31
"16005",10401,"Mount Pearl","NL",47.50513,-52.79476,2018-10-29 17:00:00,27,1,28
"16006",10401,"Mount Pearl","NL",47.50513,-52.79476,2018-10-29 18:00:00,27,1,28
"16007",10401,"Mount Pearl","NL",47.50513,-52.79476,2018-10-29 19:00:00,26,1,27
"16008",10401,"Mount Pearl","NL",47.50513,-52.79476,2018-10-29 20:00:00,25,1,26
"16009",10401,"Mount Pearl","NL",47.50513,-52.79476,2018-10-29 21:00:00,23,2,25
"16010",10401,"Mount Pearl","NL",47.50513,-52.79476,2018-10-29 22:00:00,21,1,22
"16011",10401,"Mount Pearl","NL",47.50513,-52.79476,2018-10-29 23:00:00,18,1,19
"16012",10401,"Mount Pearl","NL",47.50513,-52.79476,2018-10-30 00:00:00,17,1,18
"16013",10401,"Mount Pearl","NL",47.50513,-52.79476,2018-10-30 01:00:00,16,1,17
"16014",10401,"Mount Pearl","NL",47.50513,-52.79476,2018-10-30 02:00:00,17,1,18
"16015",10401,"Mount Pearl","NL",47.50513,-52.79476,2018-10-30 03:00:00,14,1,15
"16016",10401,"Mount Pearl","NL",47.50513,-52.79476,2018-10-30 04:00:00,10,1,11
"16017",10401,"Mount Pearl","NL",47.50513,-52.79476,2018-10-30 05:00:00,10,2,12
"16018",10401,"Mount Pearl","NL",47.50513,-52.79476,2018-10-30 06:00:00,19,2,21
"16019",10401,"Mount Pearl","NL",47.50513,-52.79476,2018-10-30 07:00:00,20,4,24
"16020",10401,"Mount Pearl","NL",47.50513,-52.79476,2018-10-30 08:00:00,16,8,24
"16021",10401,"Mount Pearl","NL",47.50513,-52.79476,2018-10-30 09:00:00,9,8,17
"16022",10401,"Mount Pearl","NL",47.50513,-52.79476,2018-10-30 10:00:00,9,3,12
"16023",10401,"Mount Pearl","NL",47.50513,-52.79476,2018-10-30 11:00:00,18,NA,NA
"16024",10401,"Mount Pearl","NL",47.50513,-52.79476,2018-10-30 12:00:00,15,NA,NA
"16025",10401,"Mount Pearl","NL",47.50513,-52.79476,2018-10-30 13:00:00,12,NA,NA
"16026",10401,"Mount Pearl","NL",47.50513,-52.79476,2018-10-30 14:00:00,15,NA,NA
"16027",10401,"Mount Pearl","NL",47.50513,-52.79476,2018-10-30 15:00:00,15,NA,NA
"16028",10401,"Mount Pearl","NL",47.50513,-52.79476,2018-10-30 16:00:00,20,NA,NA
"16029",10401,"Mount Pearl","NL",47.50513,-52.79476,2018-10-30 17:00:00,26,2,28
"16030",10401,"Mount Pearl","NL",47.50513,-52.79476,2018-10-30 18:00:00,32,1,33
"16031",10401,"Mount Pearl","NL",47.50513,-52.79476,2018-10-30 19:00:00,36,0,36
"16032",10401,"Mount Pearl","NL",47.50513,-52.79476,2018-10-30 20:00:00,33,0,33
"16033",10401,"Mount Pearl","NL",47.50513,-52.79476,2018-10-30 21:00:00,29,1,30
"16034",10401,"Mount Pearl","NL",47.50513,-52.79476,2018-10-30 22:00:00,30,1,31
"16035",10401,"Mount Pearl","NL",47.50513,-52.79476,2018-10-30 23:00:00,29,1,30
"16036",10401,"Mount Pearl","NL",47.50513,-52.79476,2018-10-31 00:00:00,28,1,29
"16037",10401,"Mount Pearl","NL",47.50513,-52.79476,2018-10-31 01:00:00,24,0,24
"16038",10401,"Mount Pearl","NL",47.50513,-52.79476,2018-10-31 02:00:00,18,2,20
"16039",10401,"Mount Pearl","NL",47.50513,-52.79476,2018-10-31 03:00:00,16,1,17
"16040",10401,"Mount Pearl","NL",47.50513,-52.79476,2018-10-31 04:00:00,15,1,16
"16041",10401,"Mount Pearl","NL",47.50513,-52.79476,2018-10-31 05:00:00,15,1,16
"16042",10401,"Mount Pearl","NL",47.50513,-52.79476,2018-10-31 06:00:00,16,1,17
"16043",10401,"Mount Pearl","NL",47.50513,-52.79476,2018-10-31 07:00:00,14,1,15
"16044",10401,"Mount Pearl","NL",47.50513,-52.79476,2018-10-31 08:00:00,14,1,15
"16045",10401,"Mount Pearl","NL",47.50513,-52.79476,2018-10-31 09:00:00,17,2,19
"16046",10401,"Mount Pearl","NL",47.50513,-52.79476,2018-10-31 10:00:00,21,1,22
"16047",10401,"Mount Pearl","NL",47.50513,-52.79476,2018-10-31 11:00:00,24,1,25
"16048",10401,"Mount Pearl","NL",47.50513,-52.79476,2018-10-31 12:00:00,26,1,27
"16049",10401,"Mount Pearl","NL",47.50513,-52.79476,2018-10-31 13:00:00,27,3,30
"16050",10401,"Mount Pearl","NL",47.50513,-52.79476,2018-10-31 14:00:00,26,3,29
"16051",10401,"Mount Pearl","NL",47.50513,-52.79476,2018-10-31 15:00:00,30,3,33
"16052",10401,"Mount Pearl","NL",47.50513,-52.79476,2018-10-31 16:00:00,33,1,34
"16053",10401,"Mount Pearl","NL",47.50513,-52.79476,2018-10-31 17:00:00,34,1,35
"16054",10401,"Mount Pearl","NL",47.50513,-52.79476,2018-10-31 18:00:00,35,2,37
"16055",10401,"Mount Pearl","NL",47.50513,-52.79476,2018-10-31 19:00:00,36,1,37
"16056",10401,"Mount Pearl","NL",47.50513,-52.79476,2018-10-31 20:00:00,36,0,36
"16057",10401,"Mount Pearl","NL",47.50513,-52.79476,2018-10-31 21:00:00,37,1,38
"16058",10401,"Mount Pearl","NL",47.50513,-52.79476,2018-10-31 22:00:00,37,1,38
"16059",10401,"Mount Pearl","NL",47.50513,-52.79476,2018-10-31 23:00:00,38,1,39
"16060",10401,"Mount Pearl","NL",47.50513,-52.79476,2018-11-01 00:00:00,37,1,38
"16061",10401,"Mount Pearl","NL",47.50513,-52.79476,2018-11-01 01:00:00,38,1,39
"16062",10401,"Mount Pearl","NL",47.50513,-52.79476,2018-11-01 02:00:00,37,1,38
"16063",10401,"Mount Pearl","NL",47.50513,-52.79476,2018-11-01 03:00:00,37,1,38
"16064",10401,"Mount Pearl","NL",47.50513,-52.79476,2018-11-01 04:00:00,37,0,37
"16065",10401,"Mount Pearl","NL",47.50513,-52.79476,2018-11-01 05:00:00,37,0,37
"16066",10401,"Mount Pearl","NL",47.50513,-52.79476,2018-11-01 06:00:00,37,1,38
"16067",10401,"Mount Pearl","NL",47.50513,-52.79476,2018-11-01 07:00:00,37,1,38
"16068",10401,"Mount Pearl","NL",47.50513,-52.79476,2018-11-01 08:00:00,36,2,38
"16069",10401,"Mount Pearl","NL",47.50513,-52.79476,2018-11-01 09:00:00,35,1,36
"16070",10401,"Mount Pearl","NL",47.50513,-52.79476,2018-11-01 10:00:00,35,2,37
"16071",10401,"Mount Pearl","NL",47.50513,-52.79476,2018-11-01 11:00:00,36,2,38
"16072",10401,"Mount Pearl","NL",47.50513,-52.79476,2018-11-01 12:00:00,36,1,37
"16073",10401,"Mount Pearl","NL",47.50513,-52.79476,2018-11-01 13:00:00,36,1,37
"16074",10401,"Mount Pearl","NL",47.50513,-52.79476,2018-11-01 14:00:00,36,1,37
"16075",10401,"Mount Pearl","NL",47.50513,-52.79476,2018-11-01 15:00:00,36,1,37
"16076",10401,"Mount Pearl","NL",47.50513,-52.79476,2018-11-01 16:00:00,34,1,35
"16077",10401,"Mount Pearl","NL",47.50513,-52.79476,2018-11-01 17:00:00,33,2,35
"16078",10401,"Mount Pearl","NL",47.50513,-52.79476,2018-11-01 18:00:00,32,2,34
"16079",10401,"Mount Pearl","NL",47.50513,-52.79476,2018-11-01 19:00:00,29,1,30
"16080",10401,"Mount Pearl","NL",47.50513,-52.79476,2018-11-01 20:00:00,23,1,24
"16081",10401,"Mount Pearl","NL",47.50513,-52.79476,2018-11-01 21:00:00,21,1,22
"16082",10401,"Mount Pearl","NL",47.50513,-52.79476,2018-11-01 22:00:00,20,1,21
"16083",10401,"Mount Pearl","NL",47.50513,-52.79476,2018-11-01 23:00:00,20,1,21
"16084",10401,"Mount Pearl","NL",47.50513,-52.79476,2018-11-02 00:00:00,26,0,26
"16085",10401,"Mount Pearl","NL",47.50513,-52.79476,2018-11-02 01:00:00,22,0,22
"16086",10401,"Mount Pearl","NL",47.50513,-52.79476,2018-11-02 02:00:00,16,1,17
"16087",10401,"Mount Pearl","NL",47.50513,-52.79476,2018-11-02 03:00:00,17,1,18
"16088",10401,"Mount Pearl","NL",47.50513,-52.79476,2018-11-02 04:00:00,12,0,12
"16089",10401,"Mount Pearl","NL",47.50513,-52.79476,2018-11-02 05:00:00,12,0,12
"16090",10401,"Mount Pearl","NL",47.50513,-52.79476,2018-11-02 06:00:00,16,1,17
"16091",10401,"Mount Pearl","NL",47.50513,-52.79476,2018-11-02 07:00:00,18,2,20
"16092",10401,"Mount Pearl","NL",47.50513,-52.79476,2018-11-02 08:00:00,17,3,20
"16093",10401,"Mount Pearl","NL",47.50513,-52.79476,2018-11-02 09:00:00,19,1,20
"16094",10401,"Mount Pearl","NL",47.50513,-52.79476,2018-11-02 10:00:00,22,2,24
"16095",10401,"Mount Pearl","NL",47.50513,-52.79476,2018-11-02 11:00:00,22,1,23
"16096",10401,"Mount Pearl","NL",47.50513,-52.79476,2018-11-02 12:00:00,22,1,23
"16097",10401,"Mount Pearl","NL",47.50513,-52.79476,2018-11-02 13:00:00,21,1,22
"16098",10401,"Mount Pearl","NL",47.50513,-52.79476,2018-11-02 14:00:00,20,1,21
"16099",10401,"Mount Pearl","NL",47.50513,-52.79476,2018-11-02 15:00:00,20,1,21
"16100",10401,"Mount Pearl","NL",47.50513,-52.79476,2018-11-02 16:00:00,20,2,22
"16101",10401,"Mount Pearl","NL",47.50513,-52.79476,2018-11-02 17:00:00,18,3,21
"16102",10401,"Mount Pearl","NL",47.50513,-52.79476,2018-11-02 18:00:00,17,1,18
"16103",10401,"Mount Pearl","NL",47.50513,-52.79476,2018-11-02 19:00:00,15,1,16
"16104",10401,"Mount Pearl","NL",47.50513,-52.79476,2018-11-02 20:00:00,16,1,17
"16105",10401,"Mount Pearl","NL",47.50513,-52.79476,2018-11-02 21:00:00,15,1,16
"16106",10401,"Mount Pearl","NL",47.50513,-52.79476,2018-11-02 22:00:00,15,1,16
"16107",10401,"Mount Pearl","NL",47.50513,-52.79476,2018-11-02 23:00:00,14,1,15
"16108",10401,"Mount Pearl","NL",47.50513,-52.79476,2018-11-03 00:00:00,15,1,16
"16109",10401,"Mount Pearl","NL",47.50513,-52.79476,2018-11-03 01:00:00,17,0,17
"16110",10401,"Mount Pearl","NL",47.50513,-52.79476,2018-11-03 02:00:00,24,0,24
"16111",10401,"Mount Pearl","NL",47.50513,-52.79476,2018-11-03 03:00:00,26,1,27
"16112",10401,"Mount Pearl","NL",47.50513,-52.79476,2018-11-03 04:00:00,28,1,29
"16113",10401,"Mount Pearl","NL",47.50513,-52.79476,2018-11-03 05:00:00,28,2,30
"16114",10401,"Mount Pearl","NL",47.50513,-52.79476,2018-11-03 06:00:00,24,1,25
"16115",10401,"Mount Pearl","NL",47.50513,-52.79476,2018-11-03 07:00:00,22,1,23
"16116",10401,"Mount Pearl","NL",47.50513,-52.79476,2018-11-03 08:00:00,20,3,23
"16117",10401,"Mount Pearl","NL",47.50513,-52.79476,2018-11-03 09:00:00,19,2,21
"16118",10401,"Mount Pearl","NL",47.50513,-52.79476,2018-11-03 10:00:00,21,1,22
"16119",10401,"Mount Pearl","NL",47.50513,-52.79476,2018-11-03 11:00:00,23,1,24
"16120",10401,"Mount Pearl","NL",47.50513,-52.79476,2018-11-03 12:00:00,28,0,28
"16121",10401,"Mount Pearl","NL",47.50513,-52.79476,2018-11-03 13:00:00,30,1,31
"16122",10401,"Mount Pearl","NL",47.50513,-52.79476,2018-11-03 14:00:00,28,1,29
"16123",10401,"Mount Pearl","NL",47.50513,-52.79476,2018-11-03 15:00:00,27,0,27
"16124",10401,"Mount Pearl","NL",47.50513,-52.79476,2018-11-03 16:00:00,26,0,26
"16125",10401,"Mount Pearl","NL",47.50513,-52.79476,2018-11-03 17:00:00,26,0,26
"16126",10401,"Mount Pearl","NL",47.50513,-52.79476,2018-11-03 18:00:00,26,1,27
"16127",10401,"Mount Pearl","NL",47.50513,-52.79476,2018-11-03 19:00:00,25,0,25
"16128",10401,"Mount Pearl","NL",47.50513,-52.79476,2018-11-03 20:00:00,26,1,27
"16129",10401,"Mount Pearl","NL",47.50513,-52.79476,2018-11-03 21:00:00,33,1,34
"16130",10401,"Mount Pearl","NL",47.50513,-52.79476,2018-11-03 22:00:00,33,1,34
"16131",10401,"Mount Pearl","NL",47.50513,-52.79476,2018-11-03 23:00:00,33,0,33
"16132",10401,"Mount Pearl","NL",47.50513,-52.79476,2018-11-04 00:00:00,32,1,33
"16133",10401,"Mount Pearl","NL",47.50513,-52.79476,2018-11-04 01:00:00,31,1,32
"16134",10401,"Mount Pearl","NL",47.50513,-52.79476,2018-11-04 02:00:00,31,1,32
"16135",10401,"Mount Pearl","NL",47.50513,-52.79476,2018-11-04 03:00:00,33,1,34
"16136",10401,"Mount Pearl","NL",47.50513,-52.79476,2018-11-04 04:00:00,34,1,35
"16137",10401,"Mount Pearl","NL",47.50513,-52.79476,2018-11-04 05:00:00,35,1,36
"16138",10401,"Mount Pearl","NL",47.50513,-52.79476,2018-11-04 06:00:00,41,1,42
"16139",10401,"Mount Pearl","NL",47.50513,-52.79476,2018-11-04 07:00:00,38,1,39
"16140",10401,"Mount Pearl","NL",47.50513,-52.79476,2018-11-04 08:00:00,33,2,35
"16141",10401,"Mount Pearl","NL",47.50513,-52.79476,2018-11-04 09:00:00,26,1,27
"16142",10401,"Mount Pearl","NL",47.50513,-52.79476,2018-11-04 10:00:00,23,1,24
"16143",10401,"Mount Pearl","NL",47.50513,-52.79476,2018-11-04 11:00:00,19,1,20
"16144",10401,"Mount Pearl","NL",47.50513,-52.79476,2018-11-04 12:00:00,17,0,17
"16145",10401,"Mount Pearl","NL",47.50513,-52.79476,2018-11-04 13:00:00,16,0,16
"16146",10401,"Mount Pearl","NL",47.50513,-52.79476,2018-11-04 14:00:00,14,0,14
"16147",10401,"Mount Pearl","NL",47.50513,-52.79476,2018-11-04 15:00:00,14,1,15
"16148",10401,"Mount Pearl","NL",47.50513,-52.79476,2018-11-04 16:00:00,17,0,17
"16149",10401,"Mount Pearl","NL",47.50513,-52.79476,2018-11-04 17:00:00,20,1,21
"16150",10401,"Mount Pearl","NL",47.50513,-52.79476,2018-11-04 18:00:00,21,1,22
"16151",10401,"Mount Pearl","NL",47.50513,-52.79476,2018-11-04 19:00:00,22,1,23
"16152",10401,"Mount Pearl","NL",47.50513,-52.79476,2018-11-04 20:00:00,21,0,21
"16153",10401,"Mount Pearl","NL",47.50513,-52.79476,2018-11-04 21:00:00,23,1,24
"16154",10401,"Mount Pearl","NL",47.50513,-52.79476,2018-11-04 22:00:00,24,1,25
"16155",10401,"Mount Pearl","NL",47.50513,-52.79476,2018-11-04 23:00:00,25,1,26
"16156",10401,"Mount Pearl","NL",47.50513,-52.79476,2018-11-05 00:00:00,25,1,26
"16157",10401,"Mount Pearl","NL",47.50513,-52.79476,2018-11-05 01:00:00,25,1,26
"16158",10401,"Mount Pearl","NL",47.50513,-52.79476,2018-11-05 02:00:00,24,1,25
"16159",10401,"Mount Pearl","NL",47.50513,-52.79476,2018-11-05 03:00:00,25,1,26
"16160",10401,"Mount Pearl","NL",47.50513,-52.79476,2018-11-05 04:00:00,27,1,28
"16161",10401,"Mount Pearl","NL",47.50513,-52.79476,2018-11-05 05:00:00,29,0,29
"16162",10401,"Mount Pearl","NL",47.50513,-52.79476,2018-11-05 06:00:00,29,1,30
"16163",10401,"Mount Pearl","NL",47.50513,-52.79476,2018-11-05 07:00:00,30,0,30
"16164",10401,"Mount Pearl","NL",47.50513,-52.79476,2018-11-05 08:00:00,28,1,29
"16165",10401,"Mount Pearl","NL",47.50513,-52.79476,2018-11-05 09:00:00,28,1,29
"16166",10401,"Mount Pearl","NL",47.50513,-52.79476,2018-11-05 10:00:00,29,2,31
"16167",10401,"Mount Pearl","NL",47.50513,-52.79476,2018-11-05 11:00:00,30,0,30
"16168",10401,"Mount Pearl","NL",47.50513,-52.79476,2018-11-05 12:00:00,27,4,31
"16169",10401,"Mount Pearl","NL",47.50513,-52.79476,2018-11-05 13:00:00,29,1,30
"16170",10401,"Mount Pearl","NL",47.50513,-52.79476,2018-11-05 14:00:00,30,1,31
"16171",10401,"Mount Pearl","NL",47.50513,-52.79476,2018-11-05 15:00:00,29,1,30
"16172",10401,"Mount Pearl","NL",47.50513,-52.79476,2018-11-05 16:00:00,29,2,31
"16173",10401,"Mount Pearl","NL",47.50513,-52.79476,2018-11-05 17:00:00,27,3,30
"16174",10401,"Mount Pearl","NL",47.50513,-52.79476,2018-11-05 18:00:00,23,5,28
"16175",10401,"Mount Pearl","NL",47.50513,-52.79476,2018-11-05 19:00:00,18,7,25
"16176",10401,"Mount Pearl","NL",47.50513,-52.79476,2018-11-05 20:00:00,17,5,22
"16177",10401,"Mount Pearl","NL",47.50513,-52.79476,2018-11-05 21:00:00,18,4,22
"16178",10401,"Mount Pearl","NL",47.50513,-52.79476,2018-11-05 22:00:00,12,7,19
"16179",10401,"Mount Pearl","NL",47.50513,-52.79476,2018-11-05 23:00:00,19,3,22
"16180",10401,"Mount Pearl","NL",47.50513,-52.79476,2018-11-06 00:00:00,21,2,23
"16181",10401,"Mount Pearl","NL",47.50513,-52.79476,2018-11-06 01:00:00,19,2,21
"16182",10401,"Mount Pearl","NL",47.50513,-52.79476,2018-11-06 02:00:00,17,3,20
"16183",10401,"Mount Pearl","NL",47.50513,-52.79476,2018-11-06 03:00:00,16,2,18
"16184",10401,"Mount Pearl","NL",47.50513,-52.79476,2018-11-06 04:00:00,16,2,18
"16185",10401,"Mount Pearl","NL",47.50513,-52.79476,2018-11-06 05:00:00,16,2,18
"16186",10401,"Mount Pearl","NL",47.50513,-52.79476,2018-11-06 06:00:00,17,3,20
"16187",10401,"Mount Pearl","NL",47.50513,-52.79476,2018-11-06 07:00:00,13,5,18
"16188",10401,"Mount Pearl","NL",47.50513,-52.79476,2018-11-06 08:00:00,6,12,18
"16189",10401,"Mount Pearl","NL",47.50513,-52.79476,2018-11-06 09:00:00,16,8,24
"16190",10401,"Mount Pearl","NL",47.50513,-52.79476,2018-11-06 10:00:00,22,6,28
"16191",10401,"Mount Pearl","NL",47.50513,-52.79476,2018-11-06 11:00:00,21,6,27
"16192",10401,"Mount Pearl","NL",47.50513,-52.79476,2018-11-06 12:00:00,22,4,26
"16193",10401,"Mount Pearl","NL",47.50513,-52.79476,2018-11-06 13:00:00,22,4,26
"16194",10401,"Mount Pearl","NL",47.50513,-52.79476,2018-11-06 14:00:00,23,3,26
"16195",10401,"Mount Pearl","NL",47.50513,-52.79476,2018-11-06 15:00:00,26,2,28
"16196",10401,"Mount Pearl","NL",47.50513,-52.79476,2018-11-06 16:00:00,22,7,29
"16197",10401,"Mount Pearl","NL",47.50513,-52.79476,2018-11-06 17:00:00,14,10,24
"16198",10401,"Mount Pearl","NL",47.50513,-52.79476,2018-11-06 18:00:00,7,15,22
"16199",10401,"Mount Pearl","NL",47.50513,-52.79476,2018-11-06 19:00:00,15,6,21
"16200",10401,"Mount Pearl","NL",47.50513,-52.79476,2018-11-06 20:00:00,20,3,23
"16201",10401,"Mount Pearl","NL",47.50513,-52.79476,2018-11-06 21:00:00,22,2,24
"16202",10401,"Mount Pearl","NL",47.50513,-52.79476,2018-11-06 22:00:00,23,2,25
"16203",10401,"Mount Pearl","NL",47.50513,-52.79476,2018-11-06 23:00:00,25,1,26
"16204",10401,"Mount Pearl","NL",47.50513,-52.79476,2018-11-07 00:00:00,27,1,28
"16205",10401,"Mount Pearl","NL",47.50513,-52.79476,2018-11-07 01:00:00,31,0,31
"16206",10401,"Mount Pearl","NL",47.50513,-52.79476,2018-11-07 02:00:00,32,1,33
"16207",10401,"Mount Pearl","NL",47.50513,-52.79476,2018-11-07 03:00:00,31,0,31
"16208",10401,"Mount Pearl","NL",47.50513,-52.79476,2018-11-07 04:00:00,32,0,32
"16209",10401,"Mount Pearl","NL",47.50513,-52.79476,2018-11-07 05:00:00,32,0,32
"16210",10401,"Mount Pearl","NL",47.50513,-52.79476,2018-11-07 06:00:00,31,0,31
"16211",10401,"Mount Pearl","NL",47.50513,-52.79476,2018-11-07 07:00:00,32,1,33
"16212",10401,"Mount Pearl","NL",47.50513,-52.79476,2018-11-07 08:00:00,31,1,32
"16213",10401,"Mount Pearl","NL",47.50513,-52.79476,2018-11-07 09:00:00,29,7,36
"16214",10401,"Mount Pearl","NL",47.50513,-52.79476,2018-11-07 10:00:00,25,12,37
"16215",10401,"Mount Pearl","NL",47.50513,-52.79476,2018-11-07 11:00:00,24,16,40
"16216",10401,"Mount Pearl","NL",47.50513,-52.79476,2018-11-07 12:00:00,24,18,42
"16217",10401,"Mount Pearl","NL",47.50513,-52.79476,2018-11-07 13:00:00,28,13,41
"16218",10401,"Mount Pearl","NL",47.50513,-52.79476,2018-11-07 14:00:00,28,10,38
"16219",10401,"Mount Pearl","NL",47.50513,-52.79476,2018-11-07 15:00:00,27,14,41
"16220",10401,"Mount Pearl","NL",47.50513,-52.79476,2018-11-07 16:00:00,24,25,49
"16221",10401,"Mount Pearl","NL",47.50513,-52.79476,2018-11-07 17:00:00,23,36,59
"16222",10401,"Mount Pearl","NL",47.50513,-52.79476,2018-11-07 18:00:00,31,9,40
"16223",10401,"Mount Pearl","NL",47.50513,-52.79476,2018-11-07 19:00:00,31,3,34
"16224",10401,"Mount Pearl","NL",47.50513,-52.79476,2018-11-07 20:00:00,30,3,33
"16225",10401,"Mount Pearl","NL",47.50513,-52.79476,2018-11-07 21:00:00,30,3,33
"16226",10401,"Mount Pearl","NL",47.50513,-52.79476,2018-11-07 22:00:00,29,2,31
"16227",10401,"Mount Pearl","NL",47.50513,-52.79476,2018-11-07 23:00:00,29,1,30
"16228",10401,"Mount Pearl","NL",47.50513,-52.79476,2018-11-08 00:00:00,30,1,31
"16229",10401,"Mount Pearl","NL",47.50513,-52.79476,2018-11-08 01:00:00,33,1,34
"16230",10401,"Mount Pearl","NL",47.50513,-52.79476,2018-11-08 02:00:00,31,2,33
"16231",10401,"Mount Pearl","NL",47.50513,-52.79476,2018-11-08 03:00:00,29,1,30
"16232",10401,"Mount Pearl","NL",47.50513,-52.79476,2018-11-08 04:00:00,28,1,29
"16233",10401,"Mount Pearl","NL",47.50513,-52.79476,2018-11-08 05:00:00,27,2,29
"16234",10401,"Mount Pearl","NL",47.50513,-52.79476,2018-11-08 06:00:00,26,2,28
"16235",10401,"Mount Pearl","NL",47.50513,-52.79476,2018-11-08 07:00:00,26,2,28
"16236",10401,"Mount Pearl","NL",47.50513,-52.79476,2018-11-08 08:00:00,20,18,38
"16237",10401,"Mount Pearl","NL",47.50513,-52.79476,2018-11-08 09:00:00,16,17,33
"16238",10401,"Mount Pearl","NL",47.50513,-52.79476,2018-11-08 10:00:00,19,11,30
"16239",10401,"Mount Pearl","NL",47.50513,-52.79476,2018-11-08 11:00:00,21,3,24
"16240",10401,"Mount Pearl","NL",47.50513,-52.79476,2018-11-08 12:00:00,20,1,21
"16241",10401,"Mount Pearl","NL",47.50513,-52.79476,2018-11-08 13:00:00,20,1,21
"16242",10401,"Mount Pearl","NL",47.50513,-52.79476,2018-11-08 14:00:00,20,1,21
"16243",10401,"Mount Pearl","NL",47.50513,-52.79476,2018-11-08 15:00:00,22,1,23
"16244",10401,"Mount Pearl","NL",47.50513,-52.79476,2018-11-08 16:00:00,20,1,21
"16245",10401,"Mount Pearl","NL",47.50513,-52.79476,2018-11-08 17:00:00,20,1,21
"16246",10401,"Mount Pearl","NL",47.50513,-52.79476,2018-11-08 18:00:00,19,0,19
"16247",10401,"Mount Pearl","NL",47.50513,-52.79476,2018-11-08 19:00:00,19,0,19
"16248",10401,"Mount Pearl","NL",47.50513,-52.79476,2018-11-08 20:00:00,18,1,19
"16249",10401,"Mount Pearl","NL",47.50513,-52.79476,2018-11-08 21:00:00,17,1,18
"16250",10401,"Mount Pearl","NL",47.50513,-52.79476,2018-11-08 22:00:00,17,1,18
"16251",10401,"Mount Pearl","NL",47.50513,-52.79476,2018-11-08 23:00:00,17,0,17
"16252",10401,"Mount Pearl","NL",47.50513,-52.79476,2018-11-09 00:00:00,16,0,16
"16253",10401,"Mount Pearl","NL",47.50513,-52.79476,2018-11-09 01:00:00,15,1,16
"16254",10401,"Mount Pearl","NL",47.50513,-52.79476,2018-11-09 02:00:00,15,1,16
"16255",10401,"Mount Pearl","NL",47.50513,-52.79476,2018-11-09 03:00:00,15,0,15
"16256",10401,"Mount Pearl","NL",47.50513,-52.79476,2018-11-09 04:00:00,14,1,15
"16257",10401,"Mount Pearl","NL",47.50513,-52.79476,2018-11-09 05:00:00,15,0,15
"16258",10401,"Mount Pearl","NL",47.50513,-52.79476,2018-11-09 06:00:00,15,0,15
"16259",10401,"Mount Pearl","NL",47.50513,-52.79476,2018-11-09 07:00:00,14,1,15
"16260",10401,"Mount Pearl","NL",47.50513,-52.79476,2018-11-09 08:00:00,13,2,15
"16261",10401,"Mount Pearl","NL",47.50513,-52.79476,2018-11-09 09:00:00,14,1,15
"16262",10401,"Mount Pearl","NL",47.50513,-52.79476,2018-11-09 10:00:00,15,1,16
"16263",10401,"Mount Pearl","NL",47.50513,-52.79476,2018-11-09 11:00:00,16,1,17
"16264",10401,"Mount Pearl","NL",47.50513,-52.79476,2018-11-09 12:00:00,16,2,18
"16265",10401,"Mount Pearl","NL",47.50513,-52.79476,2018-11-09 13:00:00,17,2,19
"16266",10401,"Mount Pearl","NL",47.50513,-52.79476,2018-11-09 14:00:00,19,2,21
"16267",10401,"Mount Pearl","NL",47.50513,-52.79476,2018-11-09 15:00:00,20,2,22
"16268",10401,"Mount Pearl","NL",47.50513,-52.79476,2018-11-09 16:00:00,19,2,21
"16269",10401,"Mount Pearl","NL",47.50513,-52.79476,2018-11-09 17:00:00,19,3,22
"16270",10401,"Mount Pearl","NL",47.50513,-52.79476,2018-11-09 18:00:00,18,2,20
"16271",10401,"Mount Pearl","NL",47.50513,-52.79476,2018-11-09 19:00:00,18,2,20
"16272",10401,"Mount Pearl","NL",47.50513,-52.79476,2018-11-09 20:00:00,20,2,22
"16273",10401,"Mount Pearl","NL",47.50513,-52.79476,2018-11-09 21:00:00,21,1,22
"16274",10401,"Mount Pearl","NL",47.50513,-52.79476,2018-11-09 22:00:00,25,1,26
"16275",10401,"Mount Pearl","NL",47.50513,-52.79476,2018-11-09 23:00:00,27,2,29
"16276",10401,"Mount Pearl","NL",47.50513,-52.79476,2018-11-10 00:00:00,30,1,31
"16277",10401,"Mount Pearl","NL",47.50513,-52.79476,2018-11-10 01:00:00,31,1,32
"16278",10401,"Mount Pearl","NL",47.50513,-52.79476,2018-11-10 02:00:00,31,1,32
"16279",10401,"Mount Pearl","NL",47.50513,-52.79476,2018-11-10 03:00:00,30,0,30
"16280",10401,"Mount Pearl","NL",47.50513,-52.79476,2018-11-10 04:00:00,30,2,32
"16281",10401,"Mount Pearl","NL",47.50513,-52.79476,2018-11-10 05:00:00,29,1,30
"16282",10401,"Mount Pearl","NL",47.50513,-52.79476,2018-11-10 06:00:00,28,1,29
"16283",10401,"Mount Pearl","NL",47.50513,-52.79476,2018-11-10 07:00:00,28,2,30
"16284",10401,"Mount Pearl","NL",47.50513,-52.79476,2018-11-10 08:00:00,25,3,28
"16285",10401,"Mount Pearl","NL",47.50513,-52.79476,2018-11-10 09:00:00,25,3,28
"16286",10401,"Mount Pearl","NL",47.50513,-52.79476,2018-11-10 10:00:00,28,2,30
"16287",10401,"Mount Pearl","NL",47.50513,-52.79476,2018-11-10 11:00:00,27,2,29
"16288",10401,"Mount Pearl","NL",47.50513,-52.79476,2018-11-10 12:00:00,28,2,30
"16289",10401,"Mount Pearl","NL",47.50513,-52.79476,2018-11-10 13:00:00,29,2,31
"16290",10401,"Mount Pearl","NL",47.50513,-52.79476,2018-11-10 14:00:00,28,3,31
"16291",10401,"Mount Pearl","NL",47.50513,-52.79476,2018-11-10 15:00:00,28,3,31
"16292",10401,"Mount Pearl","NL",47.50513,-52.79476,2018-11-10 16:00:00,28,4,32
"16293",10401,"Mount Pearl","NL",47.50513,-52.79476,2018-11-10 17:00:00,30,3,33
"16294",10401,"Mount Pearl","NL",47.50513,-52.79476,2018-11-10 18:00:00,32,2,34
"16295",10401,"Mount Pearl","NL",47.50513,-52.79476,2018-11-10 19:00:00,33,2,35
"16296",10401,"Mount Pearl","NL",47.50513,-52.79476,2018-11-10 20:00:00,34,2,36
"16297",10401,"Mount Pearl","NL",47.50513,-52.79476,2018-11-10 21:00:00,35,1,36
"16298",10401,"Mount Pearl","NL",47.50513,-52.79476,2018-11-10 22:00:00,35,1,36
"16299",10401,"Mount Pearl","NL",47.50513,-52.79476,2018-11-10 23:00:00,34,2,36
"16300",10401,"Mount Pearl","NL",47.50513,-52.79476,2018-11-11 00:00:00,33,1,34
"16301",10401,"Mount Pearl","NL",47.50513,-52.79476,2018-11-11 01:00:00,31,2,33
"16302",10401,"Mount Pearl","NL",47.50513,-52.79476,2018-11-11 02:00:00,29,1,30
"16303",10401,"Mount Pearl","NL",47.50513,-52.79476,2018-11-11 03:00:00,28,1,29
"16304",10401,"Mount Pearl","NL",47.50513,-52.79476,2018-11-11 04:00:00,27,1,28
"16305",10401,"Mount Pearl","NL",47.50513,-52.79476,2018-11-11 05:00:00,26,1,27
"16306",10401,"Mount Pearl","NL",47.50513,-52.79476,2018-11-11 06:00:00,28,2,30
"16307",10401,"Mount Pearl","NL",47.50513,-52.79476,2018-11-11 07:00:00,30,2,32
"16308",10401,"Mount Pearl","NL",47.50513,-52.79476,2018-11-11 08:00:00,28,2,30
"16309",10401,"Mount Pearl","NL",47.50513,-52.79476,2018-11-11 09:00:00,27,2,29
"16310",10401,"Mount Pearl","NL",47.50513,-52.79476,2018-11-11 10:00:00,28,3,31
"16311",10401,"Mount Pearl","NL",47.50513,-52.79476,2018-11-11 11:00:00,27,2,29
"16312",10401,"Mount Pearl","NL",47.50513,-52.79476,2018-11-11 12:00:00,23,2,25
"16313",10401,"Mount Pearl","NL",47.50513,-52.79476,2018-11-11 13:00:00,24,1,25
"16314",10401,"Mount Pearl","NL",47.50513,-52.79476,2018-11-11 14:00:00,23,1,24
"16315",10401,"Mount Pearl","NL",47.50513,-52.79476,2018-11-11 15:00:00,22,2,24
"16316",10401,"Mount Pearl","NL",47.50513,-52.79476,2018-11-11 16:00:00,22,1,23
"16317",10401,"Mount Pearl","NL",47.50513,-52.79476,2018-11-11 17:00:00,23,1,24
"16318",10401,"Mount Pearl","NL",47.50513,-52.79476,2018-11-11 18:00:00,23,1,24
"16319",10401,"Mount Pearl","NL",47.50513,-52.79476,2018-11-11 19:00:00,22,2,24
"16320",10401,"Mount Pearl","NL",47.50513,-52.79476,2018-11-11 20:00:00,22,1,23
"16321",10401,"Mount Pearl","NL",47.50513,-52.79476,2018-11-11 21:00:00,23,1,24
"16322",10401,"Mount Pearl","NL",47.50513,-52.79476,2018-11-11 22:00:00,24,1,25
"16323",10401,"Mount Pearl","NL",47.50513,-52.79476,2018-11-11 23:00:00,25,1,26
"16324",10401,"Mount Pearl","NL",47.50513,-52.79476,2018-11-12 00:00:00,26,1,27
"16325",10401,"Mount Pearl","NL",47.50513,-52.79476,2018-11-12 01:00:00,28,1,29
"16326",10401,"Mount Pearl","NL",47.50513,-52.79476,2018-11-12 02:00:00,30,1,31
"16327",10401,"Mount Pearl","NL",47.50513,-52.79476,2018-11-12 03:00:00,30,1,31
"16328",10401,"Mount Pearl","NL",47.50513,-52.79476,2018-11-12 04:00:00,30,1,31
"16329",10401,"Mount Pearl","NL",47.50513,-52.79476,2018-11-12 05:00:00,29,1,30
"16330",10401,"Mount Pearl","NL",47.50513,-52.79476,2018-11-12 06:00:00,29,2,31
"16331",10401,"Mount Pearl","NL",47.50513,-52.79476,2018-11-12 07:00:00,29,2,31
"16332",10401,"Mount Pearl","NL",47.50513,-52.79476,2018-11-12 08:00:00,31,1,32
"16333",10401,"Mount Pearl","NL",47.50513,-52.79476,2018-11-12 09:00:00,31,1,32
"16334",10401,"Mount Pearl","NL",47.50513,-52.79476,2018-11-12 10:00:00,30,2,32
"16335",10401,"Mount Pearl","NL",47.50513,-52.79476,2018-11-12 11:00:00,31,1,32
"16336",10401,"Mount Pearl","NL",47.50513,-52.79476,2018-11-12 12:00:00,32,1,33
"16337",10401,"Mount Pearl","NL",47.50513,-52.79476,2018-11-12 13:00:00,31,1,32
"16338",10401,"Mount Pearl","NL",47.50513,-52.79476,2018-11-12 14:00:00,32,1,33
"16339",10401,"Mount Pearl","NL",47.50513,-52.79476,2018-11-12 15:00:00,32,2,34
"16340",10401,"Mount Pearl","NL",47.50513,-52.79476,2018-11-12 16:00:00,31,2,33
"16341",10401,"Mount Pearl","NL",47.50513,-52.79476,2018-11-12 17:00:00,33,1,34
"16342",10401,"Mount Pearl","NL",47.50513,-52.79476,2018-11-12 18:00:00,33,2,35
"16343",10401,"Mount Pearl","NL",47.50513,-52.79476,2018-11-12 19:00:00,35,2,37
"16344",10401,"Mount Pearl","NL",47.50513,-52.79476,2018-11-12 20:00:00,34,1,35
"16345",10401,"Mount Pearl","NL",47.50513,-52.79476,2018-11-12 21:00:00,35,1,36
"16346",10401,"Mount Pearl","NL",47.50513,-52.79476,2018-11-12 22:00:00,35,1,36
"16347",10401,"Mount Pearl","NL",47.50513,-52.79476,2018-11-12 23:00:00,35,1,36
"16348",10401,"Mount Pearl","NL",47.50513,-52.79476,2018-11-13 00:00:00,34,2,36
"16349",10401,"Mount Pearl","NL",47.50513,-52.79476,2018-11-13 01:00:00,33,2,35
"16350",10401,"Mount Pearl","NL",47.50513,-52.79476,2018-11-13 02:00:00,33,1,34
"16351",10401,"Mount Pearl","NL",47.50513,-52.79476,2018-11-13 03:00:00,32,1,33
"16352",10401,"Mount Pearl","NL",47.50513,-52.79476,2018-11-13 04:00:00,31,1,32
"16353",10401,"Mount Pearl","NL",47.50513,-52.79476,2018-11-13 05:00:00,31,1,32
"16354",10401,"Mount Pearl","NL",47.50513,-52.79476,2018-11-13 06:00:00,31,1,32
"16355",10401,"Mount Pearl","NL",47.50513,-52.79476,2018-11-13 07:00:00,31,2,33
"16356",10401,"Mount Pearl","NL",47.50513,-52.79476,2018-11-13 08:00:00,29,3,32
"16357",10401,"Mount Pearl","NL",47.50513,-52.79476,2018-11-13 09:00:00,30,2,32
"16358",10401,"Mount Pearl","NL",47.50513,-52.79476,2018-11-13 10:00:00,31,2,33
"16359",10401,"Mount Pearl","NL",47.50513,-52.79476,2018-11-13 11:00:00,31,1,32
"16360",10401,"Mount Pearl","NL",47.50513,-52.79476,2018-11-13 12:00:00,30,1,31
"16361",10401,"Mount Pearl","NL",47.50513,-52.79476,2018-11-13 13:00:00,30,0,30
"16362",10401,"Mount Pearl","NL",47.50513,-52.79476,2018-11-13 14:00:00,30,0,30
"16363",10401,"Mount Pearl","NL",47.50513,-52.79476,2018-11-13 15:00:00,30,1,31
"16364",10401,"Mount Pearl","NL",47.50513,-52.79476,2018-11-13 16:00:00,30,2,32
"16365",10401,"Mount Pearl","NL",47.50513,-52.79476,2018-11-13 17:00:00,30,2,32
"16366",10401,"Mount Pearl","NL",47.50513,-52.79476,2018-11-13 18:00:00,30,2,32
"16367",10401,"Mount Pearl","NL",47.50513,-52.79476,2018-11-13 19:00:00,30,1,31
"16368",10401,"Mount Pearl","NL",47.50513,-52.79476,2018-11-13 20:00:00,30,1,31
"16369",10401,"Mount Pearl","NL",47.50513,-52.79476,2018-11-13 21:00:00,27,2,29
"16370",10401,"Mount Pearl","NL",47.50513,-52.79476,2018-11-13 22:00:00,22,2,24
"16371",10401,"Mount Pearl","NL",47.50513,-52.79476,2018-11-13 23:00:00,20,2,22
"16372",10401,"Mount Pearl","NL",47.50513,-52.79476,2018-11-14 00:00:00,22,1,23
"16373",10401,"Mount Pearl","NL",47.50513,-52.79476,2018-11-14 01:00:00,23,0,23
"16374",10401,"Mount Pearl","NL",47.50513,-52.79476,2018-11-14 02:00:00,25,1,26
"16375",10401,"Mount Pearl","NL",47.50513,-52.79476,2018-11-14 03:00:00,27,1,28
"16376",10401,"Mount Pearl","NL",47.50513,-52.79476,2018-11-14 04:00:00,28,0,28
"16377",10401,"Mount Pearl","NL",47.50513,-52.79476,2018-11-14 05:00:00,33,0,33
"16378",10401,"Mount Pearl","NL",47.50513,-52.79476,2018-11-14 06:00:00,36,0,36
"16379",10401,"Mount Pearl","NL",47.50513,-52.79476,2018-11-14 07:00:00,36,0,36
"16380",10401,"Mount Pearl","NL",47.50513,-52.79476,2018-11-14 08:00:00,37,1,38
"16381",10401,"Mount Pearl","NL",47.50513,-52.79476,2018-11-14 09:00:00,36,1,37
"16382",10401,"Mount Pearl","NL",47.50513,-52.79476,2018-11-14 10:00:00,35,1,36
"16383",10401,"Mount Pearl","NL",47.50513,-52.79476,2018-11-14 11:00:00,34,0,34
"16384",10401,"Mount Pearl","NL",47.50513,-52.79476,2018-11-14 12:00:00,35,1,36
"16385",10401,"Mount Pearl","NL",47.50513,-52.79476,2018-11-14 13:00:00,32,1,33
"16386",10401,"Mount Pearl","NL",47.50513,-52.79476,2018-11-14 14:00:00,30,1,31
"16387",10401,"Mount Pearl","NL",47.50513,-52.79476,2018-11-14 15:00:00,28,2,30
"16388",10401,"Mount Pearl","NL",47.50513,-52.79476,2018-11-14 16:00:00,25,1,26
"16389",10401,"Mount Pearl","NL",47.50513,-52.79476,2018-11-14 17:00:00,26,2,28
"16390",10401,"Mount Pearl","NL",47.50513,-52.79476,2018-11-14 18:00:00,28,1,29
"16391",10401,"Mount Pearl","NL",47.50513,-52.79476,2018-11-14 19:00:00,28,1,29
"16392",10401,"Mount Pearl","NL",47.50513,-52.79476,2018-11-14 20:00:00,28,1,29
"16393",10401,"Mount Pearl","NL",47.50513,-52.79476,2018-11-14 21:00:00,28,2,30
"16394",10401,"Mount Pearl","NL",47.50513,-52.79476,2018-11-14 22:00:00,29,2,31
"16395",10401,"Mount Pearl","NL",47.50513,-52.79476,2018-11-14 23:00:00,30,1,31
"16396",10401,"Mount Pearl","NL",47.50513,-52.79476,2018-11-15 00:00:00,31,0,31
"16397",10401,"Mount Pearl","NL",47.50513,-52.79476,2018-11-15 01:00:00,32,1,33
"16398",10401,"Mount Pearl","NL",47.50513,-52.79476,2018-11-15 02:00:00,34,0,34
"16399",10401,"Mount Pearl","NL",47.50513,-52.79476,2018-11-15 03:00:00,35,0,35
"16400",10401,"Mount Pearl","NL",47.50513,-52.79476,2018-11-15 04:00:00,35,1,36
"16401",10401,"Mount Pearl","NL",47.50513,-52.79476,2018-11-15 05:00:00,35,0,35
"16402",10401,"Mount Pearl","NL",47.50513,-52.79476,2018-11-15 06:00:00,35,1,36
"16403",10401,"Mount Pearl","NL",47.50513,-52.79476,2018-11-15 07:00:00,35,1,36
"16404",10401,"Mount Pearl","NL",47.50513,-52.79476,2018-11-15 08:00:00,34,1,35
"16405",10401,"Mount Pearl","NL",47.50513,-52.79476,2018-11-15 09:00:00,34,1,35
"16406",10401,"Mount Pearl","NL",47.50513,-52.79476,2018-11-15 10:00:00,34,1,35
"16407",10401,"Mount Pearl","NL",47.50513,-52.79476,2018-11-15 11:00:00,34,1,35
"16408",10401,"Mount Pearl","NL",47.50513,-52.79476,2018-11-15 12:00:00,33,0,33
"16409",10401,"Mount Pearl","NL",47.50513,-52.79476,2018-11-15 13:00:00,33,0,33
"16410",10401,"Mount Pearl","NL",47.50513,-52.79476,2018-11-15 14:00:00,33,0,33
"16411",10401,"Mount Pearl","NL",47.50513,-52.79476,2018-11-15 15:00:00,33,1,34
"16412",10401,"Mount Pearl","NL",47.50513,-52.79476,2018-11-15 16:00:00,33,0,33
"16413",10401,"Mount Pearl","NL",47.50513,-52.79476,2018-11-15 17:00:00,33,1,34
"16414",10401,"Mount Pearl","NL",47.50513,-52.79476,2018-11-15 18:00:00,34,1,35
"16415",10401,"Mount Pearl","NL",47.50513,-52.79476,2018-11-15 19:00:00,33,1,34
"16416",10401,"Mount Pearl","NL",47.50513,-52.79476,2018-11-15 20:00:00,33,1,34
"16417",10401,"Mount Pearl","NL",47.50513,-52.79476,2018-11-15 21:00:00,34,0,34
"16418",10401,"Mount Pearl","NL",47.50513,-52.79476,2018-11-15 22:00:00,34,0,34
"16419",10401,"Mount Pearl","NL",47.50513,-52.79476,2018-11-15 23:00:00,34,1,35
"16420",10401,"Mount Pearl","NL",47.50513,-52.79476,2018-11-16 00:00:00,34,0,34
"16421",10401,"Mount Pearl","NL",47.50513,-52.79476,2018-11-16 01:00:00,34,0,34
"16422",10401,"Mount Pearl","NL",47.50513,-52.79476,2018-11-16 02:00:00,34,0,34
"16423",10401,"Mount Pearl","NL",47.50513,-52.79476,2018-11-16 03:00:00,35,0,35
"16424",10401,"Mount Pearl","NL",47.50513,-52.79476,2018-11-16 04:00:00,35,0,35
"16425",10401,"Mount Pearl","NL",47.50513,-52.79476,2018-11-16 05:00:00,35,0,35
"16426",10401,"Mount Pearl","NL",47.50513,-52.79476,2018-11-16 06:00:00,35,1,36
"16427",10401,"Mount Pearl","NL",47.50513,-52.79476,2018-11-16 07:00:00,34,1,35
"16428",10401,"Mount Pearl","NL",47.50513,-52.79476,2018-11-16 08:00:00,33,1,34
"16429",10401,"Mount Pearl","NL",47.50513,-52.79476,2018-11-16 09:00:00,33,2,35
"16430",10401,"Mount Pearl","NL",47.50513,-52.79476,2018-11-16 10:00:00,34,1,35
"16431",10401,"Mount Pearl","NL",47.50513,-52.79476,2018-11-16 11:00:00,34,0,34
"16432",10401,"Mount Pearl","NL",47.50513,-52.79476,2018-11-16 12:00:00,33,2,35
"16433",10401,"Mount Pearl","NL",47.50513,-52.79476,2018-11-16 13:00:00,33,2,35
"16434",10401,"Mount Pearl","NL",47.50513,-52.79476,2018-11-16 14:00:00,33,2,35
"16435",10401,"Mount Pearl","NL",47.50513,-52.79476,2018-11-16 15:00:00,33,2,35
"16436",10401,"Mount Pearl","NL",47.50513,-52.79476,2018-11-16 16:00:00,32,3,35
"16437",10401,"Mount Pearl","NL",47.50513,-52.79476,2018-11-16 17:00:00,26,6,32
"16438",10401,"Mount Pearl","NL",47.50513,-52.79476,2018-11-16 18:00:00,15,14,29
"16439",10401,"Mount Pearl","NL",47.50513,-52.79476,2018-11-16 19:00:00,21,7,28
"16440",10401,"Mount Pearl","NL",47.50513,-52.79476,2018-11-16 20:00:00,27,4,31
"16441",10401,"Mount Pearl","NL",47.50513,-52.79476,2018-11-16 21:00:00,32,2,34
"16442",10401,"Mount Pearl","NL",47.50513,-52.79476,2018-11-16 22:00:00,35,1,36
"16443",10401,"Mount Pearl","NL",47.50513,-52.79476,2018-11-16 23:00:00,36,2,38
"16444",10401,"Mount Pearl","NL",47.50513,-52.79476,2018-11-17 00:00:00,36,2,38
"16445",10401,"Mount Pearl","NL",47.50513,-52.79476,2018-11-17 01:00:00,36,1,37
"16446",10401,"Mount Pearl","NL",47.50513,-52.79476,2018-11-17 02:00:00,38,2,40
"16447",10401,"Mount Pearl","NL",47.50513,-52.79476,2018-11-17 03:00:00,38,1,39
"16448",10401,"Mount Pearl","NL",47.50513,-52.79476,2018-11-17 04:00:00,38,2,40
"16449",10401,"Mount Pearl","NL",47.50513,-52.79476,2018-11-17 05:00:00,37,1,38
"16450",10401,"Mount Pearl","NL",47.50513,-52.79476,2018-11-17 06:00:00,37,2,39
"16451",10401,"Mount Pearl","NL",47.50513,-52.79476,2018-11-17 07:00:00,37,2,39
"16452",10401,"Mount Pearl","NL",47.50513,-52.79476,2018-11-17 08:00:00,37,2,39
"16453",10401,"Mount Pearl","NL",47.50513,-52.79476,2018-11-17 09:00:00,36,4,40
"16454",10401,"Mount Pearl","NL",47.50513,-52.79476,2018-11-17 10:00:00,34,3,37
"16455",10401,"Mount Pearl","NL",47.50513,-52.79476,2018-11-17 11:00:00,34,2,36
"16456",10401,"Mount Pearl","NL",47.50513,-52.79476,2018-11-17 12:00:00,32,1,33
"16457",10401,"Mount Pearl","NL",47.50513,-52.79476,2018-11-17 13:00:00,31,1,32
"16458",10401,"Mount Pearl","NL",47.50513,-52.79476,2018-11-17 14:00:00,29,2,31
"16459",10401,"Mount Pearl","NL",47.50513,-52.79476,2018-11-17 15:00:00,32,1,33
"16460",10401,"Mount Pearl","NL",47.50513,-52.79476,2018-11-17 16:00:00,36,2,38
"16461",10401,"Mount Pearl","NL",47.50513,-52.79476,2018-11-17 17:00:00,35,1,36
"16462",10401,"Mount Pearl","NL",47.50513,-52.79476,2018-11-17 18:00:00,35,2,37
"16463",10401,"Mount Pearl","NL",47.50513,-52.79476,2018-11-17 19:00:00,34,2,36
"16464",10401,"Mount Pearl","NL",47.50513,-52.79476,2018-11-17 20:00:00,33,2,35
"16465",10401,"Mount Pearl","NL",47.50513,-52.79476,2018-11-17 21:00:00,32,1,33
"16466",10401,"Mount Pearl","NL",47.50513,-52.79476,2018-11-17 22:00:00,31,1,32
"16467",10401,"Mount Pearl","NL",47.50513,-52.79476,2018-11-17 23:00:00,31,1,32
"16468",10401,"Mount Pearl","NL",47.50513,-52.79476,2018-11-18 00:00:00,31,1,32
"16469",10401,"Mount Pearl","NL",47.50513,-52.79476,2018-11-18 01:00:00,31,2,33
"16470",10401,"Mount Pearl","NL",47.50513,-52.79476,2018-11-18 02:00:00,30,1,31
"16471",10401,"Mount Pearl","NL",47.50513,-52.79476,2018-11-18 03:00:00,29,1,30
"16472",10401,"Mount Pearl","NL",47.50513,-52.79476,2018-11-18 04:00:00,29,2,31
"16473",10401,"Mount Pearl","NL",47.50513,-52.79476,2018-11-18 05:00:00,30,1,31
"16474",10401,"Mount Pearl","NL",47.50513,-52.79476,2018-11-18 06:00:00,32,1,33
"16475",10401,"Mount Pearl","NL",47.50513,-52.79476,2018-11-18 07:00:00,32,1,33
"16476",10401,"Mount Pearl","NL",47.50513,-52.79476,2018-11-18 08:00:00,31,1,32
"16477",10401,"Mount Pearl","NL",47.50513,-52.79476,2018-11-18 09:00:00,31,2,33
"16478",10401,"Mount Pearl","NL",47.50513,-52.79476,2018-11-18 10:00:00,32,1,33
"16479",10401,"Mount Pearl","NL",47.50513,-52.79476,2018-11-18 11:00:00,32,1,33
"16480",10401,"Mount Pearl","NL",47.50513,-52.79476,2018-11-18 12:00:00,33,1,34
"16481",10401,"Mount Pearl","NL",47.50513,-52.79476,2018-11-18 13:00:00,33,1,34
"16482",10401,"Mount Pearl","NL",47.50513,-52.79476,2018-11-18 14:00:00,30,1,31
"16483",10401,"Mount Pearl","NL",47.50513,-52.79476,2018-11-18 15:00:00,29,1,30
"16484",10401,"Mount Pearl","NL",47.50513,-52.79476,2018-11-18 16:00:00,27,2,29
"16485",10401,"Mount Pearl","NL",47.50513,-52.79476,2018-11-18 17:00:00,26,2,28
"16486",10401,"Mount Pearl","NL",47.50513,-52.79476,2018-11-18 18:00:00,26,2,28
"16487",10401,"Mount Pearl","NL",47.50513,-52.79476,2018-11-18 19:00:00,27,1,28
"16488",10401,"Mount Pearl","NL",47.50513,-52.79476,2018-11-18 20:00:00,28,2,30
"16489",10401,"Mount Pearl","NL",47.50513,-52.79476,2018-11-18 21:00:00,29,1,30
"16490",10401,"Mount Pearl","NL",47.50513,-52.79476,2018-11-18 22:00:00,30,1,31
"16491",10401,"Mount Pearl","NL",47.50513,-52.79476,2018-11-18 23:00:00,31,0,31
"16492",10401,"Mount Pearl","NL",47.50513,-52.79476,2018-11-19 00:00:00,33,1,34
"16493",10401,"Mount Pearl","NL",47.50513,-52.79476,2018-11-19 01:00:00,33,1,34
"16494",10401,"Mount Pearl","NL",47.50513,-52.79476,2018-11-19 02:00:00,34,0,34
"16495",10401,"Mount Pearl","NL",47.50513,-52.79476,2018-11-19 03:00:00,34,1,35
"16496",10401,"Mount Pearl","NL",47.50513,-52.79476,2018-11-19 04:00:00,34,1,35
"16497",10401,"Mount Pearl","NL",47.50513,-52.79476,2018-11-19 05:00:00,34,1,35
"16498",10401,"Mount Pearl","NL",47.50513,-52.79476,2018-11-19 06:00:00,34,2,36
"16499",10401,"Mount Pearl","NL",47.50513,-52.79476,2018-11-19 07:00:00,30,6,36
"16500",10401,"Mount Pearl","NL",47.50513,-52.79476,2018-11-19 08:00:00,19,NA,NA
"16501",10401,"Mount Pearl","NL",47.50513,-52.79476,2018-11-19 09:00:00,19,NA,NA
"16502",10401,"Mount Pearl","NL",47.50513,-52.79476,2018-11-19 10:00:00,23,NA,NA
"16503",10401,"Mount Pearl","NL",47.50513,-52.79476,2018-11-19 11:00:00,30,3,33
"16504",10401,"Mount Pearl","NL",47.50513,-52.79476,2018-11-19 12:00:00,33,2,35
"16505",10401,"Mount Pearl","NL",47.50513,-52.79476,2018-11-19 13:00:00,24,23,47
"16506",10401,"Mount Pearl","NL",47.50513,-52.79476,2018-11-19 14:00:00,23,22,45
"16507",10401,"Mount Pearl","NL",47.50513,-52.79476,2018-11-19 15:00:00,29,15,44
"16508",10401,"Mount Pearl","NL",47.50513,-52.79476,2018-11-19 16:00:00,25,29,54
"16509",10401,"Mount Pearl","NL",47.50513,-52.79476,2018-11-19 17:00:00,26,28,54
"16510",10401,"Mount Pearl","NL",47.50513,-52.79476,2018-11-19 18:00:00,32,3,35
"16511",10401,"Mount Pearl","NL",47.50513,-52.79476,2018-11-19 19:00:00,30,2,32
"16512",10401,"Mount Pearl","NL",47.50513,-52.79476,2018-11-19 20:00:00,28,2,30
"16513",10401,"Mount Pearl","NL",47.50513,-52.79476,2018-11-19 21:00:00,29,1,30
"16514",10401,"Mount Pearl","NL",47.50513,-52.79476,2018-11-19 22:00:00,31,1,32
"16515",10401,"Mount Pearl","NL",47.50513,-52.79476,2018-11-19 23:00:00,33,2,35
"16516",10401,"Mount Pearl","NL",47.50513,-52.79476,2018-11-20 00:00:00,33,1,34
"16517",10401,"Mount Pearl","NL",47.50513,-52.79476,2018-11-20 01:00:00,34,1,35
"16518",10401,"Mount Pearl","NL",47.50513,-52.79476,2018-11-20 02:00:00,34,1,35
"16519",10401,"Mount Pearl","NL",47.50513,-52.79476,2018-11-20 03:00:00,32,1,33
"16520",10401,"Mount Pearl","NL",47.50513,-52.79476,2018-11-20 04:00:00,32,1,33
"16521",10401,"Mount Pearl","NL",47.50513,-52.79476,2018-11-20 05:00:00,33,1,34
"16522",10401,"Mount Pearl","NL",47.50513,-52.79476,2018-11-20 06:00:00,34,1,35
"16523",10401,"Mount Pearl","NL",47.50513,-52.79476,2018-11-20 07:00:00,34,2,36
"16524",10401,"Mount Pearl","NL",47.50513,-52.79476,2018-11-20 08:00:00,33,3,36
"16525",10401,"Mount Pearl","NL",47.50513,-52.79476,2018-11-20 09:00:00,33,2,35
"16526",10401,"Mount Pearl","NL",47.50513,-52.79476,2018-11-20 10:00:00,34,2,36
"16527",10401,"Mount Pearl","NL",47.50513,-52.79476,2018-11-20 11:00:00,34,2,36
"16528",10401,"Mount Pearl","NL",47.50513,-52.79476,2018-11-20 12:00:00,31,1,32
"16529",10401,"Mount Pearl","NL",47.50513,-52.79476,2018-11-20 13:00:00,29,1,30
"16530",10401,"Mount Pearl","NL",47.50513,-52.79476,2018-11-20 14:00:00,27,3,30
"16531",10401,"Mount Pearl","NL",47.50513,-52.79476,2018-11-20 15:00:00,27,2,29
"16532",10401,"Mount Pearl","NL",47.50513,-52.79476,2018-11-20 16:00:00,26,2,28
"16533",10401,"Mount Pearl","NL",47.50513,-52.79476,2018-11-20 17:00:00,23,20,43
"16534",10401,"Mount Pearl","NL",47.50513,-52.79476,2018-11-20 18:00:00,22,3,25
"16535",10401,"Mount Pearl","NL",47.50513,-52.79476,2018-11-20 19:00:00,18,4,22
"16536",10401,"Mount Pearl","NL",47.50513,-52.79476,2018-11-20 20:00:00,14,7,21
"16537",10401,"Mount Pearl","NL",47.50513,-52.79476,2018-11-20 21:00:00,21,3,24
"16538",10401,"Mount Pearl","NL",47.50513,-52.79476,2018-11-20 22:00:00,24,2,26
"16539",10401,"Mount Pearl","NL",47.50513,-52.79476,2018-11-20 23:00:00,22,2,24
"16540",10401,"Mount Pearl","NL",47.50513,-52.79476,2018-11-21 00:00:00,24,1,25
"16541",10401,"Mount Pearl","NL",47.50513,-52.79476,2018-11-21 01:00:00,25,0,25
"16542",10401,"Mount Pearl","NL",47.50513,-52.79476,2018-11-21 02:00:00,26,0,26
"16543",10401,"Mount Pearl","NL",47.50513,-52.79476,2018-11-21 03:00:00,25,1,26
"16544",10401,"Mount Pearl","NL",47.50513,-52.79476,2018-11-21 04:00:00,27,1,28
"16545",10401,"Mount Pearl","NL",47.50513,-52.79476,2018-11-21 05:00:00,29,0,29
"16546",10401,"Mount Pearl","NL",47.50513,-52.79476,2018-11-21 06:00:00,31,0,31
"16547",10401,"Mount Pearl","NL",47.50513,-52.79476,2018-11-21 07:00:00,33,0,33
"16548",10401,"Mount Pearl","NL",47.50513,-52.79476,2018-11-21 08:00:00,34,1,35
"16549",10401,"Mount Pearl","NL",47.50513,-52.79476,2018-11-21 09:00:00,36,1,37
"16550",10401,"Mount Pearl","NL",47.50513,-52.79476,2018-11-21 10:00:00,36,0,36
"16551",10401,"Mount Pearl","NL",47.50513,-52.79476,2018-11-21 11:00:00,35,1,36
"16552",10401,"Mount Pearl","NL",47.50513,-52.79476,2018-11-21 12:00:00,23,NA,NA
"16553",10401,"Mount Pearl","NL",47.50513,-52.79476,2018-11-21 13:00:00,32,3,35
"16554",10401,"Mount Pearl","NL",47.50513,-52.79476,2018-11-21 14:00:00,34,2,36
"16555",10401,"Mount Pearl","NL",47.50513,-52.79476,2018-11-21 15:00:00,34,2,36
"16556",10401,"Mount Pearl","NL",47.50513,-52.79476,2018-11-21 16:00:00,34,3,37
"16557",10401,"Mount Pearl","NL",47.50513,-52.79476,2018-11-21 17:00:00,32,4,36
"16558",10401,"Mount Pearl","NL",47.50513,-52.79476,2018-11-21 18:00:00,27,2,29
"16559",10401,"Mount Pearl","NL",47.50513,-52.79476,2018-11-21 19:00:00,27,1,28
"16560",10401,"Mount Pearl","NL",47.50513,-52.79476,2018-11-21 20:00:00,28,2,30
"16561",10401,"Mount Pearl","NL",47.50513,-52.79476,2018-11-21 21:00:00,28,2,30
"16562",10401,"Mount Pearl","NL",47.50513,-52.79476,2018-11-21 22:00:00,28,2,30
"16563",10401,"Mount Pearl","NL",47.50513,-52.79476,2018-11-21 23:00:00,27,3,30
"16564",10401,"Mount Pearl","NL",47.50513,-52.79476,2018-11-22 00:00:00,29,2,31
"16565",10401,"Mount Pearl","NL",47.50513,-52.79476,2018-11-22 01:00:00,30,1,31
"16566",10401,"Mount Pearl","NL",47.50513,-52.79476,2018-11-22 02:00:00,28,2,30
"16567",10401,"Mount Pearl","NL",47.50513,-52.79476,2018-11-22 03:00:00,28,3,31
"16568",10401,"Mount Pearl","NL",47.50513,-52.79476,2018-11-22 04:00:00,28,2,30
"16569",10401,"Mount Pearl","NL",47.50513,-52.79476,2018-11-22 05:00:00,26,2,28
"16570",10401,"Mount Pearl","NL",47.50513,-52.79476,2018-11-22 06:00:00,23,2,25
"16571",10401,"Mount Pearl","NL",47.50513,-52.79476,2018-11-22 07:00:00,22,2,24
"16572",10401,"Mount Pearl","NL",47.50513,-52.79476,2018-11-22 08:00:00,25,3,28
"16573",10401,"Mount Pearl","NL",47.50513,-52.79476,2018-11-22 09:00:00,29,2,31
"16574",10401,"Mount Pearl","NL",47.50513,-52.79476,2018-11-22 10:00:00,30,2,32
"16575",10401,"Mount Pearl","NL",47.50513,-52.79476,2018-11-22 11:00:00,30,2,32
"16576",10401,"Mount Pearl","NL",47.50513,-52.79476,2018-11-22 12:00:00,29,4,33
"16577",10401,"Mount Pearl","NL",47.50513,-52.79476,2018-11-22 13:00:00,29,7,36
"16578",10401,"Mount Pearl","NL",47.50513,-52.79476,2018-11-22 14:00:00,31,3,34
"16579",10401,"Mount Pearl","NL",47.50513,-52.79476,2018-11-22 15:00:00,32,2,34
"16580",10401,"Mount Pearl","NL",47.50513,-52.79476,2018-11-22 16:00:00,28,3,31
"16581",10401,"Mount Pearl","NL",47.50513,-52.79476,2018-11-22 17:00:00,29,3,32
"16582",10401,"Mount Pearl","NL",47.50513,-52.79476,2018-11-22 18:00:00,28,3,31
"16583",10401,"Mount Pearl","NL",47.50513,-52.79476,2018-11-22 19:00:00,28,2,30
"16584",10401,"Mount Pearl","NL",47.50513,-52.79476,2018-11-22 20:00:00,31,1,32
"16585",10401,"Mount Pearl","NL",47.50513,-52.79476,2018-11-22 21:00:00,29,3,32
"16586",10401,"Mount Pearl","NL",47.50513,-52.79476,2018-11-22 22:00:00,30,2,32
"16587",10401,"Mount Pearl","NL",47.50513,-52.79476,2018-11-22 23:00:00,32,2,34
"16588",10401,"Mount Pearl","NL",47.50513,-52.79476,2018-11-23 00:00:00,33,2,35
"16589",10401,"Mount Pearl","NL",47.50513,-52.79476,2018-11-23 01:00:00,32,2,34
"16590",10401,"Mount Pearl","NL",47.50513,-52.79476,2018-11-23 02:00:00,31,2,33
"16591",10401,"Mount Pearl","NL",47.50513,-52.79476,2018-11-23 03:00:00,32,2,34
"16592",10401,"Mount Pearl","NL",47.50513,-52.79476,2018-11-23 04:00:00,32,2,34
"16593",10401,"Mount Pearl","NL",47.50513,-52.79476,2018-11-23 05:00:00,31,1,32
"16594",10401,"Mount Pearl","NL",47.50513,-52.79476,2018-11-23 06:00:00,30,2,32
"16595",10401,"Mount Pearl","NL",47.50513,-52.79476,2018-11-23 07:00:00,30,2,32
"16596",10401,"Mount Pearl","NL",47.50513,-52.79476,2018-11-23 08:00:00,27,4,31
"16597",10401,"Mount Pearl","NL",47.50513,-52.79476,2018-11-23 09:00:00,25,5,30
"16598",10401,"Mount Pearl","NL",47.50513,-52.79476,2018-11-23 10:00:00,26,3,29
"16599",10401,"Mount Pearl","NL",47.50513,-52.79476,2018-11-23 11:00:00,27,3,30
"16600",10401,"Mount Pearl","NL",47.50513,-52.79476,2018-11-23 12:00:00,30,1,31
"16601",10401,"Mount Pearl","NL",47.50513,-52.79476,2018-11-23 13:00:00,31,1,32
"16602",10401,"Mount Pearl","NL",47.50513,-52.79476,2018-11-23 14:00:00,31,1,32
"16603",10401,"Mount Pearl","NL",47.50513,-52.79476,2018-11-23 15:00:00,32,1,33
"16604",10401,"Mount Pearl","NL",47.50513,-52.79476,2018-11-23 16:00:00,31,2,33
"16605",10401,"Mount Pearl","NL",47.50513,-52.79476,2018-11-23 17:00:00,31,1,32
"16606",10401,"Mount Pearl","NL",47.50513,-52.79476,2018-11-23 18:00:00,29,2,31
"16607",10401,"Mount Pearl","NL",47.50513,-52.79476,2018-11-23 19:00:00,29,2,31
"16608",10401,"Mount Pearl","NL",47.50513,-52.79476,2018-11-23 20:00:00,32,1,33
"16609",10401,"Mount Pearl","NL",47.50513,-52.79476,2018-11-23 21:00:00,32,0,32
"16610",10401,"Mount Pearl","NL",47.50513,-52.79476,2018-11-23 22:00:00,31,1,32
"16611",10401,"Mount Pearl","NL",47.50513,-52.79476,2018-11-23 23:00:00,32,1,33
"16612",10401,"Mount Pearl","NL",47.50513,-52.79476,2018-11-24 00:00:00,32,0,32
"16613",10401,"Mount Pearl","NL",47.50513,-52.79476,2018-11-24 01:00:00,32,0,32
"16614",10401,"Mount Pearl","NL",47.50513,-52.79476,2018-11-24 02:00:00,30,2,32
"16615",10401,"Mount Pearl","NL",47.50513,-52.79476,2018-11-24 03:00:00,30,2,32
"16616",10401,"Mount Pearl","NL",47.50513,-52.79476,2018-11-24 04:00:00,32,1,33
"16617",10401,"Mount Pearl","NL",47.50513,-52.79476,2018-11-24 05:00:00,32,1,33
"16618",10401,"Mount Pearl","NL",47.50513,-52.79476,2018-11-24 06:00:00,33,0,33
"16619",10401,"Mount Pearl","NL",47.50513,-52.79476,2018-11-24 07:00:00,34,1,35
"16620",10401,"Mount Pearl","NL",47.50513,-52.79476,2018-11-24 08:00:00,35,2,37
"16621",10401,"Mount Pearl","NL",47.50513,-52.79476,2018-11-24 09:00:00,35,2,37
"16622",10401,"Mount Pearl","NL",47.50513,-52.79476,2018-11-24 10:00:00,35,2,37
"16623",10401,"Mount Pearl","NL",47.50513,-52.79476,2018-11-24 11:00:00,35,2,37
"16624",10401,"Mount Pearl","NL",47.50513,-52.79476,2018-11-24 12:00:00,35,1,36
"16625",10401,"Mount Pearl","NL",47.50513,-52.79476,2018-11-24 13:00:00,35,1,36
"16626",10401,"Mount Pearl","NL",47.50513,-52.79476,2018-11-24 14:00:00,35,1,36
"16627",10401,"Mount Pearl","NL",47.50513,-52.79476,2018-11-24 15:00:00,35,1,36
"16628",10401,"Mount Pearl","NL",47.50513,-52.79476,2018-11-24 16:00:00,35,1,36
"16629",10401,"Mount Pearl","NL",47.50513,-52.79476,2018-11-24 17:00:00,35,1,36
"16630",10401,"Mount Pearl","NL",47.50513,-52.79476,2018-11-24 18:00:00,34,2,36
"16631",10401,"Mount Pearl","NL",47.50513,-52.79476,2018-11-24 19:00:00,34,2,36
"16632",10401,"Mount Pearl","NL",47.50513,-52.79476,2018-11-24 20:00:00,34,1,35
"16633",10401,"Mount Pearl","NL",47.50513,-52.79476,2018-11-24 21:00:00,34,1,35
"16634",10401,"Mount Pearl","NL",47.50513,-52.79476,2018-11-24 22:00:00,33,1,34
"16635",10401,"Mount Pearl","NL",47.50513,-52.79476,2018-11-24 23:00:00,33,1,34
"16636",10401,"Mount Pearl","NL",47.50513,-52.79476,2018-11-25 00:00:00,33,0,33
"16637",10401,"Mount Pearl","NL",47.50513,-52.79476,2018-11-25 01:00:00,33,0,33
"16638",10401,"Mount Pearl","NL",47.50513,-52.79476,2018-11-25 02:00:00,33,0,33
"16639",10401,"Mount Pearl","NL",47.50513,-52.79476,2018-11-25 03:00:00,32,0,32
"16640",10401,"Mount Pearl","NL",47.50513,-52.79476,2018-11-25 04:00:00,32,1,33
"16641",10401,"Mount Pearl","NL",47.50513,-52.79476,2018-11-25 05:00:00,32,1,33
"16642",10401,"Mount Pearl","NL",47.50513,-52.79476,2018-11-25 06:00:00,32,0,32
"16643",10401,"Mount Pearl","NL",47.50513,-52.79476,2018-11-25 07:00:00,31,1,32
"16644",10401,"Mount Pearl","NL",47.50513,-52.79476,2018-11-25 08:00:00,30,1,31
"16645",10401,"Mount Pearl","NL",47.50513,-52.79476,2018-11-25 09:00:00,30,1,31
"16646",10401,"Mount Pearl","NL",47.50513,-52.79476,2018-11-25 10:00:00,30,1,31
"16647",10401,"Mount Pearl","NL",47.50513,-52.79476,2018-11-25 11:00:00,29,1,30
"16648",10401,"Mount Pearl","NL",47.50513,-52.79476,2018-11-25 12:00:00,30,2,32
"16649",10401,"Mount Pearl","NL",47.50513,-52.79476,2018-11-25 13:00:00,31,1,32
"16650",10401,"Mount Pearl","NL",47.50513,-52.79476,2018-11-25 14:00:00,31,2,33
"16651",10401,"Mount Pearl","NL",47.50513,-52.79476,2018-11-25 15:00:00,32,2,34
"16652",10401,"Mount Pearl","NL",47.50513,-52.79476,2018-11-25 16:00:00,32,1,33
"16653",10401,"Mount Pearl","NL",47.50513,-52.79476,2018-11-25 17:00:00,32,2,34
"16654",10401,"Mount Pearl","NL",47.50513,-52.79476,2018-11-25 18:00:00,32,1,33
"16655",10401,"Mount Pearl","NL",47.50513,-52.79476,2018-11-25 19:00:00,32,1,33
"16656",10401,"Mount Pearl","NL",47.50513,-52.79476,2018-11-25 20:00:00,32,1,33
"16657",10401,"Mount Pearl","NL",47.50513,-52.79476,2018-11-25 21:00:00,32,2,34
"16658",10401,"Mount Pearl","NL",47.50513,-52.79476,2018-11-25 22:00:00,32,1,33
"16659",10401,"Mount Pearl","NL",47.50513,-52.79476,2018-11-25 23:00:00,32,1,33
"16660",10401,"Mount Pearl","NL",47.50513,-52.79476,2018-11-26 00:00:00,32,2,34
"16661",10401,"Mount Pearl","NL",47.50513,-52.79476,2018-11-26 01:00:00,32,2,34
"16662",10401,"Mount Pearl","NL",47.50513,-52.79476,2018-11-26 02:00:00,32,1,33
"16663",10401,"Mount Pearl","NL",47.50513,-52.79476,2018-11-26 03:00:00,33,1,34
"16664",10401,"Mount Pearl","NL",47.50513,-52.79476,2018-11-26 04:00:00,33,1,34
"16665",10401,"Mount Pearl","NL",47.50513,-52.79476,2018-11-26 05:00:00,33,1,34
"16666",10401,"Mount Pearl","NL",47.50513,-52.79476,2018-11-26 06:00:00,34,1,35
"16667",10401,"Mount Pearl","NL",47.50513,-52.79476,2018-11-26 07:00:00,33,2,35
"16668",10401,"Mount Pearl","NL",47.50513,-52.79476,2018-11-26 08:00:00,32,2,34
"16669",10401,"Mount Pearl","NL",47.50513,-52.79476,2018-11-26 09:00:00,31,2,33
"16670",10401,"Mount Pearl","NL",47.50513,-52.79476,2018-11-26 10:00:00,30,3,33
"16671",10401,"Mount Pearl","NL",47.50513,-52.79476,2018-11-26 11:00:00,30,3,33
"16672",10401,"Mount Pearl","NL",47.50513,-52.79476,2018-11-26 12:00:00,31,1,32
"16673",10401,"Mount Pearl","NL",47.50513,-52.79476,2018-11-26 13:00:00,32,2,34
"16674",10401,"Mount Pearl","NL",47.50513,-52.79476,2018-11-26 14:00:00,32,3,35
"16675",10401,"Mount Pearl","NL",47.50513,-52.79476,2018-11-26 15:00:00,32,2,34
"16676",10401,"Mount Pearl","NL",47.50513,-52.79476,2018-11-26 16:00:00,32,3,35
"16677",10401,"Mount Pearl","NL",47.50513,-52.79476,2018-11-26 17:00:00,32,4,36
"16678",10401,"Mount Pearl","NL",47.50513,-52.79476,2018-11-26 18:00:00,32,2,34
"16679",10401,"Mount Pearl","NL",47.50513,-52.79476,2018-11-26 19:00:00,33,2,35
"16680",10401,"Mount Pearl","NL",47.50513,-52.79476,2018-11-26 20:00:00,33,2,35
"16681",10401,"Mount Pearl","NL",47.50513,-52.79476,2018-11-26 21:00:00,32,1,33
"16682",10401,"Mount Pearl","NL",47.50513,-52.79476,2018-11-26 22:00:00,31,1,32
"16683",10401,"Mount Pearl","NL",47.50513,-52.79476,2018-11-26 23:00:00,31,1,32
"16684",10401,"Mount Pearl","NL",47.50513,-52.79476,2018-11-27 00:00:00,31,1,32
"16685",10401,"Mount Pearl","NL",47.50513,-52.79476,2018-11-27 01:00:00,31,1,32
"16686",10401,"Mount Pearl","NL",47.50513,-52.79476,2018-11-27 02:00:00,33,1,34
"16687",10401,"Mount Pearl","NL",47.50513,-52.79476,2018-11-27 03:00:00,33,1,34
"16688",10401,"Mount Pearl","NL",47.50513,-52.79476,2018-11-27 04:00:00,34,1,35
"16689",10401,"Mount Pearl","NL",47.50513,-52.79476,2018-11-27 05:00:00,33,0,33
"16690",10401,"Mount Pearl","NL",47.50513,-52.79476,2018-11-27 06:00:00,33,1,34
"16691",10401,"Mount Pearl","NL",47.50513,-52.79476,2018-11-27 07:00:00,33,1,34
"16692",10401,"Mount Pearl","NL",47.50513,-52.79476,2018-11-27 08:00:00,32,2,34
"16693",10401,"Mount Pearl","NL",47.50513,-52.79476,2018-11-27 09:00:00,33,3,36
"16694",10401,"Mount Pearl","NL",47.50513,-52.79476,2018-11-27 10:00:00,32,2,34
"16695",10401,"Mount Pearl","NL",47.50513,-52.79476,2018-11-27 11:00:00,32,4,36
"16696",10401,"Mount Pearl","NL",47.50513,-52.79476,2018-11-27 12:00:00,31,2,33
"16697",10401,"Mount Pearl","NL",47.50513,-52.79476,2018-11-27 13:00:00,31,2,33
"16698",10401,"Mount Pearl","NL",47.50513,-52.79476,2018-11-27 14:00:00,30,2,32
"16699",10401,"Mount Pearl","NL",47.50513,-52.79476,2018-11-27 15:00:00,30,3,33
"16700",10401,"Mount Pearl","NL",47.50513,-52.79476,2018-11-27 16:00:00,29,2,31
"16701",10401,"Mount Pearl","NL",47.50513,-52.79476,2018-11-27 17:00:00,28,4,32
"16702",10401,"Mount Pearl","NL",47.50513,-52.79476,2018-11-27 18:00:00,29,4,33
"16703",10401,"Mount Pearl","NL",47.50513,-52.79476,2018-11-27 19:00:00,30,3,33
"16704",10401,"Mount Pearl","NL",47.50513,-52.79476,2018-11-27 20:00:00,30,4,34
"16705",10401,"Mount Pearl","NL",47.50513,-52.79476,2018-11-27 21:00:00,30,1,31
"16706",10401,"Mount Pearl","NL",47.50513,-52.79476,2018-11-27 22:00:00,31,2,33
"16707",10401,"Mount Pearl","NL",47.50513,-52.79476,2018-11-27 23:00:00,31,2,33
"16708",10401,"Mount Pearl","NL",47.50513,-52.79476,2018-11-28 00:00:00,31,1,32
"16709",10401,"Mount Pearl","NL",47.50513,-52.79476,2018-11-28 01:00:00,31,2,33
"16710",10401,"Mount Pearl","NL",47.50513,-52.79476,2018-11-28 02:00:00,31,3,34
"16711",10401,"Mount Pearl","NL",47.50513,-52.79476,2018-11-28 03:00:00,30,3,33
"16712",10401,"Mount Pearl","NL",47.50513,-52.79476,2018-11-28 04:00:00,30,2,32
"16713",10401,"Mount Pearl","NL",47.50513,-52.79476,2018-11-28 05:00:00,31,1,32
"16714",10401,"Mount Pearl","NL",47.50513,-52.79476,2018-11-28 06:00:00,31,0,31
"16715",10401,"Mount Pearl","NL",47.50513,-52.79476,2018-11-28 07:00:00,31,2,33
"16716",10401,"Mount Pearl","NL",47.50513,-52.79476,2018-11-28 08:00:00,30,3,33
"16717",10401,"Mount Pearl","NL",47.50513,-52.79476,2018-11-28 09:00:00,31,4,35
"16718",10401,"Mount Pearl","NL",47.50513,-52.79476,2018-11-28 10:00:00,32,2,34
"16719",10401,"Mount Pearl","NL",47.50513,-52.79476,2018-11-28 11:00:00,32,4,36
"16720",10401,"Mount Pearl","NL",47.50513,-52.79476,2018-11-28 12:00:00,30,1,31
"16721",10401,"Mount Pearl","NL",47.50513,-52.79476,2018-11-28 13:00:00,32,3,35
"16722",10401,"Mount Pearl","NL",47.50513,-52.79476,2018-11-28 14:00:00,32,1,33
"16723",10401,"Mount Pearl","NL",47.50513,-52.79476,2018-11-28 15:00:00,33,2,35
"16724",10401,"Mount Pearl","NL",47.50513,-52.79476,2018-11-28 16:00:00,33,0,33
"16725",10401,"Mount Pearl","NL",47.50513,-52.79476,2018-11-28 17:00:00,33,1,34
"16726",10401,"Mount Pearl","NL",47.50513,-52.79476,2018-11-28 18:00:00,34,1,35
"16727",10401,"Mount Pearl","NL",47.50513,-52.79476,2018-11-28 19:00:00,34,1,35
"16728",10401,"Mount Pearl","NL",47.50513,-52.79476,2018-11-28 20:00:00,34,1,35
"16729",10401,"Mount Pearl","NL",47.50513,-52.79476,2018-11-28 21:00:00,35,1,36
"16730",10401,"Mount Pearl","NL",47.50513,-52.79476,2018-11-28 22:00:00,35,1,36
"16731",10401,"Mount Pearl","NL",47.50513,-52.79476,2018-11-28 23:00:00,35,1,36
"16732",10401,"Mount Pearl","NL",47.50513,-52.79476,2018-11-29 00:00:00,35,1,36
"16733",10401,"Mount Pearl","NL",47.50513,-52.79476,2018-11-29 01:00:00,37,0,37
"16734",10401,"Mount Pearl","NL",47.50513,-52.79476,2018-11-29 02:00:00,38,0,38
"16735",10401,"Mount Pearl","NL",47.50513,-52.79476,2018-11-29 03:00:00,38,0,38
"16736",10401,"Mount Pearl","NL",47.50513,-52.79476,2018-11-29 04:00:00,37,1,38
"16737",10401,"Mount Pearl","NL",47.50513,-52.79476,2018-11-29 05:00:00,38,0,38
"16738",10401,"Mount Pearl","NL",47.50513,-52.79476,2018-11-29 06:00:00,38,1,39
"16739",10401,"Mount Pearl","NL",47.50513,-52.79476,2018-11-29 07:00:00,37,2,39
"16740",10401,"Mount Pearl","NL",47.50513,-52.79476,2018-11-29 08:00:00,36,1,37
"16741",10401,"Mount Pearl","NL",47.50513,-52.79476,2018-11-29 09:00:00,33,6,39
"16742",10401,"Mount Pearl","NL",47.50513,-52.79476,2018-11-29 10:00:00,32,8,40
"16743",10401,"Mount Pearl","NL",47.50513,-52.79476,2018-11-29 11:00:00,31,11,42
"16744",10401,"Mount Pearl","NL",47.50513,-52.79476,2018-11-29 12:00:00,29,12,41
"16745",10401,"Mount Pearl","NL",47.50513,-52.79476,2018-11-29 13:00:00,22,27,49
"16746",10401,"Mount Pearl","NL",47.50513,-52.79476,2018-11-29 14:00:00,11,55,66
"16747",10401,"Mount Pearl","NL",47.50513,-52.79476,2018-11-29 15:00:00,17,39,56
"16748",10401,"Mount Pearl","NL",47.50513,-52.79476,2018-11-29 16:00:00,9,58,67
"16749",10401,"Mount Pearl","NL",47.50513,-52.79476,2018-11-29 17:00:00,5,68,73
"16750",10401,"Mount Pearl","NL",47.50513,-52.79476,2018-11-29 18:00:00,15,38,53
"16751",10401,"Mount Pearl","NL",47.50513,-52.79476,2018-11-29 19:00:00,19,28,47
"16752",10401,"Mount Pearl","NL",47.50513,-52.79476,2018-11-29 20:00:00,28,11,39
"16753",10401,"Mount Pearl","NL",47.50513,-52.79476,2018-11-29 21:00:00,31,5,36
"16754",10401,"Mount Pearl","NL",47.50513,-52.79476,2018-11-29 22:00:00,30,9,39
"16755",10401,"Mount Pearl","NL",47.50513,-52.79476,2018-11-29 23:00:00,26,20,46
"16756",10401,"Mount Pearl","NL",47.50513,-52.79476,2018-11-30 00:00:00,35,0,35
"16757",10401,"Mount Pearl","NL",47.50513,-52.79476,2018-11-30 01:00:00,35,3,38
"16758",10401,"Mount Pearl","NL",47.50513,-52.79476,2018-11-30 02:00:00,37,1,38
"16759",10401,"Mount Pearl","NL",47.50513,-52.79476,2018-11-30 03:00:00,39,1,40
"16760",10401,"Mount Pearl","NL",47.50513,-52.79476,2018-11-30 04:00:00,39,0,39
"16761",10401,"Mount Pearl","NL",47.50513,-52.79476,2018-11-30 05:00:00,38,0,38
"16762",10401,"Mount Pearl","NL",47.50513,-52.79476,2018-11-30 06:00:00,38,0,38
"16763",10401,"Mount Pearl","NL",47.50513,-52.79476,2018-11-30 07:00:00,38,0,38
"16764",10401,"Mount Pearl","NL",47.50513,-52.79476,2018-11-30 08:00:00,38,1,39
"16765",10401,"Mount Pearl","NL",47.50513,-52.79476,2018-11-30 09:00:00,36,1,37
"16766",10401,"Mount Pearl","NL",47.50513,-52.79476,2018-11-30 10:00:00,36,0,36
"16767",10401,"Mount Pearl","NL",47.50513,-52.79476,2018-11-30 11:00:00,35,0,35
"16768",10401,"Mount Pearl","NL",47.50513,-52.79476,2018-11-30 12:00:00,35,4,39
"16769",10401,"Mount Pearl","NL",47.50513,-52.79476,2018-11-30 13:00:00,35,2,37
"16770",10401,"Mount Pearl","NL",47.50513,-52.79476,2018-11-30 14:00:00,36,2,38
"16771",10401,"Mount Pearl","NL",47.50513,-52.79476,2018-11-30 15:00:00,36,2,38
"16772",10401,"Mount Pearl","NL",47.50513,-52.79476,2018-11-30 16:00:00,36,2,38
"16773",10401,"Mount Pearl","NL",47.50513,-52.79476,2018-11-30 17:00:00,37,1,38
"16774",10401,"Mount Pearl","NL",47.50513,-52.79476,2018-11-30 18:00:00,37,1,38
"16775",10401,"Mount Pearl","NL",47.50513,-52.79476,2018-11-30 19:00:00,37,1,38
"16776",10401,"Mount Pearl","NL",47.50513,-52.79476,2018-11-30 20:00:00,37,1,38
"16777",10401,"Mount Pearl","NL",47.50513,-52.79476,2018-11-30 21:00:00,37,1,38
"16778",10401,"Mount Pearl","NL",47.50513,-52.79476,2018-11-30 22:00:00,38,1,39
"16779",10401,"Mount Pearl","NL",47.50513,-52.79476,2018-11-30 23:00:00,38,0,38
"16780",10401,"Mount Pearl","NL",47.50513,-52.79476,2018-12-01 00:00:00,37,2,39
"16781",10401,"Mount Pearl","NL",47.50513,-52.79476,2018-12-01 01:00:00,37,1,38
"16782",10401,"Mount Pearl","NL",47.50513,-52.79476,2018-12-01 02:00:00,37,1,38
"16783",10401,"Mount Pearl","NL",47.50513,-52.79476,2018-12-01 03:00:00,37,0,37
"16784",10401,"Mount Pearl","NL",47.50513,-52.79476,2018-12-01 04:00:00,37,0,37
"16785",10401,"Mount Pearl","NL",47.50513,-52.79476,2018-12-01 05:00:00,37,1,38
"16786",10401,"Mount Pearl","NL",47.50513,-52.79476,2018-12-01 06:00:00,37,0,37
"16787",10401,"Mount Pearl","NL",47.50513,-52.79476,2018-12-01 07:00:00,37,0,37
"16788",10401,"Mount Pearl","NL",47.50513,-52.79476,2018-12-01 08:00:00,37,1,38
"16789",10401,"Mount Pearl","NL",47.50513,-52.79476,2018-12-01 09:00:00,36,1,37
"16790",10401,"Mount Pearl","NL",47.50513,-52.79476,2018-12-01 10:00:00,36,2,38
"16791",10401,"Mount Pearl","NL",47.50513,-52.79476,2018-12-01 11:00:00,36,2,38
"16792",10401,"Mount Pearl","NL",47.50513,-52.79476,2018-12-01 12:00:00,37,1,38
"16793",10401,"Mount Pearl","NL",47.50513,-52.79476,2018-12-01 13:00:00,37,2,39
"16794",10401,"Mount Pearl","NL",47.50513,-52.79476,2018-12-01 14:00:00,37,2,39
"16795",10401,"Mount Pearl","NL",47.50513,-52.79476,2018-12-01 15:00:00,37,3,40
"16796",10401,"Mount Pearl","NL",47.50513,-52.79476,2018-12-01 16:00:00,37,2,39
"16797",10401,"Mount Pearl","NL",47.50513,-52.79476,2018-12-01 17:00:00,36,2,38
"16798",10401,"Mount Pearl","NL",47.50513,-52.79476,2018-12-01 18:00:00,37,2,39
"16799",10401,"Mount Pearl","NL",47.50513,-52.79476,2018-12-01 19:00:00,36,2,38
"16800",10401,"Mount Pearl","NL",47.50513,-52.79476,2018-12-01 20:00:00,36,1,37
"16801",10401,"Mount Pearl","NL",47.50513,-52.79476,2018-12-01 21:00:00,36,1,37
"16802",10401,"Mount Pearl","NL",47.50513,-52.79476,2018-12-01 22:00:00,35,2,37
"16803",10401,"Mount Pearl","NL",47.50513,-52.79476,2018-12-01 23:00:00,35,2,37
"16804",10401,"Mount Pearl","NL",47.50513,-52.79476,2018-12-02 00:00:00,35,1,36
"16805",10401,"Mount Pearl","NL",47.50513,-52.79476,2018-12-02 01:00:00,35,1,36
"16806",10401,"Mount Pearl","NL",47.50513,-52.79476,2018-12-02 02:00:00,35,1,36
"16807",10401,"Mount Pearl","NL",47.50513,-52.79476,2018-12-02 03:00:00,34,1,35
"16808",10401,"Mount Pearl","NL",47.50513,-52.79476,2018-12-02 04:00:00,34,1,35
"16809",10401,"Mount Pearl","NL",47.50513,-52.79476,2018-12-02 05:00:00,35,1,36
"16810",10401,"Mount Pearl","NL",47.50513,-52.79476,2018-12-02 06:00:00,35,1,36
"16811",10401,"Mount Pearl","NL",47.50513,-52.79476,2018-12-02 07:00:00,34,1,35
"16812",10401,"Mount Pearl","NL",47.50513,-52.79476,2018-12-02 08:00:00,34,2,36
"16813",10401,"Mount Pearl","NL",47.50513,-52.79476,2018-12-02 09:00:00,33,2,35
"16814",10401,"Mount Pearl","NL",47.50513,-52.79476,2018-12-02 10:00:00,34,2,36
"16815",10401,"Mount Pearl","NL",47.50513,-52.79476,2018-12-02 11:00:00,34,2,36
"16816",10401,"Mount Pearl","NL",47.50513,-52.79476,2018-12-02 12:00:00,34,2,36
"16817",10401,"Mount Pearl","NL",47.50513,-52.79476,2018-12-02 13:00:00,34,2,36
"16818",10401,"Mount Pearl","NL",47.50513,-52.79476,2018-12-02 14:00:00,35,1,36
"16819",10401,"Mount Pearl","NL",47.50513,-52.79476,2018-12-02 15:00:00,35,3,38
"16820",10401,"Mount Pearl","NL",47.50513,-52.79476,2018-12-02 16:00:00,33,5,38
"16821",10401,"Mount Pearl","NL",47.50513,-52.79476,2018-12-02 17:00:00,32,5,37
"16822",10401,"Mount Pearl","NL",47.50513,-52.79476,2018-12-02 18:00:00,29,10,39
"16823",10401,"Mount Pearl","NL",47.50513,-52.79476,2018-12-02 19:00:00,29,12,41
"16824",10401,"Mount Pearl","NL",47.50513,-52.79476,2018-12-02 20:00:00,31,6,37
"16825",10401,"Mount Pearl","NL",47.50513,-52.79476,2018-12-02 21:00:00,28,11,39
"16826",10401,"Mount Pearl","NL",47.50513,-52.79476,2018-12-02 22:00:00,26,9,35
"16827",10401,"Mount Pearl","NL",47.50513,-52.79476,2018-12-02 23:00:00,24,3,27
"16828",10401,"Mount Pearl","NL",47.50513,-52.79476,2018-12-03 00:00:00,25,2,27
"16829",10401,"Mount Pearl","NL",47.50513,-52.79476,2018-12-03 01:00:00,27,1,28
"16830",10401,"Mount Pearl","NL",47.50513,-52.79476,2018-12-03 02:00:00,28,1,29
"16831",10401,"Mount Pearl","NL",47.50513,-52.79476,2018-12-03 03:00:00,27,1,28
"16832",10401,"Mount Pearl","NL",47.50513,-52.79476,2018-12-03 04:00:00,24,1,25
"16833",10401,"Mount Pearl","NL",47.50513,-52.79476,2018-12-03 05:00:00,28,1,29
"16834",10401,"Mount Pearl","NL",47.50513,-52.79476,2018-12-03 06:00:00,31,1,32
"16835",10401,"Mount Pearl","NL",47.50513,-52.79476,2018-12-03 07:00:00,33,2,35
"16836",10401,"Mount Pearl","NL",47.50513,-52.79476,2018-12-03 08:00:00,35,2,37
"16837",10401,"Mount Pearl","NL",47.50513,-52.79476,2018-12-03 09:00:00,35,3,38
"16838",10401,"Mount Pearl","NL",47.50513,-52.79476,2018-12-03 10:00:00,35,3,38
"16839",10401,"Mount Pearl","NL",47.50513,-52.79476,2018-12-03 11:00:00,35,2,37
"16840",10401,"Mount Pearl","NL",47.50513,-52.79476,2018-12-03 12:00:00,36,2,38
"16841",10401,"Mount Pearl","NL",47.50513,-52.79476,2018-12-03 13:00:00,36,2,38
"16842",10401,"Mount Pearl","NL",47.50513,-52.79476,2018-12-03 14:00:00,37,3,40
"16843",10401,"Mount Pearl","NL",47.50513,-52.79476,2018-12-03 15:00:00,37,3,40
"16844",10401,"Mount Pearl","NL",47.50513,-52.79476,2018-12-03 16:00:00,37,2,39
"16845",10401,"Mount Pearl","NL",47.50513,-52.79476,2018-12-03 17:00:00,37,2,39
"16846",10401,"Mount Pearl","NL",47.50513,-52.79476,2018-12-03 18:00:00,37,2,39
"16847",10401,"Mount Pearl","NL",47.50513,-52.79476,2018-12-03 19:00:00,35,2,37
"16848",10401,"Mount Pearl","NL",47.50513,-52.79476,2018-12-03 20:00:00,34,2,36
"16849",10401,"Mount Pearl","NL",47.50513,-52.79476,2018-12-03 21:00:00,34,2,36
"16850",10401,"Mount Pearl","NL",47.50513,-52.79476,2018-12-03 22:00:00,33,3,36
"16851",10401,"Mount Pearl","NL",47.50513,-52.79476,2018-12-03 23:00:00,31,4,35
"16852",10401,"Mount Pearl","NL",47.50513,-52.79476,2018-12-04 00:00:00,31,4,35
"16853",10401,"Mount Pearl","NL",47.50513,-52.79476,2018-12-04 01:00:00,31,2,33
"16854",10401,"Mount Pearl","NL",47.50513,-52.79476,2018-12-04 02:00:00,31,1,32
"16855",10401,"Mount Pearl","NL",47.50513,-52.79476,2018-12-04 03:00:00,29,1,30
"16856",10401,"Mount Pearl","NL",47.50513,-52.79476,2018-12-04 04:00:00,28,2,30
"16857",10401,"Mount Pearl","NL",47.50513,-52.79476,2018-12-04 05:00:00,28,2,30
"16858",10401,"Mount Pearl","NL",47.50513,-52.79476,2018-12-04 06:00:00,24,3,27
"16859",10401,"Mount Pearl","NL",47.50513,-52.79476,2018-12-04 07:00:00,21,4,25
"16860",10401,"Mount Pearl","NL",47.50513,-52.79476,2018-12-04 08:00:00,17,18,35
"16861",10401,"Mount Pearl","NL",47.50513,-52.79476,2018-12-04 09:00:00,19,14,33
"16862",10401,"Mount Pearl","NL",47.50513,-52.79476,2018-12-04 10:00:00,21,12,33
"16863",10401,"Mount Pearl","NL",47.50513,-52.79476,2018-12-04 11:00:00,23,7,30
"16864",10401,"Mount Pearl","NL",47.50513,-52.79476,2018-12-04 12:00:00,19,14,33
"16865",10401,"Mount Pearl","NL",47.50513,-52.79476,2018-12-04 13:00:00,24,5,29
"16866",10401,"Mount Pearl","NL",47.50513,-52.79476,2018-12-04 14:00:00,26,3,29
"16867",10401,"Mount Pearl","NL",47.50513,-52.79476,2018-12-04 15:00:00,25,2,27
"16868",10401,"Mount Pearl","NL",47.50513,-52.79476,2018-12-04 16:00:00,27,2,29
"16869",10401,"Mount Pearl","NL",47.50513,-52.79476,2018-12-04 17:00:00,24,7,31
"16870",10401,"Mount Pearl","NL",47.50513,-52.79476,2018-12-04 18:00:00,24,7,31
"16871",10401,"Mount Pearl","NL",47.50513,-52.79476,2018-12-04 19:00:00,26,3,29
"16872",10401,"Mount Pearl","NL",47.50513,-52.79476,2018-12-04 20:00:00,28,3,31
"16873",10401,"Mount Pearl","NL",47.50513,-52.79476,2018-12-04 21:00:00,30,1,31
"16874",10401,"Mount Pearl","NL",47.50513,-52.79476,2018-12-04 22:00:00,29,1,30
"16875",10401,"Mount Pearl","NL",47.50513,-52.79476,2018-12-04 23:00:00,28,2,30
"16876",10401,"Mount Pearl","NL",47.50513,-52.79476,2018-12-05 00:00:00,26,2,28
"16877",10401,"Mount Pearl","NL",47.50513,-52.79476,2018-12-05 01:00:00,25,1,26
"16878",10401,"Mount Pearl","NL",47.50513,-52.79476,2018-12-05 02:00:00,28,1,29
"16879",10401,"Mount Pearl","NL",47.50513,-52.79476,2018-12-05 03:00:00,27,0,27
"16880",10401,"Mount Pearl","NL",47.50513,-52.79476,2018-12-05 04:00:00,27,0,27
"16881",10401,"Mount Pearl","NL",47.50513,-52.79476,2018-12-05 05:00:00,30,1,31
"16882",10401,"Mount Pearl","NL",47.50513,-52.79476,2018-12-05 06:00:00,33,1,34
"16883",10401,"Mount Pearl","NL",47.50513,-52.79476,2018-12-05 07:00:00,31,1,32
"16884",10401,"Mount Pearl","NL",47.50513,-52.79476,2018-12-05 08:00:00,29,4,33
"16885",10401,"Mount Pearl","NL",47.50513,-52.79476,2018-12-05 09:00:00,30,4,34
"16886",10401,"Mount Pearl","NL",47.50513,-52.79476,2018-12-05 10:00:00,30,4,34
"16887",10401,"Mount Pearl","NL",47.50513,-52.79476,2018-12-05 11:00:00,31,4,35
"16888",10401,"Mount Pearl","NL",47.50513,-52.79476,2018-12-05 12:00:00,31,3,34
"16889",10401,"Mount Pearl","NL",47.50513,-52.79476,2018-12-05 13:00:00,32,4,36
"16890",10401,"Mount Pearl","NL",47.50513,-52.79476,2018-12-05 14:00:00,32,4,36
"16891",10401,"Mount Pearl","NL",47.50513,-52.79476,2018-12-05 15:00:00,32,4,36
"16892",10401,"Mount Pearl","NL",47.50513,-52.79476,2018-12-05 16:00:00,32,5,37
"16893",10401,"Mount Pearl","NL",47.50513,-52.79476,2018-12-05 17:00:00,32,5,37
"16894",10401,"Mount Pearl","NL",47.50513,-52.79476,2018-12-05 18:00:00,33,3,36
"16895",10401,"Mount Pearl","NL",47.50513,-52.79476,2018-12-05 19:00:00,33,2,35
"16896",10401,"Mount Pearl","NL",47.50513,-52.79476,2018-12-05 20:00:00,33,2,35
"16897",10401,"Mount Pearl","NL",47.50513,-52.79476,2018-12-05 21:00:00,34,2,36
"16898",10401,"Mount Pearl","NL",47.50513,-52.79476,2018-12-05 22:00:00,35,2,37
"16899",10401,"Mount Pearl","NL",47.50513,-52.79476,2018-12-05 23:00:00,36,1,37
"16900",10401,"Mount Pearl","NL",47.50513,-52.79476,2018-12-06 00:00:00,36,1,37
"16901",10401,"Mount Pearl","NL",47.50513,-52.79476,2018-12-06 01:00:00,36,2,38
"16902",10401,"Mount Pearl","NL",47.50513,-52.79476,2018-12-06 02:00:00,36,1,37
"16903",10401,"Mount Pearl","NL",47.50513,-52.79476,2018-12-06 03:00:00,35,2,37
"16904",10401,"Mount Pearl","NL",47.50513,-52.79476,2018-12-06 04:00:00,35,3,38
"16905",10401,"Mount Pearl","NL",47.50513,-52.79476,2018-12-06 05:00:00,34,3,37
"16906",10401,"Mount Pearl","NL",47.50513,-52.79476,2018-12-06 06:00:00,31,5,36
"16907",10401,"Mount Pearl","NL",47.50513,-52.79476,2018-12-06 07:00:00,28,6,34
"16908",10401,"Mount Pearl","NL",47.50513,-52.79476,2018-12-06 08:00:00,26,14,40
"16909",10401,"Mount Pearl","NL",47.50513,-52.79476,2018-12-06 09:00:00,19,31,50
"16910",10401,"Mount Pearl","NL",47.50513,-52.79476,2018-12-06 10:00:00,10,46,56
"16911",10401,"Mount Pearl","NL",47.50513,-52.79476,2018-12-06 11:00:00,14,32,46
"16912",10401,"Mount Pearl","NL",47.50513,-52.79476,2018-12-06 12:00:00,18,30,48
"16913",10401,"Mount Pearl","NL",47.50513,-52.79476,2018-12-06 13:00:00,26,19,45
"16914",10401,"Mount Pearl","NL",47.50513,-52.79476,2018-12-06 14:00:00,31,7,38
"16915",10401,"Mount Pearl","NL",47.50513,-52.79476,2018-12-06 15:00:00,33,4,37
"16916",10401,"Mount Pearl","NL",47.50513,-52.79476,2018-12-06 16:00:00,35,3,38
"16917",10401,"Mount Pearl","NL",47.50513,-52.79476,2018-12-06 17:00:00,35,3,38
"16918",10401,"Mount Pearl","NL",47.50513,-52.79476,2018-12-06 18:00:00,35,2,37
"16919",10401,"Mount Pearl","NL",47.50513,-52.79476,2018-12-06 19:00:00,37,1,38
"16920",10401,"Mount Pearl","NL",47.50513,-52.79476,2018-12-06 20:00:00,37,1,38
"16921",10401,"Mount Pearl","NL",47.50513,-52.79476,2018-12-06 21:00:00,36,2,38
"16922",10401,"Mount Pearl","NL",47.50513,-52.79476,2018-12-06 22:00:00,37,2,39
"16923",10401,"Mount Pearl","NL",47.50513,-52.79476,2018-12-06 23:00:00,37,1,38
"16924",10401,"Mount Pearl","NL",47.50513,-52.79476,2018-12-07 00:00:00,37,1,38
"16925",10401,"Mount Pearl","NL",47.50513,-52.79476,2018-12-07 01:00:00,36,1,37
"16926",10401,"Mount Pearl","NL",47.50513,-52.79476,2018-12-07 02:00:00,33,0,33
"16927",10401,"Mount Pearl","NL",47.50513,-52.79476,2018-12-07 03:00:00,31,0,31
"16928",10401,"Mount Pearl","NL",47.50513,-52.79476,2018-12-07 04:00:00,30,1,31
"16929",10401,"Mount Pearl","NL",47.50513,-52.79476,2018-12-07 05:00:00,30,2,32
"16930",10401,"Mount Pearl","NL",47.50513,-52.79476,2018-12-07 06:00:00,27,3,30
"16931",10401,"Mount Pearl","NL",47.50513,-52.79476,2018-12-07 07:00:00,27,4,31
"16932",10401,"Mount Pearl","NL",47.50513,-52.79476,2018-12-07 08:00:00,27,5,32
"16933",10401,"Mount Pearl","NL",47.50513,-52.79476,2018-12-07 09:00:00,25,9,34
"16934",10401,"Mount Pearl","NL",47.50513,-52.79476,2018-12-07 10:00:00,26,7,33
"16935",10401,"Mount Pearl","NL",47.50513,-52.79476,2018-12-07 11:00:00,26,6,32
"16936",10401,"Mount Pearl","NL",47.50513,-52.79476,2018-12-07 12:00:00,26,4,30
"16937",10401,"Mount Pearl","NL",47.50513,-52.79476,2018-12-07 13:00:00,27,7,34
"16938",10401,"Mount Pearl","NL",47.50513,-52.79476,2018-12-07 14:00:00,30,4,34
"16939",10401,"Mount Pearl","NL",47.50513,-52.79476,2018-12-07 15:00:00,31,6,37
"16940",10401,"Mount Pearl","NL",47.50513,-52.79476,2018-12-07 16:00:00,31,4,35
"16941",10401,"Mount Pearl","NL",47.50513,-52.79476,2018-12-07 17:00:00,33,4,37
"16942",10401,"Mount Pearl","NL",47.50513,-52.79476,2018-12-07 18:00:00,27,12,39
"16943",10401,"Mount Pearl","NL",47.50513,-52.79476,2018-12-07 19:00:00,28,10,38
"16944",10401,"Mount Pearl","NL",47.50513,-52.79476,2018-12-07 20:00:00,30,7,37
"16945",10401,"Mount Pearl","NL",47.50513,-52.79476,2018-12-07 21:00:00,28,9,37
"16946",10401,"Mount Pearl","NL",47.50513,-52.79476,2018-12-07 22:00:00,27,12,39
"16947",10401,"Mount Pearl","NL",47.50513,-52.79476,2018-12-07 23:00:00,29,6,35
"16948",10401,"Mount Pearl","NL",47.50513,-52.79476,2018-12-08 00:00:00,30,3,33
"16949",10401,"Mount Pearl","NL",47.50513,-52.79476,2018-12-08 01:00:00,32,2,34
"16950",10401,"Mount Pearl","NL",47.50513,-52.79476,2018-12-08 02:00:00,28,3,31
"16951",10401,"Mount Pearl","NL",47.50513,-52.79476,2018-12-08 03:00:00,28,2,30
"16952",10401,"Mount Pearl","NL",47.50513,-52.79476,2018-12-08 04:00:00,28,3,31
"16953",10401,"Mount Pearl","NL",47.50513,-52.79476,2018-12-08 05:00:00,23,6,29
"16954",10401,"Mount Pearl","NL",47.50513,-52.79476,2018-12-08 06:00:00,18,24,42
"16955",10401,"Mount Pearl","NL",47.50513,-52.79476,2018-12-08 07:00:00,11,31,42
"16956",10401,"Mount Pearl","NL",47.50513,-52.79476,2018-12-08 08:00:00,22,12,34
"16957",10401,"Mount Pearl","NL",47.50513,-52.79476,2018-12-08 09:00:00,13,35,48
"16958",10401,"Mount Pearl","NL",47.50513,-52.79476,2018-12-08 10:00:00,15,39,54
"16959",10401,"Mount Pearl","NL",47.50513,-52.79476,2018-12-08 11:00:00,21,25,46
"16960",10401,"Mount Pearl","NL",47.50513,-52.79476,2018-12-08 12:00:00,22,20,42
"16961",10401,"Mount Pearl","NL",47.50513,-52.79476,2018-12-08 13:00:00,23,21,44
"16962",10401,"Mount Pearl","NL",47.50513,-52.79476,2018-12-08 14:00:00,32,4,36
"16963",10401,"Mount Pearl","NL",47.50513,-52.79476,2018-12-08 15:00:00,31,6,37
"16964",10401,"Mount Pearl","NL",47.50513,-52.79476,2018-12-08 16:00:00,29,10,39
"16965",10401,"Mount Pearl","NL",47.50513,-52.79476,2018-12-08 17:00:00,32,6,38
"16966",10401,"Mount Pearl","NL",47.50513,-52.79476,2018-12-08 18:00:00,33,4,37
"16967",10401,"Mount Pearl","NL",47.50513,-52.79476,2018-12-08 19:00:00,33,5,38
"16968",10401,"Mount Pearl","NL",47.50513,-52.79476,2018-12-08 20:00:00,35,3,38
"16969",10401,"Mount Pearl","NL",47.50513,-52.79476,2018-12-08 21:00:00,34,6,40
"16970",10401,"Mount Pearl","NL",47.50513,-52.79476,2018-12-08 22:00:00,34,6,40
"16971",10401,"Mount Pearl","NL",47.50513,-52.79476,2018-12-08 23:00:00,34,5,39
"16972",10401,"Mount Pearl","NL",47.50513,-52.79476,2018-12-09 00:00:00,34,1,35
"16973",10401,"Mount Pearl","NL",47.50513,-52.79476,2018-12-09 01:00:00,33,1,34
"16974",10401,"Mount Pearl","NL",47.50513,-52.79476,2018-12-09 02:00:00,33,3,36
"16975",10401,"Mount Pearl","NL",47.50513,-52.79476,2018-12-09 03:00:00,33,2,35
"16976",10401,"Mount Pearl","NL",47.50513,-52.79476,2018-12-09 04:00:00,32,2,34
"16977",10401,"Mount Pearl","NL",47.50513,-52.79476,2018-12-09 05:00:00,31,1,32
"16978",10401,"Mount Pearl","NL",47.50513,-52.79476,2018-12-09 06:00:00,31,2,33
"16979",10401,"Mount Pearl","NL",47.50513,-52.79476,2018-12-09 07:00:00,29,1,30
"16980",10401,"Mount Pearl","NL",47.50513,-52.79476,2018-12-09 08:00:00,25,3,28
"16981",10401,"Mount Pearl","NL",47.50513,-52.79476,2018-12-09 09:00:00,25,1,26
"16982",10401,"Mount Pearl","NL",47.50513,-52.79476,2018-12-09 10:00:00,24,3,27
"16983",10401,"Mount Pearl","NL",47.50513,-52.79476,2018-12-09 11:00:00,25,2,27
"16984",10401,"Mount Pearl","NL",47.50513,-52.79476,2018-12-09 12:00:00,27,2,29
"16985",10401,"Mount Pearl","NL",47.50513,-52.79476,2018-12-09 13:00:00,28,3,31
"16986",10401,"Mount Pearl","NL",47.50513,-52.79476,2018-12-09 14:00:00,28,2,30
"16987",10401,"Mount Pearl","NL",47.50513,-52.79476,2018-12-09 15:00:00,29,3,32
"16988",10401,"Mount Pearl","NL",47.50513,-52.79476,2018-12-09 16:00:00,31,3,34
"16989",10401,"Mount Pearl","NL",47.50513,-52.79476,2018-12-09 17:00:00,31,4,35
"16990",10401,"Mount Pearl","NL",47.50513,-52.79476,2018-12-09 18:00:00,32,3,35
"16991",10401,"Mount Pearl","NL",47.50513,-52.79476,2018-12-09 19:00:00,33,2,35
"16992",10401,"Mount Pearl","NL",47.50513,-52.79476,2018-12-09 20:00:00,31,6,37
"16993",10401,"Mount Pearl","NL",47.50513,-52.79476,2018-12-09 21:00:00,34,2,36
"16994",10401,"Mount Pearl","NL",47.50513,-52.79476,2018-12-09 22:00:00,35,2,37
"16995",10401,"Mount Pearl","NL",47.50513,-52.79476,2018-12-09 23:00:00,35,2,37
"16996",10401,"Mount Pearl","NL",47.50513,-52.79476,2018-12-10 00:00:00,36,1,37
"16997",10401,"Mount Pearl","NL",47.50513,-52.79476,2018-12-10 01:00:00,36,1,37
"16998",10401,"Mount Pearl","NL",47.50513,-52.79476,2018-12-10 02:00:00,36,2,38
"16999",10401,"Mount Pearl","NL",47.50513,-52.79476,2018-12-10 03:00:00,36,1,37
"17000",10401,"Mount Pearl","NL",47.50513,-52.79476,2018-12-10 04:00:00,36,1,37
"17001",10401,"Mount Pearl","NL",47.50513,-52.79476,2018-12-10 05:00:00,36,1,37
"17002",10401,"Mount Pearl","NL",47.50513,-52.79476,2018-12-10 06:00:00,35,3,38
"17003",10401,"Mount Pearl","NL",47.50513,-52.79476,2018-12-10 07:00:00,35,3,38
"17004",10401,"Mount Pearl","NL",47.50513,-52.79476,2018-12-10 08:00:00,34,4,38
"17005",10401,"Mount Pearl","NL",47.50513,-52.79476,2018-12-10 09:00:00,31,8,39
"17006",10401,"Mount Pearl","NL",47.50513,-52.79476,2018-12-10 10:00:00,29,11,40
"17007",10401,"Mount Pearl","NL",47.50513,-52.79476,2018-12-10 11:00:00,29,9,38
"17008",10401,"Mount Pearl","NL",47.50513,-52.79476,2018-12-10 12:00:00,29,7,36
"17009",10401,"Mount Pearl","NL",47.50513,-52.79476,2018-12-10 13:00:00,33,4,37
"17010",10401,"Mount Pearl","NL",47.50513,-52.79476,2018-12-10 14:00:00,35,3,38
"17011",10401,"Mount Pearl","NL",47.50513,-52.79476,2018-12-10 15:00:00,33,5,38
"17012",10401,"Mount Pearl","NL",47.50513,-52.79476,2018-12-10 16:00:00,33,5,38
"17013",10401,"Mount Pearl","NL",47.50513,-52.79476,2018-12-10 17:00:00,31,6,37
"17014",10401,"Mount Pearl","NL",47.50513,-52.79476,2018-12-10 18:00:00,22,22,44
"17015",10401,"Mount Pearl","NL",47.50513,-52.79476,2018-12-10 19:00:00,20,26,46
"17016",10401,"Mount Pearl","NL",47.50513,-52.79476,2018-12-10 20:00:00,26,8,34
"17017",10401,"Mount Pearl","NL",47.50513,-52.79476,2018-12-10 21:00:00,28,6,34
"17018",10401,"Mount Pearl","NL",47.50513,-52.79476,2018-12-10 22:00:00,24,13,37
"17019",10401,"Mount Pearl","NL",47.50513,-52.79476,2018-12-10 23:00:00,27,8,35
"17020",10401,"Mount Pearl","NL",47.50513,-52.79476,2018-12-11 00:00:00,20,17,37
"17021",10401,"Mount Pearl","NL",47.50513,-52.79476,2018-12-11 01:00:00,20,12,32
"17022",10401,"Mount Pearl","NL",47.50513,-52.79476,2018-12-11 02:00:00,18,19,37
"17023",10401,"Mount Pearl","NL",47.50513,-52.79476,2018-12-11 03:00:00,28,5,33
"17024",10401,"Mount Pearl","NL",47.50513,-52.79476,2018-12-11 04:00:00,31,2,33
"17025",10401,"Mount Pearl","NL",47.50513,-52.79476,2018-12-11 05:00:00,30,4,34
"17026",10401,"Mount Pearl","NL",47.50513,-52.79476,2018-12-11 06:00:00,28,8,36
"17027",10401,"Mount Pearl","NL",47.50513,-52.79476,2018-12-11 07:00:00,27,11,38
"17028",10401,"Mount Pearl","NL",47.50513,-52.79476,2018-12-11 08:00:00,26,13,39
"17029",10401,"Mount Pearl","NL",47.50513,-52.79476,2018-12-11 09:00:00,26,11,37
"17030",10401,"Mount Pearl","NL",47.50513,-52.79476,2018-12-11 10:00:00,28,8,36
"17031",10401,"Mount Pearl","NL",47.50513,-52.79476,2018-12-11 11:00:00,31,6,37
"17032",10401,"Mount Pearl","NL",47.50513,-52.79476,2018-12-11 12:00:00,31,4,35
"17033",10401,"Mount Pearl","NL",47.50513,-52.79476,2018-12-11 13:00:00,32,3,35
"17034",10401,"Mount Pearl","NL",47.50513,-52.79476,2018-12-11 14:00:00,34,2,36
"17035",10401,"Mount Pearl","NL",47.50513,-52.79476,2018-12-11 15:00:00,35,2,37
"17036",10401,"Mount Pearl","NL",47.50513,-52.79476,2018-12-11 16:00:00,35,3,38
"17037",10401,"Mount Pearl","NL",47.50513,-52.79476,2018-12-11 17:00:00,34,5,39
"17038",10401,"Mount Pearl","NL",47.50513,-52.79476,2018-12-11 18:00:00,34,4,38
"17039",10401,"Mount Pearl","NL",47.50513,-52.79476,2018-12-11 19:00:00,34,4,38
"17040",10401,"Mount Pearl","NL",47.50513,-52.79476,2018-12-11 20:00:00,34,3,37
"17041",10401,"Mount Pearl","NL",47.50513,-52.79476,2018-12-11 21:00:00,32,6,38
"17042",10401,"Mount Pearl","NL",47.50513,-52.79476,2018-12-11 22:00:00,32,8,40
"17043",10401,"Mount Pearl","NL",47.50513,-52.79476,2018-12-11 23:00:00,26,13,39
"17044",10401,"Mount Pearl","NL",47.50513,-52.79476,2018-12-12 00:00:00,22,12,34
"17045",10401,"Mount Pearl","NL",47.50513,-52.79476,2018-12-12 01:00:00,22,9,31
"17046",10401,"Mount Pearl","NL",47.50513,-52.79476,2018-12-12 02:00:00,24,9,33
"17047",10401,"Mount Pearl","NL",47.50513,-52.79476,2018-12-12 03:00:00,25,8,33
"17048",10401,"Mount Pearl","NL",47.50513,-52.79476,2018-12-12 04:00:00,28,6,34
"17049",10401,"Mount Pearl","NL",47.50513,-52.79476,2018-12-12 05:00:00,22,16,38
"17050",10401,"Mount Pearl","NL",47.50513,-52.79476,2018-12-12 06:00:00,24,10,34
"17051",10401,"Mount Pearl","NL",47.50513,-52.79476,2018-12-12 07:00:00,23,13,36
"17052",10401,"Mount Pearl","NL",47.50513,-52.79476,2018-12-12 08:00:00,15,33,48
"17053",10401,"Mount Pearl","NL",47.50513,-52.79476,2018-12-12 09:00:00,34,5,39
"17054",10401,"Mount Pearl","NL",47.50513,-52.79476,2018-12-12 10:00:00,35,2,37
"17055",10401,"Mount Pearl","NL",47.50513,-52.79476,2018-12-12 11:00:00,35,1,36
"17056",10401,"Mount Pearl","NL",47.50513,-52.79476,2018-12-12 12:00:00,36,2,38
"17057",10401,"Mount Pearl","NL",47.50513,-52.79476,2018-12-12 13:00:00,36,2,38
"17058",10401,"Mount Pearl","NL",47.50513,-52.79476,2018-12-12 14:00:00,36,3,39
"17059",10401,"Mount Pearl","NL",47.50513,-52.79476,2018-12-12 15:00:00,36,3,39
"17060",10401,"Mount Pearl","NL",47.50513,-52.79476,2018-12-12 16:00:00,36,4,40
"17061",10401,"Mount Pearl","NL",47.50513,-52.79476,2018-12-12 17:00:00,35,5,40
"17062",10401,"Mount Pearl","NL",47.50513,-52.79476,2018-12-12 18:00:00,37,3,40
"17063",10401,"Mount Pearl","NL",47.50513,-52.79476,2018-12-12 19:00:00,38,3,41
"17064",10401,"Mount Pearl","NL",47.50513,-52.79476,2018-12-12 20:00:00,38,2,40
"17065",10401,"Mount Pearl","NL",47.50513,-52.79476,2018-12-12 21:00:00,37,3,40
"17066",10401,"Mount Pearl","NL",47.50513,-52.79476,2018-12-12 22:00:00,37,1,38
"17067",10401,"Mount Pearl","NL",47.50513,-52.79476,2018-12-12 23:00:00,37,1,38
"17068",10401,"Mount Pearl","NL",47.50513,-52.79476,2018-12-13 00:00:00,36,2,38
"17069",10401,"Mount Pearl","NL",47.50513,-52.79476,2018-12-13 01:00:00,36,2,38
"17070",10401,"Mount Pearl","NL",47.50513,-52.79476,2018-12-13 02:00:00,36,1,37
"17071",10401,"Mount Pearl","NL",47.50513,-52.79476,2018-12-13 03:00:00,36,2,38
"17072",10401,"Mount Pearl","NL",47.50513,-52.79476,2018-12-13 04:00:00,35,3,38
"17073",10401,"Mount Pearl","NL",47.50513,-52.79476,2018-12-13 05:00:00,36,2,38
"17074",10401,"Mount Pearl","NL",47.50513,-52.79476,2018-12-13 06:00:00,34,3,37
"17075",10401,"Mount Pearl","NL",47.50513,-52.79476,2018-12-13 07:00:00,34,3,37
"17076",10401,"Mount Pearl","NL",47.50513,-52.79476,2018-12-13 08:00:00,34,4,38
"17077",10401,"Mount Pearl","NL",47.50513,-52.79476,2018-12-13 09:00:00,35,3,38
"17078",10401,"Mount Pearl","NL",47.50513,-52.79476,2018-12-13 10:00:00,35,3,38
"17079",10401,"Mount Pearl","NL",47.50513,-52.79476,2018-12-13 11:00:00,34,2,36
"17080",10401,"Mount Pearl","NL",47.50513,-52.79476,2018-12-13 12:00:00,34,2,36
"17081",10401,"Mount Pearl","NL",47.50513,-52.79476,2018-12-13 13:00:00,34,2,36
"17082",10401,"Mount Pearl","NL",47.50513,-52.79476,2018-12-13 14:00:00,33,4,37
"17083",10401,"Mount Pearl","NL",47.50513,-52.79476,2018-12-13 15:00:00,34,3,37
"17084",10401,"Mount Pearl","NL",47.50513,-52.79476,2018-12-13 16:00:00,34,4,38
"17085",10401,"Mount Pearl","NL",47.50513,-52.79476,2018-12-13 17:00:00,34,5,39
"17086",10401,"Mount Pearl","NL",47.50513,-52.79476,2018-12-13 18:00:00,33,6,39
"17087",10401,"Mount Pearl","NL",47.50513,-52.79476,2018-12-13 19:00:00,34,3,37
"17088",10401,"Mount Pearl","NL",47.50513,-52.79476,2018-12-13 20:00:00,33,4,37
"17089",10401,"Mount Pearl","NL",47.50513,-52.79476,2018-12-13 21:00:00,32,5,37
"17090",10401,"Mount Pearl","NL",47.50513,-52.79476,2018-12-13 22:00:00,33,3,36
"17091",10401,"Mount Pearl","NL",47.50513,-52.79476,2018-12-13 23:00:00,33,3,36
"17092",10401,"Mount Pearl","NL",47.50513,-52.79476,2018-12-14 00:00:00,34,3,37
"17093",10401,"Mount Pearl","NL",47.50513,-52.79476,2018-12-14 01:00:00,34,3,37
"17094",10401,"Mount Pearl","NL",47.50513,-52.79476,2018-12-14 02:00:00,36,1,37
"17095",10401,"Mount Pearl","NL",47.50513,-52.79476,2018-12-14 03:00:00,36,1,37
"17096",10401,"Mount Pearl","NL",47.50513,-52.79476,2018-12-14 04:00:00,37,0,37
"17097",10401,"Mount Pearl","NL",47.50513,-52.79476,2018-12-14 05:00:00,36,2,38
"17098",10401,"Mount Pearl","NL",47.50513,-52.79476,2018-12-14 06:00:00,36,3,39
"17099",10401,"Mount Pearl","NL",47.50513,-52.79476,2018-12-14 07:00:00,36,2,38
"17100",10401,"Mount Pearl","NL",47.50513,-52.79476,2018-12-14 08:00:00,35,5,40
"17101",10401,"Mount Pearl","NL",47.50513,-52.79476,2018-12-14 09:00:00,34,6,40
"17102",10401,"Mount Pearl","NL",47.50513,-52.79476,2018-12-14 10:00:00,35,4,39
"17103",10401,"Mount Pearl","NL",47.50513,-52.79476,2018-12-14 11:00:00,35,2,37
"17104",10401,"Mount Pearl","NL",47.50513,-52.79476,2018-12-14 12:00:00,35,4,39
"17105",10401,"Mount Pearl","NL",47.50513,-52.79476,2018-12-14 13:00:00,36,3,39
"17106",10401,"Mount Pearl","NL",47.50513,-52.79476,2018-12-14 14:00:00,36,3,39
"17107",10401,"Mount Pearl","NL",47.50513,-52.79476,2018-12-14 15:00:00,36,3,39
"17108",10401,"Mount Pearl","NL",47.50513,-52.79476,2018-12-14 16:00:00,36,4,40
"17109",10401,"Mount Pearl","NL",47.50513,-52.79476,2018-12-14 17:00:00,36,4,40
"17110",10401,"Mount Pearl","NL",47.50513,-52.79476,2018-12-14 18:00:00,37,4,41
"17111",10401,"Mount Pearl","NL",47.50513,-52.79476,2018-12-14 19:00:00,37,4,41
"17112",10401,"Mount Pearl","NL",47.50513,-52.79476,2018-12-14 20:00:00,37,4,41
"17113",10401,"Mount Pearl","NL",47.50513,-52.79476,2018-12-14 21:00:00,37,4,41
"17114",10401,"Mount Pearl","NL",47.50513,-52.79476,2018-12-14 22:00:00,36,5,41
"17115",10401,"Mount Pearl","NL",47.50513,-52.79476,2018-12-14 23:00:00,34,6,40
"17116",10401,"Mount Pearl","NL",47.50513,-52.79476,2018-12-15 00:00:00,29,13,42
"17117",10401,"Mount Pearl","NL",47.50513,-52.79476,2018-12-15 01:00:00,30,12,42
"17118",10401,"Mount Pearl","NL",47.50513,-52.79476,2018-12-15 02:00:00,29,11,40
"17119",10401,"Mount Pearl","NL",47.50513,-52.79476,2018-12-15 03:00:00,32,7,39
"17120",10401,"Mount Pearl","NL",47.50513,-52.79476,2018-12-15 04:00:00,32,7,39
"17121",10401,"Mount Pearl","NL",47.50513,-52.79476,2018-12-15 05:00:00,31,8,39
"17122",10401,"Mount Pearl","NL",47.50513,-52.79476,2018-12-15 06:00:00,32,4,36
"17123",10401,"Mount Pearl","NL",47.50513,-52.79476,2018-12-15 07:00:00,33,2,35
"17124",10401,"Mount Pearl","NL",47.50513,-52.79476,2018-12-15 08:00:00,32,3,35
"17125",10401,"Mount Pearl","NL",47.50513,-52.79476,2018-12-15 09:00:00,30,8,38
"17126",10401,"Mount Pearl","NL",47.50513,-52.79476,2018-12-15 10:00:00,33,3,36
"17127",10401,"Mount Pearl","NL",47.50513,-52.79476,2018-12-15 11:00:00,32,3,35
"17128",10401,"Mount Pearl","NL",47.50513,-52.79476,2018-12-15 12:00:00,33,1,34
"17129",10401,"Mount Pearl","NL",47.50513,-52.79476,2018-12-15 13:00:00,35,1,36
"17130",10401,"Mount Pearl","NL",47.50513,-52.79476,2018-12-15 14:00:00,36,1,37
"17131",10401,"Mount Pearl","NL",47.50513,-52.79476,2018-12-15 15:00:00,36,1,37
"17132",10401,"Mount Pearl","NL",47.50513,-52.79476,2018-12-15 16:00:00,37,1,38
"17133",10401,"Mount Pearl","NL",47.50513,-52.79476,2018-12-15 17:00:00,36,2,38
"17134",10401,"Mount Pearl","NL",47.50513,-52.79476,2018-12-15 18:00:00,35,3,38
"17135",10401,"Mount Pearl","NL",47.50513,-52.79476,2018-12-15 19:00:00,34,1,35
"17136",10401,"Mount Pearl","NL",47.50513,-52.79476,2018-12-15 20:00:00,32,2,34
"17137",10401,"Mount Pearl","NL",47.50513,-52.79476,2018-12-15 21:00:00,30,2,32
"17138",10401,"Mount Pearl","NL",47.50513,-52.79476,2018-12-15 22:00:00,27,2,29
"17139",10401,"Mount Pearl","NL",47.50513,-52.79476,2018-12-15 23:00:00,27,2,29
"17140",10401,"Mount Pearl","NL",47.50513,-52.79476,2018-12-16 00:00:00,26,1,27
"17141",10401,"Mount Pearl","NL",47.50513,-52.79476,2018-12-16 01:00:00,26,1,27
"17142",10401,"Mount Pearl","NL",47.50513,-52.79476,2018-12-16 02:00:00,26,2,28
"17143",10401,"Mount Pearl","NL",47.50513,-52.79476,2018-12-16 03:00:00,25,1,26
"17144",10401,"Mount Pearl","NL",47.50513,-52.79476,2018-12-16 04:00:00,25,1,26
"17145",10401,"Mount Pearl","NL",47.50513,-52.79476,2018-12-16 05:00:00,25,1,26
"17146",10401,"Mount Pearl","NL",47.50513,-52.79476,2018-12-16 06:00:00,25,1,26
"17147",10401,"Mount Pearl","NL",47.50513,-52.79476,2018-12-16 07:00:00,25,1,26
"17148",10401,"Mount Pearl","NL",47.50513,-52.79476,2018-12-16 08:00:00,25,0,25
"17149",10401,"Mount Pearl","NL",47.50513,-52.79476,2018-12-16 09:00:00,24,0,24
"17150",10401,"Mount Pearl","NL",47.50513,-52.79476,2018-12-16 10:00:00,24,1,25
"17151",10401,"Mount Pearl","NL",47.50513,-52.79476,2018-12-16 11:00:00,24,1,25
"17152",10401,"Mount Pearl","NL",47.50513,-52.79476,2018-12-16 12:00:00,26,1,27
"17153",10401,"Mount Pearl","NL",47.50513,-52.79476,2018-12-16 13:00:00,27,1,28
"17154",10401,"Mount Pearl","NL",47.50513,-52.79476,2018-12-16 14:00:00,29,0,29
"17155",10401,"Mount Pearl","NL",47.50513,-52.79476,2018-12-16 15:00:00,30,1,31
"17156",10401,"Mount Pearl","NL",47.50513,-52.79476,2018-12-16 16:00:00,31,1,32
"17157",10401,"Mount Pearl","NL",47.50513,-52.79476,2018-12-16 17:00:00,30,1,31
"17158",10401,"Mount Pearl","NL",47.50513,-52.79476,2018-12-16 18:00:00,32,1,33
"17159",10401,"Mount Pearl","NL",47.50513,-52.79476,2018-12-16 19:00:00,33,1,34
"17160",10401,"Mount Pearl","NL",47.50513,-52.79476,2018-12-16 20:00:00,32,0,32
"17161",10401,"Mount Pearl","NL",47.50513,-52.79476,2018-12-16 21:00:00,32,1,33
"17162",10401,"Mount Pearl","NL",47.50513,-52.79476,2018-12-16 22:00:00,32,1,33
"17163",10401,"Mount Pearl","NL",47.50513,-52.79476,2018-12-16 23:00:00,32,1,33
"17164",10401,"Mount Pearl","NL",47.50513,-52.79476,2018-12-17 00:00:00,33,1,34
"17165",10401,"Mount Pearl","NL",47.50513,-52.79476,2018-12-17 01:00:00,33,1,34
"17166",10401,"Mount Pearl","NL",47.50513,-52.79476,2018-12-17 02:00:00,33,0,33
"17167",10401,"Mount Pearl","NL",47.50513,-52.79476,2018-12-17 03:00:00,32,0,32
"17168",10401,"Mount Pearl","NL",47.50513,-52.79476,2018-12-17 04:00:00,31,1,32
"17169",10401,"Mount Pearl","NL",47.50513,-52.79476,2018-12-17 05:00:00,31,1,32
"17170",10401,"Mount Pearl","NL",47.50513,-52.79476,2018-12-17 06:00:00,28,8,36
"17171",10401,"Mount Pearl","NL",47.50513,-52.79476,2018-12-17 07:00:00,20,13,33
"17172",10401,"Mount Pearl","NL",47.50513,-52.79476,2018-12-17 08:00:00,8,36,44
"17173",10401,"Mount Pearl","NL",47.50513,-52.79476,2018-12-17 09:00:00,13,26,39
"17174",10401,"Mount Pearl","NL",47.50513,-52.79476,2018-12-17 10:00:00,20,14,34
"17175",10401,"Mount Pearl","NL",47.50513,-52.79476,2018-12-17 11:00:00,26,4,30
"17176",10401,"Mount Pearl","NL",47.50513,-52.79476,2018-12-17 12:00:00,29,1,30
"17177",10401,"Mount Pearl","NL",47.50513,-52.79476,2018-12-17 13:00:00,29,1,30
"17178",10401,"Mount Pearl","NL",47.50513,-52.79476,2018-12-17 14:00:00,30,1,31
"17179",10401,"Mount Pearl","NL",47.50513,-52.79476,2018-12-17 15:00:00,29,3,32
"17180",10401,"Mount Pearl","NL",47.50513,-52.79476,2018-12-17 16:00:00,29,5,34
"17181",10401,"Mount Pearl","NL",47.50513,-52.79476,2018-12-17 17:00:00,30,4,34
"17182",10401,"Mount Pearl","NL",47.50513,-52.79476,2018-12-17 18:00:00,32,2,34
"17183",10401,"Mount Pearl","NL",47.50513,-52.79476,2018-12-17 19:00:00,33,1,34
"17184",10401,"Mount Pearl","NL",47.50513,-52.79476,2018-12-17 20:00:00,34,1,35
"17185",10401,"Mount Pearl","NL",47.50513,-52.79476,2018-12-17 21:00:00,34,0,34
"17186",10401,"Mount Pearl","NL",47.50513,-52.79476,2018-12-17 22:00:00,34,0,34
"17187",10401,"Mount Pearl","NL",47.50513,-52.79476,2018-12-17 23:00:00,34,0,34
"17188",10401,"Mount Pearl","NL",47.50513,-52.79476,2018-12-18 00:00:00,35,0,35
"17189",10401,"Mount Pearl","NL",47.50513,-52.79476,2018-12-18 01:00:00,36,0,36
"17190",10401,"Mount Pearl","NL",47.50513,-52.79476,2018-12-18 02:00:00,36,0,36
"17191",10401,"Mount Pearl","NL",47.50513,-52.79476,2018-12-18 03:00:00,36,0,36
"17192",10401,"Mount Pearl","NL",47.50513,-52.79476,2018-12-18 04:00:00,36,1,37
"17193",10401,"Mount Pearl","NL",47.50513,-52.79476,2018-12-18 05:00:00,37,1,38
"17194",10401,"Mount Pearl","NL",47.50513,-52.79476,2018-12-18 06:00:00,38,0,38
"17195",10401,"Mount Pearl","NL",47.50513,-52.79476,2018-12-18 07:00:00,37,2,39
"17196",10401,"Mount Pearl","NL",47.50513,-52.79476,2018-12-18 08:00:00,37,1,38
"17197",10401,"Mount Pearl","NL",47.50513,-52.79476,2018-12-18 09:00:00,37,2,39
"17198",10401,"Mount Pearl","NL",47.50513,-52.79476,2018-12-18 10:00:00,35,3,38
"17199",10401,"Mount Pearl","NL",47.50513,-52.79476,2018-12-18 11:00:00,35,2,37
"17200",10401,"Mount Pearl","NL",47.50513,-52.79476,2018-12-18 12:00:00,32,4,36
"17201",10401,"Mount Pearl","NL",47.50513,-52.79476,2018-12-18 13:00:00,31,3,34
"17202",10401,"Mount Pearl","NL",47.50513,-52.79476,2018-12-18 14:00:00,31,1,32
"17203",10401,"Mount Pearl","NL",47.50513,-52.79476,2018-12-18 15:00:00,29,2,31
"17204",10401,"Mount Pearl","NL",47.50513,-52.79476,2018-12-18 16:00:00,27,4,31
"17205",10401,"Mount Pearl","NL",47.50513,-52.79476,2018-12-18 17:00:00,23,10,33
"17206",10401,"Mount Pearl","NL",47.50513,-52.79476,2018-12-18 18:00:00,22,15,37
"17207",10401,"Mount Pearl","NL",47.50513,-52.79476,2018-12-18 19:00:00,26,4,30
"17208",10401,"Mount Pearl","NL",47.50513,-52.79476,2018-12-18 20:00:00,26,3,29
"17209",10401,"Mount Pearl","NL",47.50513,-52.79476,2018-12-18 21:00:00,29,3,32
"17210",10401,"Mount Pearl","NL",47.50513,-52.79476,2018-12-18 22:00:00,31,2,33
"17211",10401,"Mount Pearl","NL",47.50513,-52.79476,2018-12-18 23:00:00,31,2,33
"17212",10401,"Mount Pearl","NL",47.50513,-52.79476,2018-12-19 00:00:00,30,3,33
"17213",10401,"Mount Pearl","NL",47.50513,-52.79476,2018-12-19 01:00:00,31,1,32
"17214",10401,"Mount Pearl","NL",47.50513,-52.79476,2018-12-19 02:00:00,29,1,30
"17215",10401,"Mount Pearl","NL",47.50513,-52.79476,2018-12-19 03:00:00,30,1,31
"17216",10401,"Mount Pearl","NL",47.50513,-52.79476,2018-12-19 04:00:00,30,0,30
"17217",10401,"Mount Pearl","NL",47.50513,-52.79476,2018-12-19 05:00:00,29,1,30
"17218",10401,"Mount Pearl","NL",47.50513,-52.79476,2018-12-19 06:00:00,29,0,29
"17219",10401,"Mount Pearl","NL",47.50513,-52.79476,2018-12-19 07:00:00,29,0,29
"17220",10401,"Mount Pearl","NL",47.50513,-52.79476,2018-12-19 08:00:00,28,1,29
"17221",10401,"Mount Pearl","NL",47.50513,-52.79476,2018-12-19 09:00:00,28,1,29
"17222",10401,"Mount Pearl","NL",47.50513,-52.79476,2018-12-19 10:00:00,27,2,29
"17223",10401,"Mount Pearl","NL",47.50513,-52.79476,2018-12-19 11:00:00,25,5,30
"17224",10401,"Mount Pearl","NL",47.50513,-52.79476,2018-12-19 12:00:00,25,4,29
"17225",10401,"Mount Pearl","NL",47.50513,-52.79476,2018-12-19 13:00:00,26,2,28
"17226",10401,"Mount Pearl","NL",47.50513,-52.79476,2018-12-19 14:00:00,25,3,28
"17227",10401,"Mount Pearl","NL",47.50513,-52.79476,2018-12-19 15:00:00,26,2,28
"17228",10401,"Mount Pearl","NL",47.50513,-52.79476,2018-12-19 16:00:00,27,2,29
"17229",10401,"Mount Pearl","NL",47.50513,-52.79476,2018-12-19 17:00:00,27,2,29
"17230",10401,"Mount Pearl","NL",47.50513,-52.79476,2018-12-19 18:00:00,27,2,29
"17231",10401,"Mount Pearl","NL",47.50513,-52.79476,2018-12-19 19:00:00,27,2,29
"17232",10401,"Mount Pearl","NL",47.50513,-52.79476,2018-12-19 20:00:00,28,1,29
"17233",10401,"Mount Pearl","NL",47.50513,-52.79476,2018-12-19 21:00:00,29,1,30
"17234",10401,"Mount Pearl","NL",47.50513,-52.79476,2018-12-19 22:00:00,30,1,31
"17235",10401,"Mount Pearl","NL",47.50513,-52.79476,2018-12-19 23:00:00,30,1,31
"17236",10401,"Mount Pearl","NL",47.50513,-52.79476,2018-12-20 00:00:00,29,3,32
"17237",10401,"Mount Pearl","NL",47.50513,-52.79476,2018-12-20 01:00:00,31,2,33
"17238",10401,"Mount Pearl","NL",47.50513,-52.79476,2018-12-20 02:00:00,30,4,34
"17239",10401,"Mount Pearl","NL",47.50513,-52.79476,2018-12-20 03:00:00,30,4,34
"17240",10401,"Mount Pearl","NL",47.50513,-52.79476,2018-12-20 04:00:00,31,2,33
"17241",10401,"Mount Pearl","NL",47.50513,-52.79476,2018-12-20 05:00:00,31,1,32
"17242",10401,"Mount Pearl","NL",47.50513,-52.79476,2018-12-20 06:00:00,30,1,31
"17243",10401,"Mount Pearl","NL",47.50513,-52.79476,2018-12-20 07:00:00,30,1,31
"17244",10401,"Mount Pearl","NL",47.50513,-52.79476,2018-12-20 08:00:00,29,2,31
"17245",10401,"Mount Pearl","NL",47.50513,-52.79476,2018-12-20 09:00:00,29,2,31
"17246",10401,"Mount Pearl","NL",47.50513,-52.79476,2018-12-20 10:00:00,28,2,30
"17247",10401,"Mount Pearl","NL",47.50513,-52.79476,2018-12-20 11:00:00,29,2,31
"17248",10401,"Mount Pearl","NL",47.50513,-52.79476,2018-12-20 12:00:00,30,1,31
"17249",10401,"Mount Pearl","NL",47.50513,-52.79476,2018-12-20 13:00:00,33,1,34
"17250",10401,"Mount Pearl","NL",47.50513,-52.79476,2018-12-20 14:00:00,34,2,36
"17251",10401,"Mount Pearl","NL",47.50513,-52.79476,2018-12-20 15:00:00,35,2,37
"17252",10401,"Mount Pearl","NL",47.50513,-52.79476,2018-12-20 16:00:00,35,2,37
"17253",10401,"Mount Pearl","NL",47.50513,-52.79476,2018-12-20 17:00:00,37,2,39
"17254",10401,"Mount Pearl","NL",47.50513,-52.79476,2018-12-20 18:00:00,37,1,38
"17255",10401,"Mount Pearl","NL",47.50513,-52.79476,2018-12-20 19:00:00,37,2,39
"17256",10401,"Mount Pearl","NL",47.50513,-52.79476,2018-12-20 20:00:00,37,1,38
"17257",10401,"Mount Pearl","NL",47.50513,-52.79476,2018-12-20 21:00:00,37,1,38
"17258",10401,"Mount Pearl","NL",47.50513,-52.79476,2018-12-20 22:00:00,37,0,37
"17259",10401,"Mount Pearl","NL",47.50513,-52.79476,2018-12-20 23:00:00,37,1,38
"17260",10401,"Mount Pearl","NL",47.50513,-52.79476,2018-12-21 00:00:00,36,0,36
"17261",10401,"Mount Pearl","NL",47.50513,-52.79476,2018-12-21 01:00:00,36,0,36
"17262",10401,"Mount Pearl","NL",47.50513,-52.79476,2018-12-21 02:00:00,35,0,35
"17263",10401,"Mount Pearl","NL",47.50513,-52.79476,2018-12-21 03:00:00,35,0,35
"17264",10401,"Mount Pearl","NL",47.50513,-52.79476,2018-12-21 04:00:00,35,1,36
"17265",10401,"Mount Pearl","NL",47.50513,-52.79476,2018-12-21 05:00:00,35,1,36
"17266",10401,"Mount Pearl","NL",47.50513,-52.79476,2018-12-21 06:00:00,34,1,35
"17267",10401,"Mount Pearl","NL",47.50513,-52.79476,2018-12-21 07:00:00,34,1,35
"17268",10401,"Mount Pearl","NL",47.50513,-52.79476,2018-12-21 08:00:00,33,2,35
"17269",10401,"Mount Pearl","NL",47.50513,-52.79476,2018-12-21 09:00:00,32,3,35
"17270",10401,"Mount Pearl","NL",47.50513,-52.79476,2018-12-21 10:00:00,33,2,35
"17271",10401,"Mount Pearl","NL",47.50513,-52.79476,2018-12-21 11:00:00,32,2,34
"17272",10401,"Mount Pearl","NL",47.50513,-52.79476,2018-12-21 12:00:00,33,3,36
"17273",10401,"Mount Pearl","NL",47.50513,-52.79476,2018-12-21 13:00:00,33,3,36
"17274",10401,"Mount Pearl","NL",47.50513,-52.79476,2018-12-21 14:00:00,33,2,35
"17275",10401,"Mount Pearl","NL",47.50513,-52.79476,2018-12-21 15:00:00,32,3,35
"17276",10401,"Mount Pearl","NL",47.50513,-52.79476,2018-12-21 16:00:00,31,5,36
"17277",10401,"Mount Pearl","NL",47.50513,-52.79476,2018-12-21 17:00:00,30,6,36
"17278",10401,"Mount Pearl","NL",47.50513,-52.79476,2018-12-21 18:00:00,30,5,35
"17279",10401,"Mount Pearl","NL",47.50513,-52.79476,2018-12-21 19:00:00,30,4,34
"17280",10401,"Mount Pearl","NL",47.50513,-52.79476,2018-12-21 20:00:00,29,6,35
"17281",10401,"Mount Pearl","NL",47.50513,-52.79476,2018-12-21 21:00:00,27,7,34
"17282",10401,"Mount Pearl","NL",47.50513,-52.79476,2018-12-21 22:00:00,28,6,34
"17283",10401,"Mount Pearl","NL",47.50513,-52.79476,2018-12-21 23:00:00,27,6,33
"17284",10401,"Mount Pearl","NL",47.50513,-52.79476,2018-12-22 00:00:00,23,10,33
"17285",10401,"Mount Pearl","NL",47.50513,-52.79476,2018-12-22 01:00:00,19,14,33
"17286",10401,"Mount Pearl","NL",47.50513,-52.79476,2018-12-22 02:00:00,15,17,32
"17287",10401,"Mount Pearl","NL",47.50513,-52.79476,2018-12-22 03:00:00,16,11,27
"17288",10401,"Mount Pearl","NL",47.50513,-52.79476,2018-12-22 04:00:00,15,9,24
"17289",10401,"Mount Pearl","NL",47.50513,-52.79476,2018-12-22 05:00:00,19,6,25
"17290",10401,"Mount Pearl","NL",47.50513,-52.79476,2018-12-22 06:00:00,20,5,25
"17291",10401,"Mount Pearl","NL",47.50513,-52.79476,2018-12-22 07:00:00,20,6,26
"17292",10401,"Mount Pearl","NL",47.50513,-52.79476,2018-12-22 08:00:00,22,8,30
"17293",10401,"Mount Pearl","NL",47.50513,-52.79476,2018-12-22 09:00:00,24,5,29
"17294",10401,"Mount Pearl","NL",47.50513,-52.79476,2018-12-22 10:00:00,23,5,28
"17295",10401,"Mount Pearl","NL",47.50513,-52.79476,2018-12-22 11:00:00,25,4,29
"17296",10401,"Mount Pearl","NL",47.50513,-52.79476,2018-12-22 12:00:00,26,3,29
"17297",10401,"Mount Pearl","NL",47.50513,-52.79476,2018-12-22 13:00:00,28,2,30
"17298",10401,"Mount Pearl","NL",47.50513,-52.79476,2018-12-22 14:00:00,29,2,31
"17299",10401,"Mount Pearl","NL",47.50513,-52.79476,2018-12-22 15:00:00,29,1,30
"17300",10401,"Mount Pearl","NL",47.50513,-52.79476,2018-12-22 16:00:00,30,1,31
"17301",10401,"Mount Pearl","NL",47.50513,-52.79476,2018-12-22 17:00:00,30,2,32
"17302",10401,"Mount Pearl","NL",47.50513,-52.79476,2018-12-22 18:00:00,31,1,32
"17303",10401,"Mount Pearl","NL",47.50513,-52.79476,2018-12-22 19:00:00,31,1,32
"17304",10401,"Mount Pearl","NL",47.50513,-52.79476,2018-12-22 20:00:00,31,1,32
"17305",10401,"Mount Pearl","NL",47.50513,-52.79476,2018-12-22 21:00:00,31,0,31
"17306",10401,"Mount Pearl","NL",47.50513,-52.79476,2018-12-22 22:00:00,32,1,33
"17307",10401,"Mount Pearl","NL",47.50513,-52.79476,2018-12-22 23:00:00,33,0,33
"17308",10401,"Mount Pearl","NL",47.50513,-52.79476,2018-12-23 00:00:00,34,0,34
"17309",10401,"Mount Pearl","NL",47.50513,-52.79476,2018-12-23 01:00:00,34,0,34
"17310",10401,"Mount Pearl","NL",47.50513,-52.79476,2018-12-23 02:00:00,34,1,35
"17311",10401,"Mount Pearl","NL",47.50513,-52.79476,2018-12-23 03:00:00,34,1,35
"17312",10401,"Mount Pearl","NL",47.50513,-52.79476,2018-12-23 04:00:00,35,0,35
"17313",10401,"Mount Pearl","NL",47.50513,-52.79476,2018-12-23 05:00:00,35,0,35
"17314",10401,"Mount Pearl","NL",47.50513,-52.79476,2018-12-23 06:00:00,36,0,36
"17315",10401,"Mount Pearl","NL",47.50513,-52.79476,2018-12-23 07:00:00,37,1,38
"17316",10401,"Mount Pearl","NL",47.50513,-52.79476,2018-12-23 08:00:00,37,1,38
"17317",10401,"Mount Pearl","NL",47.50513,-52.79476,2018-12-23 09:00:00,36,1,37
"17318",10401,"Mount Pearl","NL",47.50513,-52.79476,2018-12-23 10:00:00,36,1,37
"17319",10401,"Mount Pearl","NL",47.50513,-52.79476,2018-12-23 11:00:00,36,1,37
"17320",10401,"Mount Pearl","NL",47.50513,-52.79476,2018-12-23 12:00:00,38,0,38
"17321",10401,"Mount Pearl","NL",47.50513,-52.79476,2018-12-23 13:00:00,31,1,32
"17322",10401,"Mount Pearl","NL",47.50513,-52.79476,2018-12-23 14:00:00,25,1,26
"17323",10401,"Mount Pearl","NL",47.50513,-52.79476,2018-12-23 15:00:00,22,2,24
"17324",10401,"Mount Pearl","NL",47.50513,-52.79476,2018-12-23 16:00:00,19,1,20
"17325",10401,"Mount Pearl","NL",47.50513,-52.79476,2018-12-23 17:00:00,18,1,19
"17326",10401,"Mount Pearl","NL",47.50513,-52.79476,2018-12-23 18:00:00,17,1,18
"17327",10401,"Mount Pearl","NL",47.50513,-52.79476,2018-12-23 19:00:00,16,1,17
"17328",10401,"Mount Pearl","NL",47.50513,-52.79476,2018-12-23 20:00:00,21,1,22
"17329",10401,"Mount Pearl","NL",47.50513,-52.79476,2018-12-23 21:00:00,24,1,25
"17330",10401,"Mount Pearl","NL",47.50513,-52.79476,2018-12-23 22:00:00,24,5,29
"17331",10401,"Mount Pearl","NL",47.50513,-52.79476,2018-12-23 23:00:00,24,7,31
"17332",10401,"Mount Pearl","NL",47.50513,-52.79476,2018-12-24 00:00:00,27,0,27
"17333",10401,"Mount Pearl","NL",47.50513,-52.79476,2018-12-24 01:00:00,27,0,27
"17334",10401,"Mount Pearl","NL",47.50513,-52.79476,2018-12-24 02:00:00,31,0,31
"17335",10401,"Mount Pearl","NL",47.50513,-52.79476,2018-12-24 03:00:00,31,0,31
"17336",10401,"Mount Pearl","NL",47.50513,-52.79476,2018-12-24 04:00:00,32,0,32
"17337",10401,"Mount Pearl","NL",47.50513,-52.79476,2018-12-24 05:00:00,32,0,32
"17338",10401,"Mount Pearl","NL",47.50513,-52.79476,2018-12-24 06:00:00,33,2,35
"17339",10401,"Mount Pearl","NL",47.50513,-52.79476,2018-12-24 07:00:00,33,2,35
"17340",10401,"Mount Pearl","NL",47.50513,-52.79476,2018-12-24 08:00:00,32,3,35
"17341",10401,"Mount Pearl","NL",47.50513,-52.79476,2018-12-24 09:00:00,33,3,36
"17342",10401,"Mount Pearl","NL",47.50513,-52.79476,2018-12-24 10:00:00,33,2,35
"17343",10401,"Mount Pearl","NL",47.50513,-52.79476,2018-12-24 11:00:00,33,1,34
"17344",10401,"Mount Pearl","NL",47.50513,-52.79476,2018-12-24 12:00:00,33,3,36
"17345",10401,"Mount Pearl","NL",47.50513,-52.79476,2018-12-24 13:00:00,33,3,36
"17346",10401,"Mount Pearl","NL",47.50513,-52.79476,2018-12-24 14:00:00,33,4,37
"17347",10401,"Mount Pearl","NL",47.50513,-52.79476,2018-12-24 15:00:00,34,3,37
"17348",10401,"Mount Pearl","NL",47.50513,-52.79476,2018-12-24 16:00:00,35,3,38
"17349",10401,"Mount Pearl","NL",47.50513,-52.79476,2018-12-24 17:00:00,36,3,39
"17350",10401,"Mount Pearl","NL",47.50513,-52.79476,2018-12-24 18:00:00,36,3,39
"17351",10401,"Mount Pearl","NL",47.50513,-52.79476,2018-12-24 19:00:00,37,3,40
"17352",10401,"Mount Pearl","NL",47.50513,-52.79476,2018-12-24 20:00:00,36,4,40
"17353",10401,"Mount Pearl","NL",47.50513,-52.79476,2018-12-24 21:00:00,37,3,40
"17354",10401,"Mount Pearl","NL",47.50513,-52.79476,2018-12-24 22:00:00,37,3,40
"17355",10401,"Mount Pearl","NL",47.50513,-52.79476,2018-12-24 23:00:00,38,3,41
"17356",10401,"Mount Pearl","NL",47.50513,-52.79476,2018-12-25 00:00:00,37,2,39
"17357",10401,"Mount Pearl","NL",47.50513,-52.79476,2018-12-25 01:00:00,37,2,39
"17358",10401,"Mount Pearl","NL",47.50513,-52.79476,2018-12-25 02:00:00,37,2,39
"17359",10401,"Mount Pearl","NL",47.50513,-52.79476,2018-12-25 03:00:00,36,2,38
"17360",10401,"Mount Pearl","NL",47.50513,-52.79476,2018-12-25 04:00:00,35,3,38
"17361",10401,"Mount Pearl","NL",47.50513,-52.79476,2018-12-25 05:00:00,31,7,38
"17362",10401,"Mount Pearl","NL",47.50513,-52.79476,2018-12-25 06:00:00,33,4,37
"17363",10401,"Mount Pearl","NL",47.50513,-52.79476,2018-12-25 07:00:00,33,3,36
"17364",10401,"Mount Pearl","NL",47.50513,-52.79476,2018-12-25 08:00:00,32,2,34
"17365",10401,"Mount Pearl","NL",47.50513,-52.79476,2018-12-25 09:00:00,31,2,33
"17366",10401,"Mount Pearl","NL",47.50513,-52.79476,2018-12-25 10:00:00,31,2,33
"17367",10401,"Mount Pearl","NL",47.50513,-52.79476,2018-12-25 11:00:00,33,2,35
"17368",10401,"Mount Pearl","NL",47.50513,-52.79476,2018-12-25 12:00:00,34,2,36
"17369",10401,"Mount Pearl","NL",47.50513,-52.79476,2018-12-25 13:00:00,31,5,36
"17370",10401,"Mount Pearl","NL",47.50513,-52.79476,2018-12-25 14:00:00,31,9,40
"17371",10401,"Mount Pearl","NL",47.50513,-52.79476,2018-12-25 15:00:00,32,7,39
"17372",10401,"Mount Pearl","NL",47.50513,-52.79476,2018-12-25 16:00:00,33,3,36
"17373",10401,"Mount Pearl","NL",47.50513,-52.79476,2018-12-25 17:00:00,31,4,35
"17374",10401,"Mount Pearl","NL",47.50513,-52.79476,2018-12-25 18:00:00,32,5,37
"17375",10401,"Mount Pearl","NL",47.50513,-52.79476,2018-12-25 19:00:00,35,3,38
"17376",10401,"Mount Pearl","NL",47.50513,-52.79476,2018-12-25 20:00:00,36,2,38
"17377",10401,"Mount Pearl","NL",47.50513,-52.79476,2018-12-25 21:00:00,35,3,38
"17378",10401,"Mount Pearl","NL",47.50513,-52.79476,2018-12-25 22:00:00,31,9,40
"17379",10401,"Mount Pearl","NL",47.50513,-52.79476,2018-12-25 23:00:00,30,9,39
"17380",10401,"Mount Pearl","NL",47.50513,-52.79476,2018-12-26 00:00:00,35,3,38
"17381",10401,"Mount Pearl","NL",47.50513,-52.79476,2018-12-26 01:00:00,36,2,38
"17382",10401,"Mount Pearl","NL",47.50513,-52.79476,2018-12-26 02:00:00,37,1,38
"17383",10401,"Mount Pearl","NL",47.50513,-52.79476,2018-12-26 03:00:00,37,1,38
"17384",10401,"Mount Pearl","NL",47.50513,-52.79476,2018-12-26 04:00:00,38,1,39
"17385",10401,"Mount Pearl","NL",47.50513,-52.79476,2018-12-26 05:00:00,38,1,39
"17386",10401,"Mount Pearl","NL",47.50513,-52.79476,2018-12-26 06:00:00,39,1,40
"17387",10401,"Mount Pearl","NL",47.50513,-52.79476,2018-12-26 07:00:00,39,1,40
"17388",10401,"Mount Pearl","NL",47.50513,-52.79476,2018-12-26 08:00:00,39,2,41
"17389",10401,"Mount Pearl","NL",47.50513,-52.79476,2018-12-26 09:00:00,39,1,40
"17390",10401,"Mount Pearl","NL",47.50513,-52.79476,2018-12-26 10:00:00,40,1,41
"17391",10401,"Mount Pearl","NL",47.50513,-52.79476,2018-12-26 11:00:00,39,2,41
"17392",10401,"Mount Pearl","NL",47.50513,-52.79476,2018-12-26 12:00:00,40,1,41
"17393",10401,"Mount Pearl","NL",47.50513,-52.79476,2018-12-26 13:00:00,40,1,41
"17394",10401,"Mount Pearl","NL",47.50513,-52.79476,2018-12-26 14:00:00,40,1,41
"17395",10401,"Mount Pearl","NL",47.50513,-52.79476,2018-12-26 15:00:00,39,1,40
"17396",10401,"Mount Pearl","NL",47.50513,-52.79476,2018-12-26 16:00:00,39,1,40
"17397",10401,"Mount Pearl","NL",47.50513,-52.79476,2018-12-26 17:00:00,40,1,41
"17398",10401,"Mount Pearl","NL",47.50513,-52.79476,2018-12-26 18:00:00,39,2,41
"17399",10401,"Mount Pearl","NL",47.50513,-52.79476,2018-12-26 19:00:00,39,1,40
"17400",10401,"Mount Pearl","NL",47.50513,-52.79476,2018-12-26 20:00:00,40,2,42
"17401",10401,"Mount Pearl","NL",47.50513,-52.79476,2018-12-26 21:00:00,40,2,42
"17402",10401,"Mount Pearl","NL",47.50513,-52.79476,2018-12-26 22:00:00,40,1,41
"17403",10401,"Mount Pearl","NL",47.50513,-52.79476,2018-12-26 23:00:00,40,1,41
"17404",10401,"Mount Pearl","NL",47.50513,-52.79476,2018-12-27 00:00:00,39,1,40
"17405",10401,"Mount Pearl","NL",47.50513,-52.79476,2018-12-27 01:00:00,40,2,42
"17406",10401,"Mount Pearl","NL",47.50513,-52.79476,2018-12-27 02:00:00,40,1,41
"17407",10401,"Mount Pearl","NL",47.50513,-52.79476,2018-12-27 03:00:00,39,1,40
"17408",10401,"Mount Pearl","NL",47.50513,-52.79476,2018-12-27 04:00:00,36,5,41
"17409",10401,"Mount Pearl","NL",47.50513,-52.79476,2018-12-27 05:00:00,35,8,43
"17410",10401,"Mount Pearl","NL",47.50513,-52.79476,2018-12-27 06:00:00,36,4,40
"17411",10401,"Mount Pearl","NL",47.50513,-52.79476,2018-12-27 07:00:00,29,15,44
"17412",10401,"Mount Pearl","NL",47.50513,-52.79476,2018-12-27 08:00:00,33,8,41
"17413",10401,"Mount Pearl","NL",47.50513,-52.79476,2018-12-27 09:00:00,30,12,42
"17414",10401,"Mount Pearl","NL",47.50513,-52.79476,2018-12-27 10:00:00,30,9,39
"17415",10401,"Mount Pearl","NL",47.50513,-52.79476,2018-12-27 11:00:00,30,10,40
"17416",10401,"Mount Pearl","NL",47.50513,-52.79476,2018-12-27 12:00:00,34,4,38
"17417",10401,"Mount Pearl","NL",47.50513,-52.79476,2018-12-27 13:00:00,37,1,38
"17418",10401,"Mount Pearl","NL",47.50513,-52.79476,2018-12-27 14:00:00,38,1,39
"17419",10401,"Mount Pearl","NL",47.50513,-52.79476,2018-12-27 15:00:00,38,2,40
"17420",10401,"Mount Pearl","NL",47.50513,-52.79476,2018-12-27 16:00:00,38,2,40
"17421",10401,"Mount Pearl","NL",47.50513,-52.79476,2018-12-27 17:00:00,38,3,41
"17422",10401,"Mount Pearl","NL",47.50513,-52.79476,2018-12-27 18:00:00,38,3,41
"17423",10401,"Mount Pearl","NL",47.50513,-52.79476,2018-12-27 19:00:00,37,4,41
"17424",10401,"Mount Pearl","NL",47.50513,-52.79476,2018-12-27 20:00:00,36,3,39
"17425",10401,"Mount Pearl","NL",47.50513,-52.79476,2018-12-27 21:00:00,37,1,38
"17426",10401,"Mount Pearl","NL",47.50513,-52.79476,2018-12-27 22:00:00,38,1,39
"17427",10401,"Mount Pearl","NL",47.50513,-52.79476,2018-12-27 23:00:00,38,1,39
"17428",10401,"Mount Pearl","NL",47.50513,-52.79476,2018-12-28 00:00:00,38,0,38
"17429",10401,"Mount Pearl","NL",47.50513,-52.79476,2018-12-28 01:00:00,38,1,39
"17430",10401,"Mount Pearl","NL",47.50513,-52.79476,2018-12-28 02:00:00,36,0,36
"17431",10401,"Mount Pearl","NL",47.50513,-52.79476,2018-12-28 03:00:00,36,0,36
"17432",10401,"Mount Pearl","NL",47.50513,-52.79476,2018-12-28 04:00:00,35,0,35
"17433",10401,"Mount Pearl","NL",47.50513,-52.79476,2018-12-28 05:00:00,35,0,35
"17434",10401,"Mount Pearl","NL",47.50513,-52.79476,2018-12-28 06:00:00,34,1,35
"17435",10401,"Mount Pearl","NL",47.50513,-52.79476,2018-12-28 07:00:00,32,2,34
"17436",10401,"Mount Pearl","NL",47.50513,-52.79476,2018-12-28 08:00:00,31,3,34
"17437",10401,"Mount Pearl","NL",47.50513,-52.79476,2018-12-28 09:00:00,32,1,33
"17438",10401,"Mount Pearl","NL",47.50513,-52.79476,2018-12-28 10:00:00,31,2,33
"17439",10401,"Mount Pearl","NL",47.50513,-52.79476,2018-12-28 11:00:00,32,2,34
"17440",10401,"Mount Pearl","NL",47.50513,-52.79476,2018-12-28 12:00:00,31,3,34
"17441",10401,"Mount Pearl","NL",47.50513,-52.79476,2018-12-28 13:00:00,33,2,35
"17442",10401,"Mount Pearl","NL",47.50513,-52.79476,2018-12-28 14:00:00,33,2,35
"17443",10401,"Mount Pearl","NL",47.50513,-52.79476,2018-12-28 15:00:00,33,2,35
"17444",10401,"Mount Pearl","NL",47.50513,-52.79476,2018-12-28 16:00:00,33,2,35
"17445",10401,"Mount Pearl","NL",47.50513,-52.79476,2018-12-28 17:00:00,32,5,37
"17446",10401,"Mount Pearl","NL",47.50513,-52.79476,2018-12-28 18:00:00,31,5,36
"17447",10401,"Mount Pearl","NL",47.50513,-52.79476,2018-12-28 19:00:00,33,4,37
"17448",10401,"Mount Pearl","NL",47.50513,-52.79476,2018-12-28 20:00:00,33,3,36
"17449",10401,"Mount Pearl","NL",47.50513,-52.79476,2018-12-28 21:00:00,33,4,37
"17450",10401,"Mount Pearl","NL",47.50513,-52.79476,2018-12-28 22:00:00,30,8,38
"17451",10401,"Mount Pearl","NL",47.50513,-52.79476,2018-12-28 23:00:00,27,13,40
"17452",10401,"Mount Pearl","NL",47.50513,-52.79476,2018-12-29 00:00:00,26,10,36
"17453",10401,"Mount Pearl","NL",47.50513,-52.79476,2018-12-29 01:00:00,23,11,34
"17454",10401,"Mount Pearl","NL",47.50513,-52.79476,2018-12-29 02:00:00,22,10,32
"17455",10401,"Mount Pearl","NL",47.50513,-52.79476,2018-12-29 03:00:00,24,7,31
"17456",10401,"Mount Pearl","NL",47.50513,-52.79476,2018-12-29 04:00:00,22,10,32
"17457",10401,"Mount Pearl","NL",47.50513,-52.79476,2018-12-29 05:00:00,24,6,30
"17458",10401,"Mount Pearl","NL",47.50513,-52.79476,2018-12-29 06:00:00,25,6,31
"17459",10401,"Mount Pearl","NL",47.50513,-52.79476,2018-12-29 07:00:00,26,7,33
"17460",10401,"Mount Pearl","NL",47.50513,-52.79476,2018-12-29 08:00:00,26,8,34
"17461",10401,"Mount Pearl","NL",47.50513,-52.79476,2018-12-29 09:00:00,29,3,32
"17462",10401,"Mount Pearl","NL",47.50513,-52.79476,2018-12-29 10:00:00,29,4,33
"17463",10401,"Mount Pearl","NL",47.50513,-52.79476,2018-12-29 11:00:00,32,3,35
"17464",10401,"Mount Pearl","NL",47.50513,-52.79476,2018-12-29 12:00:00,35,1,36
"17465",10401,"Mount Pearl","NL",47.50513,-52.79476,2018-12-29 13:00:00,35,1,36
"17466",10401,"Mount Pearl","NL",47.50513,-52.79476,2018-12-29 14:00:00,36,2,38
"17467",10401,"Mount Pearl","NL",47.50513,-52.79476,2018-12-29 15:00:00,37,2,39
"17468",10401,"Mount Pearl","NL",47.50513,-52.79476,2018-12-29 16:00:00,38,3,41
"17469",10401,"Mount Pearl","NL",47.50513,-52.79476,2018-12-29 17:00:00,38,2,40
"17470",10401,"Mount Pearl","NL",47.50513,-52.79476,2018-12-29 18:00:00,37,1,38
"17471",10401,"Mount Pearl","NL",47.50513,-52.79476,2018-12-29 19:00:00,37,1,38
"17472",10401,"Mount Pearl","NL",47.50513,-52.79476,2018-12-29 20:00:00,37,1,38
"17473",10401,"Mount Pearl","NL",47.50513,-52.79476,2018-12-29 21:00:00,37,1,38
"17474",10401,"Mount Pearl","NL",47.50513,-52.79476,2018-12-29 22:00:00,37,0,37
"17475",10401,"Mount Pearl","NL",47.50513,-52.79476,2018-12-29 23:00:00,36,1,37
"17476",10401,"Mount Pearl","NL",47.50513,-52.79476,2018-12-30 00:00:00,37,0,37
"17477",10401,"Mount Pearl","NL",47.50513,-52.79476,2018-12-30 01:00:00,36,2,38
"17478",10401,"Mount Pearl","NL",47.50513,-52.79476,2018-12-30 02:00:00,36,2,38
"17479",10401,"Mount Pearl","NL",47.50513,-52.79476,2018-12-30 03:00:00,36,1,37
"17480",10401,"Mount Pearl","NL",47.50513,-52.79476,2018-12-30 04:00:00,35,4,39
"17481",10401,"Mount Pearl","NL",47.50513,-52.79476,2018-12-30 05:00:00,34,3,37
"17482",10401,"Mount Pearl","NL",47.50513,-52.79476,2018-12-30 06:00:00,34,3,37
"17483",10401,"Mount Pearl","NL",47.50513,-52.79476,2018-12-30 07:00:00,35,5,40
"17484",10401,"Mount Pearl","NL",47.50513,-52.79476,2018-12-30 08:00:00,35,3,38
"17485",10401,"Mount Pearl","NL",47.50513,-52.79476,2018-12-30 09:00:00,35,2,37
"17486",10401,"Mount Pearl","NL",47.50513,-52.79476,2018-12-30 10:00:00,35,3,38
"17487",10401,"Mount Pearl","NL",47.50513,-52.79476,2018-12-30 11:00:00,34,3,37
"17488",10401,"Mount Pearl","NL",47.50513,-52.79476,2018-12-30 12:00:00,35,1,36
"17489",10401,"Mount Pearl","NL",47.50513,-52.79476,2018-12-30 13:00:00,35,1,36
"17490",10401,"Mount Pearl","NL",47.50513,-52.79476,2018-12-30 14:00:00,35,1,36
"17491",10401,"Mount Pearl","NL",47.50513,-52.79476,2018-12-30 15:00:00,35,1,36
"17492",10401,"Mount Pearl","NL",47.50513,-52.79476,2018-12-30 16:00:00,35,1,36
"17493",10401,"Mount Pearl","NL",47.50513,-52.79476,2018-12-30 17:00:00,35,1,36
"17494",10401,"Mount Pearl","NL",47.50513,-52.79476,2018-12-30 18:00:00,35,1,36
"17495",10401,"Mount Pearl","NL",47.50513,-52.79476,2018-12-30 19:00:00,35,1,36
"17496",10401,"Mount Pearl","NL",47.50513,-52.79476,2018-12-30 20:00:00,35,0,35
"17497",10401,"Mount Pearl","NL",47.50513,-52.79476,2018-12-30 21:00:00,34,0,34
"17498",10401,"Mount Pearl","NL",47.50513,-52.79476,2018-12-30 22:00:00,35,1,36
"17499",10401,"Mount Pearl","NL",47.50513,-52.79476,2018-12-30 23:00:00,35,1,36
"17500",10401,"Mount Pearl","NL",47.50513,-52.79476,2018-12-31 00:00:00,35,0,35
"17501",10401,"Mount Pearl","NL",47.50513,-52.79476,2018-12-31 01:00:00,34,1,35
"17502",10401,"Mount Pearl","NL",47.50513,-52.79476,2018-12-31 02:00:00,34,0,34
"17503",10401,"Mount Pearl","NL",47.50513,-52.79476,2018-12-31 03:00:00,34,0,34
"17504",10401,"Mount Pearl","NL",47.50513,-52.79476,2018-12-31 04:00:00,34,1,35
"17505",10401,"Mount Pearl","NL",47.50513,-52.79476,2018-12-31 05:00:00,34,1,35
"17506",10401,"Mount Pearl","NL",47.50513,-52.79476,2018-12-31 06:00:00,34,1,35
"17507",10401,"Mount Pearl","NL",47.50513,-52.79476,2018-12-31 07:00:00,35,2,37
"17508",10401,"Mount Pearl","NL",47.50513,-52.79476,2018-12-31 08:00:00,35,1,36
"17509",10401,"Mount Pearl","NL",47.50513,-52.79476,2018-12-31 09:00:00,35,1,36
"17510",10401,"Mount Pearl","NL",47.50513,-52.79476,2018-12-31 10:00:00,35,2,37
"17511",10401,"Mount Pearl","NL",47.50513,-52.79476,2018-12-31 11:00:00,35,1,36
"17512",10401,"Mount Pearl","NL",47.50513,-52.79476,2018-12-31 12:00:00,34,1,35
"17513",10401,"Mount Pearl","NL",47.50513,-52.79476,2018-12-31 13:00:00,35,1,36
"17514",10401,"Mount Pearl","NL",47.50513,-52.79476,2018-12-31 14:00:00,35,1,36
"17515",10401,"Mount Pearl","NL",47.50513,-52.79476,2018-12-31 15:00:00,37,1,38
"17516",10401,"Mount Pearl","NL",47.50513,-52.79476,2018-12-31 16:00:00,37,1,38
"17517",10401,"Mount Pearl","NL",47.50513,-52.79476,2018-12-31 17:00:00,38,1,39
"17518",10401,"Mount Pearl","NL",47.50513,-52.79476,2018-12-31 18:00:00,37,1,38
"17519",10401,"Mount Pearl","NL",47.50513,-52.79476,2018-12-31 19:00:00,37,1,38
"17520",10401,"Mount Pearl","NL",47.50513,-52.79476,2018-12-31 20:00:00,37,0,37
"17521",10401,"Mount Pearl","NL",47.50513,-52.79476,2018-12-31 21:00:00,37,0,37
"17522",10401,"Mount Pearl","NL",47.50513,-52.79476,2018-12-31 22:00:00,36,0,36
"17523",10401,"Mount Pearl","NL",47.50513,-52.79476,2018-12-31 23:00:00,36,1,37
"17524",10401,"Mount Pearl","NL",47.50513,-52.79476,2019-01-01 00:00:00,36,0,36
"17525",10501,"Grand Falls-Windsor","NL",48.92696,-55.65966,2018-01-01 01:00:00,35,0,35
"17526",10501,"Grand Falls-Windsor","NL",48.92696,-55.65966,2018-01-01 02:00:00,35,1,36
"17527",10501,"Grand Falls-Windsor","NL",48.92696,-55.65966,2018-01-01 03:00:00,36,1,37
"17528",10501,"Grand Falls-Windsor","NL",48.92696,-55.65966,2018-01-01 04:00:00,36,1,37
"17529",10501,"Grand Falls-Windsor","NL",48.92696,-55.65966,2018-01-01 05:00:00,35,0,35
"17530",10501,"Grand Falls-Windsor","NL",48.92696,-55.65966,2018-01-01 06:00:00,34,0,34
"17531",10501,"Grand Falls-Windsor","NL",48.92696,-55.65966,2018-01-01 07:00:00,34,0,34
"17532",10501,"Grand Falls-Windsor","NL",48.92696,-55.65966,2018-01-01 08:00:00,33,1,34
"17533",10501,"Grand Falls-Windsor","NL",48.92696,-55.65966,2018-01-01 09:00:00,32,0,32
"17534",10501,"Grand Falls-Windsor","NL",48.92696,-55.65966,2018-01-01 10:00:00,31,0,31
"17535",10501,"Grand Falls-Windsor","NL",48.92696,-55.65966,2018-01-01 11:00:00,32,0,32
"17536",10501,"Grand Falls-Windsor","NL",48.92696,-55.65966,2018-01-01 12:00:00,35,0,35
"17537",10501,"Grand Falls-Windsor","NL",48.92696,-55.65966,2018-01-01 13:00:00,36,0,36
"17538",10501,"Grand Falls-Windsor","NL",48.92696,-55.65966,2018-01-01 14:00:00,37,1,38
"17539",10501,"Grand Falls-Windsor","NL",48.92696,-55.65966,2018-01-01 15:00:00,37,0,37
"17540",10501,"Grand Falls-Windsor","NL",48.92696,-55.65966,2018-01-01 16:00:00,37,1,38
"17541",10501,"Grand Falls-Windsor","NL",48.92696,-55.65966,2018-01-01 17:00:00,37,1,38
"17542",10501,"Grand Falls-Windsor","NL",48.92696,-55.65966,2018-01-01 18:00:00,35,0,35
"17543",10501,"Grand Falls-Windsor","NL",48.92696,-55.65966,2018-01-01 19:00:00,33,1,34
"17544",10501,"Grand Falls-Windsor","NL",48.92696,-55.65966,2018-01-01 20:00:00,33,3,36
"17545",10501,"Grand Falls-Windsor","NL",48.92696,-55.65966,2018-01-01 21:00:00,33,2,35
"17546",10501,"Grand Falls-Windsor","NL",48.92696,-55.65966,2018-01-01 22:00:00,33,2,35
"17547",10501,"Grand Falls-Windsor","NL",48.92696,-55.65966,2018-01-01 23:00:00,33,3,36
"17548",10501,"Grand Falls-Windsor","NL",48.92696,-55.65966,2018-01-02 00:00:00,34,3,37
"17549",10501,"Grand Falls-Windsor","NL",48.92696,-55.65966,2018-01-02 01:00:00,34,2,36
"17550",10501,"Grand Falls-Windsor","NL",48.92696,-55.65966,2018-01-02 02:00:00,36,1,37
"17551",10501,"Grand Falls-Windsor","NL",48.92696,-55.65966,2018-01-02 03:00:00,36,1,37
"17552",10501,"Grand Falls-Windsor","NL",48.92696,-55.65966,2018-01-02 04:00:00,32,3,35
"17553",10501,"Grand Falls-Windsor","NL",48.92696,-55.65966,2018-01-02 05:00:00,26,6,32
"17554",10501,"Grand Falls-Windsor","NL",48.92696,-55.65966,2018-01-02 06:00:00,25,3,28
"17555",10501,"Grand Falls-Windsor","NL",48.92696,-55.65966,2018-01-02 07:00:00,20,7,27
"17556",10501,"Grand Falls-Windsor","NL",48.92696,-55.65966,2018-01-02 08:00:00,18,7,25
"17557",10501,"Grand Falls-Windsor","NL",48.92696,-55.65966,2018-01-02 09:00:00,19,4,23
"17558",10501,"Grand Falls-Windsor","NL",48.92696,-55.65966,2018-01-02 10:00:00,22,3,25
"17559",10501,"Grand Falls-Windsor","NL",48.92696,-55.65966,2018-01-02 11:00:00,25,4,29
"17560",10501,"Grand Falls-Windsor","NL",48.92696,-55.65966,2018-01-02 12:00:00,27,3,30
"17561",10501,"Grand Falls-Windsor","NL",48.92696,-55.65966,2018-01-02 13:00:00,30,1,31
"17562",10501,"Grand Falls-Windsor","NL",48.92696,-55.65966,2018-01-02 14:00:00,36,1,37
"17563",10501,"Grand Falls-Windsor","NL",48.92696,-55.65966,2018-01-02 15:00:00,38,1,39
"17564",10501,"Grand Falls-Windsor","NL",48.92696,-55.65966,2018-01-02 16:00:00,38,1,39
"17565",10501,"Grand Falls-Windsor","NL",48.92696,-55.65966,2018-01-02 17:00:00,38,1,39
"17566",10501,"Grand Falls-Windsor","NL",48.92696,-55.65966,2018-01-02 18:00:00,32,4,36
"17567",10501,"Grand Falls-Windsor","NL",48.92696,-55.65966,2018-01-02 19:00:00,32,2,34
"17568",10501,"Grand Falls-Windsor","NL",48.92696,-55.65966,2018-01-02 20:00:00,32,0,32
"17569",10501,"Grand Falls-Windsor","NL",48.92696,-55.65966,2018-01-02 21:00:00,30,1,31
"17570",10501,"Grand Falls-Windsor","NL",48.92696,-55.65966,2018-01-02 22:00:00,30,1,31
"17571",10501,"Grand Falls-Windsor","NL",48.92696,-55.65966,2018-01-02 23:00:00,28,1,29
"17572",10501,"Grand Falls-Windsor","NL",48.92696,-55.65966,2018-01-03 00:00:00,30,0,30
"17573",10501,"Grand Falls-Windsor","NL",48.92696,-55.65966,2018-01-03 01:00:00,35,0,35
"17574",10501,"Grand Falls-Windsor","NL",48.92696,-55.65966,2018-01-03 02:00:00,35,0,35
"17575",10501,"Grand Falls-Windsor","NL",48.92696,-55.65966,2018-01-03 03:00:00,36,0,36
"17576",10501,"Grand Falls-Windsor","NL",48.92696,-55.65966,2018-01-03 04:00:00,36,0,36
"17577",10501,"Grand Falls-Windsor","NL",48.92696,-55.65966,2018-01-03 05:00:00,35,0,35
"17578",10501,"Grand Falls-Windsor","NL",48.92696,-55.65966,2018-01-03 06:00:00,35,0,35
"17579",10501,"Grand Falls-Windsor","NL",48.92696,-55.65966,2018-01-03 07:00:00,34,0,34
"17580",10501,"Grand Falls-Windsor","NL",48.92696,-55.65966,2018-01-03 08:00:00,32,1,33
"17581",10501,"Grand Falls-Windsor","NL",48.92696,-55.65966,2018-01-03 09:00:00,31,1,32
"17582",10501,"Grand Falls-Windsor","NL",48.92696,-55.65966,2018-01-03 10:00:00,24,10,34
"17583",10501,"Grand Falls-Windsor","NL",48.92696,-55.65966,2018-01-03 11:00:00,29,3,32
"17584",10501,"Grand Falls-Windsor","NL",48.92696,-55.65966,2018-01-03 12:00:00,36,1,37
"17585",10501,"Grand Falls-Windsor","NL",48.92696,-55.65966,2018-01-03 13:00:00,37,1,38
"17586",10501,"Grand Falls-Windsor","NL",48.92696,-55.65966,2018-01-03 14:00:00,37,1,38
"17587",10501,"Grand Falls-Windsor","NL",48.92696,-55.65966,2018-01-03 15:00:00,37,0,37
"17588",10501,"Grand Falls-Windsor","NL",48.92696,-55.65966,2018-01-03 16:00:00,37,1,38
"17589",10501,"Grand Falls-Windsor","NL",48.92696,-55.65966,2018-01-03 17:00:00,36,5,41
"17590",10501,"Grand Falls-Windsor","NL",48.92696,-55.65966,2018-01-03 18:00:00,39,0,39
"17591",10501,"Grand Falls-Windsor","NL",48.92696,-55.65966,2018-01-03 19:00:00,38,0,38
"17592",10501,"Grand Falls-Windsor","NL",48.92696,-55.65966,2018-01-03 20:00:00,38,0,38
"17593",10501,"Grand Falls-Windsor","NL",48.92696,-55.65966,2018-01-03 21:00:00,37,0,37
"17594",10501,"Grand Falls-Windsor","NL",48.92696,-55.65966,2018-01-03 22:00:00,37,0,37
"17595",10501,"Grand Falls-Windsor","NL",48.92696,-55.65966,2018-01-03 23:00:00,36,1,37
"17596",10501,"Grand Falls-Windsor","NL",48.92696,-55.65966,2018-01-04 00:00:00,36,1,37
"17597",10501,"Grand Falls-Windsor","NL",48.92696,-55.65966,2018-01-04 01:00:00,35,0,35
"17598",10501,"Grand Falls-Windsor","NL",48.92696,-55.65966,2018-01-04 02:00:00,36,0,36
"17599",10501,"Grand Falls-Windsor","NL",48.92696,-55.65966,2018-01-04 03:00:00,36,0,36
"17600",10501,"Grand Falls-Windsor","NL",48.92696,-55.65966,2018-01-04 04:00:00,35,0,35
"17601",10501,"Grand Falls-Windsor","NL",48.92696,-55.65966,2018-01-04 05:00:00,34,0,34
"17602",10501,"Grand Falls-Windsor","NL",48.92696,-55.65966,2018-01-04 06:00:00,31,2,33
"17603",10501,"Grand Falls-Windsor","NL",48.92696,-55.65966,2018-01-04 07:00:00,28,3,31
"17604",10501,"Grand Falls-Windsor","NL",48.92696,-55.65966,2018-01-04 08:00:00,29,2,31
"17605",10501,"Grand Falls-Windsor","NL",48.92696,-55.65966,2018-01-04 09:00:00,24,6,30
"17606",10501,"Grand Falls-Windsor","NL",48.92696,-55.65966,2018-01-04 10:00:00,28,4,32
"17607",10501,"Grand Falls-Windsor","NL",48.92696,-55.65966,2018-01-04 11:00:00,29,2,31
"17608",10501,"Grand Falls-Windsor","NL",48.92696,-55.65966,2018-01-04 12:00:00,33,1,34
"17609",10501,"Grand Falls-Windsor","NL",48.92696,-55.65966,2018-01-04 13:00:00,34,1,35
"17610",10501,"Grand Falls-Windsor","NL",48.92696,-55.65966,2018-01-04 14:00:00,35,1,36
"17611",10501,"Grand Falls-Windsor","NL",48.92696,-55.65966,2018-01-04 15:00:00,35,2,37
"17612",10501,"Grand Falls-Windsor","NL",48.92696,-55.65966,2018-01-04 16:00:00,34,3,37
"17613",10501,"Grand Falls-Windsor","NL",48.92696,-55.65966,2018-01-04 17:00:00,35,2,37
"17614",10501,"Grand Falls-Windsor","NL",48.92696,-55.65966,2018-01-04 18:00:00,37,1,38
"17615",10501,"Grand Falls-Windsor","NL",48.92696,-55.65966,2018-01-04 19:00:00,34,6,40
"17616",10501,"Grand Falls-Windsor","NL",48.92696,-55.65966,2018-01-04 20:00:00,36,3,39
"17617",10501,"Grand Falls-Windsor","NL",48.92696,-55.65966,2018-01-04 21:00:00,38,1,39
"17618",10501,"Grand Falls-Windsor","NL",48.92696,-55.65966,2018-01-04 22:00:00,38,1,39
"17619",10501,"Grand Falls-Windsor","NL",48.92696,-55.65966,2018-01-04 23:00:00,38,1,39
"17620",10501,"Grand Falls-Windsor","NL",48.92696,-55.65966,2018-01-05 00:00:00,39,1,40
"17621",10501,"Grand Falls-Windsor","NL",48.92696,-55.65966,2018-01-05 01:00:00,40,0,40
"17622",10501,"Grand Falls-Windsor","NL",48.92696,-55.65966,2018-01-05 02:00:00,40,0,40
"17623",10501,"Grand Falls-Windsor","NL",48.92696,-55.65966,2018-01-05 03:00:00,41,1,42
"17624",10501,"Grand Falls-Windsor","NL",48.92696,-55.65966,2018-01-05 04:00:00,41,2,43
"17625",10501,"Grand Falls-Windsor","NL",48.92696,-55.65966,2018-01-05 05:00:00,41,1,42
"17626",10501,"Grand Falls-Windsor","NL",48.92696,-55.65966,2018-01-05 06:00:00,40,1,41
"17627",10501,"Grand Falls-Windsor","NL",48.92696,-55.65966,2018-01-05 07:00:00,36,6,42
"17628",10501,"Grand Falls-Windsor","NL",48.92696,-55.65966,2018-01-05 08:00:00,37,1,38
"17629",10501,"Grand Falls-Windsor","NL",48.92696,-55.65966,2018-01-05 09:00:00,35,2,37
"17630",10501,"Grand Falls-Windsor","NL",48.92696,-55.65966,2018-01-05 10:00:00,37,0,37
"17631",10501,"Grand Falls-Windsor","NL",48.92696,-55.65966,2018-01-05 11:00:00,38,0,38
"17632",10501,"Grand Falls-Windsor","NL",48.92696,-55.65966,2018-01-05 12:00:00,39,0,39
"17633",10501,"Grand Falls-Windsor","NL",48.92696,-55.65966,2018-01-05 13:00:00,39,0,39
"17634",10501,"Grand Falls-Windsor","NL",48.92696,-55.65966,2018-01-05 14:00:00,39,0,39
"17635",10501,"Grand Falls-Windsor","NL",48.92696,-55.65966,2018-01-05 15:00:00,39,1,40
"17636",10501,"Grand Falls-Windsor","NL",48.92696,-55.65966,2018-01-05 16:00:00,40,0,40
"17637",10501,"Grand Falls-Windsor","NL",48.92696,-55.65966,2018-01-05 17:00:00,40,0,40
"17638",10501,"Grand Falls-Windsor","NL",48.92696,-55.65966,2018-01-05 18:00:00,40,0,40
"17639",10501,"Grand Falls-Windsor","NL",48.92696,-55.65966,2018-01-05 19:00:00,40,0,40
"17640",10501,"Grand Falls-Windsor","NL",48.92696,-55.65966,2018-01-05 20:00:00,40,0,40
"17641",10501,"Grand Falls-Windsor","NL",48.92696,-55.65966,2018-01-05 21:00:00,40,1,41
"17642",10501,"Grand Falls-Windsor","NL",48.92696,-55.65966,2018-01-05 22:00:00,40,0,40
"17643",10501,"Grand Falls-Windsor","NL",48.92696,-55.65966,2018-01-05 23:00:00,39,0,39
"17644",10501,"Grand Falls-Windsor","NL",48.92696,-55.65966,2018-01-06 00:00:00,39,1,40
"17645",10501,"Grand Falls-Windsor","NL",48.92696,-55.65966,2018-01-06 01:00:00,41,0,41
"17646",10501,"Grand Falls-Windsor","NL",48.92696,-55.65966,2018-01-06 02:00:00,40,0,40
"17647",10501,"Grand Falls-Windsor","NL",48.92696,-55.65966,2018-01-06 03:00:00,39,0,39
"17648",10501,"Grand Falls-Windsor","NL",48.92696,-55.65966,2018-01-06 04:00:00,39,1,40
"17649",10501,"Grand Falls-Windsor","NL",48.92696,-55.65966,2018-01-06 05:00:00,37,1,38
"17650",10501,"Grand Falls-Windsor","NL",48.92696,-55.65966,2018-01-06 06:00:00,36,1,37
"17651",10501,"Grand Falls-Windsor","NL",48.92696,-55.65966,2018-01-06 07:00:00,36,1,37
"17652",10501,"Grand Falls-Windsor","NL",48.92696,-55.65966,2018-01-06 08:00:00,35,1,36
"17653",10501,"Grand Falls-Windsor","NL",48.92696,-55.65966,2018-01-06 09:00:00,35,1,36
"17654",10501,"Grand Falls-Windsor","NL",48.92696,-55.65966,2018-01-06 10:00:00,35,1,36
"17655",10501,"Grand Falls-Windsor","NL",48.92696,-55.65966,2018-01-06 11:00:00,36,1,37
"17656",10501,"Grand Falls-Windsor","NL",48.92696,-55.65966,2018-01-06 12:00:00,36,0,36
"17657",10501,"Grand Falls-Windsor","NL",48.92696,-55.65966,2018-01-06 13:00:00,37,1,38
"17658",10501,"Grand Falls-Windsor","NL",48.92696,-55.65966,2018-01-06 14:00:00,37,0,37
"17659",10501,"Grand Falls-Windsor","NL",48.92696,-55.65966,2018-01-06 15:00:00,37,1,38
"17660",10501,"Grand Falls-Windsor","NL",48.92696,-55.65966,2018-01-06 16:00:00,36,1,37
"17661",10501,"Grand Falls-Windsor","NL",48.92696,-55.65966,2018-01-06 17:00:00,35,1,36
"17662",10501,"Grand Falls-Windsor","NL",48.92696,-55.65966,2018-01-06 18:00:00,35,1,36
"17663",10501,"Grand Falls-Windsor","NL",48.92696,-55.65966,2018-01-06 19:00:00,35,0,35
"17664",10501,"Grand Falls-Windsor","NL",48.92696,-55.65966,2018-01-06 20:00:00,35,0,35
"17665",10501,"Grand Falls-Windsor","NL",48.92696,-55.65966,2018-01-06 21:00:00,35,0,35
"17666",10501,"Grand Falls-Windsor","NL",48.92696,-55.65966,2018-01-06 22:00:00,35,0,35
"17667",10501,"Grand Falls-Windsor","NL",48.92696,-55.65966,2018-01-06 23:00:00,34,0,34
"17668",10501,"Grand Falls-Windsor","NL",48.92696,-55.65966,2018-01-07 00:00:00,35,0,35
"17669",10501,"Grand Falls-Windsor","NL",48.92696,-55.65966,2018-01-07 01:00:00,35,0,35
"17670",10501,"Grand Falls-Windsor","NL",48.92696,-55.65966,2018-01-07 02:00:00,35,0,35
"17671",10501,"Grand Falls-Windsor","NL",48.92696,-55.65966,2018-01-07 03:00:00,36,0,36
"17672",10501,"Grand Falls-Windsor","NL",48.92696,-55.65966,2018-01-07 04:00:00,36,0,36
"17673",10501,"Grand Falls-Windsor","NL",48.92696,-55.65966,2018-01-07 05:00:00,37,0,37
"17674",10501,"Grand Falls-Windsor","NL",48.92696,-55.65966,2018-01-07 06:00:00,37,0,37
"17675",10501,"Grand Falls-Windsor","NL",48.92696,-55.65966,2018-01-07 07:00:00,38,0,38
"17676",10501,"Grand Falls-Windsor","NL",48.92696,-55.65966,2018-01-07 08:00:00,40,0,40
"17677",10501,"Grand Falls-Windsor","NL",48.92696,-55.65966,2018-01-07 09:00:00,40,0,40
"17678",10501,"Grand Falls-Windsor","NL",48.92696,-55.65966,2018-01-07 10:00:00,40,0,40
"17679",10501,"Grand Falls-Windsor","NL",48.92696,-55.65966,2018-01-07 11:00:00,39,0,39
"17680",10501,"Grand Falls-Windsor","NL",48.92696,-55.65966,2018-01-07 12:00:00,39,0,39
"17681",10501,"Grand Falls-Windsor","NL",48.92696,-55.65966,2018-01-07 13:00:00,40,0,40
"17682",10501,"Grand Falls-Windsor","NL",48.92696,-55.65966,2018-01-07 14:00:00,38,4,42
"17683",10501,"Grand Falls-Windsor","NL",48.92696,-55.65966,2018-01-07 15:00:00,39,1,40
"17684",10501,"Grand Falls-Windsor","NL",48.92696,-55.65966,2018-01-07 16:00:00,40,0,40
"17685",10501,"Grand Falls-Windsor","NL",48.92696,-55.65966,2018-01-07 17:00:00,40,0,40
"17686",10501,"Grand Falls-Windsor","NL",48.92696,-55.65966,2018-01-07 18:00:00,40,0,40
"17687",10501,"Grand Falls-Windsor","NL",48.92696,-55.65966,2018-01-07 19:00:00,39,0,39
"17688",10501,"Grand Falls-Windsor","NL",48.92696,-55.65966,2018-01-07 20:00:00,39,0,39
"17689",10501,"Grand Falls-Windsor","NL",48.92696,-55.65966,2018-01-07 21:00:00,38,0,38
"17690",10501,"Grand Falls-Windsor","NL",48.92696,-55.65966,2018-01-07 22:00:00,39,0,39
"17691",10501,"Grand Falls-Windsor","NL",48.92696,-55.65966,2018-01-07 23:00:00,39,0,39
"17692",10501,"Grand Falls-Windsor","NL",48.92696,-55.65966,2018-01-08 00:00:00,40,0,40
"17693",10501,"Grand Falls-Windsor","NL",48.92696,-55.65966,2018-01-08 01:00:00,41,0,41
"17694",10501,"Grand Falls-Windsor","NL",48.92696,-55.65966,2018-01-08 02:00:00,42,0,42
"17695",10501,"Grand Falls-Windsor","NL",48.92696,-55.65966,2018-01-08 03:00:00,42,0,42
"17696",10501,"Grand Falls-Windsor","NL",48.92696,-55.65966,2018-01-08 04:00:00,42,0,42
"17697",10501,"Grand Falls-Windsor","NL",48.92696,-55.65966,2018-01-08 05:00:00,43,0,43
"17698",10501,"Grand Falls-Windsor","NL",48.92696,-55.65966,2018-01-08 06:00:00,43,0,43
"17699",10501,"Grand Falls-Windsor","NL",48.92696,-55.65966,2018-01-08 07:00:00,42,2,44
"17700",10501,"Grand Falls-Windsor","NL",48.92696,-55.65966,2018-01-08 08:00:00,43,0,43
"17701",10501,"Grand Falls-Windsor","NL",48.92696,-55.65966,2018-01-08 09:00:00,43,0,43
"17702",10501,"Grand Falls-Windsor","NL",48.92696,-55.65966,2018-01-08 10:00:00,40,8,48
"17703",10501,"Grand Falls-Windsor","NL",48.92696,-55.65966,2018-01-08 11:00:00,41,4,45
"17704",10501,"Grand Falls-Windsor","NL",48.92696,-55.65966,2018-01-08 12:00:00,43,0,43
"17705",10501,"Grand Falls-Windsor","NL",48.92696,-55.65966,2018-01-08 13:00:00,43,0,43
"17706",10501,"Grand Falls-Windsor","NL",48.92696,-55.65966,2018-01-08 14:00:00,43,0,43
"17707",10501,"Grand Falls-Windsor","NL",48.92696,-55.65966,2018-01-08 15:00:00,43,0,43
"17708",10501,"Grand Falls-Windsor","NL",48.92696,-55.65966,2018-01-08 16:00:00,43,0,43
"17709",10501,"Grand Falls-Windsor","NL",48.92696,-55.65966,2018-01-08 17:00:00,43,0,43
"17710",10501,"Grand Falls-Windsor","NL",48.92696,-55.65966,2018-01-08 18:00:00,43,1,44
"17711",10501,"Grand Falls-Windsor","NL",48.92696,-55.65966,2018-01-08 19:00:00,43,0,43
"17712",10501,"Grand Falls-Windsor","NL",48.92696,-55.65966,2018-01-08 20:00:00,43,0,43
"17713",10501,"Grand Falls-Windsor","NL",48.92696,-55.65966,2018-01-08 21:00:00,43,1,44
"17714",10501,"Grand Falls-Windsor","NL",48.92696,-55.65966,2018-01-08 22:00:00,43,0,43
"17715",10501,"Grand Falls-Windsor","NL",48.92696,-55.65966,2018-01-08 23:00:00,43,1,44
"17716",10501,"Grand Falls-Windsor","NL",48.92696,-55.65966,2018-01-09 00:00:00,43,0,43
"17717",10501,"Grand Falls-Windsor","NL",48.92696,-55.65966,2018-01-09 01:00:00,41,1,42
"17718",10501,"Grand Falls-Windsor","NL",48.92696,-55.65966,2018-01-09 02:00:00,39,1,40
"17719",10501,"Grand Falls-Windsor","NL",48.92696,-55.65966,2018-01-09 03:00:00,40,1,41
"17720",10501,"Grand Falls-Windsor","NL",48.92696,-55.65966,2018-01-09 04:00:00,38,2,40
"17721",10501,"Grand Falls-Windsor","NL",48.92696,-55.65966,2018-01-09 05:00:00,38,0,38
"17722",10501,"Grand Falls-Windsor","NL",48.92696,-55.65966,2018-01-09 06:00:00,38,1,39
"17723",10501,"Grand Falls-Windsor","NL",48.92696,-55.65966,2018-01-09 07:00:00,38,1,39
"17724",10501,"Grand Falls-Windsor","NL",48.92696,-55.65966,2018-01-09 08:00:00,39,0,39
"17725",10501,"Grand Falls-Windsor","NL",48.92696,-55.65966,2018-01-09 09:00:00,39,1,40
"17726",10501,"Grand Falls-Windsor","NL",48.92696,-55.65966,2018-01-09 10:00:00,39,1,40
"17727",10501,"Grand Falls-Windsor","NL",48.92696,-55.65966,2018-01-09 11:00:00,39,1,40
"17728",10501,"Grand Falls-Windsor","NL",48.92696,-55.65966,2018-01-09 12:00:00,37,2,39
"17729",10501,"Grand Falls-Windsor","NL",48.92696,-55.65966,2018-01-09 13:00:00,36,3,39
"17730",10501,"Grand Falls-Windsor","NL",48.92696,-55.65966,2018-01-09 14:00:00,33,4,37
"17731",10501,"Grand Falls-Windsor","NL",48.92696,-55.65966,2018-01-09 15:00:00,33,4,37
"17732",10501,"Grand Falls-Windsor","NL",48.92696,-55.65966,2018-01-09 16:00:00,32,4,36
"17733",10501,"Grand Falls-Windsor","NL",48.92696,-55.65966,2018-01-09 17:00:00,33,4,37
"17734",10501,"Grand Falls-Windsor","NL",48.92696,-55.65966,2018-01-09 18:00:00,35,3,38
"17735",10501,"Grand Falls-Windsor","NL",48.92696,-55.65966,2018-01-09 19:00:00,35,1,36
"17736",10501,"Grand Falls-Windsor","NL",48.92696,-55.65966,2018-01-09 20:00:00,35,0,35
"17737",10501,"Grand Falls-Windsor","NL",48.92696,-55.65966,2018-01-09 21:00:00,35,1,36
"17738",10501,"Grand Falls-Windsor","NL",48.92696,-55.65966,2018-01-09 22:00:00,34,1,35
"17739",10501,"Grand Falls-Windsor","NL",48.92696,-55.65966,2018-01-09 23:00:00,34,0,34
"17740",10501,"Grand Falls-Windsor","NL",48.92696,-55.65966,2018-01-10 00:00:00,33,0,33
"17741",10501,"Grand Falls-Windsor","NL",48.92696,-55.65966,2018-01-10 01:00:00,30,2,32
"17742",10501,"Grand Falls-Windsor","NL",48.92696,-55.65966,2018-01-10 02:00:00,35,1,36
"17743",10501,"Grand Falls-Windsor","NL",48.92696,-55.65966,2018-01-10 03:00:00,37,4,41
"17744",10501,"Grand Falls-Windsor","NL",48.92696,-55.65966,2018-01-10 04:00:00,39,1,40
"17745",10501,"Grand Falls-Windsor","NL",48.92696,-55.65966,2018-01-10 05:00:00,39,0,39
"17746",10501,"Grand Falls-Windsor","NL",48.92696,-55.65966,2018-01-10 06:00:00,39,0,39
"17747",10501,"Grand Falls-Windsor","NL",48.92696,-55.65966,2018-01-10 07:00:00,38,2,40
"17748",10501,"Grand Falls-Windsor","NL",48.92696,-55.65966,2018-01-10 08:00:00,40,0,40
"17749",10501,"Grand Falls-Windsor","NL",48.92696,-55.65966,2018-01-10 09:00:00,41,1,42
"17750",10501,"Grand Falls-Windsor","NL",48.92696,-55.65966,2018-01-10 10:00:00,39,1,40
"17751",10501,"Grand Falls-Windsor","NL",48.92696,-55.65966,2018-01-10 11:00:00,39,1,40
"17752",10501,"Grand Falls-Windsor","NL",48.92696,-55.65966,2018-01-10 12:00:00,41,0,41
"17753",10501,"Grand Falls-Windsor","NL",48.92696,-55.65966,2018-01-10 13:00:00,41,0,41
"17754",10501,"Grand Falls-Windsor","NL",48.92696,-55.65966,2018-01-10 14:00:00,40,1,41
"17755",10501,"Grand Falls-Windsor","NL",48.92696,-55.65966,2018-01-10 15:00:00,39,1,40
"17756",10501,"Grand Falls-Windsor","NL",48.92696,-55.65966,2018-01-10 16:00:00,39,0,39
"17757",10501,"Grand Falls-Windsor","NL",48.92696,-55.65966,2018-01-10 17:00:00,39,1,40
"17758",10501,"Grand Falls-Windsor","NL",48.92696,-55.65966,2018-01-10 18:00:00,39,0,39
"17759",10501,"Grand Falls-Windsor","NL",48.92696,-55.65966,2018-01-10 19:00:00,39,0,39
"17760",10501,"Grand Falls-Windsor","NL",48.92696,-55.65966,2018-01-10 20:00:00,38,0,38
"17761",10501,"Grand Falls-Windsor","NL",48.92696,-55.65966,2018-01-10 21:00:00,38,0,38
"17762",10501,"Grand Falls-Windsor","NL",48.92696,-55.65966,2018-01-10 22:00:00,37,0,37
"17763",10501,"Grand Falls-Windsor","NL",48.92696,-55.65966,2018-01-10 23:00:00,36,0,36
"17764",10501,"Grand Falls-Windsor","NL",48.92696,-55.65966,2018-01-11 00:00:00,36,0,36
"17765",10501,"Grand Falls-Windsor","NL",48.92696,-55.65966,2018-01-11 01:00:00,36,0,36
"17766",10501,"Grand Falls-Windsor","NL",48.92696,-55.65966,2018-01-11 02:00:00,36,0,36
"17767",10501,"Grand Falls-Windsor","NL",48.92696,-55.65966,2018-01-11 03:00:00,36,0,36
"17768",10501,"Grand Falls-Windsor","NL",48.92696,-55.65966,2018-01-11 04:00:00,35,7,42
"17769",10501,"Grand Falls-Windsor","NL",48.92696,-55.65966,2018-01-11 05:00:00,37,0,37
"17770",10501,"Grand Falls-Windsor","NL",48.92696,-55.65966,2018-01-11 06:00:00,37,0,37
"17771",10501,"Grand Falls-Windsor","NL",48.92696,-55.65966,2018-01-11 07:00:00,37,0,37
"17772",10501,"Grand Falls-Windsor","NL",48.92696,-55.65966,2018-01-11 08:00:00,37,0,37
"17773",10501,"Grand Falls-Windsor","NL",48.92696,-55.65966,2018-01-11 09:00:00,37,1,38
"17774",10501,"Grand Falls-Windsor","NL",48.92696,-55.65966,2018-01-11 10:00:00,39,0,39
"17775",10501,"Grand Falls-Windsor","NL",48.92696,-55.65966,2018-01-11 11:00:00,39,0,39
"17776",10501,"Grand Falls-Windsor","NL",48.92696,-55.65966,2018-01-11 12:00:00,40,0,40
"17777",10501,"Grand Falls-Windsor","NL",48.92696,-55.65966,2018-01-11 13:00:00,40,0,40
"17778",10501,"Grand Falls-Windsor","NL",48.92696,-55.65966,2018-01-11 14:00:00,40,0,40
"17779",10501,"Grand Falls-Windsor","NL",48.92696,-55.65966,2018-01-11 15:00:00,40,0,40
"17780",10501,"Grand Falls-Windsor","NL",48.92696,-55.65966,2018-01-11 16:00:00,39,0,39
"17781",10501,"Grand Falls-Windsor","NL",48.92696,-55.65966,2018-01-11 17:00:00,38,0,38
"17782",10501,"Grand Falls-Windsor","NL",48.92696,-55.65966,2018-01-11 18:00:00,37,0,37
"17783",10501,"Grand Falls-Windsor","NL",48.92696,-55.65966,2018-01-11 19:00:00,37,0,37
"17784",10501,"Grand Falls-Windsor","NL",48.92696,-55.65966,2018-01-11 20:00:00,36,1,37
"17785",10501,"Grand Falls-Windsor","NL",48.92696,-55.65966,2018-01-11 21:00:00,35,1,36
"17786",10501,"Grand Falls-Windsor","NL",48.92696,-55.65966,2018-01-11 22:00:00,34,1,35
"17787",10501,"Grand Falls-Windsor","NL",48.92696,-55.65966,2018-01-11 23:00:00,32,1,33
"17788",10501,"Grand Falls-Windsor","NL",48.92696,-55.65966,2018-01-12 00:00:00,31,1,32
"17789",10501,"Grand Falls-Windsor","NL",48.92696,-55.65966,2018-01-12 01:00:00,30,1,31
"17790",10501,"Grand Falls-Windsor","NL",48.92696,-55.65966,2018-01-12 02:00:00,29,1,30
"17791",10501,"Grand Falls-Windsor","NL",48.92696,-55.65966,2018-01-12 03:00:00,28,1,29
"17792",10501,"Grand Falls-Windsor","NL",48.92696,-55.65966,2018-01-12 04:00:00,28,1,29
"17793",10501,"Grand Falls-Windsor","NL",48.92696,-55.65966,2018-01-12 05:00:00,30,1,31
"17794",10501,"Grand Falls-Windsor","NL",48.92696,-55.65966,2018-01-12 06:00:00,31,1,32
"17795",10501,"Grand Falls-Windsor","NL",48.92696,-55.65966,2018-01-12 07:00:00,32,1,33
"17796",10501,"Grand Falls-Windsor","NL",48.92696,-55.65966,2018-01-12 08:00:00,31,0,31
"17797",10501,"Grand Falls-Windsor","NL",48.92696,-55.65966,2018-01-12 09:00:00,31,1,32
"17798",10501,"Grand Falls-Windsor","NL",48.92696,-55.65966,2018-01-12 10:00:00,32,1,33
"17799",10501,"Grand Falls-Windsor","NL",48.92696,-55.65966,2018-01-12 11:00:00,33,1,34
"17800",10501,"Grand Falls-Windsor","NL",48.92696,-55.65966,2018-01-12 12:00:00,34,1,35
"17801",10501,"Grand Falls-Windsor","NL",48.92696,-55.65966,2018-01-12 13:00:00,35,1,36
"17802",10501,"Grand Falls-Windsor","NL",48.92696,-55.65966,2018-01-12 14:00:00,37,1,38
"17803",10501,"Grand Falls-Windsor","NL",48.92696,-55.65966,2018-01-12 15:00:00,37,1,38
"17804",10501,"Grand Falls-Windsor","NL",48.92696,-55.65966,2018-01-12 16:00:00,36,0,36
"17805",10501,"Grand Falls-Windsor","NL",48.92696,-55.65966,2018-01-12 17:00:00,37,1,38
"17806",10501,"Grand Falls-Windsor","NL",48.92696,-55.65966,2018-01-12 18:00:00,38,1,39
"17807",10501,"Grand Falls-Windsor","NL",48.92696,-55.65966,2018-01-12 19:00:00,37,1,38
"17808",10501,"Grand Falls-Windsor","NL",48.92696,-55.65966,2018-01-12 20:00:00,37,1,38
"17809",10501,"Grand Falls-Windsor","NL",48.92696,-55.65966,2018-01-12 21:00:00,37,1,38
"17810",10501,"Grand Falls-Windsor","NL",48.92696,-55.65966,2018-01-12 22:00:00,37,0,37
"17811",10501,"Grand Falls-Windsor","NL",48.92696,-55.65966,2018-01-12 23:00:00,37,0,37
"17812",10501,"Grand Falls-Windsor","NL",48.92696,-55.65966,2018-01-13 00:00:00,37,0,37
"17813",10501,"Grand Falls-Windsor","NL",48.92696,-55.65966,2018-01-13 01:00:00,37,0,37
"17814",10501,"Grand Falls-Windsor","NL",48.92696,-55.65966,2018-01-13 02:00:00,38,0,38
"17815",10501,"Grand Falls-Windsor","NL",48.92696,-55.65966,2018-01-13 03:00:00,39,0,39
"17816",10501,"Grand Falls-Windsor","NL",48.92696,-55.65966,2018-01-13 04:00:00,40,0,40
"17817",10501,"Grand Falls-Windsor","NL",48.92696,-55.65966,2018-01-13 05:00:00,40,0,40
"17818",10501,"Grand Falls-Windsor","NL",48.92696,-55.65966,2018-01-13 06:00:00,39,0,39
"17819",10501,"Grand Falls-Windsor","NL",48.92696,-55.65966,2018-01-13 07:00:00,39,0,39
"17820",10501,"Grand Falls-Windsor","NL",48.92696,-55.65966,2018-01-13 08:00:00,40,0,40
"17821",10501,"Grand Falls-Windsor","NL",48.92696,-55.65966,2018-01-13 09:00:00,40,0,40
"17822",10501,"Grand Falls-Windsor","NL",48.92696,-55.65966,2018-01-13 10:00:00,40,0,40
"17823",10501,"Grand Falls-Windsor","NL",48.92696,-55.65966,2018-01-13 11:00:00,40,0,40
"17824",10501,"Grand Falls-Windsor","NL",48.92696,-55.65966,2018-01-13 12:00:00,40,0,40
"17825",10501,"Grand Falls-Windsor","NL",48.92696,-55.65966,2018-01-13 13:00:00,39,0,39
"17826",10501,"Grand Falls-Windsor","NL",48.92696,-55.65966,2018-01-13 14:00:00,39,0,39
"17827",10501,"Grand Falls-Windsor","NL",48.92696,-55.65966,2018-01-13 15:00:00,39,0,39
"17828",10501,"Grand Falls-Windsor","NL",48.92696,-55.65966,2018-01-13 16:00:00,40,0,40
"17829",10501,"Grand Falls-Windsor","NL",48.92696,-55.65966,2018-01-13 17:00:00,38,0,38
"17830",10501,"Grand Falls-Windsor","NL",48.92696,-55.65966,2018-01-13 18:00:00,39,0,39
"17831",10501,"Grand Falls-Windsor","NL",48.92696,-55.65966,2018-01-13 19:00:00,39,0,39
"17832",10501,"Grand Falls-Windsor","NL",48.92696,-55.65966,2018-01-13 20:00:00,39,0,39
"17833",10501,"Grand Falls-Windsor","NL",48.92696,-55.65966,2018-01-13 21:00:00,38,0,38
"17834",10501,"Grand Falls-Windsor","NL",48.92696,-55.65966,2018-01-13 22:00:00,38,0,38
"17835",10501,"Grand Falls-Windsor","NL",48.92696,-55.65966,2018-01-13 23:00:00,38,0,38
"17836",10501,"Grand Falls-Windsor","NL",48.92696,-55.65966,2018-01-14 00:00:00,38,0,38
"17837",10501,"Grand Falls-Windsor","NL",48.92696,-55.65966,2018-01-14 01:00:00,37,0,37
"17838",10501,"Grand Falls-Windsor","NL",48.92696,-55.65966,2018-01-14 02:00:00,36,0,36
"17839",10501,"Grand Falls-Windsor","NL",48.92696,-55.65966,2018-01-14 03:00:00,36,0,36
"17840",10501,"Grand Falls-Windsor","NL",48.92696,-55.65966,2018-01-14 04:00:00,33,0,33
"17841",10501,"Grand Falls-Windsor","NL",48.92696,-55.65966,2018-01-14 05:00:00,34,0,34
"17842",10501,"Grand Falls-Windsor","NL",48.92696,-55.65966,2018-01-14 06:00:00,35,0,35
"17843",10501,"Grand Falls-Windsor","NL",48.92696,-55.65966,2018-01-14 07:00:00,35,1,36
"17844",10501,"Grand Falls-Windsor","NL",48.92696,-55.65966,2018-01-14 08:00:00,36,1,37
"17845",10501,"Grand Falls-Windsor","NL",48.92696,-55.65966,2018-01-14 09:00:00,37,1,38
"17846",10501,"Grand Falls-Windsor","NL",48.92696,-55.65966,2018-01-14 10:00:00,37,1,38
"17847",10501,"Grand Falls-Windsor","NL",48.92696,-55.65966,2018-01-14 11:00:00,38,1,39
"17848",10501,"Grand Falls-Windsor","NL",48.92696,-55.65966,2018-01-14 12:00:00,38,1,39
"17849",10501,"Grand Falls-Windsor","NL",48.92696,-55.65966,2018-01-14 13:00:00,37,1,38
"17850",10501,"Grand Falls-Windsor","NL",48.92696,-55.65966,2018-01-14 14:00:00,37,1,38
"17851",10501,"Grand Falls-Windsor","NL",48.92696,-55.65966,2018-01-14 15:00:00,37,1,38
"17852",10501,"Grand Falls-Windsor","NL",48.92696,-55.65966,2018-01-14 16:00:00,36,1,37
"17853",10501,"Grand Falls-Windsor","NL",48.92696,-55.65966,2018-01-14 17:00:00,35,1,36
"17854",10501,"Grand Falls-Windsor","NL",48.92696,-55.65966,2018-01-14 18:00:00,36,1,37
"17855",10501,"Grand Falls-Windsor","NL",48.92696,-55.65966,2018-01-14 19:00:00,38,1,39
"17856",10501,"Grand Falls-Windsor","NL",48.92696,-55.65966,2018-01-14 20:00:00,40,0,40
"17857",10501,"Grand Falls-Windsor","NL",48.92696,-55.65966,2018-01-14 21:00:00,40,0,40
"17858",10501,"Grand Falls-Windsor","NL",48.92696,-55.65966,2018-01-14 22:00:00,40,0,40
"17859",10501,"Grand Falls-Windsor","NL",48.92696,-55.65966,2018-01-14 23:00:00,39,0,39
"17860",10501,"Grand Falls-Windsor","NL",48.92696,-55.65966,2018-01-15 00:00:00,38,0,38
"17861",10501,"Grand Falls-Windsor","NL",48.92696,-55.65966,2018-01-15 01:00:00,38,1,39
"17862",10501,"Grand Falls-Windsor","NL",48.92696,-55.65966,2018-01-15 02:00:00,38,0,38
"17863",10501,"Grand Falls-Windsor","NL",48.92696,-55.65966,2018-01-15 03:00:00,38,4,42
"17864",10501,"Grand Falls-Windsor","NL",48.92696,-55.65966,2018-01-15 04:00:00,38,3,41
"17865",10501,"Grand Falls-Windsor","NL",48.92696,-55.65966,2018-01-15 05:00:00,38,0,38
"17866",10501,"Grand Falls-Windsor","NL",48.92696,-55.65966,2018-01-15 06:00:00,37,1,38
"17867",10501,"Grand Falls-Windsor","NL",48.92696,-55.65966,2018-01-15 07:00:00,37,1,38
"17868",10501,"Grand Falls-Windsor","NL",48.92696,-55.65966,2018-01-15 08:00:00,37,1,38
"17869",10501,"Grand Falls-Windsor","NL",48.92696,-55.65966,2018-01-15 09:00:00,36,1,37
"17870",10501,"Grand Falls-Windsor","NL",48.92696,-55.65966,2018-01-15 10:00:00,36,1,37
"17871",10501,"Grand Falls-Windsor","NL",48.92696,-55.65966,2018-01-15 11:00:00,36,1,37
"17872",10501,"Grand Falls-Windsor","NL",48.92696,-55.65966,2018-01-15 12:00:00,36,1,37
"17873",10501,"Grand Falls-Windsor","NL",48.92696,-55.65966,2018-01-15 13:00:00,36,1,37
"17874",10501,"Grand Falls-Windsor","NL",48.92696,-55.65966,2018-01-15 14:00:00,37,1,38
"17875",10501,"Grand Falls-Windsor","NL",48.92696,-55.65966,2018-01-15 15:00:00,37,1,38
"17876",10501,"Grand Falls-Windsor","NL",48.92696,-55.65966,2018-01-15 16:00:00,37,1,38
"17877",10501,"Grand Falls-Windsor","NL",48.92696,-55.65966,2018-01-15 17:00:00,35,2,37
"17878",10501,"Grand Falls-Windsor","NL",48.92696,-55.65966,2018-01-15 18:00:00,33,3,36
"17879",10501,"Grand Falls-Windsor","NL",48.92696,-55.65966,2018-01-15 19:00:00,32,3,35
"17880",10501,"Grand Falls-Windsor","NL",48.92696,-55.65966,2018-01-15 20:00:00,30,4,34
"17881",10501,"Grand Falls-Windsor","NL",48.92696,-55.65966,2018-01-15 21:00:00,31,3,34
"17882",10501,"Grand Falls-Windsor","NL",48.92696,-55.65966,2018-01-15 22:00:00,29,2,31
"17883",10501,"Grand Falls-Windsor","NL",48.92696,-55.65966,2018-01-15 23:00:00,28,3,31
"17884",10501,"Grand Falls-Windsor","NL",48.92696,-55.65966,2018-01-16 00:00:00,28,1,29
"17885",10501,"Grand Falls-Windsor","NL",48.92696,-55.65966,2018-01-16 01:00:00,31,2,33
"17886",10501,"Grand Falls-Windsor","NL",48.92696,-55.65966,2018-01-16 02:00:00,31,2,33
"17887",10501,"Grand Falls-Windsor","NL",48.92696,-55.65966,2018-01-16 03:00:00,33,1,34
"17888",10501,"Grand Falls-Windsor","NL",48.92696,-55.65966,2018-01-16 04:00:00,34,2,36
"17889",10501,"Grand Falls-Windsor","NL",48.92696,-55.65966,2018-01-16 05:00:00,34,1,35
"17890",10501,"Grand Falls-Windsor","NL",48.92696,-55.65966,2018-01-16 06:00:00,35,1,36
"17891",10501,"Grand Falls-Windsor","NL",48.92696,-55.65966,2018-01-16 07:00:00,36,2,38
"17892",10501,"Grand Falls-Windsor","NL",48.92696,-55.65966,2018-01-16 08:00:00,37,2,39
"17893",10501,"Grand Falls-Windsor","NL",48.92696,-55.65966,2018-01-16 09:00:00,37,2,39
"17894",10501,"Grand Falls-Windsor","NL",48.92696,-55.65966,2018-01-16 10:00:00,37,3,40
"17895",10501,"Grand Falls-Windsor","NL",48.92696,-55.65966,2018-01-16 11:00:00,36,3,39
"17896",10501,"Grand Falls-Windsor","NL",48.92696,-55.65966,2018-01-16 12:00:00,37,2,39
"17897",10501,"Grand Falls-Windsor","NL",48.92696,-55.65966,2018-01-16 13:00:00,36,3,39
"17898",10501,"Grand Falls-Windsor","NL",48.92696,-55.65966,2018-01-16 14:00:00,36,3,39
"17899",10501,"Grand Falls-Windsor","NL",48.92696,-55.65966,2018-01-16 15:00:00,36,6,42
"17900",10501,"Grand Falls-Windsor","NL",48.92696,-55.65966,2018-01-16 16:00:00,38,2,40
"17901",10501,"Grand Falls-Windsor","NL",48.92696,-55.65966,2018-01-16 17:00:00,36,3,39
"17902",10501,"Grand Falls-Windsor","NL",48.92696,-55.65966,2018-01-16 18:00:00,36,4,40
"17903",10501,"Grand Falls-Windsor","NL",48.92696,-55.65966,2018-01-16 19:00:00,34,5,39
"17904",10501,"Grand Falls-Windsor","NL",48.92696,-55.65966,2018-01-16 20:00:00,36,2,38
"17905",10501,"Grand Falls-Windsor","NL",48.92696,-55.65966,2018-01-16 21:00:00,35,1,36
"17906",10501,"Grand Falls-Windsor","NL",48.92696,-55.65966,2018-01-16 22:00:00,34,1,35
"17907",10501,"Grand Falls-Windsor","NL",48.92696,-55.65966,2018-01-16 23:00:00,34,1,35
"17908",10501,"Grand Falls-Windsor","NL",48.92696,-55.65966,2018-01-17 00:00:00,33,0,33
"17909",10501,"Grand Falls-Windsor","NL",48.92696,-55.65966,2018-01-17 01:00:00,33,0,33
"17910",10501,"Grand Falls-Windsor","NL",48.92696,-55.65966,2018-01-17 02:00:00,35,1,36
"17911",10501,"Grand Falls-Windsor","NL",48.92696,-55.65966,2018-01-17 03:00:00,36,0,36
"17912",10501,"Grand Falls-Windsor","NL",48.92696,-55.65966,2018-01-17 04:00:00,37,0,37
"17913",10501,"Grand Falls-Windsor","NL",48.92696,-55.65966,2018-01-17 05:00:00,38,0,38
"17914",10501,"Grand Falls-Windsor","NL",48.92696,-55.65966,2018-01-17 06:00:00,37,1,38
"17915",10501,"Grand Falls-Windsor","NL",48.92696,-55.65966,2018-01-17 07:00:00,38,1,39
"17916",10501,"Grand Falls-Windsor","NL",48.92696,-55.65966,2018-01-17 08:00:00,38,1,39
"17917",10501,"Grand Falls-Windsor","NL",48.92696,-55.65966,2018-01-17 09:00:00,37,1,38
"17918",10501,"Grand Falls-Windsor","NL",48.92696,-55.65966,2018-01-17 10:00:00,35,1,36
"17919",10501,"Grand Falls-Windsor","NL",48.92696,-55.65966,2018-01-17 11:00:00,37,1,38
"17920",10501,"Grand Falls-Windsor","NL",48.92696,-55.65966,2018-01-17 12:00:00,38,0,38
"17921",10501,"Grand Falls-Windsor","NL",48.92696,-55.65966,2018-01-17 13:00:00,39,1,40
"17922",10501,"Grand Falls-Windsor","NL",48.92696,-55.65966,2018-01-17 14:00:00,38,0,38
"17923",10501,"Grand Falls-Windsor","NL",48.92696,-55.65966,2018-01-17 15:00:00,40,0,40
"17924",10501,"Grand Falls-Windsor","NL",48.92696,-55.65966,2018-01-17 16:00:00,40,0,40
"17925",10501,"Grand Falls-Windsor","NL",48.92696,-55.65966,2018-01-17 17:00:00,39,0,39
"17926",10501,"Grand Falls-Windsor","NL",48.92696,-55.65966,2018-01-17 18:00:00,38,0,38
"17927",10501,"Grand Falls-Windsor","NL",48.92696,-55.65966,2018-01-17 19:00:00,38,0,38
"17928",10501,"Grand Falls-Windsor","NL",48.92696,-55.65966,2018-01-17 20:00:00,37,0,37
"17929",10501,"Grand Falls-Windsor","NL",48.92696,-55.65966,2018-01-17 21:00:00,36,0,36
"17930",10501,"Grand Falls-Windsor","NL",48.92696,-55.65966,2018-01-17 22:00:00,35,0,35
"17931",10501,"Grand Falls-Windsor","NL",48.92696,-55.65966,2018-01-17 23:00:00,34,1,35
"17932",10501,"Grand Falls-Windsor","NL",48.92696,-55.65966,2018-01-18 00:00:00,34,0,34
"17933",10501,"Grand Falls-Windsor","NL",48.92696,-55.65966,2018-01-18 01:00:00,33,1,34
"17934",10501,"Grand Falls-Windsor","NL",48.92696,-55.65966,2018-01-18 02:00:00,33,1,34
"17935",10501,"Grand Falls-Windsor","NL",48.92696,-55.65966,2018-01-18 03:00:00,32,0,32
"17936",10501,"Grand Falls-Windsor","NL",48.92696,-55.65966,2018-01-18 04:00:00,31,1,32
"17937",10501,"Grand Falls-Windsor","NL",48.92696,-55.65966,2018-01-18 05:00:00,31,1,32
"17938",10501,"Grand Falls-Windsor","NL",48.92696,-55.65966,2018-01-18 06:00:00,31,1,32
"17939",10501,"Grand Falls-Windsor","NL",48.92696,-55.65966,2018-01-18 07:00:00,25,10,35
"17940",10501,"Grand Falls-Windsor","NL",48.92696,-55.65966,2018-01-18 08:00:00,29,3,32
"17941",10501,"Grand Falls-Windsor","NL",48.92696,-55.65966,2018-01-18 09:00:00,26,5,31
"17942",10501,"Grand Falls-Windsor","NL",48.92696,-55.65966,2018-01-18 10:00:00,31,3,34
"17943",10501,"Grand Falls-Windsor","NL",48.92696,-55.65966,2018-01-18 11:00:00,31,6,37
"17944",10501,"Grand Falls-Windsor","NL",48.92696,-55.65966,2018-01-18 12:00:00,32,3,35
"17945",10501,"Grand Falls-Windsor","NL",48.92696,-55.65966,2018-01-18 13:00:00,33,2,35
"17946",10501,"Grand Falls-Windsor","NL",48.92696,-55.65966,2018-01-18 14:00:00,32,3,35
"17947",10501,"Grand Falls-Windsor","NL",48.92696,-55.65966,2018-01-18 15:00:00,32,3,35
"17948",10501,"Grand Falls-Windsor","NL",48.92696,-55.65966,2018-01-18 16:00:00,33,4,37
"17949",10501,"Grand Falls-Windsor","NL",48.92696,-55.65966,2018-01-18 17:00:00,33,2,35
"17950",10501,"Grand Falls-Windsor","NL",48.92696,-55.65966,2018-01-18 18:00:00,32,1,33
"17951",10501,"Grand Falls-Windsor","NL",48.92696,-55.65966,2018-01-18 19:00:00,35,1,36
"17952",10501,"Grand Falls-Windsor","NL",48.92696,-55.65966,2018-01-18 20:00:00,33,1,34
"17953",10501,"Grand Falls-Windsor","NL",48.92696,-55.65966,2018-01-18 21:00:00,32,1,33
"17954",10501,"Grand Falls-Windsor","NL",48.92696,-55.65966,2018-01-18 22:00:00,30,1,31
"17955",10501,"Grand Falls-Windsor","NL",48.92696,-55.65966,2018-01-18 23:00:00,29,2,31
"17956",10501,"Grand Falls-Windsor","NL",48.92696,-55.65966,2018-01-19 00:00:00,28,2,30
"17957",10501,"Grand Falls-Windsor","NL",48.92696,-55.65966,2018-01-19 01:00:00,28,1,29
"17958",10501,"Grand Falls-Windsor","NL",48.92696,-55.65966,2018-01-19 02:00:00,33,0,33
"17959",10501,"Grand Falls-Windsor","NL",48.92696,-55.65966,2018-01-19 03:00:00,34,0,34
"17960",10501,"Grand Falls-Windsor","NL",48.92696,-55.65966,2018-01-19 04:00:00,31,7,38
"17961",10501,"Grand Falls-Windsor","NL",48.92696,-55.65966,2018-01-19 05:00:00,34,1,35
"17962",10501,"Grand Falls-Windsor","NL",48.92696,-55.65966,2018-01-19 06:00:00,29,4,33
"17963",10501,"Grand Falls-Windsor","NL",48.92696,-55.65966,2018-01-19 07:00:00,25,6,31
"17964",10501,"Grand Falls-Windsor","NL",48.92696,-55.65966,2018-01-19 08:00:00,27,2,29
"17965",10501,"Grand Falls-Windsor","NL",48.92696,-55.65966,2018-01-19 09:00:00,21,5,26
"17966",10501,"Grand Falls-Windsor","NL",48.92696,-55.65966,2018-01-19 10:00:00,18,10,28
"17967",10501,"Grand Falls-Windsor","NL",48.92696,-55.65966,2018-01-19 11:00:00,23,3,26
"17968",10501,"Grand Falls-Windsor","NL",48.92696,-55.65966,2018-01-19 12:00:00,25,2,27
"17969",10501,"Grand Falls-Windsor","NL",48.92696,-55.65966,2018-01-19 13:00:00,29,4,33
"17970",10501,"Grand Falls-Windsor","NL",48.92696,-55.65966,2018-01-19 14:00:00,31,1,32
"17971",10501,"Grand Falls-Windsor","NL",48.92696,-55.65966,2018-01-19 15:00:00,32,1,33
"17972",10501,"Grand Falls-Windsor","NL",48.92696,-55.65966,2018-01-19 16:00:00,31,3,34
"17973",10501,"Grand Falls-Windsor","NL",48.92696,-55.65966,2018-01-19 17:00:00,31,3,34
"17974",10501,"Grand Falls-Windsor","NL",48.92696,-55.65966,2018-01-19 18:00:00,30,4,34
"17975",10501,"Grand Falls-Windsor","NL",48.92696,-55.65966,2018-01-19 19:00:00,29,4,33
"17976",10501,"Grand Falls-Windsor","NL",48.92696,-55.65966,2018-01-19 20:00:00,30,3,33
"17977",10501,"Grand Falls-Windsor","NL",48.92696,-55.65966,2018-01-19 21:00:00,30,3,33
"17978",10501,"Grand Falls-Windsor","NL",48.92696,-55.65966,2018-01-19 22:00:00,31,1,32
"17979",10501,"Grand Falls-Windsor","NL",48.92696,-55.65966,2018-01-19 23:00:00,30,1,31
"17980",10501,"Grand Falls-Windsor","NL",48.92696,-55.65966,2018-01-20 00:00:00,32,1,33
"17981",10501,"Grand Falls-Windsor","NL",48.92696,-55.65966,2018-01-20 01:00:00,33,1,34
"17982",10501,"Grand Falls-Windsor","NL",48.92696,-55.65966,2018-01-20 02:00:00,31,1,32
"17983",10501,"Grand Falls-Windsor","NL",48.92696,-55.65966,2018-01-20 03:00:00,29,2,31
"17984",10501,"Grand Falls-Windsor","NL",48.92696,-55.65966,2018-01-20 04:00:00,27,1,28
"17985",10501,"Grand Falls-Windsor","NL",48.92696,-55.65966,2018-01-20 05:00:00,25,1,26
"17986",10501,"Grand Falls-Windsor","NL",48.92696,-55.65966,2018-01-20 06:00:00,24,1,25
"17987",10501,"Grand Falls-Windsor","NL",48.92696,-55.65966,2018-01-20 07:00:00,24,3,27
"17988",10501,"Grand Falls-Windsor","NL",48.92696,-55.65966,2018-01-20 08:00:00,28,1,29
"17989",10501,"Grand Falls-Windsor","NL",48.92696,-55.65966,2018-01-20 09:00:00,27,1,28
"17990",10501,"Grand Falls-Windsor","NL",48.92696,-55.65966,2018-01-20 10:00:00,27,2,29
"17991",10501,"Grand Falls-Windsor","NL",48.92696,-55.65966,2018-01-20 11:00:00,29,2,31
"17992",10501,"Grand Falls-Windsor","NL",48.92696,-55.65966,2018-01-20 12:00:00,31,1,32
"17993",10501,"Grand Falls-Windsor","NL",48.92696,-55.65966,2018-01-20 13:00:00,34,0,34
"17994",10501,"Grand Falls-Windsor","NL",48.92696,-55.65966,2018-01-20 14:00:00,34,1,35
"17995",10501,"Grand Falls-Windsor","NL",48.92696,-55.65966,2018-01-20 15:00:00,35,1,36
"17996",10501,"Grand Falls-Windsor","NL",48.92696,-55.65966,2018-01-20 16:00:00,36,0,36
"17997",10501,"Grand Falls-Windsor","NL",48.92696,-55.65966,2018-01-20 17:00:00,35,1,36
"17998",10501,"Grand Falls-Windsor","NL",48.92696,-55.65966,2018-01-20 18:00:00,35,0,35
"17999",10501,"Grand Falls-Windsor","NL",48.92696,-55.65966,2018-01-20 19:00:00,37,0,37
"18000",10501,"Grand Falls-Windsor","NL",48.92696,-55.65966,2018-01-20 20:00:00,36,0,36
"18001",10501,"Grand Falls-Windsor","NL",48.92696,-55.65966,2018-01-20 21:00:00,35,0,35
"18002",10501,"Grand Falls-Windsor","NL",48.92696,-55.65966,2018-01-20 22:00:00,34,1,35
"18003",10501,"Grand Falls-Windsor","NL",48.92696,-55.65966,2018-01-20 23:00:00,32,1,33
"18004",10501,"Grand Falls-Windsor","NL",48.92696,-55.65966,2018-01-21 00:00:00,32,1,33
"18005",10501,"Grand Falls-Windsor","NL",48.92696,-55.65966,2018-01-21 01:00:00,32,1,33
"18006",10501,"Grand Falls-Windsor","NL",48.92696,-55.65966,2018-01-21 02:00:00,31,2,33
"18007",10501,"Grand Falls-Windsor","NL",48.92696,-55.65966,2018-01-21 03:00:00,30,1,31
"18008",10501,"Grand Falls-Windsor","NL",48.92696,-55.65966,2018-01-21 04:00:00,29,1,30
"18009",10501,"Grand Falls-Windsor","NL",48.92696,-55.65966,2018-01-21 05:00:00,29,1,30
"18010",10501,"Grand Falls-Windsor","NL",48.92696,-55.65966,2018-01-21 06:00:00,28,1,29
"18011",10501,"Grand Falls-Windsor","NL",48.92696,-55.65966,2018-01-21 07:00:00,29,1,30
"18012",10501,"Grand Falls-Windsor","NL",48.92696,-55.65966,2018-01-21 08:00:00,31,1,32
"18013",10501,"Grand Falls-Windsor","NL",48.92696,-55.65966,2018-01-21 09:00:00,32,1,33
"18014",10501,"Grand Falls-Windsor","NL",48.92696,-55.65966,2018-01-21 10:00:00,33,0,33
"18015",10501,"Grand Falls-Windsor","NL",48.92696,-55.65966,2018-01-21 11:00:00,33,0,33
"18016",10501,"Grand Falls-Windsor","NL",48.92696,-55.65966,2018-01-21 12:00:00,35,0,35
"18017",10501,"Grand Falls-Windsor","NL",48.92696,-55.65966,2018-01-21 13:00:00,39,0,39
"18018",10501,"Grand Falls-Windsor","NL",48.92696,-55.65966,2018-01-21 14:00:00,39,2,41
"18019",10501,"Grand Falls-Windsor","NL",48.92696,-55.65966,2018-01-21 15:00:00,39,0,39
"18020",10501,"Grand Falls-Windsor","NL",48.92696,-55.65966,2018-01-21 16:00:00,39,0,39
"18021",10501,"Grand Falls-Windsor","NL",48.92696,-55.65966,2018-01-21 17:00:00,39,0,39
"18022",10501,"Grand Falls-Windsor","NL",48.92696,-55.65966,2018-01-21 18:00:00,39,0,39
"18023",10501,"Grand Falls-Windsor","NL",48.92696,-55.65966,2018-01-21 19:00:00,39,0,39
"18024",10501,"Grand Falls-Windsor","NL",48.92696,-55.65966,2018-01-21 20:00:00,NA,0,NA
"18025",10501,"Grand Falls-Windsor","NL",48.92696,-55.65966,2018-01-21 21:00:00,NA,0,NA
"18026",10501,"Grand Falls-Windsor","NL",48.92696,-55.65966,2018-01-21 22:00:00,NA,0,NA
"18027",10501,"Grand Falls-Windsor","NL",48.92696,-55.65966,2018-01-21 23:00:00,36,0,36
"18028",10501,"Grand Falls-Windsor","NL",48.92696,-55.65966,2018-01-22 00:00:00,36,0,36
"18029",10501,"Grand Falls-Windsor","NL",48.92696,-55.65966,2018-01-22 01:00:00,36,0,36
"18030",10501,"Grand Falls-Windsor","NL",48.92696,-55.65966,2018-01-22 02:00:00,36,0,36
"18031",10501,"Grand Falls-Windsor","NL",48.92696,-55.65966,2018-01-22 03:00:00,36,0,36
"18032",10501,"Grand Falls-Windsor","NL",48.92696,-55.65966,2018-01-22 04:00:00,35,0,35
"18033",10501,"Grand Falls-Windsor","NL",48.92696,-55.65966,2018-01-22 05:00:00,36,0,36
"18034",10501,"Grand Falls-Windsor","NL",48.92696,-55.65966,2018-01-22 06:00:00,36,0,36
"18035",10501,"Grand Falls-Windsor","NL",48.92696,-55.65966,2018-01-22 07:00:00,36,1,37
"18036",10501,"Grand Falls-Windsor","NL",48.92696,-55.65966,2018-01-22 08:00:00,37,0,37
"18037",10501,"Grand Falls-Windsor","NL",48.92696,-55.65966,2018-01-22 09:00:00,35,1,36
"18038",10501,"Grand Falls-Windsor","NL",48.92696,-55.65966,2018-01-22 10:00:00,NA,3,NA
"18039",10501,"Grand Falls-Windsor","NL",48.92696,-55.65966,2018-01-22 11:00:00,25,1,26
"18040",10501,"Grand Falls-Windsor","NL",48.92696,-55.65966,2018-01-22 12:00:00,36,1,37
"18041",10501,"Grand Falls-Windsor","NL",48.92696,-55.65966,2018-01-22 13:00:00,36,0,36
"18042",10501,"Grand Falls-Windsor","NL",48.92696,-55.65966,2018-01-22 14:00:00,37,0,37
"18043",10501,"Grand Falls-Windsor","NL",48.92696,-55.65966,2018-01-22 15:00:00,36,1,37
"18044",10501,"Grand Falls-Windsor","NL",48.92696,-55.65966,2018-01-22 16:00:00,36,0,36
"18045",10501,"Grand Falls-Windsor","NL",48.92696,-55.65966,2018-01-22 17:00:00,36,0,36
"18046",10501,"Grand Falls-Windsor","NL",48.92696,-55.65966,2018-01-22 18:00:00,36,0,36
"18047",10501,"Grand Falls-Windsor","NL",48.92696,-55.65966,2018-01-22 19:00:00,36,0,36
"18048",10501,"Grand Falls-Windsor","NL",48.92696,-55.65966,2018-01-22 20:00:00,36,0,36
"18049",10501,"Grand Falls-Windsor","NL",48.92696,-55.65966,2018-01-22 21:00:00,36,0,36
"18050",10501,"Grand Falls-Windsor","NL",48.92696,-55.65966,2018-01-22 22:00:00,36,1,37
"18051",10501,"Grand Falls-Windsor","NL",48.92696,-55.65966,2018-01-22 23:00:00,36,0,36
"18052",10501,"Grand Falls-Windsor","NL",48.92696,-55.65966,2018-01-23 00:00:00,37,0,37
"18053",10501,"Grand Falls-Windsor","NL",48.92696,-55.65966,2018-01-23 01:00:00,37,0,37
"18054",10501,"Grand Falls-Windsor","NL",48.92696,-55.65966,2018-01-23 02:00:00,38,0,38
"18055",10501,"Grand Falls-Windsor","NL",48.92696,-55.65966,2018-01-23 03:00:00,39,0,39
"18056",10501,"Grand Falls-Windsor","NL",48.92696,-55.65966,2018-01-23 04:00:00,39,0,39
"18057",10501,"Grand Falls-Windsor","NL",48.92696,-55.65966,2018-01-23 05:00:00,39,0,39
"18058",10501,"Grand Falls-Windsor","NL",48.92696,-55.65966,2018-01-23 06:00:00,39,0,39
"18059",10501,"Grand Falls-Windsor","NL",48.92696,-55.65966,2018-01-23 07:00:00,38,1,39
"18060",10501,"Grand Falls-Windsor","NL",48.92696,-55.65966,2018-01-23 08:00:00,38,1,39
"18061",10501,"Grand Falls-Windsor","NL",48.92696,-55.65966,2018-01-23 09:00:00,34,4,38
"18062",10501,"Grand Falls-Windsor","NL",48.92696,-55.65966,2018-01-23 10:00:00,37,1,38
"18063",10501,"Grand Falls-Windsor","NL",48.92696,-55.65966,2018-01-23 11:00:00,39,0,39
"18064",10501,"Grand Falls-Windsor","NL",48.92696,-55.65966,2018-01-23 12:00:00,39,0,39
"18065",10501,"Grand Falls-Windsor","NL",48.92696,-55.65966,2018-01-23 13:00:00,40,1,41
"18066",10501,"Grand Falls-Windsor","NL",48.92696,-55.65966,2018-01-23 14:00:00,40,1,41
"18067",10501,"Grand Falls-Windsor","NL",48.92696,-55.65966,2018-01-23 15:00:00,40,1,41
"18068",10501,"Grand Falls-Windsor","NL",48.92696,-55.65966,2018-01-23 16:00:00,39,1,40
"18069",10501,"Grand Falls-Windsor","NL",48.92696,-55.65966,2018-01-23 17:00:00,38,1,39
"18070",10501,"Grand Falls-Windsor","NL",48.92696,-55.65966,2018-01-23 18:00:00,37,1,38
"18071",10501,"Grand Falls-Windsor","NL",48.92696,-55.65966,2018-01-23 19:00:00,36,0,36
"18072",10501,"Grand Falls-Windsor","NL",48.92696,-55.65966,2018-01-23 20:00:00,35,1,36
"18073",10501,"Grand Falls-Windsor","NL",48.92696,-55.65966,2018-01-23 21:00:00,36,0,36
"18074",10501,"Grand Falls-Windsor","NL",48.92696,-55.65966,2018-01-23 22:00:00,36,1,37
"18075",10501,"Grand Falls-Windsor","NL",48.92696,-55.65966,2018-01-23 23:00:00,36,1,37
"18076",10501,"Grand Falls-Windsor","NL",48.92696,-55.65966,2018-01-24 00:00:00,34,2,36
"18077",10501,"Grand Falls-Windsor","NL",48.92696,-55.65966,2018-01-24 01:00:00,35,1,36
"18078",10501,"Grand Falls-Windsor","NL",48.92696,-55.65966,2018-01-24 02:00:00,36,0,36
"18079",10501,"Grand Falls-Windsor","NL",48.92696,-55.65966,2018-01-24 03:00:00,37,0,37
"18080",10501,"Grand Falls-Windsor","NL",48.92696,-55.65966,2018-01-24 04:00:00,37,0,37
"18081",10501,"Grand Falls-Windsor","NL",48.92696,-55.65966,2018-01-24 05:00:00,37,0,37
"18082",10501,"Grand Falls-Windsor","NL",48.92696,-55.65966,2018-01-24 06:00:00,37,0,37
"18083",10501,"Grand Falls-Windsor","NL",48.92696,-55.65966,2018-01-24 07:00:00,37,0,37
"18084",10501,"Grand Falls-Windsor","NL",48.92696,-55.65966,2018-01-24 08:00:00,37,0,37
"18085",10501,"Grand Falls-Windsor","NL",48.92696,-55.65966,2018-01-24 09:00:00,37,0,37
"18086",10501,"Grand Falls-Windsor","NL",48.92696,-55.65966,2018-01-24 10:00:00,38,0,38
"18087",10501,"Grand Falls-Windsor","NL",48.92696,-55.65966,2018-01-24 11:00:00,38,0,38
"18088",10501,"Grand Falls-Windsor","NL",48.92696,-55.65966,2018-01-24 12:00:00,38,0,38
"18089",10501,"Grand Falls-Windsor","NL",48.92696,-55.65966,2018-01-24 13:00:00,37,0,37
"18090",10501,"Grand Falls-Windsor","NL",48.92696,-55.65966,2018-01-24 14:00:00,37,0,37
"18091",10501,"Grand Falls-Windsor","NL",48.92696,-55.65966,2018-01-24 15:00:00,37,0,37
"18092",10501,"Grand Falls-Windsor","NL",48.92696,-55.65966,2018-01-24 16:00:00,39,1,40
"18093",10501,"Grand Falls-Windsor","NL",48.92696,-55.65966,2018-01-24 17:00:00,39,0,39
"18094",10501,"Grand Falls-Windsor","NL",48.92696,-55.65966,2018-01-24 18:00:00,37,0,37
"18095",10501,"Grand Falls-Windsor","NL",48.92696,-55.65966,2018-01-24 19:00:00,32,0,32
"18096",10501,"Grand Falls-Windsor","NL",48.92696,-55.65966,2018-01-24 20:00:00,30,1,31
"18097",10501,"Grand Falls-Windsor","NL",48.92696,-55.65966,2018-01-24 21:00:00,30,1,31
"18098",10501,"Grand Falls-Windsor","NL",48.92696,-55.65966,2018-01-24 22:00:00,30,0,30
"18099",10501,"Grand Falls-Windsor","NL",48.92696,-55.65966,2018-01-24 23:00:00,30,0,30
"18100",10501,"Grand Falls-Windsor","NL",48.92696,-55.65966,2018-01-25 00:00:00,27,1,28
"18101",10501,"Grand Falls-Windsor","NL",48.92696,-55.65966,2018-01-25 01:00:00,27,1,28
"18102",10501,"Grand Falls-Windsor","NL",48.92696,-55.65966,2018-01-25 02:00:00,27,1,28
"18103",10501,"Grand Falls-Windsor","NL",48.92696,-55.65966,2018-01-25 03:00:00,30,0,30
"18104",10501,"Grand Falls-Windsor","NL",48.92696,-55.65966,2018-01-25 04:00:00,33,0,33
"18105",10501,"Grand Falls-Windsor","NL",48.92696,-55.65966,2018-01-25 05:00:00,36,0,36
"18106",10501,"Grand Falls-Windsor","NL",48.92696,-55.65966,2018-01-25 06:00:00,37,0,37
"18107",10501,"Grand Falls-Windsor","NL",48.92696,-55.65966,2018-01-25 07:00:00,37,0,37
"18108",10501,"Grand Falls-Windsor","NL",48.92696,-55.65966,2018-01-25 08:00:00,37,0,37
"18109",10501,"Grand Falls-Windsor","NL",48.92696,-55.65966,2018-01-25 09:00:00,37,1,38
"18110",10501,"Grand Falls-Windsor","NL",48.92696,-55.65966,2018-01-25 10:00:00,37,0,37
"18111",10501,"Grand Falls-Windsor","NL",48.92696,-55.65966,2018-01-25 11:00:00,37,0,37
"18112",10501,"Grand Falls-Windsor","NL",48.92696,-55.65966,2018-01-25 12:00:00,37,0,37
"18113",10501,"Grand Falls-Windsor","NL",48.92696,-55.65966,2018-01-25 13:00:00,38,0,38
"18114",10501,"Grand Falls-Windsor","NL",48.92696,-55.65966,2018-01-25 14:00:00,37,0,37
"18115",10501,"Grand Falls-Windsor","NL",48.92696,-55.65966,2018-01-25 15:00:00,37,0,37
"18116",10501,"Grand Falls-Windsor","NL",48.92696,-55.65966,2018-01-25 16:00:00,37,0,37
"18117",10501,"Grand Falls-Windsor","NL",48.92696,-55.65966,2018-01-25 17:00:00,37,0,37
"18118",10501,"Grand Falls-Windsor","NL",48.92696,-55.65966,2018-01-25 18:00:00,36,1,37
"18119",10501,"Grand Falls-Windsor","NL",48.92696,-55.65966,2018-01-25 19:00:00,36,0,36
"18120",10501,"Grand Falls-Windsor","NL",48.92696,-55.65966,2018-01-25 20:00:00,35,0,35
"18121",10501,"Grand Falls-Windsor","NL",48.92696,-55.65966,2018-01-25 21:00:00,35,0,35
"18122",10501,"Grand Falls-Windsor","NL",48.92696,-55.65966,2018-01-25 22:00:00,34,0,34
"18123",10501,"Grand Falls-Windsor","NL",48.92696,-55.65966,2018-01-25 23:00:00,34,0,34
"18124",10501,"Grand Falls-Windsor","NL",48.92696,-55.65966,2018-01-26 00:00:00,33,0,33
"18125",10501,"Grand Falls-Windsor","NL",48.92696,-55.65966,2018-01-26 01:00:00,32,0,32
"18126",10501,"Grand Falls-Windsor","NL",48.92696,-55.65966,2018-01-26 02:00:00,33,0,33
"18127",10501,"Grand Falls-Windsor","NL",48.92696,-55.65966,2018-01-26 03:00:00,32,0,32
"18128",10501,"Grand Falls-Windsor","NL",48.92696,-55.65966,2018-01-26 04:00:00,32,1,33
"18129",10501,"Grand Falls-Windsor","NL",48.92696,-55.65966,2018-01-26 05:00:00,32,0,32
"18130",10501,"Grand Falls-Windsor","NL",48.92696,-55.65966,2018-01-26 06:00:00,31,0,31
"18131",10501,"Grand Falls-Windsor","NL",48.92696,-55.65966,2018-01-26 07:00:00,31,0,31
"18132",10501,"Grand Falls-Windsor","NL",48.92696,-55.65966,2018-01-26 08:00:00,30,0,30
"18133",10501,"Grand Falls-Windsor","NL",48.92696,-55.65966,2018-01-26 09:00:00,33,1,34
"18134",10501,"Grand Falls-Windsor","NL",48.92696,-55.65966,2018-01-26 10:00:00,33,1,34
"18135",10501,"Grand Falls-Windsor","NL",48.92696,-55.65966,2018-01-26 11:00:00,34,1,35
"18136",10501,"Grand Falls-Windsor","NL",48.92696,-55.65966,2018-01-26 12:00:00,34,1,35
"18137",10501,"Grand Falls-Windsor","NL",48.92696,-55.65966,2018-01-26 13:00:00,34,1,35
"18138",10501,"Grand Falls-Windsor","NL",48.92696,-55.65966,2018-01-26 14:00:00,34,1,35
"18139",10501,"Grand Falls-Windsor","NL",48.92696,-55.65966,2018-01-26 15:00:00,34,1,35
"18140",10501,"Grand Falls-Windsor","NL",48.92696,-55.65966,2018-01-26 16:00:00,35,1,36
"18141",10501,"Grand Falls-Windsor","NL",48.92696,-55.65966,2018-01-26 17:00:00,35,1,36
"18142",10501,"Grand Falls-Windsor","NL",48.92696,-55.65966,2018-01-26 18:00:00,35,1,36
"18143",10501,"Grand Falls-Windsor","NL",48.92696,-55.65966,2018-01-26 19:00:00,35,1,36
"18144",10501,"Grand Falls-Windsor","NL",48.92696,-55.65966,2018-01-26 20:00:00,35,0,35
"18145",10501,"Grand Falls-Windsor","NL",48.92696,-55.65966,2018-01-26 21:00:00,34,5,39
"18146",10501,"Grand Falls-Windsor","NL",48.92696,-55.65966,2018-01-26 22:00:00,37,0,37
"18147",10501,"Grand Falls-Windsor","NL",48.92696,-55.65966,2018-01-26 23:00:00,37,0,37
"18148",10501,"Grand Falls-Windsor","NL",48.92696,-55.65966,2018-01-27 00:00:00,37,0,37
"18149",10501,"Grand Falls-Windsor","NL",48.92696,-55.65966,2018-01-27 01:00:00,36,1,37
"18150",10501,"Grand Falls-Windsor","NL",48.92696,-55.65966,2018-01-27 02:00:00,33,0,33
"18151",10501,"Grand Falls-Windsor","NL",48.92696,-55.65966,2018-01-27 03:00:00,30,0,30
"18152",10501,"Grand Falls-Windsor","NL",48.92696,-55.65966,2018-01-27 04:00:00,28,0,28
"18153",10501,"Grand Falls-Windsor","NL",48.92696,-55.65966,2018-01-27 05:00:00,26,1,27
"18154",10501,"Grand Falls-Windsor","NL",48.92696,-55.65966,2018-01-27 06:00:00,27,0,27
"18155",10501,"Grand Falls-Windsor","NL",48.92696,-55.65966,2018-01-27 07:00:00,32,0,32
"18156",10501,"Grand Falls-Windsor","NL",48.92696,-55.65966,2018-01-27 08:00:00,36,0,36
"18157",10501,"Grand Falls-Windsor","NL",48.92696,-55.65966,2018-01-27 09:00:00,36,0,36
"18158",10501,"Grand Falls-Windsor","NL",48.92696,-55.65966,2018-01-27 10:00:00,36,0,36
"18159",10501,"Grand Falls-Windsor","NL",48.92696,-55.65966,2018-01-27 11:00:00,37,0,37
"18160",10501,"Grand Falls-Windsor","NL",48.92696,-55.65966,2018-01-27 12:00:00,37,0,37
"18161",10501,"Grand Falls-Windsor","NL",48.92696,-55.65966,2018-01-27 13:00:00,36,1,37
"18162",10501,"Grand Falls-Windsor","NL",48.92696,-55.65966,2018-01-27 14:00:00,37,0,37
"18163",10501,"Grand Falls-Windsor","NL",48.92696,-55.65966,2018-01-27 15:00:00,38,1,39
"18164",10501,"Grand Falls-Windsor","NL",48.92696,-55.65966,2018-01-27 16:00:00,38,1,39
"18165",10501,"Grand Falls-Windsor","NL",48.92696,-55.65966,2018-01-27 17:00:00,38,0,38
"18166",10501,"Grand Falls-Windsor","NL",48.92696,-55.65966,2018-01-27 18:00:00,35,1,36
"18167",10501,"Grand Falls-Windsor","NL",48.92696,-55.65966,2018-01-27 19:00:00,35,1,36
"18168",10501,"Grand Falls-Windsor","NL",48.92696,-55.65966,2018-01-27 20:00:00,36,1,37
"18169",10501,"Grand Falls-Windsor","NL",48.92696,-55.65966,2018-01-27 21:00:00,37,0,37
"18170",10501,"Grand Falls-Windsor","NL",48.92696,-55.65966,2018-01-27 22:00:00,38,0,38
"18171",10501,"Grand Falls-Windsor","NL",48.92696,-55.65966,2018-01-27 23:00:00,39,0,39
"18172",10501,"Grand Falls-Windsor","NL",48.92696,-55.65966,2018-01-28 00:00:00,39,0,39
"18173",10501,"Grand Falls-Windsor","NL",48.92696,-55.65966,2018-01-28 01:00:00,39,0,39
"18174",10501,"Grand Falls-Windsor","NL",48.92696,-55.65966,2018-01-28 02:00:00,39,0,39
"18175",10501,"Grand Falls-Windsor","NL",48.92696,-55.65966,2018-01-28 03:00:00,39,0,39
"18176",10501,"Grand Falls-Windsor","NL",48.92696,-55.65966,2018-01-28 04:00:00,39,0,39
"18177",10501,"Grand Falls-Windsor","NL",48.92696,-55.65966,2018-01-28 05:00:00,38,0,38
"18178",10501,"Grand Falls-Windsor","NL",48.92696,-55.65966,2018-01-28 06:00:00,37,0,37
"18179",10501,"Grand Falls-Windsor","NL",48.92696,-55.65966,2018-01-28 07:00:00,36,0,36
"18180",10501,"Grand Falls-Windsor","NL",48.92696,-55.65966,2018-01-28 08:00:00,36,0,36
"18181",10501,"Grand Falls-Windsor","NL",48.92696,-55.65966,2018-01-28 09:00:00,37,0,37
"18182",10501,"Grand Falls-Windsor","NL",48.92696,-55.65966,2018-01-28 10:00:00,37,0,37
"18183",10501,"Grand Falls-Windsor","NL",48.92696,-55.65966,2018-01-28 11:00:00,38,0,38
"18184",10501,"Grand Falls-Windsor","NL",48.92696,-55.65966,2018-01-28 12:00:00,39,0,39
"18185",10501,"Grand Falls-Windsor","NL",48.92696,-55.65966,2018-01-28 13:00:00,37,1,38
"18186",10501,"Grand Falls-Windsor","NL",48.92696,-55.65966,2018-01-28 14:00:00,36,1,37
"18187",10501,"Grand Falls-Windsor","NL",48.92696,-55.65966,2018-01-28 15:00:00,35,1,36
"18188",10501,"Grand Falls-Windsor","NL",48.92696,-55.65966,2018-01-28 16:00:00,34,1,35
"18189",10501,"Grand Falls-Windsor","NL",48.92696,-55.65966,2018-01-28 17:00:00,32,1,33
"18190",10501,"Grand Falls-Windsor","NL",48.92696,-55.65966,2018-01-28 18:00:00,32,1,33
"18191",10501,"Grand Falls-Windsor","NL",48.92696,-55.65966,2018-01-28 19:00:00,32,1,33
"18192",10501,"Grand Falls-Windsor","NL",48.92696,-55.65966,2018-01-28 20:00:00,33,1,34
"18193",10501,"Grand Falls-Windsor","NL",48.92696,-55.65966,2018-01-28 21:00:00,34,1,35
"18194",10501,"Grand Falls-Windsor","NL",48.92696,-55.65966,2018-01-28 22:00:00,33,0,33
"18195",10501,"Grand Falls-Windsor","NL",48.92696,-55.65966,2018-01-28 23:00:00,33,1,34
"18196",10501,"Grand Falls-Windsor","NL",48.92696,-55.65966,2018-01-29 00:00:00,32,1,33
"18197",10501,"Grand Falls-Windsor","NL",48.92696,-55.65966,2018-01-29 01:00:00,31,0,31
"18198",10501,"Grand Falls-Windsor","NL",48.92696,-55.65966,2018-01-29 02:00:00,30,0,30
"18199",10501,"Grand Falls-Windsor","NL",48.92696,-55.65966,2018-01-29 03:00:00,30,0,30
"18200",10501,"Grand Falls-Windsor","NL",48.92696,-55.65966,2018-01-29 04:00:00,30,0,30
"18201",10501,"Grand Falls-Windsor","NL",48.92696,-55.65966,2018-01-29 05:00:00,29,0,29
"18202",10501,"Grand Falls-Windsor","NL",48.92696,-55.65966,2018-01-29 06:00:00,32,1,33
"18203",10501,"Grand Falls-Windsor","NL",48.92696,-55.65966,2018-01-29 07:00:00,34,0,34
"18204",10501,"Grand Falls-Windsor","NL",48.92696,-55.65966,2018-01-29 08:00:00,36,0,36
"18205",10501,"Grand Falls-Windsor","NL",48.92696,-55.65966,2018-01-29 09:00:00,34,1,35
"18206",10501,"Grand Falls-Windsor","NL",48.92696,-55.65966,2018-01-29 10:00:00,35,0,35
"18207",10501,"Grand Falls-Windsor","NL",48.92696,-55.65966,2018-01-29 11:00:00,36,0,36
"18208",10501,"Grand Falls-Windsor","NL",48.92696,-55.65966,2018-01-29 12:00:00,36,0,36
"18209",10501,"Grand Falls-Windsor","NL",48.92696,-55.65966,2018-01-29 13:00:00,37,0,37
"18210",10501,"Grand Falls-Windsor","NL",48.92696,-55.65966,2018-01-29 14:00:00,37,0,37
"18211",10501,"Grand Falls-Windsor","NL",48.92696,-55.65966,2018-01-29 15:00:00,38,0,38
"18212",10501,"Grand Falls-Windsor","NL",48.92696,-55.65966,2018-01-29 16:00:00,38,0,38
"18213",10501,"Grand Falls-Windsor","NL",48.92696,-55.65966,2018-01-29 17:00:00,38,0,38
"18214",10501,"Grand Falls-Windsor","NL",48.92696,-55.65966,2018-01-29 18:00:00,37,1,38
"18215",10501,"Grand Falls-Windsor","NL",48.92696,-55.65966,2018-01-29 19:00:00,35,1,36
"18216",10501,"Grand Falls-Windsor","NL",48.92696,-55.65966,2018-01-29 20:00:00,35,1,36
"18217",10501,"Grand Falls-Windsor","NL",48.92696,-55.65966,2018-01-29 21:00:00,35,1,36
"18218",10501,"Grand Falls-Windsor","NL",48.92696,-55.65966,2018-01-29 22:00:00,35,1,36
"18219",10501,"Grand Falls-Windsor","NL",48.92696,-55.65966,2018-01-29 23:00:00,35,1,36
"18220",10501,"Grand Falls-Windsor","NL",48.92696,-55.65966,2018-01-30 00:00:00,35,1,36
"18221",10501,"Grand Falls-Windsor","NL",48.92696,-55.65966,2018-01-30 01:00:00,35,1,36
"18222",10501,"Grand Falls-Windsor","NL",48.92696,-55.65966,2018-01-30 02:00:00,35,1,36
"18223",10501,"Grand Falls-Windsor","NL",48.92696,-55.65966,2018-01-30 03:00:00,34,1,35
"18224",10501,"Grand Falls-Windsor","NL",48.92696,-55.65966,2018-01-30 04:00:00,34,1,35
"18225",10501,"Grand Falls-Windsor","NL",48.92696,-55.65966,2018-01-30 05:00:00,34,1,35
"18226",10501,"Grand Falls-Windsor","NL",48.92696,-55.65966,2018-01-30 06:00:00,33,1,34
"18227",10501,"Grand Falls-Windsor","NL",48.92696,-55.65966,2018-01-30 07:00:00,33,1,34
"18228",10501,"Grand Falls-Windsor","NL",48.92696,-55.65966,2018-01-30 08:00:00,34,1,35
"18229",10501,"Grand Falls-Windsor","NL",48.92696,-55.65966,2018-01-30 09:00:00,33,2,35
"18230",10501,"Grand Falls-Windsor","NL",48.92696,-55.65966,2018-01-30 10:00:00,34,1,35
"18231",10501,"Grand Falls-Windsor","NL",48.92696,-55.65966,2018-01-30 11:00:00,34,1,35
"18232",10501,"Grand Falls-Windsor","NL",48.92696,-55.65966,2018-01-30 12:00:00,33,2,35
"18233",10501,"Grand Falls-Windsor","NL",48.92696,-55.65966,2018-01-30 13:00:00,34,1,35
"18234",10501,"Grand Falls-Windsor","NL",48.92696,-55.65966,2018-01-30 14:00:00,33,2,35
"18235",10501,"Grand Falls-Windsor","NL",48.92696,-55.65966,2018-01-30 15:00:00,33,2,35
"18236",10501,"Grand Falls-Windsor","NL",48.92696,-55.65966,2018-01-30 16:00:00,33,2,35
"18237",10501,"Grand Falls-Windsor","NL",48.92696,-55.65966,2018-01-30 17:00:00,34,2,36
"18238",10501,"Grand Falls-Windsor","NL",48.92696,-55.65966,2018-01-30 18:00:00,35,1,36
"18239",10501,"Grand Falls-Windsor","NL",48.92696,-55.65966,2018-01-30 19:00:00,35,2,37
"18240",10501,"Grand Falls-Windsor","NL",48.92696,-55.65966,2018-01-30 20:00:00,34,4,38
"18241",10501,"Grand Falls-Windsor","NL",48.92696,-55.65966,2018-01-30 21:00:00,35,1,36
"18242",10501,"Grand Falls-Windsor","NL",48.92696,-55.65966,2018-01-30 22:00:00,33,2,35
"18243",10501,"Grand Falls-Windsor","NL",48.92696,-55.65966,2018-01-30 23:00:00,33,2,35
"18244",10501,"Grand Falls-Windsor","NL",48.92696,-55.65966,2018-01-31 00:00:00,31,2,33
"18245",10501,"Grand Falls-Windsor","NL",48.92696,-55.65966,2018-01-31 01:00:00,34,1,35
"18246",10501,"Grand Falls-Windsor","NL",48.92696,-55.65966,2018-01-31 02:00:00,34,2,36
"18247",10501,"Grand Falls-Windsor","NL",48.92696,-55.65966,2018-01-31 03:00:00,33,2,35
"18248",10501,"Grand Falls-Windsor","NL",48.92696,-55.65966,2018-01-31 04:00:00,32,2,34
"18249",10501,"Grand Falls-Windsor","NL",48.92696,-55.65966,2018-01-31 05:00:00,29,3,32
"18250",10501,"Grand Falls-Windsor","NL",48.92696,-55.65966,2018-01-31 06:00:00,23,8,31
"18251",10501,"Grand Falls-Windsor","NL",48.92696,-55.65966,2018-01-31 07:00:00,32,3,35
"18252",10501,"Grand Falls-Windsor","NL",48.92696,-55.65966,2018-01-31 08:00:00,37,0,37
"18253",10501,"Grand Falls-Windsor","NL",48.92696,-55.65966,2018-01-31 09:00:00,39,0,39
"18254",10501,"Grand Falls-Windsor","NL",48.92696,-55.65966,2018-01-31 10:00:00,37,0,37
"18255",10501,"Grand Falls-Windsor","NL",48.92696,-55.65966,2018-01-31 11:00:00,33,0,33
"18256",10501,"Grand Falls-Windsor","NL",48.92696,-55.65966,2018-01-31 12:00:00,34,0,34
"18257",10501,"Grand Falls-Windsor","NL",48.92696,-55.65966,2018-01-31 13:00:00,34,0,34
"18258",10501,"Grand Falls-Windsor","NL",48.92696,-55.65966,2018-01-31 14:00:00,34,0,34
"18259",10501,"Grand Falls-Windsor","NL",48.92696,-55.65966,2018-01-31 15:00:00,35,0,35
"18260",10501,"Grand Falls-Windsor","NL",48.92696,-55.65966,2018-01-31 16:00:00,36,0,36
"18261",10501,"Grand Falls-Windsor","NL",48.92696,-55.65966,2018-01-31 17:00:00,36,0,36
"18262",10501,"Grand Falls-Windsor","NL",48.92696,-55.65966,2018-01-31 18:00:00,36,0,36
"18263",10501,"Grand Falls-Windsor","NL",48.92696,-55.65966,2018-01-31 19:00:00,36,1,37
"18264",10501,"Grand Falls-Windsor","NL",48.92696,-55.65966,2018-01-31 20:00:00,36,0,36
"18265",10501,"Grand Falls-Windsor","NL",48.92696,-55.65966,2018-01-31 21:00:00,37,0,37
"18266",10501,"Grand Falls-Windsor","NL",48.92696,-55.65966,2018-01-31 22:00:00,36,0,36
"18267",10501,"Grand Falls-Windsor","NL",48.92696,-55.65966,2018-01-31 23:00:00,37,0,37
"18268",10501,"Grand Falls-Windsor","NL",48.92696,-55.65966,2018-02-01 00:00:00,36,0,36
"18269",10501,"Grand Falls-Windsor","NL",48.92696,-55.65966,2018-02-01 01:00:00,36,0,36
"18270",10501,"Grand Falls-Windsor","NL",48.92696,-55.65966,2018-02-01 02:00:00,35,0,35
"18271",10501,"Grand Falls-Windsor","NL",48.92696,-55.65966,2018-02-01 03:00:00,35,0,35
"18272",10501,"Grand Falls-Windsor","NL",48.92696,-55.65966,2018-02-01 04:00:00,35,0,35
"18273",10501,"Grand Falls-Windsor","NL",48.92696,-55.65966,2018-02-01 05:00:00,36,0,36
"18274",10501,"Grand Falls-Windsor","NL",48.92696,-55.65966,2018-02-01 06:00:00,36,0,36
"18275",10501,"Grand Falls-Windsor","NL",48.92696,-55.65966,2018-02-01 07:00:00,36,0,36
"18276",10501,"Grand Falls-Windsor","NL",48.92696,-55.65966,2018-02-01 08:00:00,36,1,37
"18277",10501,"Grand Falls-Windsor","NL",48.92696,-55.65966,2018-02-01 09:00:00,36,0,36
"18278",10501,"Grand Falls-Windsor","NL",48.92696,-55.65966,2018-02-01 10:00:00,36,0,36
"18279",10501,"Grand Falls-Windsor","NL",48.92696,-55.65966,2018-02-01 11:00:00,36,0,36
"18280",10501,"Grand Falls-Windsor","NL",48.92696,-55.65966,2018-02-01 12:00:00,36,0,36
"18281",10501,"Grand Falls-Windsor","NL",48.92696,-55.65966,2018-02-01 13:00:00,36,0,36
"18282",10501,"Grand Falls-Windsor","NL",48.92696,-55.65966,2018-02-01 14:00:00,36,0,36
"18283",10501,"Grand Falls-Windsor","NL",48.92696,-55.65966,2018-02-01 15:00:00,37,0,37
"18284",10501,"Grand Falls-Windsor","NL",48.92696,-55.65966,2018-02-01 16:00:00,37,0,37
"18285",10501,"Grand Falls-Windsor","NL",48.92696,-55.65966,2018-02-01 17:00:00,38,0,38
"18286",10501,"Grand Falls-Windsor","NL",48.92696,-55.65966,2018-02-01 18:00:00,39,0,39
"18287",10501,"Grand Falls-Windsor","NL",48.92696,-55.65966,2018-02-01 19:00:00,40,0,40
"18288",10501,"Grand Falls-Windsor","NL",48.92696,-55.65966,2018-02-01 20:00:00,39,1,40
"18289",10501,"Grand Falls-Windsor","NL",48.92696,-55.65966,2018-02-01 21:00:00,38,0,38
"18290",10501,"Grand Falls-Windsor","NL",48.92696,-55.65966,2018-02-01 22:00:00,38,0,38
"18291",10501,"Grand Falls-Windsor","NL",48.92696,-55.65966,2018-02-01 23:00:00,37,0,37
"18292",10501,"Grand Falls-Windsor","NL",48.92696,-55.65966,2018-02-02 00:00:00,37,0,37
"18293",10501,"Grand Falls-Windsor","NL",48.92696,-55.65966,2018-02-02 01:00:00,38,0,38
"18294",10501,"Grand Falls-Windsor","NL",48.92696,-55.65966,2018-02-02 02:00:00,39,0,39
"18295",10501,"Grand Falls-Windsor","NL",48.92696,-55.65966,2018-02-02 03:00:00,39,0,39
"18296",10501,"Grand Falls-Windsor","NL",48.92696,-55.65966,2018-02-02 04:00:00,39,0,39
"18297",10501,"Grand Falls-Windsor","NL",48.92696,-55.65966,2018-02-02 05:00:00,40,0,40
"18298",10501,"Grand Falls-Windsor","NL",48.92696,-55.65966,2018-02-02 06:00:00,40,0,40
"18299",10501,"Grand Falls-Windsor","NL",48.92696,-55.65966,2018-02-02 07:00:00,40,0,40
"18300",10501,"Grand Falls-Windsor","NL",48.92696,-55.65966,2018-02-02 08:00:00,40,0,40
"18301",10501,"Grand Falls-Windsor","NL",48.92696,-55.65966,2018-02-02 09:00:00,41,0,41
"18302",10501,"Grand Falls-Windsor","NL",48.92696,-55.65966,2018-02-02 10:00:00,39,0,39
"18303",10501,"Grand Falls-Windsor","NL",48.92696,-55.65966,2018-02-02 11:00:00,39,0,39
"18304",10501,"Grand Falls-Windsor","NL",48.92696,-55.65966,2018-02-02 12:00:00,39,0,39
"18305",10501,"Grand Falls-Windsor","NL",48.92696,-55.65966,2018-02-02 13:00:00,39,1,40
"18306",10501,"Grand Falls-Windsor","NL",48.92696,-55.65966,2018-02-02 14:00:00,39,0,39
"18307",10501,"Grand Falls-Windsor","NL",48.92696,-55.65966,2018-02-02 15:00:00,39,0,39
"18308",10501,"Grand Falls-Windsor","NL",48.92696,-55.65966,2018-02-02 16:00:00,37,1,38
"18309",10501,"Grand Falls-Windsor","NL",48.92696,-55.65966,2018-02-02 17:00:00,37,1,38
"18310",10501,"Grand Falls-Windsor","NL",48.92696,-55.65966,2018-02-02 18:00:00,41,0,41
"18311",10501,"Grand Falls-Windsor","NL",48.92696,-55.65966,2018-02-02 19:00:00,42,0,42
"18312",10501,"Grand Falls-Windsor","NL",48.92696,-55.65966,2018-02-02 20:00:00,42,0,42
"18313",10501,"Grand Falls-Windsor","NL",48.92696,-55.65966,2018-02-02 21:00:00,42,0,42
"18314",10501,"Grand Falls-Windsor","NL",48.92696,-55.65966,2018-02-02 22:00:00,42,0,42
"18315",10501,"Grand Falls-Windsor","NL",48.92696,-55.65966,2018-02-02 23:00:00,43,0,43
"18316",10501,"Grand Falls-Windsor","NL",48.92696,-55.65966,2018-02-03 00:00:00,43,0,43
"18317",10501,"Grand Falls-Windsor","NL",48.92696,-55.65966,2018-02-03 01:00:00,44,0,44
"18318",10501,"Grand Falls-Windsor","NL",48.92696,-55.65966,2018-02-03 02:00:00,45,0,45
"18319",10501,"Grand Falls-Windsor","NL",48.92696,-55.65966,2018-02-03 03:00:00,43,0,43
"18320",10501,"Grand Falls-Windsor","NL",48.92696,-55.65966,2018-02-03 04:00:00,34,1,35
"18321",10501,"Grand Falls-Windsor","NL",48.92696,-55.65966,2018-02-03 05:00:00,31,0,31
"18322",10501,"Grand Falls-Windsor","NL",48.92696,-55.65966,2018-02-03 06:00:00,31,0,31
"18323",10501,"Grand Falls-Windsor","NL",48.92696,-55.65966,2018-02-03 07:00:00,31,0,31
"18324",10501,"Grand Falls-Windsor","NL",48.92696,-55.65966,2018-02-03 08:00:00,32,0,32
"18325",10501,"Grand Falls-Windsor","NL",48.92696,-55.65966,2018-02-03 09:00:00,32,0,32
"18326",10501,"Grand Falls-Windsor","NL",48.92696,-55.65966,2018-02-03 10:00:00,32,0,32
"18327",10501,"Grand Falls-Windsor","NL",48.92696,-55.65966,2018-02-03 11:00:00,33,0,33
"18328",10501,"Grand Falls-Windsor","NL",48.92696,-55.65966,2018-02-03 12:00:00,33,0,33
"18329",10501,"Grand Falls-Windsor","NL",48.92696,-55.65966,2018-02-03 13:00:00,33,0,33
"18330",10501,"Grand Falls-Windsor","NL",48.92696,-55.65966,2018-02-03 14:00:00,34,0,34
"18331",10501,"Grand Falls-Windsor","NL",48.92696,-55.65966,2018-02-03 15:00:00,35,0,35
"18332",10501,"Grand Falls-Windsor","NL",48.92696,-55.65966,2018-02-03 16:00:00,35,0,35
"18333",10501,"Grand Falls-Windsor","NL",48.92696,-55.65966,2018-02-03 17:00:00,35,0,35
"18334",10501,"Grand Falls-Windsor","NL",48.92696,-55.65966,2018-02-03 18:00:00,35,0,35
"18335",10501,"Grand Falls-Windsor","NL",48.92696,-55.65966,2018-02-03 19:00:00,36,0,36
"18336",10501,"Grand Falls-Windsor","NL",48.92696,-55.65966,2018-02-03 20:00:00,37,0,37
"18337",10501,"Grand Falls-Windsor","NL",48.92696,-55.65966,2018-02-03 21:00:00,37,0,37
"18338",10501,"Grand Falls-Windsor","NL",48.92696,-55.65966,2018-02-03 22:00:00,38,0,38
"18339",10501,"Grand Falls-Windsor","NL",48.92696,-55.65966,2018-02-03 23:00:00,38,0,38
"18340",10501,"Grand Falls-Windsor","NL",48.92696,-55.65966,2018-02-04 00:00:00,39,0,39
"18341",10501,"Grand Falls-Windsor","NL",48.92696,-55.65966,2018-02-04 01:00:00,38,0,38
"18342",10501,"Grand Falls-Windsor","NL",48.92696,-55.65966,2018-02-04 02:00:00,37,0,37
"18343",10501,"Grand Falls-Windsor","NL",48.92696,-55.65966,2018-02-04 03:00:00,36,0,36
"18344",10501,"Grand Falls-Windsor","NL",48.92696,-55.65966,2018-02-04 04:00:00,36,0,36
"18345",10501,"Grand Falls-Windsor","NL",48.92696,-55.65966,2018-02-04 05:00:00,36,0,36
"18346",10501,"Grand Falls-Windsor","NL",48.92696,-55.65966,2018-02-04 06:00:00,35,0,35
"18347",10501,"Grand Falls-Windsor","NL",48.92696,-55.65966,2018-02-04 07:00:00,35,0,35
"18348",10501,"Grand Falls-Windsor","NL",48.92696,-55.65966,2018-02-04 08:00:00,35,0,35
"18349",10501,"Grand Falls-Windsor","NL",48.92696,-55.65966,2018-02-04 09:00:00,36,0,36
"18350",10501,"Grand Falls-Windsor","NL",48.92696,-55.65966,2018-02-04 10:00:00,37,0,37
"18351",10501,"Grand Falls-Windsor","NL",48.92696,-55.65966,2018-02-04 11:00:00,37,0,37
"18352",10501,"Grand Falls-Windsor","NL",48.92696,-55.65966,2018-02-04 12:00:00,37,0,37
"18353",10501,"Grand Falls-Windsor","NL",48.92696,-55.65966,2018-02-04 13:00:00,37,0,37
"18354",10501,"Grand Falls-Windsor","NL",48.92696,-55.65966,2018-02-04 14:00:00,37,0,37
"18355",10501,"Grand Falls-Windsor","NL",48.92696,-55.65966,2018-02-04 15:00:00,38,0,38
"18356",10501,"Grand Falls-Windsor","NL",48.92696,-55.65966,2018-02-04 16:00:00,38,0,38
"18357",10501,"Grand Falls-Windsor","NL",48.92696,-55.65966,2018-02-04 17:00:00,38,0,38
"18358",10501,"Grand Falls-Windsor","NL",48.92696,-55.65966,2018-02-04 18:00:00,38,0,38
"18359",10501,"Grand Falls-Windsor","NL",48.92696,-55.65966,2018-02-04 19:00:00,38,0,38
"18360",10501,"Grand Falls-Windsor","NL",48.92696,-55.65966,2018-02-04 20:00:00,38,0,38
"18361",10501,"Grand Falls-Windsor","NL",48.92696,-55.65966,2018-02-04 21:00:00,38,0,38
"18362",10501,"Grand Falls-Windsor","NL",48.92696,-55.65966,2018-02-04 22:00:00,39,0,39
"18363",10501,"Grand Falls-Windsor","NL",48.92696,-55.65966,2018-02-04 23:00:00,39,0,39
"18364",10501,"Grand Falls-Windsor","NL",48.92696,-55.65966,2018-02-05 00:00:00,39,0,39
"18365",10501,"Grand Falls-Windsor","NL",48.92696,-55.65966,2018-02-05 01:00:00,39,0,39
"18366",10501,"Grand Falls-Windsor","NL",48.92696,-55.65966,2018-02-05 02:00:00,39,0,39
"18367",10501,"Grand Falls-Windsor","NL",48.92696,-55.65966,2018-02-05 03:00:00,38,0,38
"18368",10501,"Grand Falls-Windsor","NL",48.92696,-55.65966,2018-02-05 04:00:00,39,0,39
"18369",10501,"Grand Falls-Windsor","NL",48.92696,-55.65966,2018-02-05 05:00:00,38,0,38
"18370",10501,"Grand Falls-Windsor","NL",48.92696,-55.65966,2018-02-05 06:00:00,38,0,38
"18371",10501,"Grand Falls-Windsor","NL",48.92696,-55.65966,2018-02-05 07:00:00,38,0,38
"18372",10501,"Grand Falls-Windsor","NL",48.92696,-55.65966,2018-02-05 08:00:00,38,0,38
"18373",10501,"Grand Falls-Windsor","NL",48.92696,-55.65966,2018-02-05 09:00:00,37,0,37
"18374",10501,"Grand Falls-Windsor","NL",48.92696,-55.65966,2018-02-05 10:00:00,38,0,38
"18375",10501,"Grand Falls-Windsor","NL",48.92696,-55.65966,2018-02-05 11:00:00,39,0,39
"18376",10501,"Grand Falls-Windsor","NL",48.92696,-55.65966,2018-02-05 12:00:00,40,0,40
"18377",10501,"Grand Falls-Windsor","NL",48.92696,-55.65966,2018-02-05 13:00:00,40,0,40
"18378",10501,"Grand Falls-Windsor","NL",48.92696,-55.65966,2018-02-05 14:00:00,40,0,40
"18379",10501,"Grand Falls-Windsor","NL",48.92696,-55.65966,2018-02-05 15:00:00,40,0,40
"18380",10501,"Grand Falls-Windsor","NL",48.92696,-55.65966,2018-02-05 16:00:00,39,0,39
"18381",10501,"Grand Falls-Windsor","NL",48.92696,-55.65966,2018-02-05 17:00:00,39,0,39
"18382",10501,"Grand Falls-Windsor","NL",48.92696,-55.65966,2018-02-05 18:00:00,39,0,39
"18383",10501,"Grand Falls-Windsor","NL",48.92696,-55.65966,2018-02-05 19:00:00,39,0,39
"18384",10501,"Grand Falls-Windsor","NL",48.92696,-55.65966,2018-02-05 20:00:00,39,0,39
"18385",10501,"Grand Falls-Windsor","NL",48.92696,-55.65966,2018-02-05 21:00:00,39,0,39
"18386",10501,"Grand Falls-Windsor","NL",48.92696,-55.65966,2018-02-05 22:00:00,38,0,38
"18387",10501,"Grand Falls-Windsor","NL",48.92696,-55.65966,2018-02-05 23:00:00,38,0,38
"18388",10501,"Grand Falls-Windsor","NL",48.92696,-55.65966,2018-02-06 00:00:00,38,0,38
"18389",10501,"Grand Falls-Windsor","NL",48.92696,-55.65966,2018-02-06 01:00:00,37,0,37
"18390",10501,"Grand Falls-Windsor","NL",48.92696,-55.65966,2018-02-06 02:00:00,36,0,36
"18391",10501,"Grand Falls-Windsor","NL",48.92696,-55.65966,2018-02-06 03:00:00,34,0,34
"18392",10501,"Grand Falls-Windsor","NL",48.92696,-55.65966,2018-02-06 04:00:00,32,0,32
"18393",10501,"Grand Falls-Windsor","NL",48.92696,-55.65966,2018-02-06 05:00:00,32,0,32
"18394",10501,"Grand Falls-Windsor","NL",48.92696,-55.65966,2018-02-06 06:00:00,33,0,33
"18395",10501,"Grand Falls-Windsor","NL",48.92696,-55.65966,2018-02-06 07:00:00,34,3,37
"18396",10501,"Grand Falls-Windsor","NL",48.92696,-55.65966,2018-02-06 08:00:00,36,0,36
"18397",10501,"Grand Falls-Windsor","NL",48.92696,-55.65966,2018-02-06 09:00:00,37,0,37
"18398",10501,"Grand Falls-Windsor","NL",48.92696,-55.65966,2018-02-06 10:00:00,36,0,36
"18399",10501,"Grand Falls-Windsor","NL",48.92696,-55.65966,2018-02-06 11:00:00,37,0,37
"18400",10501,"Grand Falls-Windsor","NL",48.92696,-55.65966,2018-02-06 12:00:00,37,1,38
"18401",10501,"Grand Falls-Windsor","NL",48.92696,-55.65966,2018-02-06 13:00:00,39,0,39
"18402",10501,"Grand Falls-Windsor","NL",48.92696,-55.65966,2018-02-06 14:00:00,37,0,37
"18403",10501,"Grand Falls-Windsor","NL",48.92696,-55.65966,2018-02-06 15:00:00,35,0,35
"18404",10501,"Grand Falls-Windsor","NL",48.92696,-55.65966,2018-02-06 16:00:00,30,NA,NA
"18405",10501,"Grand Falls-Windsor","NL",48.92696,-55.65966,2018-02-06 17:00:00,30,NA,NA
"18406",10501,"Grand Falls-Windsor","NL",48.92696,-55.65966,2018-02-06 18:00:00,38,NA,NA
"18407",10501,"Grand Falls-Windsor","NL",48.92696,-55.65966,2018-02-06 19:00:00,38,NA,NA
"18408",10501,"Grand Falls-Windsor","NL",48.92696,-55.65966,2018-02-06 20:00:00,38,NA,NA
"18409",10501,"Grand Falls-Windsor","NL",48.92696,-55.65966,2018-02-06 21:00:00,37,NA,NA
"18410",10501,"Grand Falls-Windsor","NL",48.92696,-55.65966,2018-02-06 22:00:00,37,NA,NA
"18411",10501,"Grand Falls-Windsor","NL",48.92696,-55.65966,2018-02-06 23:00:00,37,NA,NA
"18412",10501,"Grand Falls-Windsor","NL",48.92696,-55.65966,2018-02-07 00:00:00,36,NA,NA
"18413",10501,"Grand Falls-Windsor","NL",48.92696,-55.65966,2018-02-07 01:00:00,36,NA,NA
"18414",10501,"Grand Falls-Windsor","NL",48.92696,-55.65966,2018-02-07 02:00:00,34,NA,NA
"18415",10501,"Grand Falls-Windsor","NL",48.92696,-55.65966,2018-02-07 03:00:00,34,0,34
"18416",10501,"Grand Falls-Windsor","NL",48.92696,-55.65966,2018-02-07 04:00:00,33,0,33
"18417",10501,"Grand Falls-Windsor","NL",48.92696,-55.65966,2018-02-07 05:00:00,33,0,33
"18418",10501,"Grand Falls-Windsor","NL",48.92696,-55.65966,2018-02-07 06:00:00,32,0,32
"18419",10501,"Grand Falls-Windsor","NL",48.92696,-55.65966,2018-02-07 07:00:00,31,1,32
"18420",10501,"Grand Falls-Windsor","NL",48.92696,-55.65966,2018-02-07 08:00:00,31,1,32
"18421",10501,"Grand Falls-Windsor","NL",48.92696,-55.65966,2018-02-07 09:00:00,32,1,33
"18422",10501,"Grand Falls-Windsor","NL",48.92696,-55.65966,2018-02-07 10:00:00,29,NA,NA
"18423",10501,"Grand Falls-Windsor","NL",48.92696,-55.65966,2018-02-07 11:00:00,26,NA,NA
"18424",10501,"Grand Falls-Windsor","NL",48.92696,-55.65966,2018-02-07 12:00:00,35,NA,NA
"18425",10501,"Grand Falls-Windsor","NL",48.92696,-55.65966,2018-02-07 13:00:00,37,0,37
"18426",10501,"Grand Falls-Windsor","NL",48.92696,-55.65966,2018-02-07 14:00:00,38,1,39
"18427",10501,"Grand Falls-Windsor","NL",48.92696,-55.65966,2018-02-07 15:00:00,40,0,40
"18428",10501,"Grand Falls-Windsor","NL",48.92696,-55.65966,2018-02-07 16:00:00,40,1,41
"18429",10501,"Grand Falls-Windsor","NL",48.92696,-55.65966,2018-02-07 17:00:00,39,2,41
"18430",10501,"Grand Falls-Windsor","NL",48.92696,-55.65966,2018-02-07 18:00:00,37,3,40
"18431",10501,"Grand Falls-Windsor","NL",48.92696,-55.65966,2018-02-07 19:00:00,37,2,39
"18432",10501,"Grand Falls-Windsor","NL",48.92696,-55.65966,2018-02-07 20:00:00,34,5,39
"18433",10501,"Grand Falls-Windsor","NL",48.92696,-55.65966,2018-02-07 21:00:00,34,3,37
"18434",10501,"Grand Falls-Windsor","NL",48.92696,-55.65966,2018-02-07 22:00:00,35,3,38
"18435",10501,"Grand Falls-Windsor","NL",48.92696,-55.65966,2018-02-07 23:00:00,35,3,38
"18436",10501,"Grand Falls-Windsor","NL",48.92696,-55.65966,2018-02-08 00:00:00,36,2,38
"18437",10501,"Grand Falls-Windsor","NL",48.92696,-55.65966,2018-02-08 01:00:00,35,2,37
"18438",10501,"Grand Falls-Windsor","NL",48.92696,-55.65966,2018-02-08 02:00:00,36,2,38
"18439",10501,"Grand Falls-Windsor","NL",48.92696,-55.65966,2018-02-08 03:00:00,34,2,36
"18440",10501,"Grand Falls-Windsor","NL",48.92696,-55.65966,2018-02-08 04:00:00,34,1,35
"18441",10501,"Grand Falls-Windsor","NL",48.92696,-55.65966,2018-02-08 05:00:00,32,1,33
"18442",10501,"Grand Falls-Windsor","NL",48.92696,-55.65966,2018-02-08 06:00:00,28,3,31
"18443",10501,"Grand Falls-Windsor","NL",48.92696,-55.65966,2018-02-08 07:00:00,22,7,29
"18444",10501,"Grand Falls-Windsor","NL",48.92696,-55.65966,2018-02-08 08:00:00,19,11,30
"18445",10501,"Grand Falls-Windsor","NL",48.92696,-55.65966,2018-02-08 09:00:00,21,7,28
"18446",10501,"Grand Falls-Windsor","NL",48.92696,-55.65966,2018-02-08 10:00:00,23,6,29
"18447",10501,"Grand Falls-Windsor","NL",48.92696,-55.65966,2018-02-08 11:00:00,40,1,41
"18448",10501,"Grand Falls-Windsor","NL",48.92696,-55.65966,2018-02-08 12:00:00,41,1,42
"18449",10501,"Grand Falls-Windsor","NL",48.92696,-55.65966,2018-02-08 13:00:00,41,0,41
"18450",10501,"Grand Falls-Windsor","NL",48.92696,-55.65966,2018-02-08 14:00:00,35,1,36
"18451",10501,"Grand Falls-Windsor","NL",48.92696,-55.65966,2018-02-08 15:00:00,33,1,34
"18452",10501,"Grand Falls-Windsor","NL",48.92696,-55.65966,2018-02-08 16:00:00,35,2,37
"18453",10501,"Grand Falls-Windsor","NL",48.92696,-55.65966,2018-02-08 17:00:00,35,2,37
"18454",10501,"Grand Falls-Windsor","NL",48.92696,-55.65966,2018-02-08 18:00:00,36,2,38
"18455",10501,"Grand Falls-Windsor","NL",48.92696,-55.65966,2018-02-08 19:00:00,36,1,37
"18456",10501,"Grand Falls-Windsor","NL",48.92696,-55.65966,2018-02-08 20:00:00,36,1,37
"18457",10501,"Grand Falls-Windsor","NL",48.92696,-55.65966,2018-02-08 21:00:00,36,1,37
"18458",10501,"Grand Falls-Windsor","NL",48.92696,-55.65966,2018-02-08 22:00:00,36,2,38
"18459",10501,"Grand Falls-Windsor","NL",48.92696,-55.65966,2018-02-08 23:00:00,36,1,37
"18460",10501,"Grand Falls-Windsor","NL",48.92696,-55.65966,2018-02-09 00:00:00,35,1,36
"18461",10501,"Grand Falls-Windsor","NL",48.92696,-55.65966,2018-02-09 01:00:00,32,0,32
"18462",10501,"Grand Falls-Windsor","NL",48.92696,-55.65966,2018-02-09 02:00:00,34,0,34
"18463",10501,"Grand Falls-Windsor","NL",48.92696,-55.65966,2018-02-09 03:00:00,35,0,35
"18464",10501,"Grand Falls-Windsor","NL",48.92696,-55.65966,2018-02-09 04:00:00,36,0,36
"18465",10501,"Grand Falls-Windsor","NL",48.92696,-55.65966,2018-02-09 05:00:00,37,1,38
"18466",10501,"Grand Falls-Windsor","NL",48.92696,-55.65966,2018-02-09 06:00:00,36,0,36
"18467",10501,"Grand Falls-Windsor","NL",48.92696,-55.65966,2018-02-09 07:00:00,35,2,37
"18468",10501,"Grand Falls-Windsor","NL",48.92696,-55.65966,2018-02-09 08:00:00,33,1,34
"18469",10501,"Grand Falls-Windsor","NL",48.92696,-55.65966,2018-02-09 09:00:00,33,1,34
"18470",10501,"Grand Falls-Windsor","NL",48.92696,-55.65966,2018-02-09 10:00:00,34,1,35
"18471",10501,"Grand Falls-Windsor","NL",48.92696,-55.65966,2018-02-09 11:00:00,35,1,36
"18472",10501,"Grand Falls-Windsor","NL",48.92696,-55.65966,2018-02-09 12:00:00,37,0,37
"18473",10501,"Grand Falls-Windsor","NL",48.92696,-55.65966,2018-02-09 13:00:00,36,1,37
"18474",10501,"Grand Falls-Windsor","NL",48.92696,-55.65966,2018-02-09 14:00:00,35,7,42
"18475",10501,"Grand Falls-Windsor","NL",48.92696,-55.65966,2018-02-09 15:00:00,36,1,37
"18476",10501,"Grand Falls-Windsor","NL",48.92696,-55.65966,2018-02-09 16:00:00,36,1,37
"18477",10501,"Grand Falls-Windsor","NL",48.92696,-55.65966,2018-02-09 17:00:00,35,1,36
"18478",10501,"Grand Falls-Windsor","NL",48.92696,-55.65966,2018-02-09 18:00:00,35,1,36
"18479",10501,"Grand Falls-Windsor","NL",48.92696,-55.65966,2018-02-09 19:00:00,33,1,34
"18480",10501,"Grand Falls-Windsor","NL",48.92696,-55.65966,2018-02-09 20:00:00,31,1,32
"18481",10501,"Grand Falls-Windsor","NL",48.92696,-55.65966,2018-02-09 21:00:00,29,0,29
"18482",10501,"Grand Falls-Windsor","NL",48.92696,-55.65966,2018-02-09 22:00:00,29,1,30
"18483",10501,"Grand Falls-Windsor","NL",48.92696,-55.65966,2018-02-09 23:00:00,28,1,29
"18484",10501,"Grand Falls-Windsor","NL",48.92696,-55.65966,2018-02-10 00:00:00,27,1,28
"18485",10501,"Grand Falls-Windsor","NL",48.92696,-55.65966,2018-02-10 01:00:00,29,1,30
"18486",10501,"Grand Falls-Windsor","NL",48.92696,-55.65966,2018-02-10 02:00:00,23,1,24
"18487",10501,"Grand Falls-Windsor","NL",48.92696,-55.65966,2018-02-10 03:00:00,22,2,24
"18488",10501,"Grand Falls-Windsor","NL",48.92696,-55.65966,2018-02-10 04:00:00,20,6,26
"18489",10501,"Grand Falls-Windsor","NL",48.92696,-55.65966,2018-02-10 05:00:00,23,3,26
"18490",10501,"Grand Falls-Windsor","NL",48.92696,-55.65966,2018-02-10 06:00:00,23,3,26
"18491",10501,"Grand Falls-Windsor","NL",48.92696,-55.65966,2018-02-10 07:00:00,23,3,26
"18492",10501,"Grand Falls-Windsor","NL",48.92696,-55.65966,2018-02-10 08:00:00,31,2,33
"18493",10501,"Grand Falls-Windsor","NL",48.92696,-55.65966,2018-02-10 09:00:00,32,1,33
"18494",10501,"Grand Falls-Windsor","NL",48.92696,-55.65966,2018-02-10 10:00:00,33,1,34
"18495",10501,"Grand Falls-Windsor","NL",48.92696,-55.65966,2018-02-10 11:00:00,33,1,34
"18496",10501,"Grand Falls-Windsor","NL",48.92696,-55.65966,2018-02-10 12:00:00,36,0,36
"18497",10501,"Grand Falls-Windsor","NL",48.92696,-55.65966,2018-02-10 13:00:00,38,0,38
"18498",10501,"Grand Falls-Windsor","NL",48.92696,-55.65966,2018-02-10 14:00:00,39,0,39
"18499",10501,"Grand Falls-Windsor","NL",48.92696,-55.65966,2018-02-10 15:00:00,39,0,39
"18500",10501,"Grand Falls-Windsor","NL",48.92696,-55.65966,2018-02-10 16:00:00,39,0,39
"18501",10501,"Grand Falls-Windsor","NL",48.92696,-55.65966,2018-02-10 17:00:00,39,0,39
"18502",10501,"Grand Falls-Windsor","NL",48.92696,-55.65966,2018-02-10 18:00:00,39,1,40
"18503",10501,"Grand Falls-Windsor","NL",48.92696,-55.65966,2018-02-10 19:00:00,39,0,39
"18504",10501,"Grand Falls-Windsor","NL",48.92696,-55.65966,2018-02-10 20:00:00,39,0,39
"18505",10501,"Grand Falls-Windsor","NL",48.92696,-55.65966,2018-02-10 21:00:00,39,0,39
"18506",10501,"Grand Falls-Windsor","NL",48.92696,-55.65966,2018-02-10 22:00:00,40,0,40
"18507",10501,"Grand Falls-Windsor","NL",48.92696,-55.65966,2018-02-10 23:00:00,41,0,41
"18508",10501,"Grand Falls-Windsor","NL",48.92696,-55.65966,2018-02-11 00:00:00,39,0,39
"18509",10501,"Grand Falls-Windsor","NL",48.92696,-55.65966,2018-02-11 01:00:00,38,0,38
"18510",10501,"Grand Falls-Windsor","NL",48.92696,-55.65966,2018-02-11 02:00:00,38,0,38
"18511",10501,"Grand Falls-Windsor","NL",48.92696,-55.65966,2018-02-11 03:00:00,38,0,38
"18512",10501,"Grand Falls-Windsor","NL",48.92696,-55.65966,2018-02-11 04:00:00,38,0,38
"18513",10501,"Grand Falls-Windsor","NL",48.92696,-55.65966,2018-02-11 05:00:00,38,0,38
"18514",10501,"Grand Falls-Windsor","NL",48.92696,-55.65966,2018-02-11 06:00:00,35,0,35
"18515",10501,"Grand Falls-Windsor","NL",48.92696,-55.65966,2018-02-11 07:00:00,34,0,34
"18516",10501,"Grand Falls-Windsor","NL",48.92696,-55.65966,2018-02-11 08:00:00,35,1,36
"18517",10501,"Grand Falls-Windsor","NL",48.92696,-55.65966,2018-02-11 09:00:00,35,1,36
"18518",10501,"Grand Falls-Windsor","NL",48.92696,-55.65966,2018-02-11 10:00:00,35,2,37
"18519",10501,"Grand Falls-Windsor","NL",48.92696,-55.65966,2018-02-11 11:00:00,37,2,39
"18520",10501,"Grand Falls-Windsor","NL",48.92696,-55.65966,2018-02-11 12:00:00,35,3,38
"18521",10501,"Grand Falls-Windsor","NL",48.92696,-55.65966,2018-02-11 13:00:00,36,3,39
"18522",10501,"Grand Falls-Windsor","NL",48.92696,-55.65966,2018-02-11 14:00:00,37,2,39
"18523",10501,"Grand Falls-Windsor","NL",48.92696,-55.65966,2018-02-11 15:00:00,39,2,41
"18524",10501,"Grand Falls-Windsor","NL",48.92696,-55.65966,2018-02-11 16:00:00,39,2,41
"18525",10501,"Grand Falls-Windsor","NL",48.92696,-55.65966,2018-02-11 17:00:00,39,2,41
"18526",10501,"Grand Falls-Windsor","NL",48.92696,-55.65966,2018-02-11 18:00:00,39,2,41
"18527",10501,"Grand Falls-Windsor","NL",48.92696,-55.65966,2018-02-11 19:00:00,39,2,41
"18528",10501,"Grand Falls-Windsor","NL",48.92696,-55.65966,2018-02-11 20:00:00,38,3,41
"18529",10501,"Grand Falls-Windsor","NL",48.92696,-55.65966,2018-02-11 21:00:00,37,3,40
"18530",10501,"Grand Falls-Windsor","NL",48.92696,-55.65966,2018-02-11 22:00:00,36,3,39
"18531",10501,"Grand Falls-Windsor","NL",48.92696,-55.65966,2018-02-11 23:00:00,35,3,38
"18532",10501,"Grand Falls-Windsor","NL",48.92696,-55.65966,2018-02-12 00:00:00,34,3,37
"18533",10501,"Grand Falls-Windsor","NL",48.92696,-55.65966,2018-02-12 01:00:00,33,2,35
"18534",10501,"Grand Falls-Windsor","NL",48.92696,-55.65966,2018-02-12 02:00:00,33,2,35
"18535",10501,"Grand Falls-Windsor","NL",48.92696,-55.65966,2018-02-12 03:00:00,32,2,34
"18536",10501,"Grand Falls-Windsor","NL",48.92696,-55.65966,2018-02-12 04:00:00,34,1,35
"18537",10501,"Grand Falls-Windsor","NL",48.92696,-55.65966,2018-02-12 05:00:00,34,2,36
"18538",10501,"Grand Falls-Windsor","NL",48.92696,-55.65966,2018-02-12 06:00:00,37,1,38
"18539",10501,"Grand Falls-Windsor","NL",48.92696,-55.65966,2018-02-12 07:00:00,38,1,39
"18540",10501,"Grand Falls-Windsor","NL",48.92696,-55.65966,2018-02-12 08:00:00,38,1,39
"18541",10501,"Grand Falls-Windsor","NL",48.92696,-55.65966,2018-02-12 09:00:00,37,1,38
"18542",10501,"Grand Falls-Windsor","NL",48.92696,-55.65966,2018-02-12 10:00:00,36,1,37
"18543",10501,"Grand Falls-Windsor","NL",48.92696,-55.65966,2018-02-12 11:00:00,34,1,35
"18544",10501,"Grand Falls-Windsor","NL",48.92696,-55.65966,2018-02-12 12:00:00,33,1,34
"18545",10501,"Grand Falls-Windsor","NL",48.92696,-55.65966,2018-02-12 13:00:00,33,1,34
"18546",10501,"Grand Falls-Windsor","NL",48.92696,-55.65966,2018-02-12 14:00:00,32,1,33
"18547",10501,"Grand Falls-Windsor","NL",48.92696,-55.65966,2018-02-12 15:00:00,32,1,33
"18548",10501,"Grand Falls-Windsor","NL",48.92696,-55.65966,2018-02-12 16:00:00,32,0,32
"18549",10501,"Grand Falls-Windsor","NL",48.92696,-55.65966,2018-02-12 17:00:00,34,1,35
"18550",10501,"Grand Falls-Windsor","NL",48.92696,-55.65966,2018-02-12 18:00:00,38,1,39
"18551",10501,"Grand Falls-Windsor","NL",48.92696,-55.65966,2018-02-12 19:00:00,41,0,41
"18552",10501,"Grand Falls-Windsor","NL",48.92696,-55.65966,2018-02-12 20:00:00,41,0,41
"18553",10501,"Grand Falls-Windsor","NL",48.92696,-55.65966,2018-02-12 21:00:00,43,0,43
"18554",10501,"Grand Falls-Windsor","NL",48.92696,-55.65966,2018-02-12 22:00:00,42,0,42
"18555",10501,"Grand Falls-Windsor","NL",48.92696,-55.65966,2018-02-12 23:00:00,41,0,41
"18556",10501,"Grand Falls-Windsor","NL",48.92696,-55.65966,2018-02-13 00:00:00,40,0,40
"18557",10501,"Grand Falls-Windsor","NL",48.92696,-55.65966,2018-02-13 01:00:00,39,0,39
"18558",10501,"Grand Falls-Windsor","NL",48.92696,-55.65966,2018-02-13 02:00:00,38,0,38
"18559",10501,"Grand Falls-Windsor","NL",48.92696,-55.65966,2018-02-13 03:00:00,31,15,46
"18560",10501,"Grand Falls-Windsor","NL",48.92696,-55.65966,2018-02-13 04:00:00,39,1,40
"18561",10501,"Grand Falls-Windsor","NL",48.92696,-55.65966,2018-02-13 05:00:00,38,0,38
"18562",10501,"Grand Falls-Windsor","NL",48.92696,-55.65966,2018-02-13 06:00:00,37,9,46
"18563",10501,"Grand Falls-Windsor","NL",48.92696,-55.65966,2018-02-13 07:00:00,38,0,38
"18564",10501,"Grand Falls-Windsor","NL",48.92696,-55.65966,2018-02-13 08:00:00,38,0,38
"18565",10501,"Grand Falls-Windsor","NL",48.92696,-55.65966,2018-02-13 09:00:00,37,1,38
"18566",10501,"Grand Falls-Windsor","NL",48.92696,-55.65966,2018-02-13 10:00:00,37,0,37
"18567",10501,"Grand Falls-Windsor","NL",48.92696,-55.65966,2018-02-13 11:00:00,37,0,37
"18568",10501,"Grand Falls-Windsor","NL",48.92696,-55.65966,2018-02-13 12:00:00,37,0,37
"18569",10501,"Grand Falls-Windsor","NL",48.92696,-55.65966,2018-02-13 13:00:00,37,0,37
"18570",10501,"Grand Falls-Windsor","NL",48.92696,-55.65966,2018-02-13 14:00:00,37,1,38
"18571",10501,"Grand Falls-Windsor","NL",48.92696,-55.65966,2018-02-13 15:00:00,37,0,37
"18572",10501,"Grand Falls-Windsor","NL",48.92696,-55.65966,2018-02-13 16:00:00,37,1,38
"18573",10501,"Grand Falls-Windsor","NL",48.92696,-55.65966,2018-02-13 17:00:00,37,1,38
"18574",10501,"Grand Falls-Windsor","NL",48.92696,-55.65966,2018-02-13 18:00:00,36,0,36
"18575",10501,"Grand Falls-Windsor","NL",48.92696,-55.65966,2018-02-13 19:00:00,36,1,37
"18576",10501,"Grand Falls-Windsor","NL",48.92696,-55.65966,2018-02-13 20:00:00,36,0,36
"18577",10501,"Grand Falls-Windsor","NL",48.92696,-55.65966,2018-02-13 21:00:00,36,0,36
"18578",10501,"Grand Falls-Windsor","NL",48.92696,-55.65966,2018-02-13 22:00:00,35,0,35
"18579",10501,"Grand Falls-Windsor","NL",48.92696,-55.65966,2018-02-13 23:00:00,35,0,35
"18580",10501,"Grand Falls-Windsor","NL",48.92696,-55.65966,2018-02-14 00:00:00,34,0,34
"18581",10501,"Grand Falls-Windsor","NL",48.92696,-55.65966,2018-02-14 01:00:00,34,0,34
"18582",10501,"Grand Falls-Windsor","NL",48.92696,-55.65966,2018-02-14 02:00:00,33,0,33
"18583",10501,"Grand Falls-Windsor","NL",48.92696,-55.65966,2018-02-14 03:00:00,33,0,33
"18584",10501,"Grand Falls-Windsor","NL",48.92696,-55.65966,2018-02-14 04:00:00,34,0,34
"18585",10501,"Grand Falls-Windsor","NL",48.92696,-55.65966,2018-02-14 05:00:00,35,0,35
"18586",10501,"Grand Falls-Windsor","NL",48.92696,-55.65966,2018-02-14 06:00:00,34,0,34
"18587",10501,"Grand Falls-Windsor","NL",48.92696,-55.65966,2018-02-14 07:00:00,34,0,34
"18588",10501,"Grand Falls-Windsor","NL",48.92696,-55.65966,2018-02-14 08:00:00,34,0,34
"18589",10501,"Grand Falls-Windsor","NL",48.92696,-55.65966,2018-02-14 09:00:00,36,0,36
"18590",10501,"Grand Falls-Windsor","NL",48.92696,-55.65966,2018-02-14 10:00:00,37,0,37
"18591",10501,"Grand Falls-Windsor","NL",48.92696,-55.65966,2018-02-14 11:00:00,37,0,37
"18592",10501,"Grand Falls-Windsor","NL",48.92696,-55.65966,2018-02-14 12:00:00,38,0,38
"18593",10501,"Grand Falls-Windsor","NL",48.92696,-55.65966,2018-02-14 13:00:00,39,0,39
"18594",10501,"Grand Falls-Windsor","NL",48.92696,-55.65966,2018-02-14 14:00:00,39,1,40
"18595",10501,"Grand Falls-Windsor","NL",48.92696,-55.65966,2018-02-14 15:00:00,40,0,40
"18596",10501,"Grand Falls-Windsor","NL",48.92696,-55.65966,2018-02-14 16:00:00,40,0,40
"18597",10501,"Grand Falls-Windsor","NL",48.92696,-55.65966,2018-02-14 17:00:00,40,1,41
"18598",10501,"Grand Falls-Windsor","NL",48.92696,-55.65966,2018-02-14 18:00:00,40,1,41
"18599",10501,"Grand Falls-Windsor","NL",48.92696,-55.65966,2018-02-14 19:00:00,40,0,40
"18600",10501,"Grand Falls-Windsor","NL",48.92696,-55.65966,2018-02-14 20:00:00,40,0,40
"18601",10501,"Grand Falls-Windsor","NL",48.92696,-55.65966,2018-02-14 21:00:00,40,1,41
"18602",10501,"Grand Falls-Windsor","NL",48.92696,-55.65966,2018-02-14 22:00:00,40,0,40
"18603",10501,"Grand Falls-Windsor","NL",48.92696,-55.65966,2018-02-14 23:00:00,39,0,39
"18604",10501,"Grand Falls-Windsor","NL",48.92696,-55.65966,2018-02-15 00:00:00,39,0,39
"18605",10501,"Grand Falls-Windsor","NL",48.92696,-55.65966,2018-02-15 01:00:00,38,0,38
"18606",10501,"Grand Falls-Windsor","NL",48.92696,-55.65966,2018-02-15 02:00:00,38,0,38
"18607",10501,"Grand Falls-Windsor","NL",48.92696,-55.65966,2018-02-15 03:00:00,37,0,37
"18608",10501,"Grand Falls-Windsor","NL",48.92696,-55.65966,2018-02-15 04:00:00,36,1,37
"18609",10501,"Grand Falls-Windsor","NL",48.92696,-55.65966,2018-02-15 05:00:00,35,1,36
"18610",10501,"Grand Falls-Windsor","NL",48.92696,-55.65966,2018-02-15 06:00:00,34,1,35
"18611",10501,"Grand Falls-Windsor","NL",48.92696,-55.65966,2018-02-15 07:00:00,34,1,35
"18612",10501,"Grand Falls-Windsor","NL",48.92696,-55.65966,2018-02-15 08:00:00,36,1,37
"18613",10501,"Grand Falls-Windsor","NL",48.92696,-55.65966,2018-02-15 09:00:00,37,1,38
"18614",10501,"Grand Falls-Windsor","NL",48.92696,-55.65966,2018-02-15 10:00:00,37,1,38
"18615",10501,"Grand Falls-Windsor","NL",48.92696,-55.65966,2018-02-15 11:00:00,39,1,40
"18616",10501,"Grand Falls-Windsor","NL",48.92696,-55.65966,2018-02-15 12:00:00,41,1,42
"18617",10501,"Grand Falls-Windsor","NL",48.92696,-55.65966,2018-02-15 13:00:00,42,1,43
"18618",10501,"Grand Falls-Windsor","NL",48.92696,-55.65966,2018-02-15 14:00:00,43,1,44
"18619",10501,"Grand Falls-Windsor","NL",48.92696,-55.65966,2018-02-15 15:00:00,43,1,44
"18620",10501,"Grand Falls-Windsor","NL",48.92696,-55.65966,2018-02-15 16:00:00,44,1,45
"18621",10501,"Grand Falls-Windsor","NL",48.92696,-55.65966,2018-02-15 17:00:00,43,1,44
"18622",10501,"Grand Falls-Windsor","NL",48.92696,-55.65966,2018-02-15 18:00:00,42,2,44
"18623",10501,"Grand Falls-Windsor","NL",48.92696,-55.65966,2018-02-15 19:00:00,39,3,42
"18624",10501,"Grand Falls-Windsor","NL",48.92696,-55.65966,2018-02-15 20:00:00,38,4,42
"18625",10501,"Grand Falls-Windsor","NL",48.92696,-55.65966,2018-02-15 21:00:00,37,3,40
"18626",10501,"Grand Falls-Windsor","NL",48.92696,-55.65966,2018-02-15 22:00:00,38,2,40
"18627",10501,"Grand Falls-Windsor","NL",48.92696,-55.65966,2018-02-15 23:00:00,37,3,40
"18628",10501,"Grand Falls-Windsor","NL",48.92696,-55.65966,2018-02-16 00:00:00,36,2,38
"18629",10501,"Grand Falls-Windsor","NL",48.92696,-55.65966,2018-02-16 01:00:00,36,2,38
"18630",10501,"Grand Falls-Windsor","NL",48.92696,-55.65966,2018-02-16 02:00:00,38,1,39
"18631",10501,"Grand Falls-Windsor","NL",48.92696,-55.65966,2018-02-16 03:00:00,37,1,38
"18632",10501,"Grand Falls-Windsor","NL",48.92696,-55.65966,2018-02-16 04:00:00,37,1,38
"18633",10501,"Grand Falls-Windsor","NL",48.92696,-55.65966,2018-02-16 05:00:00,36,1,37
"18634",10501,"Grand Falls-Windsor","NL",48.92696,-55.65966,2018-02-16 06:00:00,34,0,34
"18635",10501,"Grand Falls-Windsor","NL",48.92696,-55.65966,2018-02-16 07:00:00,32,1,33
"18636",10501,"Grand Falls-Windsor","NL",48.92696,-55.65966,2018-02-16 08:00:00,30,1,31
"18637",10501,"Grand Falls-Windsor","NL",48.92696,-55.65966,2018-02-16 09:00:00,30,1,31
"18638",10501,"Grand Falls-Windsor","NL",48.92696,-55.65966,2018-02-16 10:00:00,32,1,33
"18639",10501,"Grand Falls-Windsor","NL",48.92696,-55.65966,2018-02-16 11:00:00,33,1,34
"18640",10501,"Grand Falls-Windsor","NL",48.92696,-55.65966,2018-02-16 12:00:00,32,1,33
"18641",10501,"Grand Falls-Windsor","NL",48.92696,-55.65966,2018-02-16 13:00:00,33,1,34
"18642",10501,"Grand Falls-Windsor","NL",48.92696,-55.65966,2018-02-16 14:00:00,35,1,36
"18643",10501,"Grand Falls-Windsor","NL",48.92696,-55.65966,2018-02-16 15:00:00,33,1,34
"18644",10501,"Grand Falls-Windsor","NL",48.92696,-55.65966,2018-02-16 16:00:00,36,1,37
"18645",10501,"Grand Falls-Windsor","NL",48.92696,-55.65966,2018-02-16 17:00:00,35,1,36
"18646",10501,"Grand Falls-Windsor","NL",48.92696,-55.65966,2018-02-16 18:00:00,34,2,36
"18647",10501,"Grand Falls-Windsor","NL",48.92696,-55.65966,2018-02-16 19:00:00,33,1,34
"18648",10501,"Grand Falls-Windsor","NL",48.92696,-55.65966,2018-02-16 20:00:00,34,1,35
"18649",10501,"Grand Falls-Windsor","NL",48.92696,-55.65966,2018-02-16 21:00:00,35,1,36
"18650",10501,"Grand Falls-Windsor","NL",48.92696,-55.65966,2018-02-16 22:00:00,36,1,37
"18651",10501,"Grand Falls-Windsor","NL",48.92696,-55.65966,2018-02-16 23:00:00,36,1,37
"18652",10501,"Grand Falls-Windsor","NL",48.92696,-55.65966,2018-02-17 00:00:00,35,1,36
"18653",10501,"Grand Falls-Windsor","NL",48.92696,-55.65966,2018-02-17 01:00:00,35,1,36
"18654",10501,"Grand Falls-Windsor","NL",48.92696,-55.65966,2018-02-17 02:00:00,35,1,36
"18655",10501,"Grand Falls-Windsor","NL",48.92696,-55.65966,2018-02-17 03:00:00,36,1,37
"18656",10501,"Grand Falls-Windsor","NL",48.92696,-55.65966,2018-02-17 04:00:00,33,14,47
"18657",10501,"Grand Falls-Windsor","NL",48.92696,-55.65966,2018-02-17 05:00:00,33,7,40
"18658",10501,"Grand Falls-Windsor","NL",48.92696,-55.65966,2018-02-17 06:00:00,37,0,37
"18659",10501,"Grand Falls-Windsor","NL",48.92696,-55.65966,2018-02-17 07:00:00,37,0,37
"18660",10501,"Grand Falls-Windsor","NL",48.92696,-55.65966,2018-02-17 08:00:00,36,0,36
"18661",10501,"Grand Falls-Windsor","NL",48.92696,-55.65966,2018-02-17 09:00:00,35,0,35
"18662",10501,"Grand Falls-Windsor","NL",48.92696,-55.65966,2018-02-17 10:00:00,33,4,37
"18663",10501,"Grand Falls-Windsor","NL",48.92696,-55.65966,2018-02-17 11:00:00,34,2,36
"18664",10501,"Grand Falls-Windsor","NL",48.92696,-55.65966,2018-02-17 12:00:00,34,2,36
"18665",10501,"Grand Falls-Windsor","NL",48.92696,-55.65966,2018-02-17 13:00:00,35,2,37
"18666",10501,"Grand Falls-Windsor","NL",48.92696,-55.65966,2018-02-17 14:00:00,35,2,37
"18667",10501,"Grand Falls-Windsor","NL",48.92696,-55.65966,2018-02-17 15:00:00,36,1,37
"18668",10501,"Grand Falls-Windsor","NL",48.92696,-55.65966,2018-02-17 16:00:00,37,0,37
"18669",10501,"Grand Falls-Windsor","NL",48.92696,-55.65966,2018-02-17 17:00:00,37,0,37
"18670",10501,"Grand Falls-Windsor","NL",48.92696,-55.65966,2018-02-17 18:00:00,36,0,36
"18671",10501,"Grand Falls-Windsor","NL",48.92696,-55.65966,2018-02-17 19:00:00,35,0,35
"18672",10501,"Grand Falls-Windsor","NL",48.92696,-55.65966,2018-02-17 20:00:00,34,0,34
"18673",10501,"Grand Falls-Windsor","NL",48.92696,-55.65966,2018-02-17 21:00:00,33,0,33
"18674",10501,"Grand Falls-Windsor","NL",48.92696,-55.65966,2018-02-17 22:00:00,33,1,34
"18675",10501,"Grand Falls-Windsor","NL",48.92696,-55.65966,2018-02-17 23:00:00,33,0,33
"18676",10501,"Grand Falls-Windsor","NL",48.92696,-55.65966,2018-02-18 00:00:00,33,0,33
"18677",10501,"Grand Falls-Windsor","NL",48.92696,-55.65966,2018-02-18 01:00:00,34,0,34
"18678",10501,"Grand Falls-Windsor","NL",48.92696,-55.65966,2018-02-18 02:00:00,34,0,34
"18679",10501,"Grand Falls-Windsor","NL",48.92696,-55.65966,2018-02-18 03:00:00,34,0,34
"18680",10501,"Grand Falls-Windsor","NL",48.92696,-55.65966,2018-02-18 04:00:00,34,2,36
"18681",10501,"Grand Falls-Windsor","NL",48.92696,-55.65966,2018-02-18 05:00:00,33,3,36
"18682",10501,"Grand Falls-Windsor","NL",48.92696,-55.65966,2018-02-18 06:00:00,34,0,34
"18683",10501,"Grand Falls-Windsor","NL",48.92696,-55.65966,2018-02-18 07:00:00,34,0,34
"18684",10501,"Grand Falls-Windsor","NL",48.92696,-55.65966,2018-02-18 08:00:00,33,0,33
"18685",10501,"Grand Falls-Windsor","NL",48.92696,-55.65966,2018-02-18 09:00:00,32,0,32
"18686",10501,"Grand Falls-Windsor","NL",48.92696,-55.65966,2018-02-18 10:00:00,33,0,33
"18687",10501,"Grand Falls-Windsor","NL",48.92696,-55.65966,2018-02-18 11:00:00,34,0,34
"18688",10501,"Grand Falls-Windsor","NL",48.92696,-55.65966,2018-02-18 12:00:00,35,0,35
"18689",10501,"Grand Falls-Windsor","NL",48.92696,-55.65966,2018-02-18 13:00:00,35,0,35
"18690",10501,"Grand Falls-Windsor","NL",48.92696,-55.65966,2018-02-18 14:00:00,36,0,36
"18691",10501,"Grand Falls-Windsor","NL",48.92696,-55.65966,2018-02-18 15:00:00,37,0,37
"18692",10501,"Grand Falls-Windsor","NL",48.92696,-55.65966,2018-02-18 16:00:00,37,0,37
"18693",10501,"Grand Falls-Windsor","NL",48.92696,-55.65966,2018-02-18 17:00:00,37,0,37
"18694",10501,"Grand Falls-Windsor","NL",48.92696,-55.65966,2018-02-18 18:00:00,34,7,41
"18695",10501,"Grand Falls-Windsor","NL",48.92696,-55.65966,2018-02-18 19:00:00,33,7,40
"18696",10501,"Grand Falls-Windsor","NL",48.92696,-55.65966,2018-02-18 20:00:00,26,9,35
"18697",10501,"Grand Falls-Windsor","NL",48.92696,-55.65966,2018-02-18 21:00:00,25,5,30
"18698",10501,"Grand Falls-Windsor","NL",48.92696,-55.65966,2018-02-18 22:00:00,28,3,31
"18699",10501,"Grand Falls-Windsor","NL",48.92696,-55.65966,2018-02-18 23:00:00,28,0,28
"18700",10501,"Grand Falls-Windsor","NL",48.92696,-55.65966,2018-02-19 00:00:00,31,1,32
"18701",10501,"Grand Falls-Windsor","NL",48.92696,-55.65966,2018-02-19 01:00:00,30,1,31
"18702",10501,"Grand Falls-Windsor","NL",48.92696,-55.65966,2018-02-19 02:00:00,30,1,31
"18703",10501,"Grand Falls-Windsor","NL",48.92696,-55.65966,2018-02-19 03:00:00,30,2,32
"18704",10501,"Grand Falls-Windsor","NL",48.92696,-55.65966,2018-02-19 04:00:00,28,18,46
"18705",10501,"Grand Falls-Windsor","NL",48.92696,-55.65966,2018-02-19 05:00:00,32,1,33
"18706",10501,"Grand Falls-Windsor","NL",48.92696,-55.65966,2018-02-19 06:00:00,31,1,32
"18707",10501,"Grand Falls-Windsor","NL",48.92696,-55.65966,2018-02-19 07:00:00,30,1,31
"18708",10501,"Grand Falls-Windsor","NL",48.92696,-55.65966,2018-02-19 08:00:00,29,1,30
"18709",10501,"Grand Falls-Windsor","NL",48.92696,-55.65966,2018-02-19 09:00:00,31,0,31
"18710",10501,"Grand Falls-Windsor","NL",48.92696,-55.65966,2018-02-19 10:00:00,32,1,33
"18711",10501,"Grand Falls-Windsor","NL",48.92696,-55.65966,2018-02-19 11:00:00,34,5,39
"18712",10501,"Grand Falls-Windsor","NL",48.92696,-55.65966,2018-02-19 12:00:00,35,1,36
"18713",10501,"Grand Falls-Windsor","NL",48.92696,-55.65966,2018-02-19 13:00:00,36,1,37
"18714",10501,"Grand Falls-Windsor","NL",48.92696,-55.65966,2018-02-19 14:00:00,37,1,38
"18715",10501,"Grand Falls-Windsor","NL",48.92696,-55.65966,2018-02-19 15:00:00,38,1,39
"18716",10501,"Grand Falls-Windsor","NL",48.92696,-55.65966,2018-02-19 16:00:00,38,1,39
"18717",10501,"Grand Falls-Windsor","NL",48.92696,-55.65966,2018-02-19 17:00:00,37,1,38
"18718",10501,"Grand Falls-Windsor","NL",48.92696,-55.65966,2018-02-19 18:00:00,37,1,38
"18719",10501,"Grand Falls-Windsor","NL",48.92696,-55.65966,2018-02-19 19:00:00,35,1,36
"18720",10501,"Grand Falls-Windsor","NL",48.92696,-55.65966,2018-02-19 20:00:00,35,1,36
"18721",10501,"Grand Falls-Windsor","NL",48.92696,-55.65966,2018-02-19 21:00:00,34,1,35
"18722",10501,"Grand Falls-Windsor","NL",48.92696,-55.65966,2018-02-19 22:00:00,35,1,36
"18723",10501,"Grand Falls-Windsor","NL",48.92696,-55.65966,2018-02-19 23:00:00,37,0,37
"18724",10501,"Grand Falls-Windsor","NL",48.92696,-55.65966,2018-02-20 00:00:00,38,0,38
"18725",10501,"Grand Falls-Windsor","NL",48.92696,-55.65966,2018-02-20 01:00:00,38,0,38
"18726",10501,"Grand Falls-Windsor","NL",48.92696,-55.65966,2018-02-20 02:00:00,38,0,38
"18727",10501,"Grand Falls-Windsor","NL",48.92696,-55.65966,2018-02-20 03:00:00,38,2,40
"18728",10501,"Grand Falls-Windsor","NL",48.92696,-55.65966,2018-02-20 04:00:00,39,0,39
"18729",10501,"Grand Falls-Windsor","NL",48.92696,-55.65966,2018-02-20 05:00:00,38,0,38
"18730",10501,"Grand Falls-Windsor","NL",48.92696,-55.65966,2018-02-20 06:00:00,37,0,37
"18731",10501,"Grand Falls-Windsor","NL",48.92696,-55.65966,2018-02-20 07:00:00,36,1,37
"18732",10501,"Grand Falls-Windsor","NL",48.92696,-55.65966,2018-02-20 08:00:00,36,0,36
"18733",10501,"Grand Falls-Windsor","NL",48.92696,-55.65966,2018-02-20 09:00:00,36,0,36
"18734",10501,"Grand Falls-Windsor","NL",48.92696,-55.65966,2018-02-20 10:00:00,36,0,36
"18735",10501,"Grand Falls-Windsor","NL",48.92696,-55.65966,2018-02-20 11:00:00,37,1,38
"18736",10501,"Grand Falls-Windsor","NL",48.92696,-55.65966,2018-02-20 12:00:00,38,1,39
"18737",10501,"Grand Falls-Windsor","NL",48.92696,-55.65966,2018-02-20 13:00:00,38,1,39
"18738",10501,"Grand Falls-Windsor","NL",48.92696,-55.65966,2018-02-20 14:00:00,38,1,39
"18739",10501,"Grand Falls-Windsor","NL",48.92696,-55.65966,2018-02-20 15:00:00,37,1,38
"18740",10501,"Grand Falls-Windsor","NL",48.92696,-55.65966,2018-02-20 16:00:00,35,2,37
"18741",10501,"Grand Falls-Windsor","NL",48.92696,-55.65966,2018-02-20 17:00:00,33,5,38
"18742",10501,"Grand Falls-Windsor","NL",48.92696,-55.65966,2018-02-20 18:00:00,34,2,36
"18743",10501,"Grand Falls-Windsor","NL",48.92696,-55.65966,2018-02-20 19:00:00,34,2,36
"18744",10501,"Grand Falls-Windsor","NL",48.92696,-55.65966,2018-02-20 20:00:00,35,2,37
"18745",10501,"Grand Falls-Windsor","NL",48.92696,-55.65966,2018-02-20 21:00:00,35,2,37
"18746",10501,"Grand Falls-Windsor","NL",48.92696,-55.65966,2018-02-20 22:00:00,35,2,37
"18747",10501,"Grand Falls-Windsor","NL",48.92696,-55.65966,2018-02-20 23:00:00,37,1,38
"18748",10501,"Grand Falls-Windsor","NL",48.92696,-55.65966,2018-02-21 00:00:00,37,1,38
"18749",10501,"Grand Falls-Windsor","NL",48.92696,-55.65966,2018-02-21 01:00:00,36,1,37
"18750",10501,"Grand Falls-Windsor","NL",48.92696,-55.65966,2018-02-21 02:00:00,35,2,37
"18751",10501,"Grand Falls-Windsor","NL",48.92696,-55.65966,2018-02-21 03:00:00,35,1,36
"18752",10501,"Grand Falls-Windsor","NL",48.92696,-55.65966,2018-02-21 04:00:00,36,1,37
"18753",10501,"Grand Falls-Windsor","NL",48.92696,-55.65966,2018-02-21 05:00:00,36,1,37
"18754",10501,"Grand Falls-Windsor","NL",48.92696,-55.65966,2018-02-21 06:00:00,36,1,37
"18755",10501,"Grand Falls-Windsor","NL",48.92696,-55.65966,2018-02-21 07:00:00,35,1,36
"18756",10501,"Grand Falls-Windsor","NL",48.92696,-55.65966,2018-02-21 08:00:00,36,1,37
"18757",10501,"Grand Falls-Windsor","NL",48.92696,-55.65966,2018-02-21 09:00:00,37,0,37
"18758",10501,"Grand Falls-Windsor","NL",48.92696,-55.65966,2018-02-21 10:00:00,37,0,37
"18759",10501,"Grand Falls-Windsor","NL",48.92696,-55.65966,2018-02-21 11:00:00,37,0,37
"18760",10501,"Grand Falls-Windsor","NL",48.92696,-55.65966,2018-02-21 12:00:00,36,1,37
"18761",10501,"Grand Falls-Windsor","NL",48.92696,-55.65966,2018-02-21 13:00:00,35,1,36
"18762",10501,"Grand Falls-Windsor","NL",48.92696,-55.65966,2018-02-21 14:00:00,35,0,35
"18763",10501,"Grand Falls-Windsor","NL",48.92696,-55.65966,2018-02-21 15:00:00,33,1,34
"18764",10501,"Grand Falls-Windsor","NL",48.92696,-55.65966,2018-02-21 16:00:00,33,0,33
"18765",10501,"Grand Falls-Windsor","NL",48.92696,-55.65966,2018-02-21 17:00:00,32,1,33
"18766",10501,"Grand Falls-Windsor","NL",48.92696,-55.65966,2018-02-21 18:00:00,33,1,34
"18767",10501,"Grand Falls-Windsor","NL",48.92696,-55.65966,2018-02-21 19:00:00,35,0,35
"18768",10501,"Grand Falls-Windsor","NL",48.92696,-55.65966,2018-02-21 20:00:00,36,0,36
"18769",10501,"Grand Falls-Windsor","NL",48.92696,-55.65966,2018-02-21 21:00:00,36,0,36
"18770",10501,"Grand Falls-Windsor","NL",48.92696,-55.65966,2018-02-21 22:00:00,35,0,35
"18771",10501,"Grand Falls-Windsor","NL",48.92696,-55.65966,2018-02-21 23:00:00,33,0,33
"18772",10501,"Grand Falls-Windsor","NL",48.92696,-55.65966,2018-02-22 00:00:00,32,0,32
"18773",10501,"Grand Falls-Windsor","NL",48.92696,-55.65966,2018-02-22 01:00:00,31,0,31
"18774",10501,"Grand Falls-Windsor","NL",48.92696,-55.65966,2018-02-22 02:00:00,32,0,32
"18775",10501,"Grand Falls-Windsor","NL",48.92696,-55.65966,2018-02-22 03:00:00,34,0,34
"18776",10501,"Grand Falls-Windsor","NL",48.92696,-55.65966,2018-02-22 04:00:00,34,0,34
"18777",10501,"Grand Falls-Windsor","NL",48.92696,-55.65966,2018-02-22 05:00:00,34,0,34
"18778",10501,"Grand Falls-Windsor","NL",48.92696,-55.65966,2018-02-22 06:00:00,35,1,36
"18779",10501,"Grand Falls-Windsor","NL",48.92696,-55.65966,2018-02-22 07:00:00,35,1,36
"18780",10501,"Grand Falls-Windsor","NL",48.92696,-55.65966,2018-02-22 08:00:00,36,0,36
"18781",10501,"Grand Falls-Windsor","NL",48.92696,-55.65966,2018-02-22 09:00:00,35,1,36
"18782",10501,"Grand Falls-Windsor","NL",48.92696,-55.65966,2018-02-22 10:00:00,35,0,35
"18783",10501,"Grand Falls-Windsor","NL",48.92696,-55.65966,2018-02-22 11:00:00,36,1,37
"18784",10501,"Grand Falls-Windsor","NL",48.92696,-55.65966,2018-02-22 12:00:00,36,1,37
"18785",10501,"Grand Falls-Windsor","NL",48.92696,-55.65966,2018-02-22 13:00:00,37,0,37
"18786",10501,"Grand Falls-Windsor","NL",48.92696,-55.65966,2018-02-22 14:00:00,37,0,37
"18787",10501,"Grand Falls-Windsor","NL",48.92696,-55.65966,2018-02-22 15:00:00,36,0,36
"18788",10501,"Grand Falls-Windsor","NL",48.92696,-55.65966,2018-02-22 16:00:00,36,0,36
"18789",10501,"Grand Falls-Windsor","NL",48.92696,-55.65966,2018-02-22 17:00:00,36,0,36
"18790",10501,"Grand Falls-Windsor","NL",48.92696,-55.65966,2018-02-22 18:00:00,37,1,38
"18791",10501,"Grand Falls-Windsor","NL",48.92696,-55.65966,2018-02-22 19:00:00,37,0,37
"18792",10501,"Grand Falls-Windsor","NL",48.92696,-55.65966,2018-02-22 20:00:00,37,2,39
"18793",10501,"Grand Falls-Windsor","NL",48.92696,-55.65966,2018-02-22 21:00:00,37,0,37
"18794",10501,"Grand Falls-Windsor","NL",48.92696,-55.65966,2018-02-22 22:00:00,37,0,37
"18795",10501,"Grand Falls-Windsor","NL",48.92696,-55.65966,2018-02-22 23:00:00,37,0,37
"18796",10501,"Grand Falls-Windsor","NL",48.92696,-55.65966,2018-02-23 00:00:00,37,0,37
"18797",10501,"Grand Falls-Windsor","NL",48.92696,-55.65966,2018-02-23 01:00:00,37,0,37
"18798",10501,"Grand Falls-Windsor","NL",48.92696,-55.65966,2018-02-23 02:00:00,37,0,37
"18799",10501,"Grand Falls-Windsor","NL",48.92696,-55.65966,2018-02-23 03:00:00,37,0,37
"18800",10501,"Grand Falls-Windsor","NL",48.92696,-55.65966,2018-02-23 04:00:00,37,0,37
"18801",10501,"Grand Falls-Windsor","NL",48.92696,-55.65966,2018-02-23 05:00:00,37,0,37
"18802",10501,"Grand Falls-Windsor","NL",48.92696,-55.65966,2018-02-23 06:00:00,37,0,37
"18803",10501,"Grand Falls-Windsor","NL",48.92696,-55.65966,2018-02-23 07:00:00,38,0,38
"18804",10501,"Grand Falls-Windsor","NL",48.92696,-55.65966,2018-02-23 08:00:00,38,1,39
"18805",10501,"Grand Falls-Windsor","NL",48.92696,-55.65966,2018-02-23 09:00:00,38,1,39
"18806",10501,"Grand Falls-Windsor","NL",48.92696,-55.65966,2018-02-23 10:00:00,38,1,39
"18807",10501,"Grand Falls-Windsor","NL",48.92696,-55.65966,2018-02-23 11:00:00,38,0,38
"18808",10501,"Grand Falls-Windsor","NL",48.92696,-55.65966,2018-02-23 12:00:00,39,0,39
"18809",10501,"Grand Falls-Windsor","NL",48.92696,-55.65966,2018-02-23 13:00:00,39,1,40
"18810",10501,"Grand Falls-Windsor","NL",48.92696,-55.65966,2018-02-23 14:00:00,39,0,39
"18811",10501,"Grand Falls-Windsor","NL",48.92696,-55.65966,2018-02-23 15:00:00,39,1,40
"18812",10501,"Grand Falls-Windsor","NL",48.92696,-55.65966,2018-02-23 16:00:00,39,0,39
"18813",10501,"Grand Falls-Windsor","NL",48.92696,-55.65966,2018-02-23 17:00:00,39,1,40
"18814",10501,"Grand Falls-Windsor","NL",48.92696,-55.65966,2018-02-23 18:00:00,39,0,39
"18815",10501,"Grand Falls-Windsor","NL",48.92696,-55.65966,2018-02-23 19:00:00,39,0,39
"18816",10501,"Grand Falls-Windsor","NL",48.92696,-55.65966,2018-02-23 20:00:00,38,1,39
"18817",10501,"Grand Falls-Windsor","NL",48.92696,-55.65966,2018-02-23 21:00:00,38,0,38
"18818",10501,"Grand Falls-Windsor","NL",48.92696,-55.65966,2018-02-23 22:00:00,38,1,39
"18819",10501,"Grand Falls-Windsor","NL",48.92696,-55.65966,2018-02-23 23:00:00,38,0,38
"18820",10501,"Grand Falls-Windsor","NL",48.92696,-55.65966,2018-02-24 00:00:00,38,0,38
"18821",10501,"Grand Falls-Windsor","NL",48.92696,-55.65966,2018-02-24 01:00:00,38,0,38
"18822",10501,"Grand Falls-Windsor","NL",48.92696,-55.65966,2018-02-24 02:00:00,38,0,38
"18823",10501,"Grand Falls-Windsor","NL",48.92696,-55.65966,2018-02-24 03:00:00,39,0,39
"18824",10501,"Grand Falls-Windsor","NL",48.92696,-55.65966,2018-02-24 04:00:00,39,0,39
"18825",10501,"Grand Falls-Windsor","NL",48.92696,-55.65966,2018-02-24 05:00:00,39,0,39
"18826",10501,"Grand Falls-Windsor","NL",48.92696,-55.65966,2018-02-24 06:00:00,39,0,39
"18827",10501,"Grand Falls-Windsor","NL",48.92696,-55.65966,2018-02-24 07:00:00,39,0,39
"18828",10501,"Grand Falls-Windsor","NL",48.92696,-55.65966,2018-02-24 08:00:00,38,0,38
"18829",10501,"Grand Falls-Windsor","NL",48.92696,-55.65966,2018-02-24 09:00:00,37,0,37
"18830",10501,"Grand Falls-Windsor","NL",48.92696,-55.65966,2018-02-24 10:00:00,37,0,37
"18831",10501,"Grand Falls-Windsor","NL",48.92696,-55.65966,2018-02-24 11:00:00,37,0,37
"18832",10501,"Grand Falls-Windsor","NL",48.92696,-55.65966,2018-02-24 12:00:00,37,1,38
"18833",10501,"Grand Falls-Windsor","NL",48.92696,-55.65966,2018-02-24 13:00:00,38,0,38
"18834",10501,"Grand Falls-Windsor","NL",48.92696,-55.65966,2018-02-24 14:00:00,37,1,38
"18835",10501,"Grand Falls-Windsor","NL",48.92696,-55.65966,2018-02-24 15:00:00,38,1,39
"18836",10501,"Grand Falls-Windsor","NL",48.92696,-55.65966,2018-02-24 16:00:00,38,1,39
"18837",10501,"Grand Falls-Windsor","NL",48.92696,-55.65966,2018-02-24 17:00:00,39,1,40
"18838",10501,"Grand Falls-Windsor","NL",48.92696,-55.65966,2018-02-24 18:00:00,38,1,39
"18839",10501,"Grand Falls-Windsor","NL",48.92696,-55.65966,2018-02-24 19:00:00,38,1,39
"18840",10501,"Grand Falls-Windsor","NL",48.92696,-55.65966,2018-02-24 20:00:00,38,1,39
"18841",10501,"Grand Falls-Windsor","NL",48.92696,-55.65966,2018-02-24 21:00:00,39,1,40
"18842",10501,"Grand Falls-Windsor","NL",48.92696,-55.65966,2018-02-24 22:00:00,41,1,42
"18843",10501,"Grand Falls-Windsor","NL",48.92696,-55.65966,2018-02-24 23:00:00,41,1,42
"18844",10501,"Grand Falls-Windsor","NL",48.92696,-55.65966,2018-02-25 00:00:00,42,1,43
"18845",10501,"Grand Falls-Windsor","NL",48.92696,-55.65966,2018-02-25 01:00:00,41,1,42
"18846",10501,"Grand Falls-Windsor","NL",48.92696,-55.65966,2018-02-25 02:00:00,40,1,41
"18847",10501,"Grand Falls-Windsor","NL",48.92696,-55.65966,2018-02-25 03:00:00,40,1,41
"18848",10501,"Grand Falls-Windsor","NL",48.92696,-55.65966,2018-02-25 04:00:00,40,1,41
"18849",10501,"Grand Falls-Windsor","NL",48.92696,-55.65966,2018-02-25 05:00:00,39,1,40
"18850",10501,"Grand Falls-Windsor","NL",48.92696,-55.65966,2018-02-25 06:00:00,38,2,40
"18851",10501,"Grand Falls-Windsor","NL",48.92696,-55.65966,2018-02-25 07:00:00,37,2,39
"18852",10501,"Grand Falls-Windsor","NL",48.92696,-55.65966,2018-02-25 08:00:00,37,2,39
"18853",10501,"Grand Falls-Windsor","NL",48.92696,-55.65966,2018-02-25 09:00:00,37,2,39
"18854",10501,"Grand Falls-Windsor","NL",48.92696,-55.65966,2018-02-25 10:00:00,37,1,38
"18855",10501,"Grand Falls-Windsor","NL",48.92696,-55.65966,2018-02-25 11:00:00,38,1,39
"18856",10501,"Grand Falls-Windsor","NL",48.92696,-55.65966,2018-02-25 12:00:00,38,1,39
"18857",10501,"Grand Falls-Windsor","NL",48.92696,-55.65966,2018-02-25 13:00:00,39,1,40
"18858",10501,"Grand Falls-Windsor","NL",48.92696,-55.65966,2018-02-25 14:00:00,39,1,40
"18859",10501,"Grand Falls-Windsor","NL",48.92696,-55.65966,2018-02-25 15:00:00,38,1,39
"18860",10501,"Grand Falls-Windsor","NL",48.92696,-55.65966,2018-02-25 16:00:00,39,1,40
"18861",10501,"Grand Falls-Windsor","NL",48.92696,-55.65966,2018-02-25 17:00:00,39,1,40
"18862",10501,"Grand Falls-Windsor","NL",48.92696,-55.65966,2018-02-25 18:00:00,38,2,40
"18863",10501,"Grand Falls-Windsor","NL",48.92696,-55.65966,2018-02-25 19:00:00,34,4,38
"18864",10501,"Grand Falls-Windsor","NL",48.92696,-55.65966,2018-02-25 20:00:00,31,5,36
"18865",10501,"Grand Falls-Windsor","NL",48.92696,-55.65966,2018-02-25 21:00:00,27,8,35
"18866",10501,"Grand Falls-Windsor","NL",48.92696,-55.65966,2018-02-25 22:00:00,27,4,31
"18867",10501,"Grand Falls-Windsor","NL",48.92696,-55.65966,2018-02-25 23:00:00,29,1,30
"18868",10501,"Grand Falls-Windsor","NL",48.92696,-55.65966,2018-02-26 00:00:00,29,1,30
"18869",10501,"Grand Falls-Windsor","NL",48.92696,-55.65966,2018-02-26 01:00:00,28,1,29
"18870",10501,"Grand Falls-Windsor","NL",48.92696,-55.65966,2018-02-26 02:00:00,28,1,29
"18871",10501,"Grand Falls-Windsor","NL",48.92696,-55.65966,2018-02-26 03:00:00,28,0,28
"18872",10501,"Grand Falls-Windsor","NL",48.92696,-55.65966,2018-02-26 04:00:00,28,1,29
"18873",10501,"Grand Falls-Windsor","NL",48.92696,-55.65966,2018-02-26 05:00:00,25,27,52
"18874",10501,"Grand Falls-Windsor","NL",48.92696,-55.65966,2018-02-26 06:00:00,26,1,27
"18875",10501,"Grand Falls-Windsor","NL",48.92696,-55.65966,2018-02-26 07:00:00,25,1,26
"18876",10501,"Grand Falls-Windsor","NL",48.92696,-55.65966,2018-02-26 08:00:00,26,1,27
"18877",10501,"Grand Falls-Windsor","NL",48.92696,-55.65966,2018-02-26 09:00:00,28,2,30
"18878",10501,"Grand Falls-Windsor","NL",48.92696,-55.65966,2018-02-26 10:00:00,30,2,32
"18879",10501,"Grand Falls-Windsor","NL",48.92696,-55.65966,2018-02-26 11:00:00,37,1,38
"18880",10501,"Grand Falls-Windsor","NL",48.92696,-55.65966,2018-02-26 12:00:00,39,1,40
"18881",10501,"Grand Falls-Windsor","NL",48.92696,-55.65966,2018-02-26 13:00:00,39,1,40
"18882",10501,"Grand Falls-Windsor","NL",48.92696,-55.65966,2018-02-26 14:00:00,39,0,39
"18883",10501,"Grand Falls-Windsor","NL",48.92696,-55.65966,2018-02-26 15:00:00,39,1,40
"18884",10501,"Grand Falls-Windsor","NL",48.92696,-55.65966,2018-02-26 16:00:00,39,1,40
"18885",10501,"Grand Falls-Windsor","NL",48.92696,-55.65966,2018-02-26 17:00:00,38,0,38
"18886",10501,"Grand Falls-Windsor","NL",48.92696,-55.65966,2018-02-26 18:00:00,38,1,39
"18887",10501,"Grand Falls-Windsor","NL",48.92696,-55.65966,2018-02-26 19:00:00,39,0,39
"18888",10501,"Grand Falls-Windsor","NL",48.92696,-55.65966,2018-02-26 20:00:00,38,1,39
"18889",10501,"Grand Falls-Windsor","NL",48.92696,-55.65966,2018-02-26 21:00:00,38,1,39
"18890",10501,"Grand Falls-Windsor","NL",48.92696,-55.65966,2018-02-26 22:00:00,37,1,38
"18891",10501,"Grand Falls-Windsor","NL",48.92696,-55.65966,2018-02-26 23:00:00,35,2,37
"18892",10501,"Grand Falls-Windsor","NL",48.92696,-55.65966,2018-02-27 00:00:00,36,1,37
"18893",10501,"Grand Falls-Windsor","NL",48.92696,-55.65966,2018-02-27 01:00:00,37,0,37
"18894",10501,"Grand Falls-Windsor","NL",48.92696,-55.65966,2018-02-27 02:00:00,37,0,37
"18895",10501,"Grand Falls-Windsor","NL",48.92696,-55.65966,2018-02-27 03:00:00,37,1,38
"18896",10501,"Grand Falls-Windsor","NL",48.92696,-55.65966,2018-02-27 04:00:00,37,1,38
"18897",10501,"Grand Falls-Windsor","NL",48.92696,-55.65966,2018-02-27 05:00:00,35,2,37
"18898",10501,"Grand Falls-Windsor","NL",48.92696,-55.65966,2018-02-27 06:00:00,33,5,38
"18899",10501,"Grand Falls-Windsor","NL",48.92696,-55.65966,2018-02-27 07:00:00,31,6,37
"18900",10501,"Grand Falls-Windsor","NL",48.92696,-55.65966,2018-02-27 08:00:00,32,4,36
"18901",10501,"Grand Falls-Windsor","NL",48.92696,-55.65966,2018-02-27 09:00:00,33,4,37
"18902",10501,"Grand Falls-Windsor","NL",48.92696,-55.65966,2018-02-27 10:00:00,33,4,37
"18903",10501,"Grand Falls-Windsor","NL",48.92696,-55.65966,2018-02-27 11:00:00,35,3,38
"18904",10501,"Grand Falls-Windsor","NL",48.92696,-55.65966,2018-02-27 12:00:00,35,5,40
"18905",10501,"Grand Falls-Windsor","NL",48.92696,-55.65966,2018-02-27 13:00:00,36,2,38
"18906",10501,"Grand Falls-Windsor","NL",48.92696,-55.65966,2018-02-27 14:00:00,35,3,38
"18907",10501,"Grand Falls-Windsor","NL",48.92696,-55.65966,2018-02-27 15:00:00,37,2,39
"18908",10501,"Grand Falls-Windsor","NL",48.92696,-55.65966,2018-02-27 16:00:00,36,2,38
"18909",10501,"Grand Falls-Windsor","NL",48.92696,-55.65966,2018-02-27 17:00:00,35,3,38
"18910",10501,"Grand Falls-Windsor","NL",48.92696,-55.65966,2018-02-27 18:00:00,35,4,39
"18911",10501,"Grand Falls-Windsor","NL",48.92696,-55.65966,2018-02-27 19:00:00,36,3,39
"18912",10501,"Grand Falls-Windsor","NL",48.92696,-55.65966,2018-02-27 20:00:00,36,3,39
"18913",10501,"Grand Falls-Windsor","NL",48.92696,-55.65966,2018-02-27 21:00:00,38,2,40
"18914",10501,"Grand Falls-Windsor","NL",48.92696,-55.65966,2018-02-27 22:00:00,37,4,41
"18915",10501,"Grand Falls-Windsor","NL",48.92696,-55.65966,2018-02-27 23:00:00,39,2,41
"18916",10501,"Grand Falls-Windsor","NL",48.92696,-55.65966,2018-02-28 00:00:00,39,2,41
"18917",10501,"Grand Falls-Windsor","NL",48.92696,-55.65966,2018-02-28 01:00:00,38,2,40
"18918",10501,"Grand Falls-Windsor","NL",48.92696,-55.65966,2018-02-28 02:00:00,38,2,40
"18919",10501,"Grand Falls-Windsor","NL",48.92696,-55.65966,2018-02-28 03:00:00,38,1,39
"18920",10501,"Grand Falls-Windsor","NL",48.92696,-55.65966,2018-02-28 04:00:00,37,2,39
"18921",10501,"Grand Falls-Windsor","NL",48.92696,-55.65966,2018-02-28 05:00:00,34,5,39
"18922",10501,"Grand Falls-Windsor","NL",48.92696,-55.65966,2018-02-28 06:00:00,31,11,42
"18923",10501,"Grand Falls-Windsor","NL",48.92696,-55.65966,2018-02-28 07:00:00,34,4,38
"18924",10501,"Grand Falls-Windsor","NL",48.92696,-55.65966,2018-02-28 08:00:00,35,4,39
"18925",10501,"Grand Falls-Windsor","NL",48.92696,-55.65966,2018-02-28 09:00:00,36,3,39
"18926",10501,"Grand Falls-Windsor","NL",48.92696,-55.65966,2018-02-28 10:00:00,37,2,39
"18927",10501,"Grand Falls-Windsor","NL",48.92696,-55.65966,2018-02-28 11:00:00,39,1,40
"18928",10501,"Grand Falls-Windsor","NL",48.92696,-55.65966,2018-02-28 12:00:00,39,2,41
"18929",10501,"Grand Falls-Windsor","NL",48.92696,-55.65966,2018-02-28 13:00:00,38,3,41
"18930",10501,"Grand Falls-Windsor","NL",48.92696,-55.65966,2018-02-28 14:00:00,38,3,41
"18931",10501,"Grand Falls-Windsor","NL",48.92696,-55.65966,2018-02-28 15:00:00,39,3,42
"18932",10501,"Grand Falls-Windsor","NL",48.92696,-55.65966,2018-02-28 16:00:00,40,2,42
"18933",10501,"Grand Falls-Windsor","NL",48.92696,-55.65966,2018-02-28 17:00:00,39,2,41
"18934",10501,"Grand Falls-Windsor","NL",48.92696,-55.65966,2018-02-28 18:00:00,40,2,42
"18935",10501,"Grand Falls-Windsor","NL",48.92696,-55.65966,2018-02-28 19:00:00,39,2,41
"18936",10501,"Grand Falls-Windsor","NL",48.92696,-55.65966,2018-02-28 20:00:00,40,1,41
"18937",10501,"Grand Falls-Windsor","NL",48.92696,-55.65966,2018-02-28 21:00:00,39,2,41
"18938",10501,"Grand Falls-Windsor","NL",48.92696,-55.65966,2018-02-28 22:00:00,39,1,40
"18939",10501,"Grand Falls-Windsor","NL",48.92696,-55.65966,2018-02-28 23:00:00,39,1,40
"18940",10501,"Grand Falls-Windsor","NL",48.92696,-55.65966,2018-03-01 00:00:00,39,1,40
"18941",10501,"Grand Falls-Windsor","NL",48.92696,-55.65966,2018-03-01 01:00:00,38,1,39
"18942",10501,"Grand Falls-Windsor","NL",48.92696,-55.65966,2018-03-01 02:00:00,39,1,40
"18943",10501,"Grand Falls-Windsor","NL",48.92696,-55.65966,2018-03-01 03:00:00,39,1,40
"18944",10501,"Grand Falls-Windsor","NL",48.92696,-55.65966,2018-03-01 04:00:00,40,1,41
"18945",10501,"Grand Falls-Windsor","NL",48.92696,-55.65966,2018-03-01 05:00:00,39,1,40
"18946",10501,"Grand Falls-Windsor","NL",48.92696,-55.65966,2018-03-01 06:00:00,39,2,41
"18947",10501,"Grand Falls-Windsor","NL",48.92696,-55.65966,2018-03-01 07:00:00,38,1,39
"18948",10501,"Grand Falls-Windsor","NL",48.92696,-55.65966,2018-03-01 08:00:00,38,2,40
"18949",10501,"Grand Falls-Windsor","NL",48.92696,-55.65966,2018-03-01 09:00:00,38,2,40
"18950",10501,"Grand Falls-Windsor","NL",48.92696,-55.65966,2018-03-01 10:00:00,39,1,40
"18951",10501,"Grand Falls-Windsor","NL",48.92696,-55.65966,2018-03-01 11:00:00,38,1,39
"18952",10501,"Grand Falls-Windsor","NL",48.92696,-55.65966,2018-03-01 12:00:00,39,1,40
"18953",10501,"Grand Falls-Windsor","NL",48.92696,-55.65966,2018-03-01 13:00:00,38,1,39
"18954",10501,"Grand Falls-Windsor","NL",48.92696,-55.65966,2018-03-01 14:00:00,38,1,39
"18955",10501,"Grand Falls-Windsor","NL",48.92696,-55.65966,2018-03-01 15:00:00,36,2,38
"18956",10501,"Grand Falls-Windsor","NL",48.92696,-55.65966,2018-03-01 16:00:00,35,4,39
"18957",10501,"Grand Falls-Windsor","NL",48.92696,-55.65966,2018-03-01 17:00:00,36,2,38
"18958",10501,"Grand Falls-Windsor","NL",48.92696,-55.65966,2018-03-01 18:00:00,35,2,37
"18959",10501,"Grand Falls-Windsor","NL",48.92696,-55.65966,2018-03-01 19:00:00,33,3,36
"18960",10501,"Grand Falls-Windsor","NL",48.92696,-55.65966,2018-03-01 20:00:00,33,3,36
"18961",10501,"Grand Falls-Windsor","NL",48.92696,-55.65966,2018-03-01 21:00:00,32,4,36
"18962",10501,"Grand Falls-Windsor","NL",48.92696,-55.65966,2018-03-01 22:00:00,32,3,35
"18963",10501,"Grand Falls-Windsor","NL",48.92696,-55.65966,2018-03-01 23:00:00,32,2,34
"18964",10501,"Grand Falls-Windsor","NL",48.92696,-55.65966,2018-03-02 00:00:00,32,2,34
"18965",10501,"Grand Falls-Windsor","NL",48.92696,-55.65966,2018-03-02 01:00:00,32,2,34
"18966",10501,"Grand Falls-Windsor","NL",48.92696,-55.65966,2018-03-02 02:00:00,30,2,32
"18967",10501,"Grand Falls-Windsor","NL",48.92696,-55.65966,2018-03-02 03:00:00,30,2,32
"18968",10501,"Grand Falls-Windsor","NL",48.92696,-55.65966,2018-03-02 04:00:00,29,1,30
"18969",10501,"Grand Falls-Windsor","NL",48.92696,-55.65966,2018-03-02 05:00:00,30,2,32
"18970",10501,"Grand Falls-Windsor","NL",48.92696,-55.65966,2018-03-02 06:00:00,31,2,33
"18971",10501,"Grand Falls-Windsor","NL",48.92696,-55.65966,2018-03-02 07:00:00,32,2,34
"18972",10501,"Grand Falls-Windsor","NL",48.92696,-55.65966,2018-03-02 08:00:00,31,2,33
"18973",10501,"Grand Falls-Windsor","NL",48.92696,-55.65966,2018-03-02 09:00:00,31,6,37
"18974",10501,"Grand Falls-Windsor","NL",48.92696,-55.65966,2018-03-02 10:00:00,33,2,35
"18975",10501,"Grand Falls-Windsor","NL",48.92696,-55.65966,2018-03-02 11:00:00,33,2,35
"18976",10501,"Grand Falls-Windsor","NL",48.92696,-55.65966,2018-03-02 12:00:00,35,2,37
"18977",10501,"Grand Falls-Windsor","NL",48.92696,-55.65966,2018-03-02 13:00:00,37,1,38
"18978",10501,"Grand Falls-Windsor","NL",48.92696,-55.65966,2018-03-02 14:00:00,37,2,39
"18979",10501,"Grand Falls-Windsor","NL",48.92696,-55.65966,2018-03-02 15:00:00,38,2,40
"18980",10501,"Grand Falls-Windsor","NL",48.92696,-55.65966,2018-03-02 16:00:00,39,3,42
"18981",10501,"Grand Falls-Windsor","NL",48.92696,-55.65966,2018-03-02 17:00:00,38,3,41
"18982",10501,"Grand Falls-Windsor","NL",48.92696,-55.65966,2018-03-02 18:00:00,38,3,41
"18983",10501,"Grand Falls-Windsor","NL",48.92696,-55.65966,2018-03-02 19:00:00,39,2,41
"18984",10501,"Grand Falls-Windsor","NL",48.92696,-55.65966,2018-03-02 20:00:00,39,1,40
"18985",10501,"Grand Falls-Windsor","NL",48.92696,-55.65966,2018-03-02 21:00:00,38,1,39
"18986",10501,"Grand Falls-Windsor","NL",48.92696,-55.65966,2018-03-02 22:00:00,38,1,39
"18987",10501,"Grand Falls-Windsor","NL",48.92696,-55.65966,2018-03-02 23:00:00,39,1,40
"18988",10501,"Grand Falls-Windsor","NL",48.92696,-55.65966,2018-03-03 00:00:00,39,1,40
"18989",10501,"Grand Falls-Windsor","NL",48.92696,-55.65966,2018-03-03 01:00:00,38,1,39
"18990",10501,"Grand Falls-Windsor","NL",48.92696,-55.65966,2018-03-03 02:00:00,38,1,39
"18991",10501,"Grand Falls-Windsor","NL",48.92696,-55.65966,2018-03-03 03:00:00,37,1,38
"18992",10501,"Grand Falls-Windsor","NL",48.92696,-55.65966,2018-03-03 04:00:00,37,1,38
"18993",10501,"Grand Falls-Windsor","NL",48.92696,-55.65966,2018-03-03 05:00:00,36,1,37
"18994",10501,"Grand Falls-Windsor","NL",48.92696,-55.65966,2018-03-03 06:00:00,36,1,37
"18995",10501,"Grand Falls-Windsor","NL",48.92696,-55.65966,2018-03-03 07:00:00,36,2,38
"18996",10501,"Grand Falls-Windsor","NL",48.92696,-55.65966,2018-03-03 08:00:00,38,1,39
"18997",10501,"Grand Falls-Windsor","NL",48.92696,-55.65966,2018-03-03 09:00:00,38,1,39
"18998",10501,"Grand Falls-Windsor","NL",48.92696,-55.65966,2018-03-03 10:00:00,38,1,39
"18999",10501,"Grand Falls-Windsor","NL",48.92696,-55.65966,2018-03-03 11:00:00,39,1,40
"19000",10501,"Grand Falls-Windsor","NL",48.92696,-55.65966,2018-03-03 12:00:00,39,1,40
"19001",10501,"Grand Falls-Windsor","NL",48.92696,-55.65966,2018-03-03 13:00:00,40,1,41
"19002",10501,"Grand Falls-Windsor","NL",48.92696,-55.65966,2018-03-03 14:00:00,40,1,41
"19003",10501,"Grand Falls-Windsor","NL",48.92696,-55.65966,2018-03-03 15:00:00,41,1,42
"19004",10501,"Grand Falls-Windsor","NL",48.92696,-55.65966,2018-03-03 16:00:00,41,1,42
"19005",10501,"Grand Falls-Windsor","NL",48.92696,-55.65966,2018-03-03 17:00:00,41,1,42
"19006",10501,"Grand Falls-Windsor","NL",48.92696,-55.65966,2018-03-03 18:00:00,41,1,42
"19007",10501,"Grand Falls-Windsor","NL",48.92696,-55.65966,2018-03-03 19:00:00,41,1,42
"19008",10501,"Grand Falls-Windsor","NL",48.92696,-55.65966,2018-03-03 20:00:00,42,1,43
"19009",10501,"Grand Falls-Windsor","NL",48.92696,-55.65966,2018-03-03 21:00:00,43,1,44
"19010",10501,"Grand Falls-Windsor","NL",48.92696,-55.65966,2018-03-03 22:00:00,41,1,42
"19011",10501,"Grand Falls-Windsor","NL",48.92696,-55.65966,2018-03-03 23:00:00,41,1,42
"19012",10501,"Grand Falls-Windsor","NL",48.92696,-55.65966,2018-03-04 00:00:00,42,1,43
"19013",10501,"Grand Falls-Windsor","NL",48.92696,-55.65966,2018-03-04 01:00:00,42,1,43
"19014",10501,"Grand Falls-Windsor","NL",48.92696,-55.65966,2018-03-04 02:00:00,42,1,43
"19015",10501,"Grand Falls-Windsor","NL",48.92696,-55.65966,2018-03-04 03:00:00,41,1,42
"19016",10501,"Grand Falls-Windsor","NL",48.92696,-55.65966,2018-03-04 04:00:00,42,1,43
"19017",10501,"Grand Falls-Windsor","NL",48.92696,-55.65966,2018-03-04 05:00:00,42,0,42
"19018",10501,"Grand Falls-Windsor","NL",48.92696,-55.65966,2018-03-04 06:00:00,42,1,43
"19019",10501,"Grand Falls-Windsor","NL",48.92696,-55.65966,2018-03-04 07:00:00,42,1,43
"19020",10501,"Grand Falls-Windsor","NL",48.92696,-55.65966,2018-03-04 08:00:00,42,1,43
"19021",10501,"Grand Falls-Windsor","NL",48.92696,-55.65966,2018-03-04 09:00:00,42,1,43
"19022",10501,"Grand Falls-Windsor","NL",48.92696,-55.65966,2018-03-04 10:00:00,43,1,44
"19023",10501,"Grand Falls-Windsor","NL",48.92696,-55.65966,2018-03-04 11:00:00,43,1,44
"19024",10501,"Grand Falls-Windsor","NL",48.92696,-55.65966,2018-03-04 12:00:00,42,1,43
"19025",10501,"Grand Falls-Windsor","NL",48.92696,-55.65966,2018-03-04 13:00:00,42,1,43
"19026",10501,"Grand Falls-Windsor","NL",48.92696,-55.65966,2018-03-04 14:00:00,42,1,43
"19027",10501,"Grand Falls-Windsor","NL",48.92696,-55.65966,2018-03-04 15:00:00,43,1,44
"19028",10501,"Grand Falls-Windsor","NL",48.92696,-55.65966,2018-03-04 16:00:00,43,1,44
"19029",10501,"Grand Falls-Windsor","NL",48.92696,-55.65966,2018-03-04 17:00:00,42,2,44
"19030",10501,"Grand Falls-Windsor","NL",48.92696,-55.65966,2018-03-04 18:00:00,42,1,43
"19031",10501,"Grand Falls-Windsor","NL",48.92696,-55.65966,2018-03-04 19:00:00,42,2,44
"19032",10501,"Grand Falls-Windsor","NL",48.92696,-55.65966,2018-03-04 20:00:00,42,1,43
"19033",10501,"Grand Falls-Windsor","NL",48.92696,-55.65966,2018-03-04 21:00:00,42,1,43
"19034",10501,"Grand Falls-Windsor","NL",48.92696,-55.65966,2018-03-04 22:00:00,43,1,44
"19035",10501,"Grand Falls-Windsor","NL",48.92696,-55.65966,2018-03-04 23:00:00,43,1,44
"19036",10501,"Grand Falls-Windsor","NL",48.92696,-55.65966,2018-03-05 00:00:00,43,0,43
"19037",10501,"Grand Falls-Windsor","NL",48.92696,-55.65966,2018-03-05 01:00:00,43,1,44
"19038",10501,"Grand Falls-Windsor","NL",48.92696,-55.65966,2018-03-05 02:00:00,43,1,44
"19039",10501,"Grand Falls-Windsor","NL",48.92696,-55.65966,2018-03-05 03:00:00,42,1,43
"19040",10501,"Grand Falls-Windsor","NL",48.92696,-55.65966,2018-03-05 04:00:00,43,1,44
"19041",10501,"Grand Falls-Windsor","NL",48.92696,-55.65966,2018-03-05 05:00:00,43,1,44
"19042",10501,"Grand Falls-Windsor","NL",48.92696,-55.65966,2018-03-05 06:00:00,43,1,44
"19043",10501,"Grand Falls-Windsor","NL",48.92696,-55.65966,2018-03-05 07:00:00,42,1,43
"19044",10501,"Grand Falls-Windsor","NL",48.92696,-55.65966,2018-03-05 08:00:00,42,1,43
"19045",10501,"Grand Falls-Windsor","NL",48.92696,-55.65966,2018-03-05 09:00:00,42,1,43
"19046",10501,"Grand Falls-Windsor","NL",48.92696,-55.65966,2018-03-05 10:00:00,42,1,43
"19047",10501,"Grand Falls-Windsor","NL",48.92696,-55.65966,2018-03-05 11:00:00,43,1,44
"19048",10501,"Grand Falls-Windsor","NL",48.92696,-55.65966,2018-03-05 12:00:00,43,1,44
"19049",10501,"Grand Falls-Windsor","NL",48.92696,-55.65966,2018-03-05 13:00:00,42,1,43
"19050",10501,"Grand Falls-Windsor","NL",48.92696,-55.65966,2018-03-05 14:00:00,42,1,43
"19051",10501,"Grand Falls-Windsor","NL",48.92696,-55.65966,2018-03-05 15:00:00,42,1,43
"19052",10501,"Grand Falls-Windsor","NL",48.92696,-55.65966,2018-03-05 16:00:00,42,1,43
"19053",10501,"Grand Falls-Windsor","NL",48.92696,-55.65966,2018-03-05 17:00:00,42,1,43
"19054",10501,"Grand Falls-Windsor","NL",48.92696,-55.65966,2018-03-05 18:00:00,41,1,42
"19055",10501,"Grand Falls-Windsor","NL",48.92696,-55.65966,2018-03-05 19:00:00,42,1,43
"19056",10501,"Grand Falls-Windsor","NL",48.92696,-55.65966,2018-03-05 20:00:00,42,1,43
"19057",10501,"Grand Falls-Windsor","NL",48.92696,-55.65966,2018-03-05 21:00:00,41,1,42
"19058",10501,"Grand Falls-Windsor","NL",48.92696,-55.65966,2018-03-05 22:00:00,41,1,42
"19059",10501,"Grand Falls-Windsor","NL",48.92696,-55.65966,2018-03-05 23:00:00,40,1,41
"19060",10501,"Grand Falls-Windsor","NL",48.92696,-55.65966,2018-03-06 00:00:00,40,1,41
"19061",10501,"Grand Falls-Windsor","NL",48.92696,-55.65966,2018-03-06 01:00:00,41,1,42
"19062",10501,"Grand Falls-Windsor","NL",48.92696,-55.65966,2018-03-06 02:00:00,41,1,42
"19063",10501,"Grand Falls-Windsor","NL",48.92696,-55.65966,2018-03-06 03:00:00,41,1,42
"19064",10501,"Grand Falls-Windsor","NL",48.92696,-55.65966,2018-03-06 04:00:00,41,0,41
"19065",10501,"Grand Falls-Windsor","NL",48.92696,-55.65966,2018-03-06 05:00:00,40,1,41
"19066",10501,"Grand Falls-Windsor","NL",48.92696,-55.65966,2018-03-06 06:00:00,40,1,41
"19067",10501,"Grand Falls-Windsor","NL",48.92696,-55.65966,2018-03-06 07:00:00,40,1,41
"19068",10501,"Grand Falls-Windsor","NL",48.92696,-55.65966,2018-03-06 08:00:00,41,1,42
"19069",10501,"Grand Falls-Windsor","NL",48.92696,-55.65966,2018-03-06 09:00:00,40,3,43
"19070",10501,"Grand Falls-Windsor","NL",48.92696,-55.65966,2018-03-06 10:00:00,41,1,42
"19071",10501,"Grand Falls-Windsor","NL",48.92696,-55.65966,2018-03-06 11:00:00,41,1,42
"19072",10501,"Grand Falls-Windsor","NL",48.92696,-55.65966,2018-03-06 12:00:00,41,1,42
"19073",10501,"Grand Falls-Windsor","NL",48.92696,-55.65966,2018-03-06 13:00:00,41,1,42
"19074",10501,"Grand Falls-Windsor","NL",48.92696,-55.65966,2018-03-06 14:00:00,41,1,42
"19075",10501,"Grand Falls-Windsor","NL",48.92696,-55.65966,2018-03-06 15:00:00,42,1,43
"19076",10501,"Grand Falls-Windsor","NL",48.92696,-55.65966,2018-03-06 16:00:00,43,2,45
"19077",10501,"Grand Falls-Windsor","NL",48.92696,-55.65966,2018-03-06 17:00:00,43,2,45
"19078",10501,"Grand Falls-Windsor","NL",48.92696,-55.65966,2018-03-06 18:00:00,43,1,44
"19079",10501,"Grand Falls-Windsor","NL",48.92696,-55.65966,2018-03-06 19:00:00,43,1,44
"19080",10501,"Grand Falls-Windsor","NL",48.92696,-55.65966,2018-03-06 20:00:00,43,1,44
"19081",10501,"Grand Falls-Windsor","NL",48.92696,-55.65966,2018-03-06 21:00:00,43,1,44
"19082",10501,"Grand Falls-Windsor","NL",48.92696,-55.65966,2018-03-06 22:00:00,43,1,44
"19083",10501,"Grand Falls-Windsor","NL",48.92696,-55.65966,2018-03-06 23:00:00,43,1,44
"19084",10501,"Grand Falls-Windsor","NL",48.92696,-55.65966,2018-03-07 00:00:00,43,1,44
"19085",10501,"Grand Falls-Windsor","NL",48.92696,-55.65966,2018-03-07 01:00:00,43,1,44
"19086",10501,"Grand Falls-Windsor","NL",48.92696,-55.65966,2018-03-07 02:00:00,43,1,44
"19087",10501,"Grand Falls-Windsor","NL",48.92696,-55.65966,2018-03-07 03:00:00,44,1,45
"19088",10501,"Grand Falls-Windsor","NL",48.92696,-55.65966,2018-03-07 04:00:00,44,1,45
"19089",10501,"Grand Falls-Windsor","NL",48.92696,-55.65966,2018-03-07 05:00:00,43,1,44
"19090",10501,"Grand Falls-Windsor","NL",48.92696,-55.65966,2018-03-07 06:00:00,43,1,44
"19091",10501,"Grand Falls-Windsor","NL",48.92696,-55.65966,2018-03-07 07:00:00,42,1,43
"19092",10501,"Grand Falls-Windsor","NL",48.92696,-55.65966,2018-03-07 08:00:00,41,1,42
"19093",10501,"Grand Falls-Windsor","NL",48.92696,-55.65966,2018-03-07 09:00:00,41,2,43
"19094",10501,"Grand Falls-Windsor","NL",48.92696,-55.65966,2018-03-07 10:00:00,41,2,43
"19095",10501,"Grand Falls-Windsor","NL",48.92696,-55.65966,2018-03-07 11:00:00,41,1,42
"19096",10501,"Grand Falls-Windsor","NL",48.92696,-55.65966,2018-03-07 12:00:00,41,1,42
"19097",10501,"Grand Falls-Windsor","NL",48.92696,-55.65966,2018-03-07 13:00:00,41,2,43
"19098",10501,"Grand Falls-Windsor","NL",48.92696,-55.65966,2018-03-07 14:00:00,42,2,44
"19099",10501,"Grand Falls-Windsor","NL",48.92696,-55.65966,2018-03-07 15:00:00,42,1,43
"19100",10501,"Grand Falls-Windsor","NL",48.92696,-55.65966,2018-03-07 16:00:00,42,2,44
"19101",10501,"Grand Falls-Windsor","NL",48.92696,-55.65966,2018-03-07 17:00:00,41,2,43
"19102",10501,"Grand Falls-Windsor","NL",48.92696,-55.65966,2018-03-07 18:00:00,41,2,43
"19103",10501,"Grand Falls-Windsor","NL",48.92696,-55.65966,2018-03-07 19:00:00,41,2,43
"19104",10501,"Grand Falls-Windsor","NL",48.92696,-55.65966,2018-03-07 20:00:00,41,2,43
"19105",10501,"Grand Falls-Windsor","NL",48.92696,-55.65966,2018-03-07 21:00:00,40,2,42
"19106",10501,"Grand Falls-Windsor","NL",48.92696,-55.65966,2018-03-07 22:00:00,41,1,42
"19107",10501,"Grand Falls-Windsor","NL",48.92696,-55.65966,2018-03-07 23:00:00,41,1,42
"19108",10501,"Grand Falls-Windsor","NL",48.92696,-55.65966,2018-03-08 00:00:00,41,1,42
"19109",10501,"Grand Falls-Windsor","NL",48.92696,-55.65966,2018-03-08 01:00:00,41,1,42
"19110",10501,"Grand Falls-Windsor","NL",48.92696,-55.65966,2018-03-08 02:00:00,41,1,42
"19111",10501,"Grand Falls-Windsor","NL",48.92696,-55.65966,2018-03-08 03:00:00,41,1,42
"19112",10501,"Grand Falls-Windsor","NL",48.92696,-55.65966,2018-03-08 04:00:00,40,1,41
"19113",10501,"Grand Falls-Windsor","NL",48.92696,-55.65966,2018-03-08 05:00:00,41,1,42
"19114",10501,"Grand Falls-Windsor","NL",48.92696,-55.65966,2018-03-08 06:00:00,40,2,42
"19115",10501,"Grand Falls-Windsor","NL",48.92696,-55.65966,2018-03-08 07:00:00,40,2,42
"19116",10501,"Grand Falls-Windsor","NL",48.92696,-55.65966,2018-03-08 08:00:00,40,2,42
"19117",10501,"Grand Falls-Windsor","NL",48.92696,-55.65966,2018-03-08 09:00:00,41,2,43
"19118",10501,"Grand Falls-Windsor","NL",48.92696,-55.65966,2018-03-08 10:00:00,41,2,43
"19119",10501,"Grand Falls-Windsor","NL",48.92696,-55.65966,2018-03-08 11:00:00,42,1,43
"19120",10501,"Grand Falls-Windsor","NL",48.92696,-55.65966,2018-03-08 12:00:00,42,2,44
"19121",10501,"Grand Falls-Windsor","NL",48.92696,-55.65966,2018-03-08 13:00:00,41,2,43
"19122",10501,"Grand Falls-Windsor","NL",48.92696,-55.65966,2018-03-08 14:00:00,41,2,43
"19123",10501,"Grand Falls-Windsor","NL",48.92696,-55.65966,2018-03-08 15:00:00,42,1,43
"19124",10501,"Grand Falls-Windsor","NL",48.92696,-55.65966,2018-03-08 16:00:00,42,1,43
"19125",10501,"Grand Falls-Windsor","NL",48.92696,-55.65966,2018-03-08 17:00:00,42,1,43
"19126",10501,"Grand Falls-Windsor","NL",48.92696,-55.65966,2018-03-08 18:00:00,42,1,43
"19127",10501,"Grand Falls-Windsor","NL",48.92696,-55.65966,2018-03-08 19:00:00,42,1,43
"19128",10501,"Grand Falls-Windsor","NL",48.92696,-55.65966,2018-03-08 20:00:00,43,1,44
"19129",10501,"Grand Falls-Windsor","NL",48.92696,-55.65966,2018-03-08 21:00:00,42,1,43
"19130",10501,"Grand Falls-Windsor","NL",48.92696,-55.65966,2018-03-08 22:00:00,42,1,43
"19131",10501,"Grand Falls-Windsor","NL",48.92696,-55.65966,2018-03-08 23:00:00,41,2,43
"19132",10501,"Grand Falls-Windsor","NL",48.92696,-55.65966,2018-03-09 00:00:00,41,1,42
"19133",10501,"Grand Falls-Windsor","NL",48.92696,-55.65966,2018-03-09 01:00:00,40,1,41
"19134",10501,"Grand Falls-Windsor","NL",48.92696,-55.65966,2018-03-09 02:00:00,40,1,41
"19135",10501,"Grand Falls-Windsor","NL",48.92696,-55.65966,2018-03-09 03:00:00,39,1,40
"19136",10501,"Grand Falls-Windsor","NL",48.92696,-55.65966,2018-03-09 04:00:00,39,1,40
"19137",10501,"Grand Falls-Windsor","NL",48.92696,-55.65966,2018-03-09 05:00:00,39,1,40
"19138",10501,"Grand Falls-Windsor","NL",48.92696,-55.65966,2018-03-09 06:00:00,38,1,39
"19139",10501,"Grand Falls-Windsor","NL",48.92696,-55.65966,2018-03-09 07:00:00,38,2,40
"19140",10501,"Grand Falls-Windsor","NL",48.92696,-55.65966,2018-03-09 08:00:00,37,2,39
"19141",10501,"Grand Falls-Windsor","NL",48.92696,-55.65966,2018-03-09 09:00:00,38,2,40
"19142",10501,"Grand Falls-Windsor","NL",48.92696,-55.65966,2018-03-09 10:00:00,40,1,41
"19143",10501,"Grand Falls-Windsor","NL",48.92696,-55.65966,2018-03-09 11:00:00,41,1,42
"19144",10501,"Grand Falls-Windsor","NL",48.92696,-55.65966,2018-03-09 12:00:00,42,1,43
"19145",10501,"Grand Falls-Windsor","NL",48.92696,-55.65966,2018-03-09 13:00:00,42,1,43
"19146",10501,"Grand Falls-Windsor","NL",48.92696,-55.65966,2018-03-09 14:00:00,42,1,43
"19147",10501,"Grand Falls-Windsor","NL",48.92696,-55.65966,2018-03-09 15:00:00,42,1,43
"19148",10501,"Grand Falls-Windsor","NL",48.92696,-55.65966,2018-03-09 16:00:00,42,1,43
"19149",10501,"Grand Falls-Windsor","NL",48.92696,-55.65966,2018-03-09 17:00:00,43,1,44
"19150",10501,"Grand Falls-Windsor","NL",48.92696,-55.65966,2018-03-09 18:00:00,43,1,44
"19151",10501,"Grand Falls-Windsor","NL",48.92696,-55.65966,2018-03-09 19:00:00,43,1,44
"19152",10501,"Grand Falls-Windsor","NL",48.92696,-55.65966,2018-03-09 20:00:00,43,0,43
"19153",10501,"Grand Falls-Windsor","NL",48.92696,-55.65966,2018-03-09 21:00:00,42,1,43
"19154",10501,"Grand Falls-Windsor","NL",48.92696,-55.65966,2018-03-09 22:00:00,41,1,42
"19155",10501,"Grand Falls-Windsor","NL",48.92696,-55.65966,2018-03-09 23:00:00,42,1,43
"19156",10501,"Grand Falls-Windsor","NL",48.92696,-55.65966,2018-03-10 00:00:00,41,1,42
"19157",10501,"Grand Falls-Windsor","NL",48.92696,-55.65966,2018-03-10 01:00:00,42,1,43
"19158",10501,"Grand Falls-Windsor","NL",48.92696,-55.65966,2018-03-10 02:00:00,42,1,43
"19159",10501,"Grand Falls-Windsor","NL",48.92696,-55.65966,2018-03-10 03:00:00,43,0,43
"19160",10501,"Grand Falls-Windsor","NL",48.92696,-55.65966,2018-03-10 04:00:00,44,0,44
"19161",10501,"Grand Falls-Windsor","NL",48.92696,-55.65966,2018-03-10 05:00:00,43,1,44
"19162",10501,"Grand Falls-Windsor","NL",48.92696,-55.65966,2018-03-10 06:00:00,43,0,43
"19163",10501,"Grand Falls-Windsor","NL",48.92696,-55.65966,2018-03-10 07:00:00,40,3,43
"19164",10501,"Grand Falls-Windsor","NL",48.92696,-55.65966,2018-03-10 08:00:00,41,2,43
"19165",10501,"Grand Falls-Windsor","NL",48.92696,-55.65966,2018-03-10 09:00:00,41,2,43
"19166",10501,"Grand Falls-Windsor","NL",48.92696,-55.65966,2018-03-10 10:00:00,41,2,43
"19167",10501,"Grand Falls-Windsor","NL",48.92696,-55.65966,2018-03-10 11:00:00,40,2,42
"19168",10501,"Grand Falls-Windsor","NL",48.92696,-55.65966,2018-03-10 12:00:00,41,2,43
"19169",10501,"Grand Falls-Windsor","NL",48.92696,-55.65966,2018-03-10 13:00:00,40,3,43
"19170",10501,"Grand Falls-Windsor","NL",48.92696,-55.65966,2018-03-10 14:00:00,42,3,45
"19171",10501,"Grand Falls-Windsor","NL",48.92696,-55.65966,2018-03-10 15:00:00,42,1,43
"19172",10501,"Grand Falls-Windsor","NL",48.92696,-55.65966,2018-03-10 16:00:00,41,2,43
"19173",10501,"Grand Falls-Windsor","NL",48.92696,-55.65966,2018-03-10 17:00:00,40,1,41
"19174",10501,"Grand Falls-Windsor","NL",48.92696,-55.65966,2018-03-10 18:00:00,40,1,41
"19175",10501,"Grand Falls-Windsor","NL",48.92696,-55.65966,2018-03-10 19:00:00,39,1,40
"19176",10501,"Grand Falls-Windsor","NL",48.92696,-55.65966,2018-03-10 20:00:00,37,2,39
"19177",10501,"Grand Falls-Windsor","NL",48.92696,-55.65966,2018-03-10 21:00:00,36,2,38
"19178",10501,"Grand Falls-Windsor","NL",48.92696,-55.65966,2018-03-10 22:00:00,34,3,37
"19179",10501,"Grand Falls-Windsor","NL",48.92696,-55.65966,2018-03-10 23:00:00,31,3,34
"19180",10501,"Grand Falls-Windsor","NL",48.92696,-55.65966,2018-03-11 00:00:00,30,4,34
"19181",10501,"Grand Falls-Windsor","NL",48.92696,-55.65966,2018-03-11 01:00:00,28,4,32
"19182",10501,"Grand Falls-Windsor","NL",48.92696,-55.65966,2018-03-11 01:00:00,28,6,34
"19183",10501,"Grand Falls-Windsor","NL",48.92696,-55.65966,2018-03-11 01:00:00,27,4,31
"19184",10501,"Grand Falls-Windsor","NL",48.92696,-55.65966,2018-03-11 01:00:00,27,6,33
"19185",10501,"Grand Falls-Windsor","NL",48.92696,-55.65966,2018-03-11 03:00:00,33,2,35
"19186",10501,"Grand Falls-Windsor","NL",48.92696,-55.65966,2018-03-11 04:00:00,33,3,36
"19187",10501,"Grand Falls-Windsor","NL",48.92696,-55.65966,2018-03-11 05:00:00,30,9,39
"19188",10501,"Grand Falls-Windsor","NL",48.92696,-55.65966,2018-03-11 06:00:00,33,3,36
"19189",10501,"Grand Falls-Windsor","NL",48.92696,-55.65966,2018-03-11 07:00:00,35,2,37
"19190",10501,"Grand Falls-Windsor","NL",48.92696,-55.65966,2018-03-11 08:00:00,34,2,36
"19191",10501,"Grand Falls-Windsor","NL",48.92696,-55.65966,2018-03-11 09:00:00,35,1,36
"19192",10501,"Grand Falls-Windsor","NL",48.92696,-55.65966,2018-03-11 10:00:00,37,1,38
"19193",10501,"Grand Falls-Windsor","NL",48.92696,-55.65966,2018-03-11 11:00:00,37,2,39
"19194",10501,"Grand Falls-Windsor","NL",48.92696,-55.65966,2018-03-11 12:00:00,39,2,41
"19195",10501,"Grand Falls-Windsor","NL",48.92696,-55.65966,2018-03-11 13:00:00,39,2,41
"19196",10501,"Grand Falls-Windsor","NL",48.92696,-55.65966,2018-03-11 14:00:00,40,2,42
"19197",10501,"Grand Falls-Windsor","NL",48.92696,-55.65966,2018-03-11 15:00:00,41,2,43
"19198",10501,"Grand Falls-Windsor","NL",48.92696,-55.65966,2018-03-11 16:00:00,43,1,44
"19199",10501,"Grand Falls-Windsor","NL",48.92696,-55.65966,2018-03-11 17:00:00,44,2,46
"19200",10501,"Grand Falls-Windsor","NL",48.92696,-55.65966,2018-03-11 18:00:00,44,1,45
"19201",10501,"Grand Falls-Windsor","NL",48.92696,-55.65966,2018-03-11 19:00:00,44,2,46
"19202",10501,"Grand Falls-Windsor","NL",48.92696,-55.65966,2018-03-11 20:00:00,44,1,45
"19203",10501,"Grand Falls-Windsor","NL",48.92696,-55.65966,2018-03-11 21:00:00,44,2,46
"19204",10501,"Grand Falls-Windsor","NL",48.92696,-55.65966,2018-03-11 22:00:00,44,1,45
"19205",10501,"Grand Falls-Windsor","NL",48.92696,-55.65966,2018-03-11 23:00:00,44,1,45
"19206",10501,"Grand Falls-Windsor","NL",48.92696,-55.65966,2018-03-12 00:00:00,44,1,45
"19207",10501,"Grand Falls-Windsor","NL",48.92696,-55.65966,2018-03-12 01:00:00,44,1,45
"19208",10501,"Grand Falls-Windsor","NL",48.92696,-55.65966,2018-03-12 02:00:00,43,0,43
"19209",10501,"Grand Falls-Windsor","NL",48.92696,-55.65966,2018-03-12 03:00:00,43,1,44
"19210",10501,"Grand Falls-Windsor","NL",48.92696,-55.65966,2018-03-12 04:00:00,43,1,44
"19211",10501,"Grand Falls-Windsor","NL",48.92696,-55.65966,2018-03-12 05:00:00,43,1,44
"19212",10501,"Grand Falls-Windsor","NL",48.92696,-55.65966,2018-03-12 06:00:00,44,2,46
"19213",10501,"Grand Falls-Windsor","NL",48.92696,-55.65966,2018-03-12 07:00:00,43,2,45
"19214",10501,"Grand Falls-Windsor","NL",48.92696,-55.65966,2018-03-12 08:00:00,43,2,45
"19215",10501,"Grand Falls-Windsor","NL",48.92696,-55.65966,2018-03-12 09:00:00,42,2,44
"19216",10501,"Grand Falls-Windsor","NL",48.92696,-55.65966,2018-03-12 10:00:00,41,2,43
"19217",10501,"Grand Falls-Windsor","NL",48.92696,-55.65966,2018-03-12 11:00:00,40,2,42
"19218",10501,"Grand Falls-Windsor","NL",48.92696,-55.65966,2018-03-12 12:00:00,41,1,42
"19219",10501,"Grand Falls-Windsor","NL",48.92696,-55.65966,2018-03-12 13:00:00,42,2,44
"19220",10501,"Grand Falls-Windsor","NL",48.92696,-55.65966,2018-03-12 14:00:00,42,1,43
"19221",10501,"Grand Falls-Windsor","NL",48.92696,-55.65966,2018-03-12 15:00:00,41,2,43
"19222",10501,"Grand Falls-Windsor","NL",48.92696,-55.65966,2018-03-12 16:00:00,39,2,41
"19223",10501,"Grand Falls-Windsor","NL",48.92696,-55.65966,2018-03-12 17:00:00,40,1,41
"19224",10501,"Grand Falls-Windsor","NL",48.92696,-55.65966,2018-03-12 18:00:00,40,1,41
"19225",10501,"Grand Falls-Windsor","NL",48.92696,-55.65966,2018-03-12 19:00:00,39,1,40
"19226",10501,"Grand Falls-Windsor","NL",48.92696,-55.65966,2018-03-12 20:00:00,39,1,40
"19227",10501,"Grand Falls-Windsor","NL",48.92696,-55.65966,2018-03-12 21:00:00,38,1,39
"19228",10501,"Grand Falls-Windsor","NL",48.92696,-55.65966,2018-03-12 22:00:00,37,1,38
"19229",10501,"Grand Falls-Windsor","NL",48.92696,-55.65966,2018-03-12 23:00:00,38,1,39
"19230",10501,"Grand Falls-Windsor","NL",48.92696,-55.65966,2018-03-13 00:00:00,37,1,38
"19231",10501,"Grand Falls-Windsor","NL",48.92696,-55.65966,2018-03-13 01:00:00,35,1,36
"19232",10501,"Grand Falls-Windsor","NL",48.92696,-55.65966,2018-03-13 02:00:00,35,1,36
"19233",10501,"Grand Falls-Windsor","NL",48.92696,-55.65966,2018-03-13 03:00:00,36,1,37
"19234",10501,"Grand Falls-Windsor","NL",48.92696,-55.65966,2018-03-13 04:00:00,35,1,36
"19235",10501,"Grand Falls-Windsor","NL",48.92696,-55.65966,2018-03-13 05:00:00,34,1,35
"19236",10501,"Grand Falls-Windsor","NL",48.92696,-55.65966,2018-03-13 06:00:00,33,2,35
"19237",10501,"Grand Falls-Windsor","NL",48.92696,-55.65966,2018-03-13 07:00:00,32,3,35
"19238",10501,"Grand Falls-Windsor","NL",48.92696,-55.65966,2018-03-13 08:00:00,32,3,35
"19239",10501,"Grand Falls-Windsor","NL",48.92696,-55.65966,2018-03-13 09:00:00,29,8,37
"19240",10501,"Grand Falls-Windsor","NL",48.92696,-55.65966,2018-03-13 10:00:00,28,10,38
"19241",10501,"Grand Falls-Windsor","NL",48.92696,-55.65966,2018-03-13 11:00:00,33,6,39
"19242",10501,"Grand Falls-Windsor","NL",48.92696,-55.65966,2018-03-13 12:00:00,37,4,41
"19243",10501,"Grand Falls-Windsor","NL",48.92696,-55.65966,2018-03-13 13:00:00,39,1,40
"19244",10501,"Grand Falls-Windsor","NL",48.92696,-55.65966,2018-03-13 14:00:00,39,1,40
"19245",10501,"Grand Falls-Windsor","NL",48.92696,-55.65966,2018-03-13 15:00:00,39,1,40
"19246",10501,"Grand Falls-Windsor","NL",48.92696,-55.65966,2018-03-13 16:00:00,39,1,40
"19247",10501,"Grand Falls-Windsor","NL",48.92696,-55.65966,2018-03-13 17:00:00,38,1,39
"19248",10501,"Grand Falls-Windsor","NL",48.92696,-55.65966,2018-03-13 18:00:00,38,1,39
"19249",10501,"Grand Falls-Windsor","NL",48.92696,-55.65966,2018-03-13 19:00:00,37,1,38
"19250",10501,"Grand Falls-Windsor","NL",48.92696,-55.65966,2018-03-13 20:00:00,39,1,40
"19251",10501,"Grand Falls-Windsor","NL",48.92696,-55.65966,2018-03-13 21:00:00,39,1,40
"19252",10501,"Grand Falls-Windsor","NL",48.92696,-55.65966,2018-03-13 22:00:00,37,2,39
"19253",10501,"Grand Falls-Windsor","NL",48.92696,-55.65966,2018-03-13 23:00:00,38,1,39
"19254",10501,"Grand Falls-Windsor","NL",48.92696,-55.65966,2018-03-14 00:00:00,38,1,39
"19255",10501,"Grand Falls-Windsor","NL",48.92696,-55.65966,2018-03-14 01:00:00,38,1,39
"19256",10501,"Grand Falls-Windsor","NL",48.92696,-55.65966,2018-03-14 02:00:00,38,1,39
"19257",10501,"Grand Falls-Windsor","NL",48.92696,-55.65966,2018-03-14 03:00:00,43,0,43
"19258",10501,"Grand Falls-Windsor","NL",48.92696,-55.65966,2018-03-14 04:00:00,44,0,44
"19259",10501,"Grand Falls-Windsor","NL",48.92696,-55.65966,2018-03-14 05:00:00,43,1,44
"19260",10501,"Grand Falls-Windsor","NL",48.92696,-55.65966,2018-03-14 06:00:00,43,1,44
"19261",10501,"Grand Falls-Windsor","NL",48.92696,-55.65966,2018-03-14 07:00:00,42,0,42
"19262",10501,"Grand Falls-Windsor","NL",48.92696,-55.65966,2018-03-14 08:00:00,43,0,43
"19263",10501,"Grand Falls-Windsor","NL",48.92696,-55.65966,2018-03-14 09:00:00,43,1,44
"19264",10501,"Grand Falls-Windsor","NL",48.92696,-55.65966,2018-03-14 10:00:00,43,1,44
"19265",10501,"Grand Falls-Windsor","NL",48.92696,-55.65966,2018-03-14 11:00:00,44,1,45
"19266",10501,"Grand Falls-Windsor","NL",48.92696,-55.65966,2018-03-14 12:00:00,43,1,44
"19267",10501,"Grand Falls-Windsor","NL",48.92696,-55.65966,2018-03-14 13:00:00,43,0,43
"19268",10501,"Grand Falls-Windsor","NL",48.92696,-55.65966,2018-03-14 14:00:00,42,0,42
"19269",10501,"Grand Falls-Windsor","NL",48.92696,-55.65966,2018-03-14 15:00:00,41,1,42
"19270",10501,"Grand Falls-Windsor","NL",48.92696,-55.65966,2018-03-14 16:00:00,42,1,43
"19271",10501,"Grand Falls-Windsor","NL",48.92696,-55.65966,2018-03-14 17:00:00,41,0,41
"19272",10501,"Grand Falls-Windsor","NL",48.92696,-55.65966,2018-03-14 18:00:00,41,0,41
"19273",10501,"Grand Falls-Windsor","NL",48.92696,-55.65966,2018-03-14 19:00:00,39,1,40
"19274",10501,"Grand Falls-Windsor","NL",48.92696,-55.65966,2018-03-14 20:00:00,38,1,39
"19275",10501,"Grand Falls-Windsor","NL",48.92696,-55.65966,2018-03-14 21:00:00,36,1,37
"19276",10501,"Grand Falls-Windsor","NL",48.92696,-55.65966,2018-03-14 22:00:00,38,0,38
"19277",10501,"Grand Falls-Windsor","NL",48.92696,-55.65966,2018-03-14 23:00:00,37,0,37
"19278",10501,"Grand Falls-Windsor","NL",48.92696,-55.65966,2018-03-15 00:00:00,36,0,36
"19279",10501,"Grand Falls-Windsor","NL",48.92696,-55.65966,2018-03-15 01:00:00,34,0,34
"19280",10501,"Grand Falls-Windsor","NL",48.92696,-55.65966,2018-03-15 02:00:00,36,0,36
"19281",10501,"Grand Falls-Windsor","NL",48.92696,-55.65966,2018-03-15 03:00:00,36,0,36
"19282",10501,"Grand Falls-Windsor","NL",48.92696,-55.65966,2018-03-15 04:00:00,36,1,37
"19283",10501,"Grand Falls-Windsor","NL",48.92696,-55.65966,2018-03-15 05:00:00,34,1,35
"19284",10501,"Grand Falls-Windsor","NL",48.92696,-55.65966,2018-03-15 06:00:00,34,1,35
"19285",10501,"Grand Falls-Windsor","NL",48.92696,-55.65966,2018-03-15 07:00:00,38,1,39
"19286",10501,"Grand Falls-Windsor","NL",48.92696,-55.65966,2018-03-15 08:00:00,40,1,41
"19287",10501,"Grand Falls-Windsor","NL",48.92696,-55.65966,2018-03-15 09:00:00,41,0,41
"19288",10501,"Grand Falls-Windsor","NL",48.92696,-55.65966,2018-03-15 10:00:00,41,0,41
"19289",10501,"Grand Falls-Windsor","NL",48.92696,-55.65966,2018-03-15 11:00:00,43,0,43
"19290",10501,"Grand Falls-Windsor","NL",48.92696,-55.65966,2018-03-15 12:00:00,42,4,46
"19291",10501,"Grand Falls-Windsor","NL",48.92696,-55.65966,2018-03-15 13:00:00,42,0,42
"19292",10501,"Grand Falls-Windsor","NL",48.92696,-55.65966,2018-03-15 14:00:00,41,1,42
"19293",10501,"Grand Falls-Windsor","NL",48.92696,-55.65966,2018-03-15 15:00:00,41,0,41
"19294",10501,"Grand Falls-Windsor","NL",48.92696,-55.65966,2018-03-15 16:00:00,41,0,41
"19295",10501,"Grand Falls-Windsor","NL",48.92696,-55.65966,2018-03-15 17:00:00,41,0,41
"19296",10501,"Grand Falls-Windsor","NL",48.92696,-55.65966,2018-03-15 18:00:00,44,0,44
"19297",10501,"Grand Falls-Windsor","NL",48.92696,-55.65966,2018-03-15 19:00:00,45,1,46
"19298",10501,"Grand Falls-Windsor","NL",48.92696,-55.65966,2018-03-15 20:00:00,45,1,46
"19299",10501,"Grand Falls-Windsor","NL",48.92696,-55.65966,2018-03-15 21:00:00,44,1,45
"19300",10501,"Grand Falls-Windsor","NL",48.92696,-55.65966,2018-03-15 22:00:00,40,2,42
"19301",10501,"Grand Falls-Windsor","NL",48.92696,-55.65966,2018-03-15 23:00:00,40,0,40
"19302",10501,"Grand Falls-Windsor","NL",48.92696,-55.65966,2018-03-16 00:00:00,43,0,43
"19303",10501,"Grand Falls-Windsor","NL",48.92696,-55.65966,2018-03-16 01:00:00,44,0,44
"19304",10501,"Grand Falls-Windsor","NL",48.92696,-55.65966,2018-03-16 02:00:00,42,0,42
"19305",10501,"Grand Falls-Windsor","NL",48.92696,-55.65966,2018-03-16 03:00:00,40,0,40
"19306",10501,"Grand Falls-Windsor","NL",48.92696,-55.65966,2018-03-16 04:00:00,39,0,39
"19307",10501,"Grand Falls-Windsor","NL",48.92696,-55.65966,2018-03-16 05:00:00,39,0,39
"19308",10501,"Grand Falls-Windsor","NL",48.92696,-55.65966,2018-03-16 06:00:00,38,0,38
"19309",10501,"Grand Falls-Windsor","NL",48.92696,-55.65966,2018-03-16 07:00:00,37,0,37
"19310",10501,"Grand Falls-Windsor","NL",48.92696,-55.65966,2018-03-16 08:00:00,37,0,37
"19311",10501,"Grand Falls-Windsor","NL",48.92696,-55.65966,2018-03-16 09:00:00,37,0,37
"19312",10501,"Grand Falls-Windsor","NL",48.92696,-55.65966,2018-03-16 10:00:00,38,0,38
"19313",10501,"Grand Falls-Windsor","NL",48.92696,-55.65966,2018-03-16 11:00:00,38,0,38
"19314",10501,"Grand Falls-Windsor","NL",48.92696,-55.65966,2018-03-16 12:00:00,38,0,38
"19315",10501,"Grand Falls-Windsor","NL",48.92696,-55.65966,2018-03-16 13:00:00,38,0,38
"19316",10501,"Grand Falls-Windsor","NL",48.92696,-55.65966,2018-03-16 14:00:00,39,0,39
"19317",10501,"Grand Falls-Windsor","NL",48.92696,-55.65966,2018-03-16 15:00:00,39,0,39
"19318",10501,"Grand Falls-Windsor","NL",48.92696,-55.65966,2018-03-16 16:00:00,39,0,39
"19319",10501,"Grand Falls-Windsor","NL",48.92696,-55.65966,2018-03-16 17:00:00,39,0,39
"19320",10501,"Grand Falls-Windsor","NL",48.92696,-55.65966,2018-03-16 18:00:00,39,0,39
"19321",10501,"Grand Falls-Windsor","NL",48.92696,-55.65966,2018-03-16 19:00:00,39,0,39
"19322",10501,"Grand Falls-Windsor","NL",48.92696,-55.65966,2018-03-16 20:00:00,38,0,38
"19323",10501,"Grand Falls-Windsor","NL",48.92696,-55.65966,2018-03-16 21:00:00,37,1,38
"19324",10501,"Grand Falls-Windsor","NL",48.92696,-55.65966,2018-03-16 22:00:00,36,1,37
"19325",10501,"Grand Falls-Windsor","NL",48.92696,-55.65966,2018-03-16 23:00:00,36,0,36
"19326",10501,"Grand Falls-Windsor","NL",48.92696,-55.65966,2018-03-17 00:00:00,35,0,35
"19327",10501,"Grand Falls-Windsor","NL",48.92696,-55.65966,2018-03-17 01:00:00,34,0,34
"19328",10501,"Grand Falls-Windsor","NL",48.92696,-55.65966,2018-03-17 02:00:00,33,0,33
"19329",10501,"Grand Falls-Windsor","NL",48.92696,-55.65966,2018-03-17 03:00:00,29,1,30
"19330",10501,"Grand Falls-Windsor","NL",48.92696,-55.65966,2018-03-17 04:00:00,30,0,30
"19331",10501,"Grand Falls-Windsor","NL",48.92696,-55.65966,2018-03-17 05:00:00,31,0,31
"19332",10501,"Grand Falls-Windsor","NL",48.92696,-55.65966,2018-03-17 06:00:00,29,0,29
"19333",10501,"Grand Falls-Windsor","NL",48.92696,-55.65966,2018-03-17 07:00:00,27,1,28
"19334",10501,"Grand Falls-Windsor","NL",48.92696,-55.65966,2018-03-17 08:00:00,29,0,29
"19335",10501,"Grand Falls-Windsor","NL",48.92696,-55.65966,2018-03-17 09:00:00,29,0,29
"19336",10501,"Grand Falls-Windsor","NL",48.92696,-55.65966,2018-03-17 10:00:00,30,1,31
"19337",10501,"Grand Falls-Windsor","NL",48.92696,-55.65966,2018-03-17 11:00:00,37,1,38
"19338",10501,"Grand Falls-Windsor","NL",48.92696,-55.65966,2018-03-17 12:00:00,40,1,41
"19339",10501,"Grand Falls-Windsor","NL",48.92696,-55.65966,2018-03-17 13:00:00,41,1,42
"19340",10501,"Grand Falls-Windsor","NL",48.92696,-55.65966,2018-03-17 14:00:00,41,0,41
"19341",10501,"Grand Falls-Windsor","NL",48.92696,-55.65966,2018-03-17 15:00:00,40,0,40
"19342",10501,"Grand Falls-Windsor","NL",48.92696,-55.65966,2018-03-17 16:00:00,40,0,40
"19343",10501,"Grand Falls-Windsor","NL",48.92696,-55.65966,2018-03-17 17:00:00,40,1,41
"19344",10501,"Grand Falls-Windsor","NL",48.92696,-55.65966,2018-03-17 18:00:00,39,2,41
"19345",10501,"Grand Falls-Windsor","NL",48.92696,-55.65966,2018-03-17 19:00:00,35,3,38
"19346",10501,"Grand Falls-Windsor","NL",48.92696,-55.65966,2018-03-17 20:00:00,33,1,34
"19347",10501,"Grand Falls-Windsor","NL",48.92696,-55.65966,2018-03-17 21:00:00,34,2,36
"19348",10501,"Grand Falls-Windsor","NL",48.92696,-55.65966,2018-03-17 22:00:00,36,2,38
"19349",10501,"Grand Falls-Windsor","NL",48.92696,-55.65966,2018-03-17 23:00:00,33,1,34
"19350",10501,"Grand Falls-Windsor","NL",48.92696,-55.65966,2018-03-18 00:00:00,35,0,35
"19351",10501,"Grand Falls-Windsor","NL",48.92696,-55.65966,2018-03-18 01:00:00,38,0,38
"19352",10501,"Grand Falls-Windsor","NL",48.92696,-55.65966,2018-03-18 02:00:00,37,0,37
"19353",10501,"Grand Falls-Windsor","NL",48.92696,-55.65966,2018-03-18 03:00:00,35,0,35
"19354",10501,"Grand Falls-Windsor","NL",48.92696,-55.65966,2018-03-18 04:00:00,35,0,35
"19355",10501,"Grand Falls-Windsor","NL",48.92696,-55.65966,2018-03-18 05:00:00,36,0,36
"19356",10501,"Grand Falls-Windsor","NL",48.92696,-55.65966,2018-03-18 06:00:00,36,0,36
"19357",10501,"Grand Falls-Windsor","NL",48.92696,-55.65966,2018-03-18 07:00:00,37,0,37
"19358",10501,"Grand Falls-Windsor","NL",48.92696,-55.65966,2018-03-18 08:00:00,37,0,37
"19359",10501,"Grand Falls-Windsor","NL",48.92696,-55.65966,2018-03-18 09:00:00,37,0,37
"19360",10501,"Grand Falls-Windsor","NL",48.92696,-55.65966,2018-03-18 10:00:00,36,0,36
"19361",10501,"Grand Falls-Windsor","NL",48.92696,-55.65966,2018-03-18 11:00:00,37,0,37
"19362",10501,"Grand Falls-Windsor","NL",48.92696,-55.65966,2018-03-18 12:00:00,36,0,36
"19363",10501,"Grand Falls-Windsor","NL",48.92696,-55.65966,2018-03-18 13:00:00,35,0,35
"19364",10501,"Grand Falls-Windsor","NL",48.92696,-55.65966,2018-03-18 14:00:00,36,0,36
"19365",10501,"Grand Falls-Windsor","NL",48.92696,-55.65966,2018-03-18 15:00:00,36,0,36
"19366",10501,"Grand Falls-Windsor","NL",48.92696,-55.65966,2018-03-18 16:00:00,37,0,37
"19367",10501,"Grand Falls-Windsor","NL",48.92696,-55.65966,2018-03-18 17:00:00,37,0,37
"19368",10501,"Grand Falls-Windsor","NL",48.92696,-55.65966,2018-03-18 18:00:00,36,0,36
"19369",10501,"Grand Falls-Windsor","NL",48.92696,-55.65966,2018-03-18 19:00:00,36,0,36
"19370",10501,"Grand Falls-Windsor","NL",48.92696,-55.65966,2018-03-18 20:00:00,36,0,36
"19371",10501,"Grand Falls-Windsor","NL",48.92696,-55.65966,2018-03-18 21:00:00,36,0,36
"19372",10501,"Grand Falls-Windsor","NL",48.92696,-55.65966,2018-03-18 22:00:00,36,0,36
"19373",10501,"Grand Falls-Windsor","NL",48.92696,-55.65966,2018-03-18 23:00:00,36,0,36
"19374",10501,"Grand Falls-Windsor","NL",48.92696,-55.65966,2018-03-19 00:00:00,36,0,36
"19375",10501,"Grand Falls-Windsor","NL",48.92696,-55.65966,2018-03-19 01:00:00,36,0,36
"19376",10501,"Grand Falls-Windsor","NL",48.92696,-55.65966,2018-03-19 02:00:00,36,0,36
"19377",10501,"Grand Falls-Windsor","NL",48.92696,-55.65966,2018-03-19 03:00:00,35,0,35
"19378",10501,"Grand Falls-Windsor","NL",48.92696,-55.65966,2018-03-19 04:00:00,35,0,35
"19379",10501,"Grand Falls-Windsor","NL",48.92696,-55.65966,2018-03-19 05:00:00,34,0,34
"19380",10501,"Grand Falls-Windsor","NL",48.92696,-55.65966,2018-03-19 06:00:00,34,0,34
"19381",10501,"Grand Falls-Windsor","NL",48.92696,-55.65966,2018-03-19 07:00:00,34,1,35
"19382",10501,"Grand Falls-Windsor","NL",48.92696,-55.65966,2018-03-19 08:00:00,33,1,34
"19383",10501,"Grand Falls-Windsor","NL",48.92696,-55.65966,2018-03-19 09:00:00,34,1,35
"19384",10501,"Grand Falls-Windsor","NL",48.92696,-55.65966,2018-03-19 10:00:00,35,3,38
"19385",10501,"Grand Falls-Windsor","NL",48.92696,-55.65966,2018-03-19 11:00:00,33,8,41
"19386",10501,"Grand Falls-Windsor","NL",48.92696,-55.65966,2018-03-19 12:00:00,37,1,38
"19387",10501,"Grand Falls-Windsor","NL",48.92696,-55.65966,2018-03-19 13:00:00,37,0,37
"19388",10501,"Grand Falls-Windsor","NL",48.92696,-55.65966,2018-03-19 14:00:00,36,1,37
"19389",10501,"Grand Falls-Windsor","NL",48.92696,-55.65966,2018-03-19 15:00:00,36,0,36
"19390",10501,"Grand Falls-Windsor","NL",48.92696,-55.65966,2018-03-19 16:00:00,36,0,36
"19391",10501,"Grand Falls-Windsor","NL",48.92696,-55.65966,2018-03-19 17:00:00,36,0,36
"19392",10501,"Grand Falls-Windsor","NL",48.92696,-55.65966,2018-03-19 18:00:00,35,0,35
"19393",10501,"Grand Falls-Windsor","NL",48.92696,-55.65966,2018-03-19 19:00:00,35,0,35
"19394",10501,"Grand Falls-Windsor","NL",48.92696,-55.65966,2018-03-19 20:00:00,34,0,34
"19395",10501,"Grand Falls-Windsor","NL",48.92696,-55.65966,2018-03-19 21:00:00,34,0,34
"19396",10501,"Grand Falls-Windsor","NL",48.92696,-55.65966,2018-03-19 22:00:00,34,0,34
"19397",10501,"Grand Falls-Windsor","NL",48.92696,-55.65966,2018-03-19 23:00:00,33,0,33
"19398",10501,"Grand Falls-Windsor","NL",48.92696,-55.65966,2018-03-20 00:00:00,31,0,31
"19399",10501,"Grand Falls-Windsor","NL",48.92696,-55.65966,2018-03-20 01:00:00,31,0,31
"19400",10501,"Grand Falls-Windsor","NL",48.92696,-55.65966,2018-03-20 02:00:00,31,0,31
"19401",10501,"Grand Falls-Windsor","NL",48.92696,-55.65966,2018-03-20 03:00:00,31,0,31
"19402",10501,"Grand Falls-Windsor","NL",48.92696,-55.65966,2018-03-20 04:00:00,31,0,31
"19403",10501,"Grand Falls-Windsor","NL",48.92696,-55.65966,2018-03-20 05:00:00,31,0,31
"19404",10501,"Grand Falls-Windsor","NL",48.92696,-55.65966,2018-03-20 06:00:00,31,0,31
"19405",10501,"Grand Falls-Windsor","NL",48.92696,-55.65966,2018-03-20 07:00:00,31,0,31
"19406",10501,"Grand Falls-Windsor","NL",48.92696,-55.65966,2018-03-20 08:00:00,32,1,33
"19407",10501,"Grand Falls-Windsor","NL",48.92696,-55.65966,2018-03-20 09:00:00,32,1,33
"19408",10501,"Grand Falls-Windsor","NL",48.92696,-55.65966,2018-03-20 10:00:00,34,1,35
"19409",10501,"Grand Falls-Windsor","NL",48.92696,-55.65966,2018-03-20 11:00:00,36,1,37
"19410",10501,"Grand Falls-Windsor","NL",48.92696,-55.65966,2018-03-20 12:00:00,38,0,38
"19411",10501,"Grand Falls-Windsor","NL",48.92696,-55.65966,2018-03-20 13:00:00,39,0,39
"19412",10501,"Grand Falls-Windsor","NL",48.92696,-55.65966,2018-03-20 14:00:00,39,1,40
"19413",10501,"Grand Falls-Windsor","NL",48.92696,-55.65966,2018-03-20 15:00:00,39,1,40
"19414",10501,"Grand Falls-Windsor","NL",48.92696,-55.65966,2018-03-20 16:00:00,39,1,40
"19415",10501,"Grand Falls-Windsor","NL",48.92696,-55.65966,2018-03-20 17:00:00,40,0,40
"19416",10501,"Grand Falls-Windsor","NL",48.92696,-55.65966,2018-03-20 18:00:00,40,0,40
"19417",10501,"Grand Falls-Windsor","NL",48.92696,-55.65966,2018-03-20 19:00:00,40,0,40
"19418",10501,"Grand Falls-Windsor","NL",48.92696,-55.65966,2018-03-20 20:00:00,40,0,40
"19419",10501,"Grand Falls-Windsor","NL",48.92696,-55.65966,2018-03-20 21:00:00,40,0,40
"19420",10501,"Grand Falls-Windsor","NL",48.92696,-55.65966,2018-03-20 22:00:00,40,0,40
"19421",10501,"Grand Falls-Windsor","NL",48.92696,-55.65966,2018-03-20 23:00:00,40,0,40
"19422",10501,"Grand Falls-Windsor","NL",48.92696,-55.65966,2018-03-21 00:00:00,40,0,40
"19423",10501,"Grand Falls-Windsor","NL",48.92696,-55.65966,2018-03-21 01:00:00,40,0,40
"19424",10501,"Grand Falls-Windsor","NL",48.92696,-55.65966,2018-03-21 02:00:00,41,0,41
"19425",10501,"Grand Falls-Windsor","NL",48.92696,-55.65966,2018-03-21 03:00:00,41,0,41
"19426",10501,"Grand Falls-Windsor","NL",48.92696,-55.65966,2018-03-21 04:00:00,40,0,40
"19427",10501,"Grand Falls-Windsor","NL",48.92696,-55.65966,2018-03-21 05:00:00,40,0,40
"19428",10501,"Grand Falls-Windsor","NL",48.92696,-55.65966,2018-03-21 06:00:00,40,0,40
"19429",10501,"Grand Falls-Windsor","NL",48.92696,-55.65966,2018-03-21 07:00:00,39,0,39
"19430",10501,"Grand Falls-Windsor","NL",48.92696,-55.65966,2018-03-21 08:00:00,38,0,38
"19431",10501,"Grand Falls-Windsor","NL",48.92696,-55.65966,2018-03-21 09:00:00,39,3,42
"19432",10501,"Grand Falls-Windsor","NL",48.92696,-55.65966,2018-03-21 10:00:00,41,1,42
"19433",10501,"Grand Falls-Windsor","NL",48.92696,-55.65966,2018-03-21 11:00:00,41,1,42
"19434",10501,"Grand Falls-Windsor","NL",48.92696,-55.65966,2018-03-21 12:00:00,41,1,42
"19435",10501,"Grand Falls-Windsor","NL",48.92696,-55.65966,2018-03-21 13:00:00,41,0,41
"19436",10501,"Grand Falls-Windsor","NL",48.92696,-55.65966,2018-03-21 14:00:00,41,1,42
"19437",10501,"Grand Falls-Windsor","NL",48.92696,-55.65966,2018-03-21 15:00:00,41,1,42
"19438",10501,"Grand Falls-Windsor","NL",48.92696,-55.65966,2018-03-21 16:00:00,41,1,42
"19439",10501,"Grand Falls-Windsor","NL",48.92696,-55.65966,2018-03-21 17:00:00,42,1,43
"19440",10501,"Grand Falls-Windsor","NL",48.92696,-55.65966,2018-03-21 18:00:00,41,1,42
"19441",10501,"Grand Falls-Windsor","NL",48.92696,-55.65966,2018-03-21 19:00:00,38,3,41
"19442",10501,"Grand Falls-Windsor","NL",48.92696,-55.65966,2018-03-21 20:00:00,36,4,40
"19443",10501,"Grand Falls-Windsor","NL",48.92696,-55.65966,2018-03-21 21:00:00,37,2,39
"19444",10501,"Grand Falls-Windsor","NL",48.92696,-55.65966,2018-03-21 22:00:00,37,1,38
"19445",10501,"Grand Falls-Windsor","NL",48.92696,-55.65966,2018-03-21 23:00:00,38,1,39
"19446",10501,"Grand Falls-Windsor","NL",48.92696,-55.65966,2018-03-22 00:00:00,38,1,39
"19447",10501,"Grand Falls-Windsor","NL",48.92696,-55.65966,2018-03-22 01:00:00,39,1,40
"19448",10501,"Grand Falls-Windsor","NL",48.92696,-55.65966,2018-03-22 02:00:00,39,1,40
"19449",10501,"Grand Falls-Windsor","NL",48.92696,-55.65966,2018-03-22 03:00:00,39,0,39
"19450",10501,"Grand Falls-Windsor","NL",48.92696,-55.65966,2018-03-22 04:00:00,38,1,39
"19451",10501,"Grand Falls-Windsor","NL",48.92696,-55.65966,2018-03-22 05:00:00,38,1,39
"19452",10501,"Grand Falls-Windsor","NL",48.92696,-55.65966,2018-03-22 06:00:00,37,2,39
"19453",10501,"Grand Falls-Windsor","NL",48.92696,-55.65966,2018-03-22 07:00:00,39,1,40
"19454",10501,"Grand Falls-Windsor","NL",48.92696,-55.65966,2018-03-22 08:00:00,38,2,40
"19455",10501,"Grand Falls-Windsor","NL",48.92696,-55.65966,2018-03-22 09:00:00,39,1,40
"19456",10501,"Grand Falls-Windsor","NL",48.92696,-55.65966,2018-03-22 10:00:00,39,1,40
"19457",10501,"Grand Falls-Windsor","NL",48.92696,-55.65966,2018-03-22 11:00:00,40,1,41
"19458",10501,"Grand Falls-Windsor","NL",48.92696,-55.65966,2018-03-22 12:00:00,40,1,41
"19459",10501,"Grand Falls-Windsor","NL",48.92696,-55.65966,2018-03-22 13:00:00,40,1,41
"19460",10501,"Grand Falls-Windsor","NL",48.92696,-55.65966,2018-03-22 14:00:00,41,1,42
"19461",10501,"Grand Falls-Windsor","NL",48.92696,-55.65966,2018-03-22 15:00:00,41,1,42
"19462",10501,"Grand Falls-Windsor","NL",48.92696,-55.65966,2018-03-22 16:00:00,41,1,42
"19463",10501,"Grand Falls-Windsor","NL",48.92696,-55.65966,2018-03-22 17:00:00,41,1,42
"19464",10501,"Grand Falls-Windsor","NL",48.92696,-55.65966,2018-03-22 18:00:00,41,1,42
"19465",10501,"Grand Falls-Windsor","NL",48.92696,-55.65966,2018-03-22 19:00:00,42,1,43
"19466",10501,"Grand Falls-Windsor","NL",48.92696,-55.65966,2018-03-22 20:00:00,41,1,42
"19467",10501,"Grand Falls-Windsor","NL",48.92696,-55.65966,2018-03-22 21:00:00,41,1,42
"19468",10501,"Grand Falls-Windsor","NL",48.92696,-55.65966,2018-03-22 22:00:00,40,1,41
"19469",10501,"Grand Falls-Windsor","NL",48.92696,-55.65966,2018-03-22 23:00:00,40,1,41
"19470",10501,"Grand Falls-Windsor","NL",48.92696,-55.65966,2018-03-23 00:00:00,40,2,42
"19471",10501,"Grand Falls-Windsor","NL",48.92696,-55.65966,2018-03-23 01:00:00,40,1,41
"19472",10501,"Grand Falls-Windsor","NL",48.92696,-55.65966,2018-03-23 02:00:00,39,2,41
"19473",10501,"Grand Falls-Windsor","NL",48.92696,-55.65966,2018-03-23 03:00:00,40,1,41
"19474",10501,"Grand Falls-Windsor","NL",48.92696,-55.65966,2018-03-23 04:00:00,39,1,40
"19475",10501,"Grand Falls-Windsor","NL",48.92696,-55.65966,2018-03-23 05:00:00,36,4,40
"19476",10501,"Grand Falls-Windsor","NL",48.92696,-55.65966,2018-03-23 06:00:00,36,4,40
"19477",10501,"Grand Falls-Windsor","NL",48.92696,-55.65966,2018-03-23 07:00:00,35,4,39
"19478",10501,"Grand Falls-Windsor","NL",48.92696,-55.65966,2018-03-23 08:00:00,35,3,38
"19479",10501,"Grand Falls-Windsor","NL",48.92696,-55.65966,2018-03-23 09:00:00,37,2,39
"19480",10501,"Grand Falls-Windsor","NL",48.92696,-55.65966,2018-03-23 10:00:00,36,3,39
"19481",10501,"Grand Falls-Windsor","NL",48.92696,-55.65966,2018-03-23 11:00:00,36,2,38
"19482",10501,"Grand Falls-Windsor","NL",48.92696,-55.65966,2018-03-23 12:00:00,36,3,39
"19483",10501,"Grand Falls-Windsor","NL",48.92696,-55.65966,2018-03-23 13:00:00,36,1,37
"19484",10501,"Grand Falls-Windsor","NL",48.92696,-55.65966,2018-03-23 14:00:00,36,2,38
"19485",10501,"Grand Falls-Windsor","NL",48.92696,-55.65966,2018-03-23 15:00:00,35,4,39
"19486",10501,"Grand Falls-Windsor","NL",48.92696,-55.65966,2018-03-23 16:00:00,36,2,38
"19487",10501,"Grand Falls-Windsor","NL",48.92696,-55.65966,2018-03-23 17:00:00,39,1,40
"19488",10501,"Grand Falls-Windsor","NL",48.92696,-55.65966,2018-03-23 18:00:00,40,1,41
"19489",10501,"Grand Falls-Windsor","NL",48.92696,-55.65966,2018-03-23 19:00:00,41,1,42
"19490",10501,"Grand Falls-Windsor","NL",48.92696,-55.65966,2018-03-23 20:00:00,41,1,42
"19491",10501,"Grand Falls-Windsor","NL",48.92696,-55.65966,2018-03-23 21:00:00,41,1,42
"19492",10501,"Grand Falls-Windsor","NL",48.92696,-55.65966,2018-03-23 22:00:00,42,1,43
"19493",10501,"Grand Falls-Windsor","NL",48.92696,-55.65966,2018-03-23 23:00:00,43,1,44
"19494",10501,"Grand Falls-Windsor","NL",48.92696,-55.65966,2018-03-24 00:00:00,40,3,43
"19495",10501,"Grand Falls-Windsor","NL",48.92696,-55.65966,2018-03-24 01:00:00,42,1,43
"19496",10501,"Grand Falls-Windsor","NL",48.92696,-55.65966,2018-03-24 02:00:00,41,3,44
"19497",10501,"Grand Falls-Windsor","NL",48.92696,-55.65966,2018-03-24 03:00:00,41,0,41
"19498",10501,"Grand Falls-Windsor","NL",48.92696,-55.65966,2018-03-24 04:00:00,41,1,42
"19499",10501,"Grand Falls-Windsor","NL",48.92696,-55.65966,2018-03-24 05:00:00,40,1,41
"19500",10501,"Grand Falls-Windsor","NL",48.92696,-55.65966,2018-03-24 06:00:00,40,1,41
"19501",10501,"Grand Falls-Windsor","NL",48.92696,-55.65966,2018-03-24 07:00:00,40,1,41
"19502",10501,"Grand Falls-Windsor","NL",48.92696,-55.65966,2018-03-24 08:00:00,40,1,41
"19503",10501,"Grand Falls-Windsor","NL",48.92696,-55.65966,2018-03-24 09:00:00,40,1,41
"19504",10501,"Grand Falls-Windsor","NL",48.92696,-55.65966,2018-03-24 10:00:00,42,1,43
"19505",10501,"Grand Falls-Windsor","NL",48.92696,-55.65966,2018-03-24 11:00:00,42,1,43
"19506",10501,"Grand Falls-Windsor","NL",48.92696,-55.65966,2018-03-24 12:00:00,42,1,43
"19507",10501,"Grand Falls-Windsor","NL",48.92696,-55.65966,2018-03-24 13:00:00,42,1,43
"19508",10501,"Grand Falls-Windsor","NL",48.92696,-55.65966,2018-03-24 14:00:00,42,1,43
"19509",10501,"Grand Falls-Windsor","NL",48.92696,-55.65966,2018-03-24 15:00:00,42,1,43
"19510",10501,"Grand Falls-Windsor","NL",48.92696,-55.65966,2018-03-24 16:00:00,42,1,43
"19511",10501,"Grand Falls-Windsor","NL",48.92696,-55.65966,2018-03-24 17:00:00,43,1,44
"19512",10501,"Grand Falls-Windsor","NL",48.92696,-55.65966,2018-03-24 18:00:00,42,1,43
"19513",10501,"Grand Falls-Windsor","NL",48.92696,-55.65966,2018-03-24 19:00:00,42,1,43
"19514",10501,"Grand Falls-Windsor","NL",48.92696,-55.65966,2018-03-24 20:00:00,41,1,42
"19515",10501,"Grand Falls-Windsor","NL",48.92696,-55.65966,2018-03-24 21:00:00,41,1,42
"19516",10501,"Grand Falls-Windsor","NL",48.92696,-55.65966,2018-03-24 22:00:00,40,1,41
"19517",10501,"Grand Falls-Windsor","NL",48.92696,-55.65966,2018-03-24 23:00:00,40,1,41
"19518",10501,"Grand Falls-Windsor","NL",48.92696,-55.65966,2018-03-25 00:00:00,40,1,41
"19519",10501,"Grand Falls-Windsor","NL",48.92696,-55.65966,2018-03-25 01:00:00,40,1,41
"19520",10501,"Grand Falls-Windsor","NL",48.92696,-55.65966,2018-03-25 02:00:00,40,1,41
"19521",10501,"Grand Falls-Windsor","NL",48.92696,-55.65966,2018-03-25 03:00:00,40,1,41
"19522",10501,"Grand Falls-Windsor","NL",48.92696,-55.65966,2018-03-25 04:00:00,41,1,42
"19523",10501,"Grand Falls-Windsor","NL",48.92696,-55.65966,2018-03-25 05:00:00,42,1,43
"19524",10501,"Grand Falls-Windsor","NL",48.92696,-55.65966,2018-03-25 06:00:00,42,1,43
"19525",10501,"Grand Falls-Windsor","NL",48.92696,-55.65966,2018-03-25 07:00:00,41,1,42
"19526",10501,"Grand Falls-Windsor","NL",48.92696,-55.65966,2018-03-25 08:00:00,42,1,43
"19527",10501,"Grand Falls-Windsor","NL",48.92696,-55.65966,2018-03-25 09:00:00,42,1,43
"19528",10501,"Grand Falls-Windsor","NL",48.92696,-55.65966,2018-03-25 10:00:00,41,1,42
"19529",10501,"Grand Falls-Windsor","NL",48.92696,-55.65966,2018-03-25 11:00:00,40,1,41
"19530",10501,"Grand Falls-Windsor","NL",48.92696,-55.65966,2018-03-25 12:00:00,40,1,41
"19531",10501,"Grand Falls-Windsor","NL",48.92696,-55.65966,2018-03-25 13:00:00,40,1,41
"19532",10501,"Grand Falls-Windsor","NL",48.92696,-55.65966,2018-03-25 14:00:00,40,1,41
"19533",10501,"Grand Falls-Windsor","NL",48.92696,-55.65966,2018-03-25 15:00:00,41,1,42
"19534",10501,"Grand Falls-Windsor","NL",48.92696,-55.65966,2018-03-25 16:00:00,41,1,42
"19535",10501,"Grand Falls-Windsor","NL",48.92696,-55.65966,2018-03-25 17:00:00,41,1,42
"19536",10501,"Grand Falls-Windsor","NL",48.92696,-55.65966,2018-03-25 18:00:00,41,1,42
"19537",10501,"Grand Falls-Windsor","NL",48.92696,-55.65966,2018-03-25 19:00:00,41,1,42
"19538",10501,"Grand Falls-Windsor","NL",48.92696,-55.65966,2018-03-25 20:00:00,39,2,41
"19539",10501,"Grand Falls-Windsor","NL",48.92696,-55.65966,2018-03-25 21:00:00,38,2,40
"19540",10501,"Grand Falls-Windsor","NL",48.92696,-55.65966,2018-03-25 22:00:00,38,2,40
"19541",10501,"Grand Falls-Windsor","NL",48.92696,-55.65966,2018-03-25 23:00:00,38,2,40
"19542",10501,"Grand Falls-Windsor","NL",48.92696,-55.65966,2018-03-26 00:00:00,37,2,39
"19543",10501,"Grand Falls-Windsor","NL",48.92696,-55.65966,2018-03-26 01:00:00,35,1,36
"19544",10501,"Grand Falls-Windsor","NL",48.92696,-55.65966,2018-03-26 02:00:00,35,1,36
"19545",10501,"Grand Falls-Windsor","NL",48.92696,-55.65966,2018-03-26 03:00:00,30,11,41
"19546",10501,"Grand Falls-Windsor","NL",48.92696,-55.65966,2018-03-26 04:00:00,36,1,37
"19547",10501,"Grand Falls-Windsor","NL",48.92696,-55.65966,2018-03-26 05:00:00,36,0,36
"19548",10501,"Grand Falls-Windsor","NL",48.92696,-55.65966,2018-03-26 06:00:00,35,0,35
"19549",10501,"Grand Falls-Windsor","NL",48.92696,-55.65966,2018-03-26 07:00:00,34,0,34
"19550",10501,"Grand Falls-Windsor","NL",48.92696,-55.65966,2018-03-26 08:00:00,37,1,38
"19551",10501,"Grand Falls-Windsor","NL",48.92696,-55.65966,2018-03-26 09:00:00,38,1,39
"19552",10501,"Grand Falls-Windsor","NL",48.92696,-55.65966,2018-03-26 10:00:00,38,1,39
"19553",10501,"Grand Falls-Windsor","NL",48.92696,-55.65966,2018-03-26 11:00:00,39,0,39
"19554",10501,"Grand Falls-Windsor","NL",48.92696,-55.65966,2018-03-26 12:00:00,41,1,42
"19555",10501,"Grand Falls-Windsor","NL",48.92696,-55.65966,2018-03-26 13:00:00,42,0,42
"19556",10501,"Grand Falls-Windsor","NL",48.92696,-55.65966,2018-03-26 14:00:00,44,1,45
"19557",10501,"Grand Falls-Windsor","NL",48.92696,-55.65966,2018-03-26 15:00:00,45,1,46
"19558",10501,"Grand Falls-Windsor","NL",48.92696,-55.65966,2018-03-26 16:00:00,45,1,46
"19559",10501,"Grand Falls-Windsor","NL",48.92696,-55.65966,2018-03-26 17:00:00,46,0,46
"19560",10501,"Grand Falls-Windsor","NL",48.92696,-55.65966,2018-03-26 18:00:00,45,0,45
"19561",10501,"Grand Falls-Windsor","NL",48.92696,-55.65966,2018-03-26 19:00:00,43,1,44
"19562",10501,"Grand Falls-Windsor","NL",48.92696,-55.65966,2018-03-26 20:00:00,41,1,42
"19563",10501,"Grand Falls-Windsor","NL",48.92696,-55.65966,2018-03-26 21:00:00,40,1,41
"19564",10501,"Grand Falls-Windsor","NL",48.92696,-55.65966,2018-03-26 22:00:00,40,1,41
"19565",10501,"Grand Falls-Windsor","NL",48.92696,-55.65966,2018-03-26 23:00:00,38,1,39
"19566",10501,"Grand Falls-Windsor","NL",48.92696,-55.65966,2018-03-27 00:00:00,38,0,38
"19567",10501,"Grand Falls-Windsor","NL",48.92696,-55.65966,2018-03-27 01:00:00,39,1,40
"19568",10501,"Grand Falls-Windsor","NL",48.92696,-55.65966,2018-03-27 02:00:00,39,0,39
"19569",10501,"Grand Falls-Windsor","NL",48.92696,-55.65966,2018-03-27 03:00:00,38,2,40
"19570",10501,"Grand Falls-Windsor","NL",48.92696,-55.65966,2018-03-27 04:00:00,38,1,39
"19571",10501,"Grand Falls-Windsor","NL",48.92696,-55.65966,2018-03-27 05:00:00,38,1,39
"19572",10501,"Grand Falls-Windsor","NL",48.92696,-55.65966,2018-03-27 06:00:00,37,3,40
"19573",10501,"Grand Falls-Windsor","NL",48.92696,-55.65966,2018-03-27 07:00:00,37,1,38
"19574",10501,"Grand Falls-Windsor","NL",48.92696,-55.65966,2018-03-27 08:00:00,37,1,38
"19575",10501,"Grand Falls-Windsor","NL",48.92696,-55.65966,2018-03-27 09:00:00,38,1,39
"19576",10501,"Grand Falls-Windsor","NL",48.92696,-55.65966,2018-03-27 10:00:00,41,0,41
"19577",10501,"Grand Falls-Windsor","NL",48.92696,-55.65966,2018-03-27 11:00:00,42,0,42
"19578",10501,"Grand Falls-Windsor","NL",48.92696,-55.65966,2018-03-27 12:00:00,43,1,44
"19579",10501,"Grand Falls-Windsor","NL",48.92696,-55.65966,2018-03-27 13:00:00,44,1,45
"19580",10501,"Grand Falls-Windsor","NL",48.92696,-55.65966,2018-03-27 14:00:00,45,1,46
"19581",10501,"Grand Falls-Windsor","NL",48.92696,-55.65966,2018-03-27 15:00:00,45,1,46
"19582",10501,"Grand Falls-Windsor","NL",48.92696,-55.65966,2018-03-27 16:00:00,45,1,46
"19583",10501,"Grand Falls-Windsor","NL",48.92696,-55.65966,2018-03-27 17:00:00,44,0,44
"19584",10501,"Grand Falls-Windsor","NL",48.92696,-55.65966,2018-03-27 18:00:00,46,0,46
"19585",10501,"Grand Falls-Windsor","NL",48.92696,-55.65966,2018-03-27 19:00:00,45,1,46
"19586",10501,"Grand Falls-Windsor","NL",48.92696,-55.65966,2018-03-27 20:00:00,33,4,37
"19587",10501,"Grand Falls-Windsor","NL",48.92696,-55.65966,2018-03-27 21:00:00,29,4,33
"19588",10501,"Grand Falls-Windsor","NL",48.92696,-55.65966,2018-03-27 22:00:00,30,3,33
"19589",10501,"Grand Falls-Windsor","NL",48.92696,-55.65966,2018-03-27 23:00:00,30,4,34
"19590",10501,"Grand Falls-Windsor","NL",48.92696,-55.65966,2018-03-28 00:00:00,32,1,33
"19591",10501,"Grand Falls-Windsor","NL",48.92696,-55.65966,2018-03-28 01:00:00,28,3,31
"19592",10501,"Grand Falls-Windsor","NL",48.92696,-55.65966,2018-03-28 02:00:00,26,2,28
"19593",10501,"Grand Falls-Windsor","NL",48.92696,-55.65966,2018-03-28 03:00:00,24,3,27
"19594",10501,"Grand Falls-Windsor","NL",48.92696,-55.65966,2018-03-28 04:00:00,24,2,26
"19595",10501,"Grand Falls-Windsor","NL",48.92696,-55.65966,2018-03-28 05:00:00,24,1,25
"19596",10501,"Grand Falls-Windsor","NL",48.92696,-55.65966,2018-03-28 06:00:00,22,3,25
"19597",10501,"Grand Falls-Windsor","NL",48.92696,-55.65966,2018-03-28 07:00:00,22,3,25
"19598",10501,"Grand Falls-Windsor","NL",48.92696,-55.65966,2018-03-28 08:00:00,21,4,25
"19599",10501,"Grand Falls-Windsor","NL",48.92696,-55.65966,2018-03-28 09:00:00,23,3,26
"19600",10501,"Grand Falls-Windsor","NL",48.92696,-55.65966,2018-03-28 10:00:00,28,3,31
"19601",10501,"Grand Falls-Windsor","NL",48.92696,-55.65966,2018-03-28 11:00:00,33,2,35
"19602",10501,"Grand Falls-Windsor","NL",48.92696,-55.65966,2018-03-28 12:00:00,41,2,43
"19603",10501,"Grand Falls-Windsor","NL",48.92696,-55.65966,2018-03-28 13:00:00,42,2,44
"19604",10501,"Grand Falls-Windsor","NL",48.92696,-55.65966,2018-03-28 14:00:00,43,1,44
"19605",10501,"Grand Falls-Windsor","NL",48.92696,-55.65966,2018-03-28 15:00:00,40,3,43
"19606",10501,"Grand Falls-Windsor","NL",48.92696,-55.65966,2018-03-28 16:00:00,40,3,43
"19607",10501,"Grand Falls-Windsor","NL",48.92696,-55.65966,2018-03-28 17:00:00,39,3,42
"19608",10501,"Grand Falls-Windsor","NL",48.92696,-55.65966,2018-03-28 18:00:00,39,4,43
"19609",10501,"Grand Falls-Windsor","NL",48.92696,-55.65966,2018-03-28 19:00:00,39,2,41
"19610",10501,"Grand Falls-Windsor","NL",48.92696,-55.65966,2018-03-28 20:00:00,38,3,41
"19611",10501,"Grand Falls-Windsor","NL",48.92696,-55.65966,2018-03-28 21:00:00,37,2,39
"19612",10501,"Grand Falls-Windsor","NL",48.92696,-55.65966,2018-03-28 22:00:00,36,2,38
"19613",10501,"Grand Falls-Windsor","NL",48.92696,-55.65966,2018-03-28 23:00:00,35,2,37
"19614",10501,"Grand Falls-Windsor","NL",48.92696,-55.65966,2018-03-29 00:00:00,37,1,38
"19615",10501,"Grand Falls-Windsor","NL",48.92696,-55.65966,2018-03-29 01:00:00,35,2,37
"19616",10501,"Grand Falls-Windsor","NL",48.92696,-55.65966,2018-03-29 02:00:00,35,1,36
"19617",10501,"Grand Falls-Windsor","NL",48.92696,-55.65966,2018-03-29 03:00:00,35,1,36
"19618",10501,"Grand Falls-Windsor","NL",48.92696,-55.65966,2018-03-29 04:00:00,35,1,36
"19619",10501,"Grand Falls-Windsor","NL",48.92696,-55.65966,2018-03-29 05:00:00,34,1,35
"19620",10501,"Grand Falls-Windsor","NL",48.92696,-55.65966,2018-03-29 06:00:00,35,1,36
"19621",10501,"Grand Falls-Windsor","NL",48.92696,-55.65966,2018-03-29 07:00:00,36,2,38
"19622",10501,"Grand Falls-Windsor","NL",48.92696,-55.65966,2018-03-29 08:00:00,37,3,40
"19623",10501,"Grand Falls-Windsor","NL",48.92696,-55.65966,2018-03-29 09:00:00,39,2,41
"19624",10501,"Grand Falls-Windsor","NL",48.92696,-55.65966,2018-03-29 10:00:00,39,2,41
"19625",10501,"Grand Falls-Windsor","NL",48.92696,-55.65966,2018-03-29 11:00:00,40,2,42
"19626",10501,"Grand Falls-Windsor","NL",48.92696,-55.65966,2018-03-29 12:00:00,40,2,42
"19627",10501,"Grand Falls-Windsor","NL",48.92696,-55.65966,2018-03-29 13:00:00,41,2,43
"19628",10501,"Grand Falls-Windsor","NL",48.92696,-55.65966,2018-03-29 14:00:00,41,1,42
"19629",10501,"Grand Falls-Windsor","NL",48.92696,-55.65966,2018-03-29 15:00:00,41,2,43
"19630",10501,"Grand Falls-Windsor","NL",48.92696,-55.65966,2018-03-29 16:00:00,41,1,42
"19631",10501,"Grand Falls-Windsor","NL",48.92696,-55.65966,2018-03-29 17:00:00,42,1,43
"19632",10501,"Grand Falls-Windsor","NL",48.92696,-55.65966,2018-03-29 18:00:00,42,1,43
"19633",10501,"Grand Falls-Windsor","NL",48.92696,-55.65966,2018-03-29 19:00:00,41,1,42
"19634",10501,"Grand Falls-Windsor","NL",48.92696,-55.65966,2018-03-29 20:00:00,41,1,42
"19635",10501,"Grand Falls-Windsor","NL",48.92696,-55.65966,2018-03-29 21:00:00,41,1,42
"19636",10501,"Grand Falls-Windsor","NL",48.92696,-55.65966,2018-03-29 22:00:00,42,1,43
"19637",10501,"Grand Falls-Windsor","NL",48.92696,-55.65966,2018-03-29 23:00:00,42,1,43
"19638",10501,"Grand Falls-Windsor","NL",48.92696,-55.65966,2018-03-30 00:00:00,41,1,42
"19639",10501,"Grand Falls-Windsor","NL",48.92696,-55.65966,2018-03-30 01:00:00,41,0,41
"19640",10501,"Grand Falls-Windsor","NL",48.92696,-55.65966,2018-03-30 02:00:00,42,0,42
"19641",10501,"Grand Falls-Windsor","NL",48.92696,-55.65966,2018-03-30 03:00:00,40,0,40
"19642",10501,"Grand Falls-Windsor","NL",48.92696,-55.65966,2018-03-30 04:00:00,41,0,41
"19643",10501,"Grand Falls-Windsor","NL",48.92696,-55.65966,2018-03-30 05:00:00,40,0,40
"19644",10501,"Grand Falls-Windsor","NL",48.92696,-55.65966,2018-03-30 06:00:00,39,4,43
"19645",10501,"Grand Falls-Windsor","NL",48.92696,-55.65966,2018-03-30 07:00:00,38,0,38
"19646",10501,"Grand Falls-Windsor","NL",48.92696,-55.65966,2018-03-30 08:00:00,39,0,39
"19647",10501,"Grand Falls-Windsor","NL",48.92696,-55.65966,2018-03-30 09:00:00,41,1,42
"19648",10501,"Grand Falls-Windsor","NL",48.92696,-55.65966,2018-03-30 10:00:00,44,1,45
"19649",10501,"Grand Falls-Windsor","NL",48.92696,-55.65966,2018-03-30 11:00:00,44,1,45
"19650",10501,"Grand Falls-Windsor","NL",48.92696,-55.65966,2018-03-30 12:00:00,45,1,46
"19651",10501,"Grand Falls-Windsor","NL",48.92696,-55.65966,2018-03-30 13:00:00,46,1,47
"19652",10501,"Grand Falls-Windsor","NL",48.92696,-55.65966,2018-03-30 14:00:00,45,1,46
"19653",10501,"Grand Falls-Windsor","NL",48.92696,-55.65966,2018-03-30 15:00:00,45,0,45
"19654",10501,"Grand Falls-Windsor","NL",48.92696,-55.65966,2018-03-30 16:00:00,45,0,45
"19655",10501,"Grand Falls-Windsor","NL",48.92696,-55.65966,2018-03-30 17:00:00,44,1,45
"19656",10501,"Grand Falls-Windsor","NL",48.92696,-55.65966,2018-03-30 18:00:00,43,1,44
"19657",10501,"Grand Falls-Windsor","NL",48.92696,-55.65966,2018-03-30 19:00:00,39,2,41
"19658",10501,"Grand Falls-Windsor","NL",48.92696,-55.65966,2018-03-30 20:00:00,37,1,38
"19659",10501,"Grand Falls-Windsor","NL",48.92696,-55.65966,2018-03-30 21:00:00,35,0,35
"19660",10501,"Grand Falls-Windsor","NL",48.92696,-55.65966,2018-03-30 22:00:00,35,1,36
"19661",10501,"Grand Falls-Windsor","NL",48.92696,-55.65966,2018-03-30 23:00:00,36,0,36
"19662",10501,"Grand Falls-Windsor","NL",48.92696,-55.65966,2018-03-31 00:00:00,37,0,37
"19663",10501,"Grand Falls-Windsor","NL",48.92696,-55.65966,2018-03-31 01:00:00,36,0,36
"19664",10501,"Grand Falls-Windsor","NL",48.92696,-55.65966,2018-03-31 02:00:00,35,0,35
"19665",10501,"Grand Falls-Windsor","NL",48.92696,-55.65966,2018-03-31 03:00:00,35,0,35
"19666",10501,"Grand Falls-Windsor","NL",48.92696,-55.65966,2018-03-31 04:00:00,35,0,35
"19667",10501,"Grand Falls-Windsor","NL",48.92696,-55.65966,2018-03-31 05:00:00,34,0,34
"19668",10501,"Grand Falls-Windsor","NL",48.92696,-55.65966,2018-03-31 06:00:00,33,0,33
"19669",10501,"Grand Falls-Windsor","NL",48.92696,-55.65966,2018-03-31 07:00:00,31,1,32
"19670",10501,"Grand Falls-Windsor","NL",48.92696,-55.65966,2018-03-31 08:00:00,31,0,31
"19671",10501,"Grand Falls-Windsor","NL",48.92696,-55.65966,2018-03-31 09:00:00,33,0,33
"19672",10501,"Grand Falls-Windsor","NL",48.92696,-55.65966,2018-03-31 10:00:00,32,0,32
"19673",10501,"Grand Falls-Windsor","NL",48.92696,-55.65966,2018-03-31 11:00:00,32,0,32
"19674",10501,"Grand Falls-Windsor","NL",48.92696,-55.65966,2018-03-31 12:00:00,31,1,32
"19675",10501,"Grand Falls-Windsor","NL",48.92696,-55.65966,2018-03-31 13:00:00,30,1,31
"19676",10501,"Grand Falls-Windsor","NL",48.92696,-55.65966,2018-03-31 14:00:00,30,1,31
"19677",10501,"Grand Falls-Windsor","NL",48.92696,-55.65966,2018-03-31 15:00:00,34,0,34
"19678",10501,"Grand Falls-Windsor","NL",48.92696,-55.65966,2018-03-31 16:00:00,39,0,39
"19679",10501,"Grand Falls-Windsor","NL",48.92696,-55.65966,2018-03-31 17:00:00,39,0,39
"19680",10501,"Grand Falls-Windsor","NL",48.92696,-55.65966,2018-03-31 18:00:00,38,0,38
"19681",10501,"Grand Falls-Windsor","NL",48.92696,-55.65966,2018-03-31 19:00:00,38,0,38
"19682",10501,"Grand Falls-Windsor","NL",48.92696,-55.65966,2018-03-31 20:00:00,36,0,36
"19683",10501,"Grand Falls-Windsor","NL",48.92696,-55.65966,2018-03-31 21:00:00,36,0,36
"19684",10501,"Grand Falls-Windsor","NL",48.92696,-55.65966,2018-03-31 22:00:00,39,0,39
"19685",10501,"Grand Falls-Windsor","NL",48.92696,-55.65966,2018-03-31 23:00:00,41,0,41
"19686",10501,"Grand Falls-Windsor","NL",48.92696,-55.65966,2018-04-01 00:00:00,42,0,42
"19687",10501,"Grand Falls-Windsor","NL",48.92696,-55.65966,2018-04-01 01:00:00,42,0,42
"19688",10501,"Grand Falls-Windsor","NL",48.92696,-55.65966,2018-04-01 02:00:00,42,0,42
"19689",10501,"Grand Falls-Windsor","NL",48.92696,-55.65966,2018-04-01 03:00:00,43,0,43
"19690",10501,"Grand Falls-Windsor","NL",48.92696,-55.65966,2018-04-01 04:00:00,43,0,43
"19691",10501,"Grand Falls-Windsor","NL",48.92696,-55.65966,2018-04-01 05:00:00,42,0,42
"19692",10501,"Grand Falls-Windsor","NL",48.92696,-55.65966,2018-04-01 06:00:00,42,0,42
"19693",10501,"Grand Falls-Windsor","NL",48.92696,-55.65966,2018-04-01 07:00:00,41,2,43
"19694",10501,"Grand Falls-Windsor","NL",48.92696,-55.65966,2018-04-01 08:00:00,41,0,41
"19695",10501,"Grand Falls-Windsor","NL",48.92696,-55.65966,2018-04-01 09:00:00,41,0,41
"19696",10501,"Grand Falls-Windsor","NL",48.92696,-55.65966,2018-04-01 10:00:00,42,0,42
"19697",10501,"Grand Falls-Windsor","NL",48.92696,-55.65966,2018-04-01 11:00:00,41,0,41
"19698",10501,"Grand Falls-Windsor","NL",48.92696,-55.65966,2018-04-01 12:00:00,41,0,41
"19699",10501,"Grand Falls-Windsor","NL",48.92696,-55.65966,2018-04-01 13:00:00,42,0,42
"19700",10501,"Grand Falls-Windsor","NL",48.92696,-55.65966,2018-04-01 14:00:00,43,0,43
"19701",10501,"Grand Falls-Windsor","NL",48.92696,-55.65966,2018-04-01 15:00:00,44,0,44
"19702",10501,"Grand Falls-Windsor","NL",48.92696,-55.65966,2018-04-01 16:00:00,43,0,43
"19703",10501,"Grand Falls-Windsor","NL",48.92696,-55.65966,2018-04-01 17:00:00,44,0,44
"19704",10501,"Grand Falls-Windsor","NL",48.92696,-55.65966,2018-04-01 18:00:00,44,0,44
"19705",10501,"Grand Falls-Windsor","NL",48.92696,-55.65966,2018-04-01 19:00:00,44,0,44
"19706",10501,"Grand Falls-Windsor","NL",48.92696,-55.65966,2018-04-01 20:00:00,44,0,44
"19707",10501,"Grand Falls-Windsor","NL",48.92696,-55.65966,2018-04-01 21:00:00,43,0,43
"19708",10501,"Grand Falls-Windsor","NL",48.92696,-55.65966,2018-04-01 22:00:00,43,0,43
"19709",10501,"Grand Falls-Windsor","NL",48.92696,-55.65966,2018-04-01 23:00:00,42,0,42
"19710",10501,"Grand Falls-Windsor","NL",48.92696,-55.65966,2018-04-02 00:00:00,42,0,42
"19711",10501,"Grand Falls-Windsor","NL",48.92696,-55.65966,2018-04-02 01:00:00,41,0,41
"19712",10501,"Grand Falls-Windsor","NL",48.92696,-55.65966,2018-04-02 02:00:00,40,0,40
"19713",10501,"Grand Falls-Windsor","NL",48.92696,-55.65966,2018-04-02 03:00:00,39,0,39
"19714",10501,"Grand Falls-Windsor","NL",48.92696,-55.65966,2018-04-02 04:00:00,38,0,38
"19715",10501,"Grand Falls-Windsor","NL",48.92696,-55.65966,2018-04-02 05:00:00,38,0,38
"19716",10501,"Grand Falls-Windsor","NL",48.92696,-55.65966,2018-04-02 06:00:00,38,0,38
"19717",10501,"Grand Falls-Windsor","NL",48.92696,-55.65966,2018-04-02 07:00:00,38,0,38
"19718",10501,"Grand Falls-Windsor","NL",48.92696,-55.65966,2018-04-02 08:00:00,38,0,38
"19719",10501,"Grand Falls-Windsor","NL",48.92696,-55.65966,2018-04-02 09:00:00,38,0,38
"19720",10501,"Grand Falls-Windsor","NL",48.92696,-55.65966,2018-04-02 10:00:00,39,1,40
"19721",10501,"Grand Falls-Windsor","NL",48.92696,-55.65966,2018-04-02 11:00:00,39,0,39
"19722",10501,"Grand Falls-Windsor","NL",48.92696,-55.65966,2018-04-02 12:00:00,39,0,39
"19723",10501,"Grand Falls-Windsor","NL",48.92696,-55.65966,2018-04-02 13:00:00,39,0,39
"19724",10501,"Grand Falls-Windsor","NL",48.92696,-55.65966,2018-04-02 14:00:00,39,0,39
"19725",10501,"Grand Falls-Windsor","NL",48.92696,-55.65966,2018-04-02 15:00:00,39,1,40
"19726",10501,"Grand Falls-Windsor","NL",48.92696,-55.65966,2018-04-02 16:00:00,39,1,40
"19727",10501,"Grand Falls-Windsor","NL",48.92696,-55.65966,2018-04-02 17:00:00,39,1,40
"19728",10501,"Grand Falls-Windsor","NL",48.92696,-55.65966,2018-04-02 18:00:00,39,0,39
"19729",10501,"Grand Falls-Windsor","NL",48.92696,-55.65966,2018-04-02 19:00:00,39,0,39
"19730",10501,"Grand Falls-Windsor","NL",48.92696,-55.65966,2018-04-02 20:00:00,39,0,39
"19731",10501,"Grand Falls-Windsor","NL",48.92696,-55.65966,2018-04-02 21:00:00,39,0,39
"19732",10501,"Grand Falls-Windsor","NL",48.92696,-55.65966,2018-04-02 22:00:00,39,0,39
"19733",10501,"Grand Falls-Windsor","NL",48.92696,-55.65966,2018-04-02 23:00:00,39,0,39
"19734",10501,"Grand Falls-Windsor","NL",48.92696,-55.65966,2018-04-03 00:00:00,39,0,39
"19735",10501,"Grand Falls-Windsor","NL",48.92696,-55.65966,2018-04-03 01:00:00,39,0,39
"19736",10501,"Grand Falls-Windsor","NL",48.92696,-55.65966,2018-04-03 02:00:00,39,0,39
"19737",10501,"Grand Falls-Windsor","NL",48.92696,-55.65966,2018-04-03 03:00:00,38,0,38
"19738",10501,"Grand Falls-Windsor","NL",48.92696,-55.65966,2018-04-03 04:00:00,38,0,38
"19739",10501,"Grand Falls-Windsor","NL",48.92696,-55.65966,2018-04-03 05:00:00,37,0,37
"19740",10501,"Grand Falls-Windsor","NL",48.92696,-55.65966,2018-04-03 06:00:00,37,0,37
"19741",10501,"Grand Falls-Windsor","NL",48.92696,-55.65966,2018-04-03 07:00:00,37,0,37
"19742",10501,"Grand Falls-Windsor","NL",48.92696,-55.65966,2018-04-03 08:00:00,37,0,37
"19743",10501,"Grand Falls-Windsor","NL",48.92696,-55.65966,2018-04-03 09:00:00,37,0,37
"19744",10501,"Grand Falls-Windsor","NL",48.92696,-55.65966,2018-04-03 10:00:00,38,0,38
"19745",10501,"Grand Falls-Windsor","NL",48.92696,-55.65966,2018-04-03 11:00:00,39,0,39
"19746",10501,"Grand Falls-Windsor","NL",48.92696,-55.65966,2018-04-03 12:00:00,39,0,39
"19747",10501,"Grand Falls-Windsor","NL",48.92696,-55.65966,2018-04-03 13:00:00,40,0,40
"19748",10501,"Grand Falls-Windsor","NL",48.92696,-55.65966,2018-04-03 14:00:00,41,0,41
"19749",10501,"Grand Falls-Windsor","NL",48.92696,-55.65966,2018-04-03 15:00:00,NA,1,NA
"19750",10501,"Grand Falls-Windsor","NL",48.92696,-55.65966,2018-04-03 16:00:00,NA,0,NA
"19751",10501,"Grand Falls-Windsor","NL",48.92696,-55.65966,2018-04-03 17:00:00,NA,0,NA
"19752",10501,"Grand Falls-Windsor","NL",48.92696,-55.65966,2018-04-03 18:00:00,40,0,40
"19753",10501,"Grand Falls-Windsor","NL",48.92696,-55.65966,2018-04-03 19:00:00,38,0,38
"19754",10501,"Grand Falls-Windsor","NL",48.92696,-55.65966,2018-04-03 20:00:00,37,0,37
"19755",10501,"Grand Falls-Windsor","NL",48.92696,-55.65966,2018-04-03 21:00:00,36,1,37
"19756",10501,"Grand Falls-Windsor","NL",48.92696,-55.65966,2018-04-03 22:00:00,36,0,36
"19757",10501,"Grand Falls-Windsor","NL",48.92696,-55.65966,2018-04-03 23:00:00,35,0,35
"19758",10501,"Grand Falls-Windsor","NL",48.92696,-55.65966,2018-04-04 00:00:00,36,0,36
"19759",10501,"Grand Falls-Windsor","NL",48.92696,-55.65966,2018-04-04 01:00:00,36,0,36
"19760",10501,"Grand Falls-Windsor","NL",48.92696,-55.65966,2018-04-04 02:00:00,35,1,36
"19761",10501,"Grand Falls-Windsor","NL",48.92696,-55.65966,2018-04-04 03:00:00,35,0,35
"19762",10501,"Grand Falls-Windsor","NL",48.92696,-55.65966,2018-04-04 04:00:00,34,0,34
"19763",10501,"Grand Falls-Windsor","NL",48.92696,-55.65966,2018-04-04 05:00:00,34,0,34
"19764",10501,"Grand Falls-Windsor","NL",48.92696,-55.65966,2018-04-04 06:00:00,34,0,34
"19765",10501,"Grand Falls-Windsor","NL",48.92696,-55.65966,2018-04-04 07:00:00,34,0,34
"19766",10501,"Grand Falls-Windsor","NL",48.92696,-55.65966,2018-04-04 08:00:00,34,0,34
"19767",10501,"Grand Falls-Windsor","NL",48.92696,-55.65966,2018-04-04 09:00:00,34,0,34
"19768",10501,"Grand Falls-Windsor","NL",48.92696,-55.65966,2018-04-04 10:00:00,38,0,38
"19769",10501,"Grand Falls-Windsor","NL",48.92696,-55.65966,2018-04-04 11:00:00,38,0,38
"19770",10501,"Grand Falls-Windsor","NL",48.92696,-55.65966,2018-04-04 12:00:00,38,0,38
"19771",10501,"Grand Falls-Windsor","NL",48.92696,-55.65966,2018-04-04 13:00:00,39,0,39
"19772",10501,"Grand Falls-Windsor","NL",48.92696,-55.65966,2018-04-04 14:00:00,39,0,39
"19773",10501,"Grand Falls-Windsor","NL",48.92696,-55.65966,2018-04-04 15:00:00,39,0,39
"19774",10501,"Grand Falls-Windsor","NL",48.92696,-55.65966,2018-04-04 16:00:00,39,0,39
"19775",10501,"Grand Falls-Windsor","NL",48.92696,-55.65966,2018-04-04 17:00:00,38,0,38
"19776",10501,"Grand Falls-Windsor","NL",48.92696,-55.65966,2018-04-04 18:00:00,38,0,38
"19777",10501,"Grand Falls-Windsor","NL",48.92696,-55.65966,2018-04-04 19:00:00,36,0,36
"19778",10501,"Grand Falls-Windsor","NL",48.92696,-55.65966,2018-04-04 20:00:00,39,0,39
"19779",10501,"Grand Falls-Windsor","NL",48.92696,-55.65966,2018-04-04 21:00:00,42,0,42
"19780",10501,"Grand Falls-Windsor","NL",48.92696,-55.65966,2018-04-04 22:00:00,41,1,42
"19781",10501,"Grand Falls-Windsor","NL",48.92696,-55.65966,2018-04-04 23:00:00,40,1,41
"19782",10501,"Grand Falls-Windsor","NL",48.92696,-55.65966,2018-04-05 00:00:00,40,1,41
"19783",10501,"Grand Falls-Windsor","NL",48.92696,-55.65966,2018-04-05 01:00:00,40,0,40
"19784",10501,"Grand Falls-Windsor","NL",48.92696,-55.65966,2018-04-05 02:00:00,40,0,40
"19785",10501,"Grand Falls-Windsor","NL",48.92696,-55.65966,2018-04-05 03:00:00,39,0,39
"19786",10501,"Grand Falls-Windsor","NL",48.92696,-55.65966,2018-04-05 04:00:00,39,0,39
"19787",10501,"Grand Falls-Windsor","NL",48.92696,-55.65966,2018-04-05 05:00:00,38,0,38
"19788",10501,"Grand Falls-Windsor","NL",48.92696,-55.65966,2018-04-05 06:00:00,36,0,36
"19789",10501,"Grand Falls-Windsor","NL",48.92696,-55.65966,2018-04-05 07:00:00,34,0,34
"19790",10501,"Grand Falls-Windsor","NL",48.92696,-55.65966,2018-04-05 08:00:00,32,1,33
"19791",10501,"Grand Falls-Windsor","NL",48.92696,-55.65966,2018-04-05 09:00:00,30,1,31
"19792",10501,"Grand Falls-Windsor","NL",48.92696,-55.65966,2018-04-05 10:00:00,27,0,27
"19793",10501,"Grand Falls-Windsor","NL",48.92696,-55.65966,2018-04-05 11:00:00,26,0,26
"19794",10501,"Grand Falls-Windsor","NL",48.92696,-55.65966,2018-04-05 12:00:00,26,0,26
"19795",10501,"Grand Falls-Windsor","NL",48.92696,-55.65966,2018-04-05 13:00:00,26,0,26
"19796",10501,"Grand Falls-Windsor","NL",48.92696,-55.65966,2018-04-05 14:00:00,31,0,31
"19797",10501,"Grand Falls-Windsor","NL",48.92696,-55.65966,2018-04-05 15:00:00,38,0,38
"19798",10501,"Grand Falls-Windsor","NL",48.92696,-55.65966,2018-04-05 16:00:00,40,0,40
"19799",10501,"Grand Falls-Windsor","NL",48.92696,-55.65966,2018-04-05 17:00:00,40,0,40
"19800",10501,"Grand Falls-Windsor","NL",48.92696,-55.65966,2018-04-05 18:00:00,38,0,38
"19801",10501,"Grand Falls-Windsor","NL",48.92696,-55.65966,2018-04-05 19:00:00,37,0,37
"19802",10501,"Grand Falls-Windsor","NL",48.92696,-55.65966,2018-04-05 20:00:00,37,0,37
"19803",10501,"Grand Falls-Windsor","NL",48.92696,-55.65966,2018-04-05 21:00:00,35,0,35
"19804",10501,"Grand Falls-Windsor","NL",48.92696,-55.65966,2018-04-05 22:00:00,33,0,33
"19805",10501,"Grand Falls-Windsor","NL",48.92696,-55.65966,2018-04-05 23:00:00,33,0,33
"19806",10501,"Grand Falls-Windsor","NL",48.92696,-55.65966,2018-04-06 00:00:00,34,0,34
"19807",10501,"Grand Falls-Windsor","NL",48.92696,-55.65966,2018-04-06 01:00:00,33,0,33
"19808",10501,"Grand Falls-Windsor","NL",48.92696,-55.65966,2018-04-06 02:00:00,34,0,34
"19809",10501,"Grand Falls-Windsor","NL",48.92696,-55.65966,2018-04-06 03:00:00,35,0,35
"19810",10501,"Grand Falls-Windsor","NL",48.92696,-55.65966,2018-04-06 04:00:00,35,0,35
"19811",10501,"Grand Falls-Windsor","NL",48.92696,-55.65966,2018-04-06 05:00:00,35,0,35
"19812",10501,"Grand Falls-Windsor","NL",48.92696,-55.65966,2018-04-06 06:00:00,35,0,35
"19813",10501,"Grand Falls-Windsor","NL",48.92696,-55.65966,2018-04-06 07:00:00,34,0,34
"19814",10501,"Grand Falls-Windsor","NL",48.92696,-55.65966,2018-04-06 08:00:00,34,0,34
"19815",10501,"Grand Falls-Windsor","NL",48.92696,-55.65966,2018-04-06 09:00:00,34,0,34
"19816",10501,"Grand Falls-Windsor","NL",48.92696,-55.65966,2018-04-06 10:00:00,33,0,33
"19817",10501,"Grand Falls-Windsor","NL",48.92696,-55.65966,2018-04-06 11:00:00,33,0,33
"19818",10501,"Grand Falls-Windsor","NL",48.92696,-55.65966,2018-04-06 12:00:00,34,0,34
"19819",10501,"Grand Falls-Windsor","NL",48.92696,-55.65966,2018-04-06 13:00:00,35,0,35
"19820",10501,"Grand Falls-Windsor","NL",48.92696,-55.65966,2018-04-06 14:00:00,37,0,37
"19821",10501,"Grand Falls-Windsor","NL",48.92696,-55.65966,2018-04-06 15:00:00,36,0,36
"19822",10501,"Grand Falls-Windsor","NL",48.92696,-55.65966,2018-04-06 16:00:00,36,0,36
"19823",10501,"Grand Falls-Windsor","NL",48.92696,-55.65966,2018-04-06 17:00:00,37,0,37
"19824",10501,"Grand Falls-Windsor","NL",48.92696,-55.65966,2018-04-06 18:00:00,38,0,38
"19825",10501,"Grand Falls-Windsor","NL",48.92696,-55.65966,2018-04-06 19:00:00,38,0,38
"19826",10501,"Grand Falls-Windsor","NL",48.92696,-55.65966,2018-04-06 20:00:00,37,0,37
"19827",10501,"Grand Falls-Windsor","NL",48.92696,-55.65966,2018-04-06 21:00:00,38,0,38
"19828",10501,"Grand Falls-Windsor","NL",48.92696,-55.65966,2018-04-06 22:00:00,38,0,38
"19829",10501,"Grand Falls-Windsor","NL",48.92696,-55.65966,2018-04-06 23:00:00,37,0,37
"19830",10501,"Grand Falls-Windsor","NL",48.92696,-55.65966,2018-04-07 00:00:00,37,0,37
"19831",10501,"Grand Falls-Windsor","NL",48.92696,-55.65966,2018-04-07 01:00:00,36,0,36
"19832",10501,"Grand Falls-Windsor","NL",48.92696,-55.65966,2018-04-07 02:00:00,36,0,36
"19833",10501,"Grand Falls-Windsor","NL",48.92696,-55.65966,2018-04-07 03:00:00,36,0,36
"19834",10501,"Grand Falls-Windsor","NL",48.92696,-55.65966,2018-04-07 04:00:00,36,0,36
"19835",10501,"Grand Falls-Windsor","NL",48.92696,-55.65966,2018-04-07 05:00:00,36,0,36
"19836",10501,"Grand Falls-Windsor","NL",48.92696,-55.65966,2018-04-07 06:00:00,35,0,35
"19837",10501,"Grand Falls-Windsor","NL",48.92696,-55.65966,2018-04-07 07:00:00,36,0,36
"19838",10501,"Grand Falls-Windsor","NL",48.92696,-55.65966,2018-04-07 08:00:00,37,0,37
"19839",10501,"Grand Falls-Windsor","NL",48.92696,-55.65966,2018-04-07 09:00:00,38,0,38
"19840",10501,"Grand Falls-Windsor","NL",48.92696,-55.65966,2018-04-07 10:00:00,39,0,39
"19841",10501,"Grand Falls-Windsor","NL",48.92696,-55.65966,2018-04-07 11:00:00,39,0,39
"19842",10501,"Grand Falls-Windsor","NL",48.92696,-55.65966,2018-04-07 12:00:00,38,0,38
"19843",10501,"Grand Falls-Windsor","NL",48.92696,-55.65966,2018-04-07 13:00:00,38,0,38
"19844",10501,"Grand Falls-Windsor","NL",48.92696,-55.65966,2018-04-07 14:00:00,38,1,39
"19845",10501,"Grand Falls-Windsor","NL",48.92696,-55.65966,2018-04-07 15:00:00,37,1,38
"19846",10501,"Grand Falls-Windsor","NL",48.92696,-55.65966,2018-04-07 16:00:00,37,1,38
"19847",10501,"Grand Falls-Windsor","NL",48.92696,-55.65966,2018-04-07 17:00:00,36,1,37
"19848",10501,"Grand Falls-Windsor","NL",48.92696,-55.65966,2018-04-07 18:00:00,36,1,37
"19849",10501,"Grand Falls-Windsor","NL",48.92696,-55.65966,2018-04-07 19:00:00,36,1,37
"19850",10501,"Grand Falls-Windsor","NL",48.92696,-55.65966,2018-04-07 20:00:00,37,1,38
"19851",10501,"Grand Falls-Windsor","NL",48.92696,-55.65966,2018-04-07 21:00:00,36,1,37
"19852",10501,"Grand Falls-Windsor","NL",48.92696,-55.65966,2018-04-07 22:00:00,38,1,39
"19853",10501,"Grand Falls-Windsor","NL",48.92696,-55.65966,2018-04-07 23:00:00,38,1,39
"19854",10501,"Grand Falls-Windsor","NL",48.92696,-55.65966,2018-04-08 00:00:00,38,1,39
"19855",10501,"Grand Falls-Windsor","NL",48.92696,-55.65966,2018-04-08 01:00:00,39,1,40
"19856",10501,"Grand Falls-Windsor","NL",48.92696,-55.65966,2018-04-08 02:00:00,39,0,39
"19857",10501,"Grand Falls-Windsor","NL",48.92696,-55.65966,2018-04-08 03:00:00,38,1,39
"19858",10501,"Grand Falls-Windsor","NL",48.92696,-55.65966,2018-04-08 04:00:00,36,1,37
"19859",10501,"Grand Falls-Windsor","NL",48.92696,-55.65966,2018-04-08 05:00:00,29,22,51
"19860",10501,"Grand Falls-Windsor","NL",48.92696,-55.65966,2018-04-08 06:00:00,35,1,36
"19861",10501,"Grand Falls-Windsor","NL",48.92696,-55.65966,2018-04-08 07:00:00,36,0,36
"19862",10501,"Grand Falls-Windsor","NL",48.92696,-55.65966,2018-04-08 08:00:00,36,0,36
"19863",10501,"Grand Falls-Windsor","NL",48.92696,-55.65966,2018-04-08 09:00:00,36,0,36
"19864",10501,"Grand Falls-Windsor","NL",48.92696,-55.65966,2018-04-08 10:00:00,36,0,36
"19865",10501,"Grand Falls-Windsor","NL",48.92696,-55.65966,2018-04-08 11:00:00,37,0,37
"19866",10501,"Grand Falls-Windsor","NL",48.92696,-55.65966,2018-04-08 12:00:00,38,0,38
"19867",10501,"Grand Falls-Windsor","NL",48.92696,-55.65966,2018-04-08 13:00:00,39,0,39
"19868",10501,"Grand Falls-Windsor","NL",48.92696,-55.65966,2018-04-08 14:00:00,39,0,39
"19869",10501,"Grand Falls-Windsor","NL",48.92696,-55.65966,2018-04-08 15:00:00,38,0,38
"19870",10501,"Grand Falls-Windsor","NL",48.92696,-55.65966,2018-04-08 16:00:00,37,0,37
"19871",10501,"Grand Falls-Windsor","NL",48.92696,-55.65966,2018-04-08 17:00:00,37,1,38
"19872",10501,"Grand Falls-Windsor","NL",48.92696,-55.65966,2018-04-08 18:00:00,37,1,38
"19873",10501,"Grand Falls-Windsor","NL",48.92696,-55.65966,2018-04-08 19:00:00,37,0,37
"19874",10501,"Grand Falls-Windsor","NL",48.92696,-55.65966,2018-04-08 20:00:00,36,1,37
"19875",10501,"Grand Falls-Windsor","NL",48.92696,-55.65966,2018-04-08 21:00:00,36,1,37
"19876",10501,"Grand Falls-Windsor","NL",48.92696,-55.65966,2018-04-08 22:00:00,37,0,37
"19877",10501,"Grand Falls-Windsor","NL",48.92696,-55.65966,2018-04-08 23:00:00,38,1,39
"19878",10501,"Grand Falls-Windsor","NL",48.92696,-55.65966,2018-04-09 00:00:00,39,0,39
"19879",10501,"Grand Falls-Windsor","NL",48.92696,-55.65966,2018-04-09 01:00:00,40,0,40
"19880",10501,"Grand Falls-Windsor","NL",48.92696,-55.65966,2018-04-09 02:00:00,41,1,42
"19881",10501,"Grand Falls-Windsor","NL",48.92696,-55.65966,2018-04-09 03:00:00,41,0,41
"19882",10501,"Grand Falls-Windsor","NL",48.92696,-55.65966,2018-04-09 04:00:00,39,1,40
"19883",10501,"Grand Falls-Windsor","NL",48.92696,-55.65966,2018-04-09 05:00:00,36,3,39
"19884",10501,"Grand Falls-Windsor","NL",48.92696,-55.65966,2018-04-09 06:00:00,36,3,39
"19885",10501,"Grand Falls-Windsor","NL",48.92696,-55.65966,2018-04-09 07:00:00,35,2,37
"19886",10501,"Grand Falls-Windsor","NL",48.92696,-55.65966,2018-04-09 08:00:00,33,2,35
"19887",10501,"Grand Falls-Windsor","NL",48.92696,-55.65966,2018-04-09 09:00:00,33,0,33
"19888",10501,"Grand Falls-Windsor","NL",48.92696,-55.65966,2018-04-09 10:00:00,35,0,35
"19889",10501,"Grand Falls-Windsor","NL",48.92696,-55.65966,2018-04-09 11:00:00,38,0,38
"19890",10501,"Grand Falls-Windsor","NL",48.92696,-55.65966,2018-04-09 12:00:00,38,0,38
"19891",10501,"Grand Falls-Windsor","NL",48.92696,-55.65966,2018-04-09 13:00:00,38,0,38
"19892",10501,"Grand Falls-Windsor","NL",48.92696,-55.65966,2018-04-09 14:00:00,38,0,38
"19893",10501,"Grand Falls-Windsor","NL",48.92696,-55.65966,2018-04-09 15:00:00,38,0,38
"19894",10501,"Grand Falls-Windsor","NL",48.92696,-55.65966,2018-04-09 16:00:00,38,0,38
"19895",10501,"Grand Falls-Windsor","NL",48.92696,-55.65966,2018-04-09 17:00:00,39,0,39
"19896",10501,"Grand Falls-Windsor","NL",48.92696,-55.65966,2018-04-09 18:00:00,39,0,39
"19897",10501,"Grand Falls-Windsor","NL",48.92696,-55.65966,2018-04-09 19:00:00,38,0,38
"19898",10501,"Grand Falls-Windsor","NL",48.92696,-55.65966,2018-04-09 20:00:00,38,1,39
"19899",10501,"Grand Falls-Windsor","NL",48.92696,-55.65966,2018-04-09 21:00:00,37,0,37
"19900",10501,"Grand Falls-Windsor","NL",48.92696,-55.65966,2018-04-09 22:00:00,37,0,37
"19901",10501,"Grand Falls-Windsor","NL",48.92696,-55.65966,2018-04-09 23:00:00,37,0,37
"19902",10501,"Grand Falls-Windsor","NL",48.92696,-55.65966,2018-04-10 00:00:00,37,0,37
"19903",10501,"Grand Falls-Windsor","NL",48.92696,-55.65966,2018-04-10 01:00:00,37,0,37
"19904",10501,"Grand Falls-Windsor","NL",48.92696,-55.65966,2018-04-10 02:00:00,37,0,37
"19905",10501,"Grand Falls-Windsor","NL",48.92696,-55.65966,2018-04-10 03:00:00,36,0,36
"19906",10501,"Grand Falls-Windsor","NL",48.92696,-55.65966,2018-04-10 04:00:00,36,0,36
"19907",10501,"Grand Falls-Windsor","NL",48.92696,-55.65966,2018-04-10 05:00:00,36,0,36
"19908",10501,"Grand Falls-Windsor","NL",48.92696,-55.65966,2018-04-10 06:00:00,35,0,35
"19909",10501,"Grand Falls-Windsor","NL",48.92696,-55.65966,2018-04-10 07:00:00,35,0,35
"19910",10501,"Grand Falls-Windsor","NL",48.92696,-55.65966,2018-04-10 08:00:00,36,0,36
"19911",10501,"Grand Falls-Windsor","NL",48.92696,-55.65966,2018-04-10 09:00:00,35,0,35
"19912",10501,"Grand Falls-Windsor","NL",48.92696,-55.65966,2018-04-10 10:00:00,35,0,35
"19913",10501,"Grand Falls-Windsor","NL",48.92696,-55.65966,2018-04-10 11:00:00,36,0,36
"19914",10501,"Grand Falls-Windsor","NL",48.92696,-55.65966,2018-04-10 12:00:00,35,0,35
"19915",10501,"Grand Falls-Windsor","NL",48.92696,-55.65966,2018-04-10 13:00:00,36,0,36
"19916",10501,"Grand Falls-Windsor","NL",48.92696,-55.65966,2018-04-10 14:00:00,38,0,38
"19917",10501,"Grand Falls-Windsor","NL",48.92696,-55.65966,2018-04-10 15:00:00,40,0,40
"19918",10501,"Grand Falls-Windsor","NL",48.92696,-55.65966,2018-04-10 16:00:00,40,0,40
"19919",10501,"Grand Falls-Windsor","NL",48.92696,-55.65966,2018-04-10 17:00:00,40,0,40
"19920",10501,"Grand Falls-Windsor","NL",48.92696,-55.65966,2018-04-10 18:00:00,41,0,41
"19921",10501,"Grand Falls-Windsor","NL",48.92696,-55.65966,2018-04-10 19:00:00,42,0,42
"19922",10501,"Grand Falls-Windsor","NL",48.92696,-55.65966,2018-04-10 20:00:00,41,0,41
"19923",10501,"Grand Falls-Windsor","NL",48.92696,-55.65966,2018-04-10 21:00:00,40,0,40
"19924",10501,"Grand Falls-Windsor","NL",48.92696,-55.65966,2018-04-10 22:00:00,39,0,39
"19925",10501,"Grand Falls-Windsor","NL",48.92696,-55.65966,2018-04-10 23:00:00,39,0,39
"19926",10501,"Grand Falls-Windsor","NL",48.92696,-55.65966,2018-04-11 00:00:00,38,0,38
"19927",10501,"Grand Falls-Windsor","NL",48.92696,-55.65966,2018-04-11 01:00:00,38,0,38
"19928",10501,"Grand Falls-Windsor","NL",48.92696,-55.65966,2018-04-11 02:00:00,37,0,37
"19929",10501,"Grand Falls-Windsor","NL",48.92696,-55.65966,2018-04-11 03:00:00,36,0,36
"19930",10501,"Grand Falls-Windsor","NL",48.92696,-55.65966,2018-04-11 04:00:00,35,0,35
"19931",10501,"Grand Falls-Windsor","NL",48.92696,-55.65966,2018-04-11 05:00:00,33,0,33
"19932",10501,"Grand Falls-Windsor","NL",48.92696,-55.65966,2018-04-11 06:00:00,33,0,33
"19933",10501,"Grand Falls-Windsor","NL",48.92696,-55.65966,2018-04-11 07:00:00,33,0,33
"19934",10501,"Grand Falls-Windsor","NL",48.92696,-55.65966,2018-04-11 08:00:00,34,0,34
"19935",10501,"Grand Falls-Windsor","NL",48.92696,-55.65966,2018-04-11 09:00:00,33,0,33
"19936",10501,"Grand Falls-Windsor","NL",48.92696,-55.65966,2018-04-11 10:00:00,33,1,34
"19937",10501,"Grand Falls-Windsor","NL",48.92696,-55.65966,2018-04-11 11:00:00,34,0,34
"19938",10501,"Grand Falls-Windsor","NL",48.92696,-55.65966,2018-04-11 12:00:00,36,0,36
"19939",10501,"Grand Falls-Windsor","NL",48.92696,-55.65966,2018-04-11 13:00:00,36,0,36
"19940",10501,"Grand Falls-Windsor","NL",48.92696,-55.65966,2018-04-11 14:00:00,37,0,37
"19941",10501,"Grand Falls-Windsor","NL",48.92696,-55.65966,2018-04-11 15:00:00,37,0,37
"19942",10501,"Grand Falls-Windsor","NL",48.92696,-55.65966,2018-04-11 16:00:00,37,0,37
"19943",10501,"Grand Falls-Windsor","NL",48.92696,-55.65966,2018-04-11 17:00:00,37,0,37
"19944",10501,"Grand Falls-Windsor","NL",48.92696,-55.65966,2018-04-11 18:00:00,37,1,38
"19945",10501,"Grand Falls-Windsor","NL",48.92696,-55.65966,2018-04-11 19:00:00,36,1,37
"19946",10501,"Grand Falls-Windsor","NL",48.92696,-55.65966,2018-04-11 20:00:00,36,1,37
"19947",10501,"Grand Falls-Windsor","NL",48.92696,-55.65966,2018-04-11 21:00:00,35,1,36
"19948",10501,"Grand Falls-Windsor","NL",48.92696,-55.65966,2018-04-11 22:00:00,32,1,33
"19949",10501,"Grand Falls-Windsor","NL",48.92696,-55.65966,2018-04-11 23:00:00,32,0,32
"19950",10501,"Grand Falls-Windsor","NL",48.92696,-55.65966,2018-04-12 00:00:00,33,1,34
"19951",10501,"Grand Falls-Windsor","NL",48.92696,-55.65966,2018-04-12 01:00:00,31,1,32
"19952",10501,"Grand Falls-Windsor","NL",48.92696,-55.65966,2018-04-12 02:00:00,28,1,29
"19953",10501,"Grand Falls-Windsor","NL",48.92696,-55.65966,2018-04-12 03:00:00,30,0,30
"19954",10501,"Grand Falls-Windsor","NL",48.92696,-55.65966,2018-04-12 04:00:00,30,1,31
"19955",10501,"Grand Falls-Windsor","NL",48.92696,-55.65966,2018-04-12 05:00:00,29,1,30
"19956",10501,"Grand Falls-Windsor","NL",48.92696,-55.65966,2018-04-12 06:00:00,30,0,30
"19957",10501,"Grand Falls-Windsor","NL",48.92696,-55.65966,2018-04-12 07:00:00,29,0,29
"19958",10501,"Grand Falls-Windsor","NL",48.92696,-55.65966,2018-04-12 08:00:00,31,0,31
"19959",10501,"Grand Falls-Windsor","NL",48.92696,-55.65966,2018-04-12 09:00:00,32,1,33
"19960",10501,"Grand Falls-Windsor","NL",48.92696,-55.65966,2018-04-12 10:00:00,34,1,35
"19961",10501,"Grand Falls-Windsor","NL",48.92696,-55.65966,2018-04-12 11:00:00,36,1,37
"19962",10501,"Grand Falls-Windsor","NL",48.92696,-55.65966,2018-04-12 12:00:00,38,0,38
"19963",10501,"Grand Falls-Windsor","NL",48.92696,-55.65966,2018-04-12 13:00:00,39,0,39
"19964",10501,"Grand Falls-Windsor","NL",48.92696,-55.65966,2018-04-12 14:00:00,40,0,40
"19965",10501,"Grand Falls-Windsor","NL",48.92696,-55.65966,2018-04-12 15:00:00,40,1,41
"19966",10501,"Grand Falls-Windsor","NL",48.92696,-55.65966,2018-04-12 16:00:00,42,0,42
"19967",10501,"Grand Falls-Windsor","NL",48.92696,-55.65966,2018-04-12 17:00:00,42,0,42
"19968",10501,"Grand Falls-Windsor","NL",48.92696,-55.65966,2018-04-12 18:00:00,40,0,40
"19969",10501,"Grand Falls-Windsor","NL",48.92696,-55.65966,2018-04-12 19:00:00,36,1,37
"19970",10501,"Grand Falls-Windsor","NL",48.92696,-55.65966,2018-04-12 20:00:00,36,1,37
"19971",10501,"Grand Falls-Windsor","NL",48.92696,-55.65966,2018-04-12 21:00:00,34,1,35
"19972",10501,"Grand Falls-Windsor","NL",48.92696,-55.65966,2018-04-12 22:00:00,33,1,34
"19973",10501,"Grand Falls-Windsor","NL",48.92696,-55.65966,2018-04-12 23:00:00,33,0,33
"19974",10501,"Grand Falls-Windsor","NL",48.92696,-55.65966,2018-04-13 00:00:00,30,0,30
"19975",10501,"Grand Falls-Windsor","NL",48.92696,-55.65966,2018-04-13 01:00:00,25,0,25
"19976",10501,"Grand Falls-Windsor","NL",48.92696,-55.65966,2018-04-13 02:00:00,22,0,22
"19977",10501,"Grand Falls-Windsor","NL",48.92696,-55.65966,2018-04-13 03:00:00,21,0,21
"19978",10501,"Grand Falls-Windsor","NL",48.92696,-55.65966,2018-04-13 04:00:00,25,1,26
"19979",10501,"Grand Falls-Windsor","NL",48.92696,-55.65966,2018-04-13 05:00:00,23,0,23
"19980",10501,"Grand Falls-Windsor","NL",48.92696,-55.65966,2018-04-13 06:00:00,22,0,22
"19981",10501,"Grand Falls-Windsor","NL",48.92696,-55.65966,2018-04-13 07:00:00,25,0,25
"19982",10501,"Grand Falls-Windsor","NL",48.92696,-55.65966,2018-04-13 08:00:00,29,0,29
"19983",10501,"Grand Falls-Windsor","NL",48.92696,-55.65966,2018-04-13 09:00:00,32,0,32
"19984",10501,"Grand Falls-Windsor","NL",48.92696,-55.65966,2018-04-13 10:00:00,37,0,37
"19985",10501,"Grand Falls-Windsor","NL",48.92696,-55.65966,2018-04-13 11:00:00,39,0,39
"19986",10501,"Grand Falls-Windsor","NL",48.92696,-55.65966,2018-04-13 12:00:00,40,0,40
"19987",10501,"Grand Falls-Windsor","NL",48.92696,-55.65966,2018-04-13 13:00:00,39,0,39
"19988",10501,"Grand Falls-Windsor","NL",48.92696,-55.65966,2018-04-13 14:00:00,37,0,37
"19989",10501,"Grand Falls-Windsor","NL",48.92696,-55.65966,2018-04-13 15:00:00,38,0,38
"19990",10501,"Grand Falls-Windsor","NL",48.92696,-55.65966,2018-04-13 16:00:00,38,0,38
"19991",10501,"Grand Falls-Windsor","NL",48.92696,-55.65966,2018-04-13 17:00:00,38,1,39
"19992",10501,"Grand Falls-Windsor","NL",48.92696,-55.65966,2018-04-13 18:00:00,40,0,40
"19993",10501,"Grand Falls-Windsor","NL",48.92696,-55.65966,2018-04-13 19:00:00,39,0,39
"19994",10501,"Grand Falls-Windsor","NL",48.92696,-55.65966,2018-04-13 20:00:00,36,0,36
"19995",10501,"Grand Falls-Windsor","NL",48.92696,-55.65966,2018-04-13 21:00:00,36,0,36
"19996",10501,"Grand Falls-Windsor","NL",48.92696,-55.65966,2018-04-13 22:00:00,35,1,36
"19997",10501,"Grand Falls-Windsor","NL",48.92696,-55.65966,2018-04-13 23:00:00,35,0,35
"19998",10501,"Grand Falls-Windsor","NL",48.92696,-55.65966,2018-04-14 00:00:00,34,0,34
"19999",10501,"Grand Falls-Windsor","NL",48.92696,-55.65966,2018-04-14 01:00:00,33,0,33
"20000",10501,"Grand Falls-Windsor","NL",48.92696,-55.65966,2018-04-14 02:00:00,31,1,32
"20001",10501,"Grand Falls-Windsor","NL",48.92696,-55.65966,2018-04-14 03:00:00,30,1,31
"20002",10501,"Grand Falls-Windsor","NL",48.92696,-55.65966,2018-04-14 04:00:00,27,0,27
"20003",10501,"Grand Falls-Windsor","NL",48.92696,-55.65966,2018-04-14 05:00:00,28,0,28
"20004",10501,"Grand Falls-Windsor","NL",48.92696,-55.65966,2018-04-14 06:00:00,31,0,31
"20005",10501,"Grand Falls-Windsor","NL",48.92696,-55.65966,2018-04-14 07:00:00,33,3,36
"20006",10501,"Grand Falls-Windsor","NL",48.92696,-55.65966,2018-04-14 08:00:00,39,0,39
"20007",10501,"Grand Falls-Windsor","NL",48.92696,-55.65966,2018-04-14 09:00:00,40,0,40
"20008",10501,"Grand Falls-Windsor","NL",48.92696,-55.65966,2018-04-14 10:00:00,41,0,41
"20009",10501,"Grand Falls-Windsor","NL",48.92696,-55.65966,2018-04-14 11:00:00,43,1,44
"20010",10501,"Grand Falls-Windsor","NL",48.92696,-55.65966,2018-04-14 12:00:00,43,0,43
"20011",10501,"Grand Falls-Windsor","NL",48.92696,-55.65966,2018-04-14 13:00:00,43,1,44
"20012",10501,"Grand Falls-Windsor","NL",48.92696,-55.65966,2018-04-14 14:00:00,41,0,41
"20013",10501,"Grand Falls-Windsor","NL",48.92696,-55.65966,2018-04-14 15:00:00,41,0,41
"20014",10501,"Grand Falls-Windsor","NL",48.92696,-55.65966,2018-04-14 16:00:00,41,0,41
"20015",10501,"Grand Falls-Windsor","NL",48.92696,-55.65966,2018-04-14 17:00:00,40,0,40
"20016",10501,"Grand Falls-Windsor","NL",48.92696,-55.65966,2018-04-14 18:00:00,39,0,39
"20017",10501,"Grand Falls-Windsor","NL",48.92696,-55.65966,2018-04-14 19:00:00,37,0,37
"20018",10501,"Grand Falls-Windsor","NL",48.92696,-55.65966,2018-04-14 20:00:00,35,0,35
"20019",10501,"Grand Falls-Windsor","NL",48.92696,-55.65966,2018-04-14 21:00:00,34,0,34
"20020",10501,"Grand Falls-Windsor","NL",48.92696,-55.65966,2018-04-14 22:00:00,34,0,34
"20021",10501,"Grand Falls-Windsor","NL",48.92696,-55.65966,2018-04-14 23:00:00,35,0,35
"20022",10501,"Grand Falls-Windsor","NL",48.92696,-55.65966,2018-04-15 00:00:00,36,0,36
"20023",10501,"Grand Falls-Windsor","NL",48.92696,-55.65966,2018-04-15 01:00:00,37,0,37
"20024",10501,"Grand Falls-Windsor","NL",48.92696,-55.65966,2018-04-15 02:00:00,36,0,36
"20025",10501,"Grand Falls-Windsor","NL",48.92696,-55.65966,2018-04-15 03:00:00,36,0,36
"20026",10501,"Grand Falls-Windsor","NL",48.92696,-55.65966,2018-04-15 04:00:00,35,0,35
"20027",10501,"Grand Falls-Windsor","NL",48.92696,-55.65966,2018-04-15 05:00:00,35,0,35
"20028",10501,"Grand Falls-Windsor","NL",48.92696,-55.65966,2018-04-15 06:00:00,35,0,35
"20029",10501,"Grand Falls-Windsor","NL",48.92696,-55.65966,2018-04-15 07:00:00,34,0,34
"20030",10501,"Grand Falls-Windsor","NL",48.92696,-55.65966,2018-04-15 08:00:00,34,0,34
"20031",10501,"Grand Falls-Windsor","NL",48.92696,-55.65966,2018-04-15 09:00:00,34,0,34
"20032",10501,"Grand Falls-Windsor","NL",48.92696,-55.65966,2018-04-15 10:00:00,33,0,33
"20033",10501,"Grand Falls-Windsor","NL",48.92696,-55.65966,2018-04-15 11:00:00,32,0,32
"20034",10501,"Grand Falls-Windsor","NL",48.92696,-55.65966,2018-04-15 12:00:00,31,0,31
"20035",10501,"Grand Falls-Windsor","NL",48.92696,-55.65966,2018-04-15 13:00:00,31,0,31
"20036",10501,"Grand Falls-Windsor","NL",48.92696,-55.65966,2018-04-15 14:00:00,33,0,33
"20037",10501,"Grand Falls-Windsor","NL",48.92696,-55.65966,2018-04-15 15:00:00,35,0,35
"20038",10501,"Grand Falls-Windsor","NL",48.92696,-55.65966,2018-04-15 16:00:00,34,0,34
"20039",10501,"Grand Falls-Windsor","NL",48.92696,-55.65966,2018-04-15 17:00:00,34,0,34
"20040",10501,"Grand Falls-Windsor","NL",48.92696,-55.65966,2018-04-15 18:00:00,33,0,33
"20041",10501,"Grand Falls-Windsor","NL",48.92696,-55.65966,2018-04-15 19:00:00,33,0,33
"20042",10501,"Grand Falls-Windsor","NL",48.92696,-55.65966,2018-04-15 20:00:00,33,0,33
"20043",10501,"Grand Falls-Windsor","NL",48.92696,-55.65966,2018-04-15 21:00:00,33,0,33
"20044",10501,"Grand Falls-Windsor","NL",48.92696,-55.65966,2018-04-15 22:00:00,32,0,32
"20045",10501,"Grand Falls-Windsor","NL",48.92696,-55.65966,2018-04-15 23:00:00,31,0,31
"20046",10501,"Grand Falls-Windsor","NL",48.92696,-55.65966,2018-04-16 00:00:00,29,0,29
"20047",10501,"Grand Falls-Windsor","NL",48.92696,-55.65966,2018-04-16 01:00:00,28,0,28
"20048",10501,"Grand Falls-Windsor","NL",48.92696,-55.65966,2018-04-16 02:00:00,27,0,27
"20049",10501,"Grand Falls-Windsor","NL",48.92696,-55.65966,2018-04-16 03:00:00,26,0,26
"20050",10501,"Grand Falls-Windsor","NL",48.92696,-55.65966,2018-04-16 04:00:00,26,0,26
"20051",10501,"Grand Falls-Windsor","NL",48.92696,-55.65966,2018-04-16 05:00:00,26,0,26
"20052",10501,"Grand Falls-Windsor","NL",48.92696,-55.65966,2018-04-16 06:00:00,26,0,26
"20053",10501,"Grand Falls-Windsor","NL",48.92696,-55.65966,2018-04-16 07:00:00,28,0,28
"20054",10501,"Grand Falls-Windsor","NL",48.92696,-55.65966,2018-04-16 08:00:00,32,0,32
"20055",10501,"Grand Falls-Windsor","NL",48.92696,-55.65966,2018-04-16 09:00:00,37,0,37
"20056",10501,"Grand Falls-Windsor","NL",48.92696,-55.65966,2018-04-16 10:00:00,39,0,39
"20057",10501,"Grand Falls-Windsor","NL",48.92696,-55.65966,2018-04-16 11:00:00,41,0,41
"20058",10501,"Grand Falls-Windsor","NL",48.92696,-55.65966,2018-04-16 12:00:00,42,0,42
"20059",10501,"Grand Falls-Windsor","NL",48.92696,-55.65966,2018-04-16 13:00:00,43,0,43
"20060",10501,"Grand Falls-Windsor","NL",48.92696,-55.65966,2018-04-16 14:00:00,43,0,43
"20061",10501,"Grand Falls-Windsor","NL",48.92696,-55.65966,2018-04-16 15:00:00,43,0,43
"20062",10501,"Grand Falls-Windsor","NL",48.92696,-55.65966,2018-04-16 16:00:00,42,0,42
"20063",10501,"Grand Falls-Windsor","NL",48.92696,-55.65966,2018-04-16 17:00:00,41,0,41
"20064",10501,"Grand Falls-Windsor","NL",48.92696,-55.65966,2018-04-16 18:00:00,41,0,41
"20065",10501,"Grand Falls-Windsor","NL",48.92696,-55.65966,2018-04-16 19:00:00,40,0,40
"20066",10501,"Grand Falls-Windsor","NL",48.92696,-55.65966,2018-04-16 20:00:00,39,0,39
"20067",10501,"Grand Falls-Windsor","NL",48.92696,-55.65966,2018-04-16 21:00:00,39,0,39
"20068",10501,"Grand Falls-Windsor","NL",48.92696,-55.65966,2018-04-16 22:00:00,38,0,38
"20069",10501,"Grand Falls-Windsor","NL",48.92696,-55.65966,2018-04-16 23:00:00,39,0,39
"20070",10501,"Grand Falls-Windsor","NL",48.92696,-55.65966,2018-04-17 00:00:00,40,0,40
"20071",10501,"Grand Falls-Windsor","NL",48.92696,-55.65966,2018-04-17 01:00:00,40,0,40
"20072",10501,"Grand Falls-Windsor","NL",48.92696,-55.65966,2018-04-17 02:00:00,41,0,41
"20073",10501,"Grand Falls-Windsor","NL",48.92696,-55.65966,2018-04-17 03:00:00,41,0,41
"20074",10501,"Grand Falls-Windsor","NL",48.92696,-55.65966,2018-04-17 04:00:00,42,0,42
"20075",10501,"Grand Falls-Windsor","NL",48.92696,-55.65966,2018-04-17 05:00:00,43,0,43
"20076",10501,"Grand Falls-Windsor","NL",48.92696,-55.65966,2018-04-17 06:00:00,38,9,47
"20077",10501,"Grand Falls-Windsor","NL",48.92696,-55.65966,2018-04-17 07:00:00,41,0,41
"20078",10501,"Grand Falls-Windsor","NL",48.92696,-55.65966,2018-04-17 08:00:00,41,0,41
"20079",10501,"Grand Falls-Windsor","NL",48.92696,-55.65966,2018-04-17 09:00:00,40,0,40
"20080",10501,"Grand Falls-Windsor","NL",48.92696,-55.65966,2018-04-17 10:00:00,40,1,41
"20081",10501,"Grand Falls-Windsor","NL",48.92696,-55.65966,2018-04-17 11:00:00,41,0,41
"20082",10501,"Grand Falls-Windsor","NL",48.92696,-55.65966,2018-04-17 12:00:00,42,0,42
"20083",10501,"Grand Falls-Windsor","NL",48.92696,-55.65966,2018-04-17 13:00:00,41,0,41
"20084",10501,"Grand Falls-Windsor","NL",48.92696,-55.65966,2018-04-17 14:00:00,41,0,41
"20085",10501,"Grand Falls-Windsor","NL",48.92696,-55.65966,2018-04-17 15:00:00,42,1,43
"20086",10501,"Grand Falls-Windsor","NL",48.92696,-55.65966,2018-04-17 16:00:00,41,1,42
"20087",10501,"Grand Falls-Windsor","NL",48.92696,-55.65966,2018-04-17 17:00:00,41,0,41
"20088",10501,"Grand Falls-Windsor","NL",48.92696,-55.65966,2018-04-17 18:00:00,40,1,41
"20089",10501,"Grand Falls-Windsor","NL",48.92696,-55.65966,2018-04-17 19:00:00,39,1,40
"20090",10501,"Grand Falls-Windsor","NL",48.92696,-55.65966,2018-04-17 20:00:00,39,0,39
"20091",10501,"Grand Falls-Windsor","NL",48.92696,-55.65966,2018-04-17 21:00:00,39,1,40
"20092",10501,"Grand Falls-Windsor","NL",48.92696,-55.65966,2018-04-17 22:00:00,36,1,37
"20093",10501,"Grand Falls-Windsor","NL",48.92696,-55.65966,2018-04-17 23:00:00,36,1,37
"20094",10501,"Grand Falls-Windsor","NL",48.92696,-55.65966,2018-04-18 00:00:00,35,0,35
"20095",10501,"Grand Falls-Windsor","NL",48.92696,-55.65966,2018-04-18 01:00:00,36,0,36
"20096",10501,"Grand Falls-Windsor","NL",48.92696,-55.65966,2018-04-18 02:00:00,35,1,36
"20097",10501,"Grand Falls-Windsor","NL",48.92696,-55.65966,2018-04-18 03:00:00,35,0,35
"20098",10501,"Grand Falls-Windsor","NL",48.92696,-55.65966,2018-04-18 04:00:00,38,0,38
"20099",10501,"Grand Falls-Windsor","NL",48.92696,-55.65966,2018-04-18 05:00:00,39,0,39
"20100",10501,"Grand Falls-Windsor","NL",48.92696,-55.65966,2018-04-18 06:00:00,38,1,39
"20101",10501,"Grand Falls-Windsor","NL",48.92696,-55.65966,2018-04-18 07:00:00,36,1,37
"20102",10501,"Grand Falls-Windsor","NL",48.92696,-55.65966,2018-04-18 08:00:00,34,1,35
"20103",10501,"Grand Falls-Windsor","NL",48.92696,-55.65966,2018-04-18 09:00:00,37,0,37
"20104",10501,"Grand Falls-Windsor","NL",48.92696,-55.65966,2018-04-18 10:00:00,38,1,39
"20105",10501,"Grand Falls-Windsor","NL",48.92696,-55.65966,2018-04-18 11:00:00,38,1,39
"20106",10501,"Grand Falls-Windsor","NL",48.92696,-55.65966,2018-04-18 12:00:00,37,0,37
"20107",10501,"Grand Falls-Windsor","NL",48.92696,-55.65966,2018-04-18 13:00:00,37,0,37
"20108",10501,"Grand Falls-Windsor","NL",48.92696,-55.65966,2018-04-18 14:00:00,37,0,37
"20109",10501,"Grand Falls-Windsor","NL",48.92696,-55.65966,2018-04-18 15:00:00,35,1,36
"20110",10501,"Grand Falls-Windsor","NL",48.92696,-55.65966,2018-04-18 16:00:00,33,1,34
"20111",10501,"Grand Falls-Windsor","NL",48.92696,-55.65966,2018-04-18 17:00:00,32,1,33
"20112",10501,"Grand Falls-Windsor","NL",48.92696,-55.65966,2018-04-18 18:00:00,32,1,33
"20113",10501,"Grand Falls-Windsor","NL",48.92696,-55.65966,2018-04-18 19:00:00,31,1,32
"20114",10501,"Grand Falls-Windsor","NL",48.92696,-55.65966,2018-04-18 20:00:00,30,1,31
"20115",10501,"Grand Falls-Windsor","NL",48.92696,-55.65966,2018-04-18 21:00:00,29,2,31
"20116",10501,"Grand Falls-Windsor","NL",48.92696,-55.65966,2018-04-18 22:00:00,36,0,36
"20117",10501,"Grand Falls-Windsor","NL",48.92696,-55.65966,2018-04-18 23:00:00,34,0,34
"20118",10501,"Grand Falls-Windsor","NL",48.92696,-55.65966,2018-04-19 00:00:00,34,0,34
"20119",10501,"Grand Falls-Windsor","NL",48.92696,-55.65966,2018-04-19 01:00:00,33,0,33
"20120",10501,"Grand Falls-Windsor","NL",48.92696,-55.65966,2018-04-19 02:00:00,32,0,32
"20121",10501,"Grand Falls-Windsor","NL",48.92696,-55.65966,2018-04-19 03:00:00,32,0,32
"20122",10501,"Grand Falls-Windsor","NL",48.92696,-55.65966,2018-04-19 04:00:00,33,0,33
"20123",10501,"Grand Falls-Windsor","NL",48.92696,-55.65966,2018-04-19 05:00:00,33,0,33
"20124",10501,"Grand Falls-Windsor","NL",48.92696,-55.65966,2018-04-19 06:00:00,34,1,35
"20125",10501,"Grand Falls-Windsor","NL",48.92696,-55.65966,2018-04-19 07:00:00,33,0,33
"20126",10501,"Grand Falls-Windsor","NL",48.92696,-55.65966,2018-04-19 08:00:00,32,0,32
"20127",10501,"Grand Falls-Windsor","NL",48.92696,-55.65966,2018-04-19 09:00:00,31,0,31
"20128",10501,"Grand Falls-Windsor","NL",48.92696,-55.65966,2018-04-19 10:00:00,31,0,31
"20129",10501,"Grand Falls-Windsor","NL",48.92696,-55.65966,2018-04-19 11:00:00,30,1,31
"20130",10501,"Grand Falls-Windsor","NL",48.92696,-55.65966,2018-04-19 12:00:00,30,0,30
"20131",10501,"Grand Falls-Windsor","NL",48.92696,-55.65966,2018-04-19 13:00:00,31,0,31
"20132",10501,"Grand Falls-Windsor","NL",48.92696,-55.65966,2018-04-19 14:00:00,32,0,32
"20133",10501,"Grand Falls-Windsor","NL",48.92696,-55.65966,2018-04-19 15:00:00,32,0,32
"20134",10501,"Grand Falls-Windsor","NL",48.92696,-55.65966,2018-04-19 16:00:00,32,0,32
"20135",10501,"Grand Falls-Windsor","NL",48.92696,-55.65966,2018-04-19 17:00:00,32,1,33
"20136",10501,"Grand Falls-Windsor","NL",48.92696,-55.65966,2018-04-19 18:00:00,31,1,32
"20137",10501,"Grand Falls-Windsor","NL",48.92696,-55.65966,2018-04-19 19:00:00,29,1,30
"20138",10501,"Grand Falls-Windsor","NL",48.92696,-55.65966,2018-04-19 20:00:00,27,1,28
"20139",10501,"Grand Falls-Windsor","NL",48.92696,-55.65966,2018-04-19 21:00:00,27,0,27
"20140",10501,"Grand Falls-Windsor","NL",48.92696,-55.65966,2018-04-19 22:00:00,25,0,25
"20141",10501,"Grand Falls-Windsor","NL",48.92696,-55.65966,2018-04-19 23:00:00,24,0,24
"20142",10501,"Grand Falls-Windsor","NL",48.92696,-55.65966,2018-04-20 00:00:00,24,1,25
"20143",10501,"Grand Falls-Windsor","NL",48.92696,-55.65966,2018-04-20 01:00:00,21,0,21
"20144",10501,"Grand Falls-Windsor","NL",48.92696,-55.65966,2018-04-20 02:00:00,19,1,20
"20145",10501,"Grand Falls-Windsor","NL",48.92696,-55.65966,2018-04-20 03:00:00,15,2,17
"20146",10501,"Grand Falls-Windsor","NL",48.92696,-55.65966,2018-04-20 04:00:00,18,2,20
"20147",10501,"Grand Falls-Windsor","NL",48.92696,-55.65966,2018-04-20 05:00:00,18,0,18
"20148",10501,"Grand Falls-Windsor","NL",48.92696,-55.65966,2018-04-20 06:00:00,24,1,25
"20149",10501,"Grand Falls-Windsor","NL",48.92696,-55.65966,2018-04-20 07:00:00,30,1,31
"20150",10501,"Grand Falls-Windsor","NL",48.92696,-55.65966,2018-04-20 08:00:00,30,2,32
"20151",10501,"Grand Falls-Windsor","NL",48.92696,-55.65966,2018-04-20 09:00:00,31,1,32
"20152",10501,"Grand Falls-Windsor","NL",48.92696,-55.65966,2018-04-20 10:00:00,30,2,32
"20153",10501,"Grand Falls-Windsor","NL",48.92696,-55.65966,2018-04-20 11:00:00,29,2,31
"20154",10501,"Grand Falls-Windsor","NL",48.92696,-55.65966,2018-04-20 12:00:00,30,1,31
"20155",10501,"Grand Falls-Windsor","NL",48.92696,-55.65966,2018-04-20 13:00:00,29,1,30
"20156",10501,"Grand Falls-Windsor","NL",48.92696,-55.65966,2018-04-20 14:00:00,29,1,30
"20157",10501,"Grand Falls-Windsor","NL",48.92696,-55.65966,2018-04-20 15:00:00,30,1,31
"20158",10501,"Grand Falls-Windsor","NL",48.92696,-55.65966,2018-04-20 16:00:00,30,1,31
"20159",10501,"Grand Falls-Windsor","NL",48.92696,-55.65966,2018-04-20 17:00:00,29,1,30
"20160",10501,"Grand Falls-Windsor","NL",48.92696,-55.65966,2018-04-20 18:00:00,29,1,30
"20161",10501,"Grand Falls-Windsor","NL",48.92696,-55.65966,2018-04-20 19:00:00,28,1,29
"20162",10501,"Grand Falls-Windsor","NL",48.92696,-55.65966,2018-04-20 20:00:00,29,1,30
"20163",10501,"Grand Falls-Windsor","NL",48.92696,-55.65966,2018-04-20 21:00:00,29,1,30
"20164",10501,"Grand Falls-Windsor","NL",48.92696,-55.65966,2018-04-20 22:00:00,29,1,30
"20165",10501,"Grand Falls-Windsor","NL",48.92696,-55.65966,2018-04-20 23:00:00,30,0,30
"20166",10501,"Grand Falls-Windsor","NL",48.92696,-55.65966,2018-04-21 00:00:00,29,0,29
"20167",10501,"Grand Falls-Windsor","NL",48.92696,-55.65966,2018-04-21 01:00:00,28,0,28
"20168",10501,"Grand Falls-Windsor","NL",48.92696,-55.65966,2018-04-21 02:00:00,28,0,28
"20169",10501,"Grand Falls-Windsor","NL",48.92696,-55.65966,2018-04-21 03:00:00,29,0,29
"20170",10501,"Grand Falls-Windsor","NL",48.92696,-55.65966,2018-04-21 04:00:00,29,0,29
"20171",10501,"Grand Falls-Windsor","NL",48.92696,-55.65966,2018-04-21 05:00:00,29,0,29
"20172",10501,"Grand Falls-Windsor","NL",48.92696,-55.65966,2018-04-21 06:00:00,31,0,31
"20173",10501,"Grand Falls-Windsor","NL",48.92696,-55.65966,2018-04-21 07:00:00,32,0,32
"20174",10501,"Grand Falls-Windsor","NL",48.92696,-55.65966,2018-04-21 08:00:00,34,0,34
"20175",10501,"Grand Falls-Windsor","NL",48.92696,-55.65966,2018-04-21 09:00:00,34,0,34
"20176",10501,"Grand Falls-Windsor","NL",48.92696,-55.65966,2018-04-21 10:00:00,35,0,35
"20177",10501,"Grand Falls-Windsor","NL",48.92696,-55.65966,2018-04-21 11:00:00,35,0,35
"20178",10501,"Grand Falls-Windsor","NL",48.92696,-55.65966,2018-04-21 12:00:00,35,0,35
"20179",10501,"Grand Falls-Windsor","NL",48.92696,-55.65966,2018-04-21 13:00:00,35,0,35
"20180",10501,"Grand Falls-Windsor","NL",48.92696,-55.65966,2018-04-21 14:00:00,35,0,35
"20181",10501,"Grand Falls-Windsor","NL",48.92696,-55.65966,2018-04-21 15:00:00,35,0,35
"20182",10501,"Grand Falls-Windsor","NL",48.92696,-55.65966,2018-04-21 16:00:00,35,0,35
"20183",10501,"Grand Falls-Windsor","NL",48.92696,-55.65966,2018-04-21 17:00:00,35,0,35
"20184",10501,"Grand Falls-Windsor","NL",48.92696,-55.65966,2018-04-21 18:00:00,35,0,35
"20185",10501,"Grand Falls-Windsor","NL",48.92696,-55.65966,2018-04-21 19:00:00,35,0,35
"20186",10501,"Grand Falls-Windsor","NL",48.92696,-55.65966,2018-04-21 20:00:00,35,0,35
"20187",10501,"Grand Falls-Windsor","NL",48.92696,-55.65966,2018-04-21 21:00:00,35,0,35
"20188",10501,"Grand Falls-Windsor","NL",48.92696,-55.65966,2018-04-21 22:00:00,35,0,35
"20189",10501,"Grand Falls-Windsor","NL",48.92696,-55.65966,2018-04-21 23:00:00,35,0,35
"20190",10501,"Grand Falls-Windsor","NL",48.92696,-55.65966,2018-04-22 00:00:00,35,0,35
"20191",10501,"Grand Falls-Windsor","NL",48.92696,-55.65966,2018-04-22 01:00:00,35,0,35
"20192",10501,"Grand Falls-Windsor","NL",48.92696,-55.65966,2018-04-22 02:00:00,35,0,35
"20193",10501,"Grand Falls-Windsor","NL",48.92696,-55.65966,2018-04-22 03:00:00,35,0,35
"20194",10501,"Grand Falls-Windsor","NL",48.92696,-55.65966,2018-04-22 04:00:00,36,0,36
"20195",10501,"Grand Falls-Windsor","NL",48.92696,-55.65966,2018-04-22 05:00:00,36,2,38
"20196",10501,"Grand Falls-Windsor","NL",48.92696,-55.65966,2018-04-22 06:00:00,37,0,37
"20197",10501,"Grand Falls-Windsor","NL",48.92696,-55.65966,2018-04-22 07:00:00,38,0,38
"20198",10501,"Grand Falls-Windsor","NL",48.92696,-55.65966,2018-04-22 08:00:00,38,0,38
"20199",10501,"Grand Falls-Windsor","NL",48.92696,-55.65966,2018-04-22 09:00:00,38,0,38
"20200",10501,"Grand Falls-Windsor","NL",48.92696,-55.65966,2018-04-22 10:00:00,38,0,38
"20201",10501,"Grand Falls-Windsor","NL",48.92696,-55.65966,2018-04-22 11:00:00,38,0,38
"20202",10501,"Grand Falls-Windsor","NL",48.92696,-55.65966,2018-04-22 12:00:00,38,0,38
"20203",10501,"Grand Falls-Windsor","NL",48.92696,-55.65966,2018-04-22 13:00:00,38,0,38
"20204",10501,"Grand Falls-Windsor","NL",48.92696,-55.65966,2018-04-22 14:00:00,39,0,39
"20205",10501,"Grand Falls-Windsor","NL",48.92696,-55.65966,2018-04-22 15:00:00,39,0,39
"20206",10501,"Grand Falls-Windsor","NL",48.92696,-55.65966,2018-04-22 16:00:00,39,0,39
"20207",10501,"Grand Falls-Windsor","NL",48.92696,-55.65966,2018-04-22 17:00:00,40,0,40
"20208",10501,"Grand Falls-Windsor","NL",48.92696,-55.65966,2018-04-22 18:00:00,40,0,40
"20209",10501,"Grand Falls-Windsor","NL",48.92696,-55.65966,2018-04-22 19:00:00,39,1,40
"20210",10501,"Grand Falls-Windsor","NL",48.92696,-55.65966,2018-04-22 20:00:00,39,1,40
"20211",10501,"Grand Falls-Windsor","NL",48.92696,-55.65966,2018-04-22 21:00:00,39,2,41
"20212",10501,"Grand Falls-Windsor","NL",48.92696,-55.65966,2018-04-22 22:00:00,37,1,38
"20213",10501,"Grand Falls-Windsor","NL",48.92696,-55.65966,2018-04-22 23:00:00,31,0,31
"20214",10501,"Grand Falls-Windsor","NL",48.92696,-55.65966,2018-04-23 00:00:00,30,0,30
"20215",10501,"Grand Falls-Windsor","NL",48.92696,-55.65966,2018-04-23 01:00:00,32,0,32
"20216",10501,"Grand Falls-Windsor","NL",48.92696,-55.65966,2018-04-23 02:00:00,37,0,37
"20217",10501,"Grand Falls-Windsor","NL",48.92696,-55.65966,2018-04-23 03:00:00,36,0,36
"20218",10501,"Grand Falls-Windsor","NL",48.92696,-55.65966,2018-04-23 04:00:00,34,0,34
"20219",10501,"Grand Falls-Windsor","NL",48.92696,-55.65966,2018-04-23 05:00:00,36,1,37
"20220",10501,"Grand Falls-Windsor","NL",48.92696,-55.65966,2018-04-23 06:00:00,38,1,39
"20221",10501,"Grand Falls-Windsor","NL",48.92696,-55.65966,2018-04-23 07:00:00,40,0,40
"20222",10501,"Grand Falls-Windsor","NL",48.92696,-55.65966,2018-04-23 08:00:00,40,0,40
"20223",10501,"Grand Falls-Windsor","NL",48.92696,-55.65966,2018-04-23 09:00:00,40,0,40
"20224",10501,"Grand Falls-Windsor","NL",48.92696,-55.65966,2018-04-23 10:00:00,41,0,41
"20225",10501,"Grand Falls-Windsor","NL",48.92696,-55.65966,2018-04-23 11:00:00,42,0,42
"20226",10501,"Grand Falls-Windsor","NL",48.92696,-55.65966,2018-04-23 12:00:00,43,0,43
"20227",10501,"Grand Falls-Windsor","NL",48.92696,-55.65966,2018-04-23 13:00:00,44,0,44
"20228",10501,"Grand Falls-Windsor","NL",48.92696,-55.65966,2018-04-23 14:00:00,43,0,43
"20229",10501,"Grand Falls-Windsor","NL",48.92696,-55.65966,2018-04-23 15:00:00,44,0,44
"20230",10501,"Grand Falls-Windsor","NL",48.92696,-55.65966,2018-04-23 16:00:00,44,0,44
"20231",10501,"Grand Falls-Windsor","NL",48.92696,-55.65966,2018-04-23 17:00:00,44,0,44
"20232",10501,"Grand Falls-Windsor","NL",48.92696,-55.65966,2018-04-23 18:00:00,44,0,44
"20233",10501,"Grand Falls-Windsor","NL",48.92696,-55.65966,2018-04-23 19:00:00,44,0,44
"20234",10501,"Grand Falls-Windsor","NL",48.92696,-55.65966,2018-04-23 20:00:00,44,0,44
"20235",10501,"Grand Falls-Windsor","NL",48.92696,-55.65966,2018-04-23 21:00:00,43,0,43
"20236",10501,"Grand Falls-Windsor","NL",48.92696,-55.65966,2018-04-23 22:00:00,40,1,41
"20237",10501,"Grand Falls-Windsor","NL",48.92696,-55.65966,2018-04-23 23:00:00,41,0,41
"20238",10501,"Grand Falls-Windsor","NL",48.92696,-55.65966,2018-04-24 00:00:00,41,0,41
"20239",10501,"Grand Falls-Windsor","NL",48.92696,-55.65966,2018-04-24 01:00:00,39,0,39
"20240",10501,"Grand Falls-Windsor","NL",48.92696,-55.65966,2018-04-24 02:00:00,39,0,39
"20241",10501,"Grand Falls-Windsor","NL",48.92696,-55.65966,2018-04-24 03:00:00,40,0,40
"20242",10501,"Grand Falls-Windsor","NL",48.92696,-55.65966,2018-04-24 04:00:00,40,0,40
"20243",10501,"Grand Falls-Windsor","NL",48.92696,-55.65966,2018-04-24 05:00:00,40,0,40
"20244",10501,"Grand Falls-Windsor","NL",48.92696,-55.65966,2018-04-24 06:00:00,41,0,41
"20245",10501,"Grand Falls-Windsor","NL",48.92696,-55.65966,2018-04-24 07:00:00,41,0,41
"20246",10501,"Grand Falls-Windsor","NL",48.92696,-55.65966,2018-04-24 08:00:00,41,0,41
"20247",10501,"Grand Falls-Windsor","NL",48.92696,-55.65966,2018-04-24 09:00:00,42,1,43
"20248",10501,"Grand Falls-Windsor","NL",48.92696,-55.65966,2018-04-24 10:00:00,44,0,44
"20249",10501,"Grand Falls-Windsor","NL",48.92696,-55.65966,2018-04-24 11:00:00,45,0,45
"20250",10501,"Grand Falls-Windsor","NL",48.92696,-55.65966,2018-04-24 12:00:00,45,0,45
"20251",10501,"Grand Falls-Windsor","NL",48.92696,-55.65966,2018-04-24 13:00:00,46,0,46
"20252",10501,"Grand Falls-Windsor","NL",48.92696,-55.65966,2018-04-24 14:00:00,46,0,46
"20253",10501,"Grand Falls-Windsor","NL",48.92696,-55.65966,2018-04-24 15:00:00,46,0,46
"20254",10501,"Grand Falls-Windsor","NL",48.92696,-55.65966,2018-04-24 16:00:00,46,0,46
"20255",10501,"Grand Falls-Windsor","NL",48.92696,-55.65966,2018-04-24 17:00:00,46,0,46
"20256",10501,"Grand Falls-Windsor","NL",48.92696,-55.65966,2018-04-24 18:00:00,47,0,47
"20257",10501,"Grand Falls-Windsor","NL",48.92696,-55.65966,2018-04-24 19:00:00,46,0,46
"20258",10501,"Grand Falls-Windsor","NL",48.92696,-55.65966,2018-04-24 20:00:00,45,0,45
"20259",10501,"Grand Falls-Windsor","NL",48.92696,-55.65966,2018-04-24 21:00:00,44,0,44
"20260",10501,"Grand Falls-Windsor","NL",48.92696,-55.65966,2018-04-24 22:00:00,44,0,44
"20261",10501,"Grand Falls-Windsor","NL",48.92696,-55.65966,2018-04-24 23:00:00,43,0,43
"20262",10501,"Grand Falls-Windsor","NL",48.92696,-55.65966,2018-04-25 00:00:00,43,0,43
"20263",10501,"Grand Falls-Windsor","NL",48.92696,-55.65966,2018-04-25 01:00:00,43,0,43
"20264",10501,"Grand Falls-Windsor","NL",48.92696,-55.65966,2018-04-25 02:00:00,42,0,42
"20265",10501,"Grand Falls-Windsor","NL",48.92696,-55.65966,2018-04-25 03:00:00,44,0,44
"20266",10501,"Grand Falls-Windsor","NL",48.92696,-55.65966,2018-04-25 04:00:00,43,0,43
"20267",10501,"Grand Falls-Windsor","NL",48.92696,-55.65966,2018-04-25 05:00:00,42,0,42
"20268",10501,"Grand Falls-Windsor","NL",48.92696,-55.65966,2018-04-25 06:00:00,42,0,42
"20269",10501,"Grand Falls-Windsor","NL",48.92696,-55.65966,2018-04-25 07:00:00,40,0,40
"20270",10501,"Grand Falls-Windsor","NL",48.92696,-55.65966,2018-04-25 08:00:00,41,0,41
"20271",10501,"Grand Falls-Windsor","NL",48.92696,-55.65966,2018-04-25 09:00:00,43,0,43
"20272",10501,"Grand Falls-Windsor","NL",48.92696,-55.65966,2018-04-25 10:00:00,44,0,44
"20273",10501,"Grand Falls-Windsor","NL",48.92696,-55.65966,2018-04-25 11:00:00,46,0,46
"20274",10501,"Grand Falls-Windsor","NL",48.92696,-55.65966,2018-04-25 12:00:00,48,1,49
"20275",10501,"Grand Falls-Windsor","NL",48.92696,-55.65966,2018-04-25 13:00:00,48,1,49
"20276",10501,"Grand Falls-Windsor","NL",48.92696,-55.65966,2018-04-25 14:00:00,48,0,48
"20277",10501,"Grand Falls-Windsor","NL",48.92696,-55.65966,2018-04-25 15:00:00,47,0,47
"20278",10501,"Grand Falls-Windsor","NL",48.92696,-55.65966,2018-04-25 16:00:00,48,0,48
"20279",10501,"Grand Falls-Windsor","NL",48.92696,-55.65966,2018-04-25 17:00:00,49,0,49
"20280",10501,"Grand Falls-Windsor","NL",48.92696,-55.65966,2018-04-25 18:00:00,48,0,48
"20281",10501,"Grand Falls-Windsor","NL",48.92696,-55.65966,2018-04-25 19:00:00,47,0,47
"20282",10501,"Grand Falls-Windsor","NL",48.92696,-55.65966,2018-04-25 20:00:00,46,1,47
"20283",10501,"Grand Falls-Windsor","NL",48.92696,-55.65966,2018-04-25 21:00:00,47,0,47
"20284",10501,"Grand Falls-Windsor","NL",48.92696,-55.65966,2018-04-25 22:00:00,47,1,48
"20285",10501,"Grand Falls-Windsor","NL",48.92696,-55.65966,2018-04-25 23:00:00,47,0,47
"20286",10501,"Grand Falls-Windsor","NL",48.92696,-55.65966,2018-04-26 00:00:00,46,0,46
"20287",10501,"Grand Falls-Windsor","NL",48.92696,-55.65966,2018-04-26 01:00:00,45,0,45
"20288",10501,"Grand Falls-Windsor","NL",48.92696,-55.65966,2018-04-26 02:00:00,43,0,43
"20289",10501,"Grand Falls-Windsor","NL",48.92696,-55.65966,2018-04-26 03:00:00,41,0,41
"20290",10501,"Grand Falls-Windsor","NL",48.92696,-55.65966,2018-04-26 04:00:00,37,0,37
"20291",10501,"Grand Falls-Windsor","NL",48.92696,-55.65966,2018-04-26 05:00:00,37,1,38
"20292",10501,"Grand Falls-Windsor","NL",48.92696,-55.65966,2018-04-26 06:00:00,34,1,35
"20293",10501,"Grand Falls-Windsor","NL",48.92696,-55.65966,2018-04-26 07:00:00,36,1,37
"20294",10501,"Grand Falls-Windsor","NL",48.92696,-55.65966,2018-04-26 08:00:00,37,1,38
"20295",10501,"Grand Falls-Windsor","NL",48.92696,-55.65966,2018-04-26 09:00:00,40,0,40
"20296",10501,"Grand Falls-Windsor","NL",48.92696,-55.65966,2018-04-26 10:00:00,40,0,40
"20297",10501,"Grand Falls-Windsor","NL",48.92696,-55.65966,2018-04-26 11:00:00,39,0,39
"20298",10501,"Grand Falls-Windsor","NL",48.92696,-55.65966,2018-04-26 12:00:00,40,0,40
"20299",10501,"Grand Falls-Windsor","NL",48.92696,-55.65966,2018-04-26 13:00:00,40,0,40
"20300",10501,"Grand Falls-Windsor","NL",48.92696,-55.65966,2018-04-26 14:00:00,41,0,41
"20301",10501,"Grand Falls-Windsor","NL",48.92696,-55.65966,2018-04-26 15:00:00,41,0,41
"20302",10501,"Grand Falls-Windsor","NL",48.92696,-55.65966,2018-04-26 16:00:00,43,0,43
"20303",10501,"Grand Falls-Windsor","NL",48.92696,-55.65966,2018-04-26 17:00:00,42,0,42
"20304",10501,"Grand Falls-Windsor","NL",48.92696,-55.65966,2018-04-26 18:00:00,41,NA,NA
"20305",10501,"Grand Falls-Windsor","NL",48.92696,-55.65966,2018-04-26 19:00:00,40,NA,NA
"20306",10501,"Grand Falls-Windsor","NL",48.92696,-55.65966,2018-04-26 20:00:00,41,0,41
"20307",10501,"Grand Falls-Windsor","NL",48.92696,-55.65966,2018-04-26 21:00:00,40,0,40
"20308",10501,"Grand Falls-Windsor","NL",48.92696,-55.65966,2018-04-26 22:00:00,39,0,39
"20309",10501,"Grand Falls-Windsor","NL",48.92696,-55.65966,2018-04-26 23:00:00,37,0,37
"20310",10501,"Grand Falls-Windsor","NL",48.92696,-55.65966,2018-04-27 00:00:00,36,0,36
"20311",10501,"Grand Falls-Windsor","NL",48.92696,-55.65966,2018-04-27 01:00:00,36,0,36
"20312",10501,"Grand Falls-Windsor","NL",48.92696,-55.65966,2018-04-27 02:00:00,36,0,36
"20313",10501,"Grand Falls-Windsor","NL",48.92696,-55.65966,2018-04-27 03:00:00,35,0,35
"20314",10501,"Grand Falls-Windsor","NL",48.92696,-55.65966,2018-04-27 04:00:00,35,0,35
"20315",10501,"Grand Falls-Windsor","NL",48.92696,-55.65966,2018-04-27 05:00:00,35,0,35
"20316",10501,"Grand Falls-Windsor","NL",48.92696,-55.65966,2018-04-27 06:00:00,36,0,36
"20317",10501,"Grand Falls-Windsor","NL",48.92696,-55.65966,2018-04-27 07:00:00,38,0,38
"20318",10501,"Grand Falls-Windsor","NL",48.92696,-55.65966,2018-04-27 08:00:00,39,0,39
"20319",10501,"Grand Falls-Windsor","NL",48.92696,-55.65966,2018-04-27 09:00:00,39,NA,NA
"20320",10501,"Grand Falls-Windsor","NL",48.92696,-55.65966,2018-04-27 10:00:00,39,0,39
"20321",10501,"Grand Falls-Windsor","NL",48.92696,-55.65966,2018-04-27 11:00:00,39,1,40
"20322",10501,"Grand Falls-Windsor","NL",48.92696,-55.65966,2018-04-27 12:00:00,39,0,39
"20323",10501,"Grand Falls-Windsor","NL",48.92696,-55.65966,2018-04-27 13:00:00,38,0,38
"20324",10501,"Grand Falls-Windsor","NL",48.92696,-55.65966,2018-04-27 14:00:00,36,0,36
"20325",10501,"Grand Falls-Windsor","NL",48.92696,-55.65966,2018-04-27 15:00:00,34,0,34
"20326",10501,"Grand Falls-Windsor","NL",48.92696,-55.65966,2018-04-27 16:00:00,33,0,33
"20327",10501,"Grand Falls-Windsor","NL",48.92696,-55.65966,2018-04-27 17:00:00,31,0,31
"20328",10501,"Grand Falls-Windsor","NL",48.92696,-55.65966,2018-04-27 18:00:00,30,0,30
"20329",10501,"Grand Falls-Windsor","NL",48.92696,-55.65966,2018-04-27 19:00:00,30,0,30
"20330",10501,"Grand Falls-Windsor","NL",48.92696,-55.65966,2018-04-27 20:00:00,29,0,29
"20331",10501,"Grand Falls-Windsor","NL",48.92696,-55.65966,2018-04-27 21:00:00,28,0,28
"20332",10501,"Grand Falls-Windsor","NL",48.92696,-55.65966,2018-04-27 22:00:00,28,0,28
"20333",10501,"Grand Falls-Windsor","NL",48.92696,-55.65966,2018-04-27 23:00:00,26,0,26
"20334",10501,"Grand Falls-Windsor","NL",48.92696,-55.65966,2018-04-28 00:00:00,23,0,23
"20335",10501,"Grand Falls-Windsor","NL",48.92696,-55.65966,2018-04-28 01:00:00,20,0,20
"20336",10501,"Grand Falls-Windsor","NL",48.92696,-55.65966,2018-04-28 02:00:00,18,0,18
"20337",10501,"Grand Falls-Windsor","NL",48.92696,-55.65966,2018-04-28 03:00:00,19,0,19
"20338",10501,"Grand Falls-Windsor","NL",48.92696,-55.65966,2018-04-28 04:00:00,20,1,21
"20339",10501,"Grand Falls-Windsor","NL",48.92696,-55.65966,2018-04-28 05:00:00,17,0,17
"20340",10501,"Grand Falls-Windsor","NL",48.92696,-55.65966,2018-04-28 06:00:00,17,0,17
"20341",10501,"Grand Falls-Windsor","NL",48.92696,-55.65966,2018-04-28 07:00:00,23,0,23
"20342",10501,"Grand Falls-Windsor","NL",48.92696,-55.65966,2018-04-28 08:00:00,25,0,25
"20343",10501,"Grand Falls-Windsor","NL",48.92696,-55.65966,2018-04-28 09:00:00,26,0,26
"20344",10501,"Grand Falls-Windsor","NL",48.92696,-55.65966,2018-04-28 10:00:00,28,0,28
"20345",10501,"Grand Falls-Windsor","NL",48.92696,-55.65966,2018-04-28 11:00:00,33,1,34
"20346",10501,"Grand Falls-Windsor","NL",48.92696,-55.65966,2018-04-28 12:00:00,42,0,42
"20347",10501,"Grand Falls-Windsor","NL",48.92696,-55.65966,2018-04-28 13:00:00,42,0,42
"20348",10501,"Grand Falls-Windsor","NL",48.92696,-55.65966,2018-04-28 14:00:00,40,0,40
"20349",10501,"Grand Falls-Windsor","NL",48.92696,-55.65966,2018-04-28 15:00:00,33,0,33
"20350",10501,"Grand Falls-Windsor","NL",48.92696,-55.65966,2018-04-28 16:00:00,29,0,29
"20351",10501,"Grand Falls-Windsor","NL",48.92696,-55.65966,2018-04-28 17:00:00,27,0,27
"20352",10501,"Grand Falls-Windsor","NL",48.92696,-55.65966,2018-04-28 18:00:00,25,0,25
"20353",10501,"Grand Falls-Windsor","NL",48.92696,-55.65966,2018-04-28 19:00:00,23,0,23
"20354",10501,"Grand Falls-Windsor","NL",48.92696,-55.65966,2018-04-28 20:00:00,24,0,24
"20355",10501,"Grand Falls-Windsor","NL",48.92696,-55.65966,2018-04-28 21:00:00,25,0,25
"20356",10501,"Grand Falls-Windsor","NL",48.92696,-55.65966,2018-04-28 22:00:00,25,0,25
"20357",10501,"Grand Falls-Windsor","NL",48.92696,-55.65966,2018-04-28 23:00:00,26,0,26
"20358",10501,"Grand Falls-Windsor","NL",48.92696,-55.65966,2018-04-29 00:00:00,26,0,26
"20359",10501,"Grand Falls-Windsor","NL",48.92696,-55.65966,2018-04-29 01:00:00,26,0,26
"20360",10501,"Grand Falls-Windsor","NL",48.92696,-55.65966,2018-04-29 02:00:00,26,NA,NA
"20361",10501,"Grand Falls-Windsor","NL",48.92696,-55.65966,2018-04-29 03:00:00,26,NA,NA
"20362",10501,"Grand Falls-Windsor","NL",48.92696,-55.65966,2018-04-29 04:00:00,26,0,26
"20363",10501,"Grand Falls-Windsor","NL",48.92696,-55.65966,2018-04-29 05:00:00,24,0,24
"20364",10501,"Grand Falls-Windsor","NL",48.92696,-55.65966,2018-04-29 06:00:00,23,0,23
"20365",10501,"Grand Falls-Windsor","NL",48.92696,-55.65966,2018-04-29 07:00:00,23,0,23
"20366",10501,"Grand Falls-Windsor","NL",48.92696,-55.65966,2018-04-29 08:00:00,24,0,24
"20367",10501,"Grand Falls-Windsor","NL",48.92696,-55.65966,2018-04-29 09:00:00,24,0,24
"20368",10501,"Grand Falls-Windsor","NL",48.92696,-55.65966,2018-04-29 10:00:00,26,0,26
"20369",10501,"Grand Falls-Windsor","NL",48.92696,-55.65966,2018-04-29 11:00:00,25,0,25
"20370",10501,"Grand Falls-Windsor","NL",48.92696,-55.65966,2018-04-29 12:00:00,24,0,24
"20371",10501,"Grand Falls-Windsor","NL",48.92696,-55.65966,2018-04-29 13:00:00,22,0,22
"20372",10501,"Grand Falls-Windsor","NL",48.92696,-55.65966,2018-04-29 14:00:00,21,1,22
"20373",10501,"Grand Falls-Windsor","NL",48.92696,-55.65966,2018-04-29 15:00:00,20,1,21
"20374",10501,"Grand Falls-Windsor","NL",48.92696,-55.65966,2018-04-29 16:00:00,23,0,23
"20375",10501,"Grand Falls-Windsor","NL",48.92696,-55.65966,2018-04-29 17:00:00,23,0,23
"20376",10501,"Grand Falls-Windsor","NL",48.92696,-55.65966,2018-04-29 18:00:00,22,0,22
"20377",10501,"Grand Falls-Windsor","NL",48.92696,-55.65966,2018-04-29 19:00:00,22,1,23
"20378",10501,"Grand Falls-Windsor","NL",48.92696,-55.65966,2018-04-29 20:00:00,25,0,25
"20379",10501,"Grand Falls-Windsor","NL",48.92696,-55.65966,2018-04-29 21:00:00,27,1,28
"20380",10501,"Grand Falls-Windsor","NL",48.92696,-55.65966,2018-04-29 22:00:00,30,0,30
"20381",10501,"Grand Falls-Windsor","NL",48.92696,-55.65966,2018-04-29 23:00:00,31,0,31
"20382",10501,"Grand Falls-Windsor","NL",48.92696,-55.65966,2018-04-30 00:00:00,32,0,32
"20383",10501,"Grand Falls-Windsor","NL",48.92696,-55.65966,2018-04-30 01:00:00,32,0,32
"20384",10501,"Grand Falls-Windsor","NL",48.92696,-55.65966,2018-04-30 02:00:00,32,1,33
"20385",10501,"Grand Falls-Windsor","NL",48.92696,-55.65966,2018-04-30 03:00:00,31,0,31
"20386",10501,"Grand Falls-Windsor","NL",48.92696,-55.65966,2018-04-30 04:00:00,31,1,32
"20387",10501,"Grand Falls-Windsor","NL",48.92696,-55.65966,2018-04-30 05:00:00,31,1,32
"20388",10501,"Grand Falls-Windsor","NL",48.92696,-55.65966,2018-04-30 06:00:00,30,1,31
"20389",10501,"Grand Falls-Windsor","NL",48.92696,-55.65966,2018-04-30 07:00:00,30,1,31
"20390",10501,"Grand Falls-Windsor","NL",48.92696,-55.65966,2018-04-30 08:00:00,30,1,31
"20391",10501,"Grand Falls-Windsor","NL",48.92696,-55.65966,2018-04-30 09:00:00,30,1,31
"20392",10501,"Grand Falls-Windsor","NL",48.92696,-55.65966,2018-04-30 10:00:00,31,1,32
"20393",10501,"Grand Falls-Windsor","NL",48.92696,-55.65966,2018-04-30 11:00:00,31,1,32
"20394",10501,"Grand Falls-Windsor","NL",48.92696,-55.65966,2018-04-30 12:00:00,30,0,30
"20395",10501,"Grand Falls-Windsor","NL",48.92696,-55.65966,2018-04-30 13:00:00,30,0,30
"20396",10501,"Grand Falls-Windsor","NL",48.92696,-55.65966,2018-04-30 14:00:00,30,1,31
"20397",10501,"Grand Falls-Windsor","NL",48.92696,-55.65966,2018-04-30 15:00:00,29,0,29
"20398",10501,"Grand Falls-Windsor","NL",48.92696,-55.65966,2018-04-30 16:00:00,29,0,29
"20399",10501,"Grand Falls-Windsor","NL",48.92696,-55.65966,2018-04-30 17:00:00,28,1,29
"20400",10501,"Grand Falls-Windsor","NL",48.92696,-55.65966,2018-04-30 18:00:00,27,1,28
"20401",10501,"Grand Falls-Windsor","NL",48.92696,-55.65966,2018-04-30 19:00:00,26,1,27
"20402",10501,"Grand Falls-Windsor","NL",48.92696,-55.65966,2018-04-30 20:00:00,23,2,25
"20403",10501,"Grand Falls-Windsor","NL",48.92696,-55.65966,2018-04-30 21:00:00,18,2,20
"20404",10501,"Grand Falls-Windsor","NL",48.92696,-55.65966,2018-04-30 22:00:00,10,1,11
"20405",10501,"Grand Falls-Windsor","NL",48.92696,-55.65966,2018-04-30 23:00:00,9,1,10
"20406",10501,"Grand Falls-Windsor","NL",48.92696,-55.65966,2018-05-01 00:00:00,5,1,6
"20407",10501,"Grand Falls-Windsor","NL",48.92696,-55.65966,2018-05-01 01:00:00,10,1,11
"20408",10501,"Grand Falls-Windsor","NL",48.92696,-55.65966,2018-05-01 02:00:00,13,1,14
"20409",10501,"Grand Falls-Windsor","NL",48.92696,-55.65966,2018-05-01 03:00:00,5,2,7
"20410",10501,"Grand Falls-Windsor","NL",48.92696,-55.65966,2018-05-01 04:00:00,5,0,5
"20411",10501,"Grand Falls-Windsor","NL",48.92696,-55.65966,2018-05-01 05:00:00,5,1,6
"20412",10501,"Grand Falls-Windsor","NL",48.92696,-55.65966,2018-05-01 06:00:00,2,1,3
"20413",10501,"Grand Falls-Windsor","NL",48.92696,-55.65966,2018-05-01 07:00:00,3,1,4
"20414",10501,"Grand Falls-Windsor","NL",48.92696,-55.65966,2018-05-01 08:00:00,6,1,7
"20415",10501,"Grand Falls-Windsor","NL",48.92696,-55.65966,2018-05-01 09:00:00,13,1,14
"20416",10501,"Grand Falls-Windsor","NL",48.92696,-55.65966,2018-05-01 10:00:00,19,1,20
"20417",10501,"Grand Falls-Windsor","NL",48.92696,-55.65966,2018-05-01 11:00:00,22,1,23
"20418",10501,"Grand Falls-Windsor","NL",48.92696,-55.65966,2018-05-01 12:00:00,22,1,23
"20419",10501,"Grand Falls-Windsor","NL",48.92696,-55.65966,2018-05-01 13:00:00,21,1,22
"20420",10501,"Grand Falls-Windsor","NL",48.92696,-55.65966,2018-05-01 14:00:00,21,1,22
"20421",10501,"Grand Falls-Windsor","NL",48.92696,-55.65966,2018-05-01 15:00:00,23,1,24
"20422",10501,"Grand Falls-Windsor","NL",48.92696,-55.65966,2018-05-01 16:00:00,23,1,24
"20423",10501,"Grand Falls-Windsor","NL",48.92696,-55.65966,2018-05-01 17:00:00,25,1,26
"20424",10501,"Grand Falls-Windsor","NL",48.92696,-55.65966,2018-05-01 18:00:00,24,1,25
"20425",10501,"Grand Falls-Windsor","NL",48.92696,-55.65966,2018-05-01 19:00:00,21,1,22
"20426",10501,"Grand Falls-Windsor","NL",48.92696,-55.65966,2018-05-01 20:00:00,20,1,21
"20427",10501,"Grand Falls-Windsor","NL",48.92696,-55.65966,2018-05-01 21:00:00,17,2,19
"20428",10501,"Grand Falls-Windsor","NL",48.92696,-55.65966,2018-05-01 22:00:00,15,1,16
"20429",10501,"Grand Falls-Windsor","NL",48.92696,-55.65966,2018-05-01 23:00:00,13,1,14
"20430",10501,"Grand Falls-Windsor","NL",48.92696,-55.65966,2018-05-02 00:00:00,12,1,13
"20431",10501,"Grand Falls-Windsor","NL",48.92696,-55.65966,2018-05-02 01:00:00,11,1,12
"20432",10501,"Grand Falls-Windsor","NL",48.92696,-55.65966,2018-05-02 02:00:00,10,1,11
"20433",10501,"Grand Falls-Windsor","NL",48.92696,-55.65966,2018-05-02 03:00:00,9,1,10
"20434",10501,"Grand Falls-Windsor","NL",48.92696,-55.65966,2018-05-02 04:00:00,10,1,11
"20435",10501,"Grand Falls-Windsor","NL",48.92696,-55.65966,2018-05-02 05:00:00,12,0,12
"20436",10501,"Grand Falls-Windsor","NL",48.92696,-55.65966,2018-05-02 06:00:00,15,0,15
"20437",10501,"Grand Falls-Windsor","NL",48.92696,-55.65966,2018-05-02 07:00:00,17,0,17
"20438",10501,"Grand Falls-Windsor","NL",48.92696,-55.65966,2018-05-02 08:00:00,16,1,17
"20439",10501,"Grand Falls-Windsor","NL",48.92696,-55.65966,2018-05-02 09:00:00,16,0,16
"20440",10501,"Grand Falls-Windsor","NL",48.92696,-55.65966,2018-05-02 10:00:00,18,0,18
"20441",10501,"Grand Falls-Windsor","NL",48.92696,-55.65966,2018-05-02 11:00:00,22,1,23
"20442",10501,"Grand Falls-Windsor","NL",48.92696,-55.65966,2018-05-02 12:00:00,24,1,25
"20443",10501,"Grand Falls-Windsor","NL",48.92696,-55.65966,2018-05-02 13:00:00,25,0,25
"20444",10501,"Grand Falls-Windsor","NL",48.92696,-55.65966,2018-05-02 14:00:00,25,0,25
"20445",10501,"Grand Falls-Windsor","NL",48.92696,-55.65966,2018-05-02 15:00:00,26,1,27
"20446",10501,"Grand Falls-Windsor","NL",48.92696,-55.65966,2018-05-02 16:00:00,25,0,25
"20447",10501,"Grand Falls-Windsor","NL",48.92696,-55.65966,2018-05-02 17:00:00,26,0,26
"20448",10501,"Grand Falls-Windsor","NL",48.92696,-55.65966,2018-05-02 18:00:00,30,1,31
"20449",10501,"Grand Falls-Windsor","NL",48.92696,-55.65966,2018-05-02 19:00:00,27,0,27
"20450",10501,"Grand Falls-Windsor","NL",48.92696,-55.65966,2018-05-02 20:00:00,24,0,24
"20451",10501,"Grand Falls-Windsor","NL",48.92696,-55.65966,2018-05-02 21:00:00,23,0,23
"20452",10501,"Grand Falls-Windsor","NL",48.92696,-55.65966,2018-05-02 22:00:00,24,0,24
"20453",10501,"Grand Falls-Windsor","NL",48.92696,-55.65966,2018-05-02 23:00:00,25,0,25
"20454",10501,"Grand Falls-Windsor","NL",48.92696,-55.65966,2018-05-03 00:00:00,25,0,25
"20455",10501,"Grand Falls-Windsor","NL",48.92696,-55.65966,2018-05-03 01:00:00,27,1,28
"20456",10501,"Grand Falls-Windsor","NL",48.92696,-55.65966,2018-05-03 02:00:00,24,1,25
"20457",10501,"Grand Falls-Windsor","NL",48.92696,-55.65966,2018-05-03 03:00:00,30,0,30
"20458",10501,"Grand Falls-Windsor","NL",48.92696,-55.65966,2018-05-03 04:00:00,33,0,33
"20459",10501,"Grand Falls-Windsor","NL",48.92696,-55.65966,2018-05-03 05:00:00,35,1,36
"20460",10501,"Grand Falls-Windsor","NL",48.92696,-55.65966,2018-05-03 06:00:00,38,1,39
"20461",10501,"Grand Falls-Windsor","NL",48.92696,-55.65966,2018-05-03 07:00:00,34,1,35
"20462",10501,"Grand Falls-Windsor","NL",48.92696,-55.65966,2018-05-03 08:00:00,35,1,36
"20463",10501,"Grand Falls-Windsor","NL",48.92696,-55.65966,2018-05-03 09:00:00,36,2,38
"20464",10501,"Grand Falls-Windsor","NL",48.92696,-55.65966,2018-05-03 10:00:00,37,1,38
"20465",10501,"Grand Falls-Windsor","NL",48.92696,-55.65966,2018-05-03 11:00:00,36,1,37
"20466",10501,"Grand Falls-Windsor","NL",48.92696,-55.65966,2018-05-03 12:00:00,35,1,36
"20467",10501,"Grand Falls-Windsor","NL",48.92696,-55.65966,2018-05-03 13:00:00,35,1,36
"20468",10501,"Grand Falls-Windsor","NL",48.92696,-55.65966,2018-05-03 14:00:00,35,1,36
"20469",10501,"Grand Falls-Windsor","NL",48.92696,-55.65966,2018-05-03 15:00:00,33,1,34
"20470",10501,"Grand Falls-Windsor","NL",48.92696,-55.65966,2018-05-03 16:00:00,31,1,32
"20471",10501,"Grand Falls-Windsor","NL",48.92696,-55.65966,2018-05-03 17:00:00,29,1,30
"20472",10501,"Grand Falls-Windsor","NL",48.92696,-55.65966,2018-05-03 18:00:00,29,1,30
"20473",10501,"Grand Falls-Windsor","NL",48.92696,-55.65966,2018-05-03 19:00:00,30,1,31
"20474",10501,"Grand Falls-Windsor","NL",48.92696,-55.65966,2018-05-03 20:00:00,30,1,31
"20475",10501,"Grand Falls-Windsor","NL",48.92696,-55.65966,2018-05-03 21:00:00,31,1,32
"20476",10501,"Grand Falls-Windsor","NL",48.92696,-55.65966,2018-05-03 22:00:00,32,1,33
"20477",10501,"Grand Falls-Windsor","NL",48.92696,-55.65966,2018-05-03 23:00:00,31,1,32
"20478",10501,"Grand Falls-Windsor","NL",48.92696,-55.65966,2018-05-04 00:00:00,31,1,32
"20479",10501,"Grand Falls-Windsor","NL",48.92696,-55.65966,2018-05-04 01:00:00,32,1,33
"20480",10501,"Grand Falls-Windsor","NL",48.92696,-55.65966,2018-05-04 02:00:00,32,1,33
"20481",10501,"Grand Falls-Windsor","NL",48.92696,-55.65966,2018-05-04 03:00:00,32,0,32
"20482",10501,"Grand Falls-Windsor","NL",48.92696,-55.65966,2018-05-04 04:00:00,32,1,33
"20483",10501,"Grand Falls-Windsor","NL",48.92696,-55.65966,2018-05-04 05:00:00,32,0,32
"20484",10501,"Grand Falls-Windsor","NL",48.92696,-55.65966,2018-05-04 06:00:00,31,1,32
"20485",10501,"Grand Falls-Windsor","NL",48.92696,-55.65966,2018-05-04 07:00:00,30,0,30
"20486",10501,"Grand Falls-Windsor","NL",48.92696,-55.65966,2018-05-04 08:00:00,30,0,30
"20487",10501,"Grand Falls-Windsor","NL",48.92696,-55.65966,2018-05-04 09:00:00,30,0,30
"20488",10501,"Grand Falls-Windsor","NL",48.92696,-55.65966,2018-05-04 10:00:00,30,0,30
"20489",10501,"Grand Falls-Windsor","NL",48.92696,-55.65966,2018-05-04 11:00:00,30,1,31
"20490",10501,"Grand Falls-Windsor","NL",48.92696,-55.65966,2018-05-04 12:00:00,30,1,31
"20491",10501,"Grand Falls-Windsor","NL",48.92696,-55.65966,2018-05-04 13:00:00,31,0,31
"20492",10501,"Grand Falls-Windsor","NL",48.92696,-55.65966,2018-05-04 14:00:00,31,0,31
"20493",10501,"Grand Falls-Windsor","NL",48.92696,-55.65966,2018-05-04 15:00:00,31,0,31
"20494",10501,"Grand Falls-Windsor","NL",48.92696,-55.65966,2018-05-04 16:00:00,31,1,32
"20495",10501,"Grand Falls-Windsor","NL",48.92696,-55.65966,2018-05-04 17:00:00,30,0,30
"20496",10501,"Grand Falls-Windsor","NL",48.92696,-55.65966,2018-05-04 18:00:00,29,0,29
"20497",10501,"Grand Falls-Windsor","NL",48.92696,-55.65966,2018-05-04 19:00:00,28,0,28
"20498",10501,"Grand Falls-Windsor","NL",48.92696,-55.65966,2018-05-04 20:00:00,26,0,26
"20499",10501,"Grand Falls-Windsor","NL",48.92696,-55.65966,2018-05-04 21:00:00,27,0,27
"20500",10501,"Grand Falls-Windsor","NL",48.92696,-55.65966,2018-05-04 22:00:00,26,0,26
"20501",10501,"Grand Falls-Windsor","NL",48.92696,-55.65966,2018-05-04 23:00:00,24,0,24
"20502",10501,"Grand Falls-Windsor","NL",48.92696,-55.65966,2018-05-05 00:00:00,23,0,23
"20503",10501,"Grand Falls-Windsor","NL",48.92696,-55.65966,2018-05-05 01:00:00,22,0,22
"20504",10501,"Grand Falls-Windsor","NL",48.92696,-55.65966,2018-05-05 02:00:00,23,0,23
"20505",10501,"Grand Falls-Windsor","NL",48.92696,-55.65966,2018-05-05 03:00:00,23,0,23
"20506",10501,"Grand Falls-Windsor","NL",48.92696,-55.65966,2018-05-05 04:00:00,23,0,23
"20507",10501,"Grand Falls-Windsor","NL",48.92696,-55.65966,2018-05-05 05:00:00,24,0,24
"20508",10501,"Grand Falls-Windsor","NL",48.92696,-55.65966,2018-05-05 06:00:00,25,0,25
"20509",10501,"Grand Falls-Windsor","NL",48.92696,-55.65966,2018-05-05 07:00:00,26,0,26
"20510",10501,"Grand Falls-Windsor","NL",48.92696,-55.65966,2018-05-05 08:00:00,27,0,27
"20511",10501,"Grand Falls-Windsor","NL",48.92696,-55.65966,2018-05-05 09:00:00,28,0,28
"20512",10501,"Grand Falls-Windsor","NL",48.92696,-55.65966,2018-05-05 10:00:00,29,1,30
"20513",10501,"Grand Falls-Windsor","NL",48.92696,-55.65966,2018-05-05 11:00:00,28,0,28
"20514",10501,"Grand Falls-Windsor","NL",48.92696,-55.65966,2018-05-05 12:00:00,28,0,28
"20515",10501,"Grand Falls-Windsor","NL",48.92696,-55.65966,2018-05-05 13:00:00,30,0,30
"20516",10501,"Grand Falls-Windsor","NL",48.92696,-55.65966,2018-05-05 14:00:00,32,0,32
"20517",10501,"Grand Falls-Windsor","NL",48.92696,-55.65966,2018-05-05 15:00:00,33,0,33
"20518",10501,"Grand Falls-Windsor","NL",48.92696,-55.65966,2018-05-05 16:00:00,33,0,33
"20519",10501,"Grand Falls-Windsor","NL",48.92696,-55.65966,2018-05-05 17:00:00,33,0,33
"20520",10501,"Grand Falls-Windsor","NL",48.92696,-55.65966,2018-05-05 18:00:00,28,0,28
"20521",10501,"Grand Falls-Windsor","NL",48.92696,-55.65966,2018-05-05 19:00:00,25,0,25
"20522",10501,"Grand Falls-Windsor","NL",48.92696,-55.65966,2018-05-05 20:00:00,28,0,28
"20523",10501,"Grand Falls-Windsor","NL",48.92696,-55.65966,2018-05-05 21:00:00,28,0,28
"20524",10501,"Grand Falls-Windsor","NL",48.92696,-55.65966,2018-05-05 22:00:00,26,0,26
"20525",10501,"Grand Falls-Windsor","NL",48.92696,-55.65966,2018-05-05 23:00:00,26,0,26
"20526",10501,"Grand Falls-Windsor","NL",48.92696,-55.65966,2018-05-06 00:00:00,26,0,26
"20527",10501,"Grand Falls-Windsor","NL",48.92696,-55.65966,2018-05-06 01:00:00,26,0,26
"20528",10501,"Grand Falls-Windsor","NL",48.92696,-55.65966,2018-05-06 02:00:00,27,0,27
"20529",10501,"Grand Falls-Windsor","NL",48.92696,-55.65966,2018-05-06 03:00:00,28,0,28
"20530",10501,"Grand Falls-Windsor","NL",48.92696,-55.65966,2018-05-06 04:00:00,29,0,29
"20531",10501,"Grand Falls-Windsor","NL",48.92696,-55.65966,2018-05-06 05:00:00,28,0,28
"20532",10501,"Grand Falls-Windsor","NL",48.92696,-55.65966,2018-05-06 06:00:00,29,0,29
"20533",10501,"Grand Falls-Windsor","NL",48.92696,-55.65966,2018-05-06 07:00:00,30,0,30
"20534",10501,"Grand Falls-Windsor","NL",48.92696,-55.65966,2018-05-06 08:00:00,30,0,30
"20535",10501,"Grand Falls-Windsor","NL",48.92696,-55.65966,2018-05-06 09:00:00,32,0,32
"20536",10501,"Grand Falls-Windsor","NL",48.92696,-55.65966,2018-05-06 10:00:00,32,1,33
"20537",10501,"Grand Falls-Windsor","NL",48.92696,-55.65966,2018-05-06 11:00:00,33,0,33
"20538",10501,"Grand Falls-Windsor","NL",48.92696,-55.65966,2018-05-06 12:00:00,33,1,34
"20539",10501,"Grand Falls-Windsor","NL",48.92696,-55.65966,2018-05-06 13:00:00,30,0,30
"20540",10501,"Grand Falls-Windsor","NL",48.92696,-55.65966,2018-05-06 14:00:00,30,0,30
"20541",10501,"Grand Falls-Windsor","NL",48.92696,-55.65966,2018-05-06 15:00:00,32,0,32
"20542",10501,"Grand Falls-Windsor","NL",48.92696,-55.65966,2018-05-06 16:00:00,35,1,36
"20543",10501,"Grand Falls-Windsor","NL",48.92696,-55.65966,2018-05-06 17:00:00,34,0,34
"20544",10501,"Grand Falls-Windsor","NL",48.92696,-55.65966,2018-05-06 18:00:00,33,0,33
"20545",10501,"Grand Falls-Windsor","NL",48.92696,-55.65966,2018-05-06 19:00:00,33,0,33
"20546",10501,"Grand Falls-Windsor","NL",48.92696,-55.65966,2018-05-06 20:00:00,32,0,32
"20547",10501,"Grand Falls-Windsor","NL",48.92696,-55.65966,2018-05-06 21:00:00,28,1,29
"20548",10501,"Grand Falls-Windsor","NL",48.92696,-55.65966,2018-05-06 22:00:00,23,0,23
"20549",10501,"Grand Falls-Windsor","NL",48.92696,-55.65966,2018-05-06 23:00:00,22,0,22
"20550",10501,"Grand Falls-Windsor","NL",48.92696,-55.65966,2018-05-07 00:00:00,18,1,19
"20551",10501,"Grand Falls-Windsor","NL",48.92696,-55.65966,2018-05-07 01:00:00,15,1,16
"20552",10501,"Grand Falls-Windsor","NL",48.92696,-55.65966,2018-05-07 02:00:00,8,1,9
"20553",10501,"Grand Falls-Windsor","NL",48.92696,-55.65966,2018-05-07 03:00:00,8,2,10
"20554",10501,"Grand Falls-Windsor","NL",48.92696,-55.65966,2018-05-07 04:00:00,6,2,8
"20555",10501,"Grand Falls-Windsor","NL",48.92696,-55.65966,2018-05-07 05:00:00,7,2,9
"20556",10501,"Grand Falls-Windsor","NL",48.92696,-55.65966,2018-05-07 06:00:00,6,1,7
"20557",10501,"Grand Falls-Windsor","NL",48.92696,-55.65966,2018-05-07 07:00:00,8,2,10
"20558",10501,"Grand Falls-Windsor","NL",48.92696,-55.65966,2018-05-07 08:00:00,10,3,13
"20559",10501,"Grand Falls-Windsor","NL",48.92696,-55.65966,2018-05-07 09:00:00,11,4,15
"20560",10501,"Grand Falls-Windsor","NL",48.92696,-55.65966,2018-05-07 10:00:00,12,5,17
"20561",10501,"Grand Falls-Windsor","NL",48.92696,-55.65966,2018-05-07 11:00:00,16,4,20
"20562",10501,"Grand Falls-Windsor","NL",48.92696,-55.65966,2018-05-07 12:00:00,28,2,30
"20563",10501,"Grand Falls-Windsor","NL",48.92696,-55.65966,2018-05-07 13:00:00,27,1,28
"20564",10501,"Grand Falls-Windsor","NL",48.92696,-55.65966,2018-05-07 14:00:00,29,1,30
"20565",10501,"Grand Falls-Windsor","NL",48.92696,-55.65966,2018-05-07 15:00:00,33,1,34
"20566",10501,"Grand Falls-Windsor","NL",48.92696,-55.65966,2018-05-07 16:00:00,33,1,34
"20567",10501,"Grand Falls-Windsor","NL",48.92696,-55.65966,2018-05-07 17:00:00,38,1,39
"20568",10501,"Grand Falls-Windsor","NL",48.92696,-55.65966,2018-05-07 18:00:00,36,1,37
"20569",10501,"Grand Falls-Windsor","NL",48.92696,-55.65966,2018-05-07 19:00:00,35,1,36
"20570",10501,"Grand Falls-Windsor","NL",48.92696,-55.65966,2018-05-07 20:00:00,32,0,32
"20571",10501,"Grand Falls-Windsor","NL",48.92696,-55.65966,2018-05-07 21:00:00,31,0,31
"20572",10501,"Grand Falls-Windsor","NL",48.92696,-55.65966,2018-05-07 22:00:00,29,0,29
"20573",10501,"Grand Falls-Windsor","NL",48.92696,-55.65966,2018-05-07 23:00:00,27,0,27
"20574",10501,"Grand Falls-Windsor","NL",48.92696,-55.65966,2018-05-08 00:00:00,27,0,27
"20575",10501,"Grand Falls-Windsor","NL",48.92696,-55.65966,2018-05-08 01:00:00,29,0,29
"20576",10501,"Grand Falls-Windsor","NL",48.92696,-55.65966,2018-05-08 02:00:00,28,0,28
"20577",10501,"Grand Falls-Windsor","NL",48.92696,-55.65966,2018-05-08 03:00:00,25,0,25
"20578",10501,"Grand Falls-Windsor","NL",48.92696,-55.65966,2018-05-08 04:00:00,23,1,24
"20579",10501,"Grand Falls-Windsor","NL",48.92696,-55.65966,2018-05-08 05:00:00,22,2,24
"20580",10501,"Grand Falls-Windsor","NL",48.92696,-55.65966,2018-05-08 06:00:00,21,1,22
"20581",10501,"Grand Falls-Windsor","NL",48.92696,-55.65966,2018-05-08 07:00:00,26,0,26
"20582",10501,"Grand Falls-Windsor","NL",48.92696,-55.65966,2018-05-08 08:00:00,29,1,30
"20583",10501,"Grand Falls-Windsor","NL",48.92696,-55.65966,2018-05-08 09:00:00,32,0,32
"20584",10501,"Grand Falls-Windsor","NL",48.92696,-55.65966,2018-05-08 10:00:00,36,0,36
"20585",10501,"Grand Falls-Windsor","NL",48.92696,-55.65966,2018-05-08 11:00:00,37,1,38
"20586",10501,"Grand Falls-Windsor","NL",48.92696,-55.65966,2018-05-08 12:00:00,39,0,39
"20587",10501,"Grand Falls-Windsor","NL",48.92696,-55.65966,2018-05-08 13:00:00,39,1,40
"20588",10501,"Grand Falls-Windsor","NL",48.92696,-55.65966,2018-05-08 14:00:00,39,0,39
"20589",10501,"Grand Falls-Windsor","NL",48.92696,-55.65966,2018-05-08 15:00:00,38,0,38
"20590",10501,"Grand Falls-Windsor","NL",48.92696,-55.65966,2018-05-08 16:00:00,39,0,39
"20591",10501,"Grand Falls-Windsor","NL",48.92696,-55.65966,2018-05-08 17:00:00,39,0,39
"20592",10501,"Grand Falls-Windsor","NL",48.92696,-55.65966,2018-05-08 18:00:00,39,0,39
"20593",10501,"Grand Falls-Windsor","NL",48.92696,-55.65966,2018-05-08 19:00:00,39,1,40
"20594",10501,"Grand Falls-Windsor","NL",48.92696,-55.65966,2018-05-08 20:00:00,40,0,40
"20595",10501,"Grand Falls-Windsor","NL",48.92696,-55.65966,2018-05-08 21:00:00,39,0,39
"20596",10501,"Grand Falls-Windsor","NL",48.92696,-55.65966,2018-05-08 22:00:00,39,0,39
"20597",10501,"Grand Falls-Windsor","NL",48.92696,-55.65966,2018-05-08 23:00:00,37,0,37
"20598",10501,"Grand Falls-Windsor","NL",48.92696,-55.65966,2018-05-09 00:00:00,36,0,36
"20599",10501,"Grand Falls-Windsor","NL",48.92696,-55.65966,2018-05-09 01:00:00,36,0,36
"20600",10501,"Grand Falls-Windsor","NL",48.92696,-55.65966,2018-05-09 02:00:00,35,0,35
"20601",10501,"Grand Falls-Windsor","NL",48.92696,-55.65966,2018-05-09 03:00:00,33,0,33
"20602",10501,"Grand Falls-Windsor","NL",48.92696,-55.65966,2018-05-09 04:00:00,31,1,32
"20603",10501,"Grand Falls-Windsor","NL",48.92696,-55.65966,2018-05-09 05:00:00,29,1,30
"20604",10501,"Grand Falls-Windsor","NL",48.92696,-55.65966,2018-05-09 06:00:00,26,2,28
"20605",10501,"Grand Falls-Windsor","NL",48.92696,-55.65966,2018-05-09 07:00:00,30,1,31
"20606",10501,"Grand Falls-Windsor","NL",48.92696,-55.65966,2018-05-09 08:00:00,33,1,34
"20607",10501,"Grand Falls-Windsor","NL",48.92696,-55.65966,2018-05-09 09:00:00,37,0,37
"20608",10501,"Grand Falls-Windsor","NL",48.92696,-55.65966,2018-05-09 10:00:00,39,0,39
"20609",10501,"Grand Falls-Windsor","NL",48.92696,-55.65966,2018-05-09 11:00:00,39,0,39
"20610",10501,"Grand Falls-Windsor","NL",48.92696,-55.65966,2018-05-09 12:00:00,39,0,39
"20611",10501,"Grand Falls-Windsor","NL",48.92696,-55.65966,2018-05-09 13:00:00,39,0,39
"20612",10501,"Grand Falls-Windsor","NL",48.92696,-55.65966,2018-05-09 14:00:00,38,1,39
"20613",10501,"Grand Falls-Windsor","NL",48.92696,-55.65966,2018-05-09 15:00:00,38,0,38
"20614",10501,"Grand Falls-Windsor","NL",48.92696,-55.65966,2018-05-09 16:00:00,38,0,38
"20615",10501,"Grand Falls-Windsor","NL",48.92696,-55.65966,2018-05-09 17:00:00,37,0,37
"20616",10501,"Grand Falls-Windsor","NL",48.92696,-55.65966,2018-05-09 18:00:00,35,0,35
"20617",10501,"Grand Falls-Windsor","NL",48.92696,-55.65966,2018-05-09 19:00:00,35,0,35
"20618",10501,"Grand Falls-Windsor","NL",48.92696,-55.65966,2018-05-09 20:00:00,34,1,35
"20619",10501,"Grand Falls-Windsor","NL",48.92696,-55.65966,2018-05-09 21:00:00,32,0,32
"20620",10501,"Grand Falls-Windsor","NL",48.92696,-55.65966,2018-05-09 22:00:00,30,0,30
"20621",10501,"Grand Falls-Windsor","NL",48.92696,-55.65966,2018-05-09 23:00:00,27,1,28
"20622",10501,"Grand Falls-Windsor","NL",48.92696,-55.65966,2018-05-10 00:00:00,22,1,23
"20623",10501,"Grand Falls-Windsor","NL",48.92696,-55.65966,2018-05-10 01:00:00,19,1,20
"20624",10501,"Grand Falls-Windsor","NL",48.92696,-55.65966,2018-05-10 02:00:00,20,0,20
"20625",10501,"Grand Falls-Windsor","NL",48.92696,-55.65966,2018-05-10 03:00:00,18,0,18
"20626",10501,"Grand Falls-Windsor","NL",48.92696,-55.65966,2018-05-10 04:00:00,18,0,18
"20627",10501,"Grand Falls-Windsor","NL",48.92696,-55.65966,2018-05-10 05:00:00,15,0,15
"20628",10501,"Grand Falls-Windsor","NL",48.92696,-55.65966,2018-05-10 06:00:00,18,1,19
"20629",10501,"Grand Falls-Windsor","NL",48.92696,-55.65966,2018-05-10 07:00:00,19,0,19
"20630",10501,"Grand Falls-Windsor","NL",48.92696,-55.65966,2018-05-10 08:00:00,25,0,25
"20631",10501,"Grand Falls-Windsor","NL",48.92696,-55.65966,2018-05-10 09:00:00,31,1,32
"20632",10501,"Grand Falls-Windsor","NL",48.92696,-55.65966,2018-05-10 10:00:00,32,0,32
"20633",10501,"Grand Falls-Windsor","NL",48.92696,-55.65966,2018-05-10 11:00:00,33,0,33
"20634",10501,"Grand Falls-Windsor","NL",48.92696,-55.65966,2018-05-10 12:00:00,32,1,33
"20635",10501,"Grand Falls-Windsor","NL",48.92696,-55.65966,2018-05-10 13:00:00,33,0,33
"20636",10501,"Grand Falls-Windsor","NL",48.92696,-55.65966,2018-05-10 14:00:00,34,0,34
"20637",10501,"Grand Falls-Windsor","NL",48.92696,-55.65966,2018-05-10 15:00:00,34,1,35
"20638",10501,"Grand Falls-Windsor","NL",48.92696,-55.65966,2018-05-10 16:00:00,34,0,34
"20639",10501,"Grand Falls-Windsor","NL",48.92696,-55.65966,2018-05-10 17:00:00,36,0,36
"20640",10501,"Grand Falls-Windsor","NL",48.92696,-55.65966,2018-05-10 18:00:00,37,0,37
"20641",10501,"Grand Falls-Windsor","NL",48.92696,-55.65966,2018-05-10 19:00:00,35,0,35
"20642",10501,"Grand Falls-Windsor","NL",48.92696,-55.65966,2018-05-10 20:00:00,35,0,35
"20643",10501,"Grand Falls-Windsor","NL",48.92696,-55.65966,2018-05-10 21:00:00,35,0,35
"20644",10501,"Grand Falls-Windsor","NL",48.92696,-55.65966,2018-05-10 22:00:00,35,0,35
"20645",10501,"Grand Falls-Windsor","NL",48.92696,-55.65966,2018-05-10 23:00:00,36,0,36
"20646",10501,"Grand Falls-Windsor","NL",48.92696,-55.65966,2018-05-11 00:00:00,34,0,34
"20647",10501,"Grand Falls-Windsor","NL",48.92696,-55.65966,2018-05-11 01:00:00,33,0,33
"20648",10501,"Grand Falls-Windsor","NL",48.92696,-55.65966,2018-05-11 02:00:00,31,0,31
"20649",10501,"Grand Falls-Windsor","NL",48.92696,-55.65966,2018-05-11 03:00:00,29,0,29
"20650",10501,"Grand Falls-Windsor","NL",48.92696,-55.65966,2018-05-11 04:00:00,27,0,27
"20651",10501,"Grand Falls-Windsor","NL",48.92696,-55.65966,2018-05-11 05:00:00,26,0,26
"20652",10501,"Grand Falls-Windsor","NL",48.92696,-55.65966,2018-05-11 06:00:00,28,0,28
"20653",10501,"Grand Falls-Windsor","NL",48.92696,-55.65966,2018-05-11 07:00:00,26,0,26
"20654",10501,"Grand Falls-Windsor","NL",48.92696,-55.65966,2018-05-11 08:00:00,26,0,26
"20655",10501,"Grand Falls-Windsor","NL",48.92696,-55.65966,2018-05-11 09:00:00,27,0,27
"20656",10501,"Grand Falls-Windsor","NL",48.92696,-55.65966,2018-05-11 10:00:00,28,0,28
"20657",10501,"Grand Falls-Windsor","NL",48.92696,-55.65966,2018-05-11 11:00:00,33,0,33
"20658",10501,"Grand Falls-Windsor","NL",48.92696,-55.65966,2018-05-11 12:00:00,32,0,32
"20659",10501,"Grand Falls-Windsor","NL",48.92696,-55.65966,2018-05-11 13:00:00,32,0,32
"20660",10501,"Grand Falls-Windsor","NL",48.92696,-55.65966,2018-05-11 14:00:00,29,0,29
"20661",10501,"Grand Falls-Windsor","NL",48.92696,-55.65966,2018-05-11 15:00:00,29,1,30
"20662",10501,"Grand Falls-Windsor","NL",48.92696,-55.65966,2018-05-11 16:00:00,31,0,31
"20663",10501,"Grand Falls-Windsor","NL",48.92696,-55.65966,2018-05-11 17:00:00,31,0,31
"20664",10501,"Grand Falls-Windsor","NL",48.92696,-55.65966,2018-05-11 18:00:00,30,0,30
"20665",10501,"Grand Falls-Windsor","NL",48.92696,-55.65966,2018-05-11 19:00:00,29,1,30
"20666",10501,"Grand Falls-Windsor","NL",48.92696,-55.65966,2018-05-11 20:00:00,29,0,29
"20667",10501,"Grand Falls-Windsor","NL",48.92696,-55.65966,2018-05-11 21:00:00,26,0,26
"20668",10501,"Grand Falls-Windsor","NL",48.92696,-55.65966,2018-05-11 22:00:00,24,0,24
"20669",10501,"Grand Falls-Windsor","NL",48.92696,-55.65966,2018-05-11 23:00:00,23,0,23
"20670",10501,"Grand Falls-Windsor","NL",48.92696,-55.65966,2018-05-12 00:00:00,24,0,24
"20671",10501,"Grand Falls-Windsor","NL",48.92696,-55.65966,2018-05-12 01:00:00,22,0,22
"20672",10501,"Grand Falls-Windsor","NL",48.92696,-55.65966,2018-05-12 02:00:00,22,0,22
"20673",10501,"Grand Falls-Windsor","NL",48.92696,-55.65966,2018-05-12 03:00:00,20,1,21
"20674",10501,"Grand Falls-Windsor","NL",48.92696,-55.65966,2018-05-12 04:00:00,20,1,21
"20675",10501,"Grand Falls-Windsor","NL",48.92696,-55.65966,2018-05-12 05:00:00,20,0,20
"20676",10501,"Grand Falls-Windsor","NL",48.92696,-55.65966,2018-05-12 06:00:00,21,0,21
"20677",10501,"Grand Falls-Windsor","NL",48.92696,-55.65966,2018-05-12 07:00:00,24,0,24
"20678",10501,"Grand Falls-Windsor","NL",48.92696,-55.65966,2018-05-12 08:00:00,26,0,26
"20679",10501,"Grand Falls-Windsor","NL",48.92696,-55.65966,2018-05-12 09:00:00,27,0,27
"20680",10501,"Grand Falls-Windsor","NL",48.92696,-55.65966,2018-05-12 10:00:00,28,0,28
"20681",10501,"Grand Falls-Windsor","NL",48.92696,-55.65966,2018-05-12 11:00:00,29,0,29
"20682",10501,"Grand Falls-Windsor","NL",48.92696,-55.65966,2018-05-12 12:00:00,31,0,31
"20683",10501,"Grand Falls-Windsor","NL",48.92696,-55.65966,2018-05-12 13:00:00,33,0,33
"20684",10501,"Grand Falls-Windsor","NL",48.92696,-55.65966,2018-05-12 14:00:00,34,0,34
"20685",10501,"Grand Falls-Windsor","NL",48.92696,-55.65966,2018-05-12 15:00:00,34,0,34
"20686",10501,"Grand Falls-Windsor","NL",48.92696,-55.65966,2018-05-12 16:00:00,33,0,33
"20687",10501,"Grand Falls-Windsor","NL",48.92696,-55.65966,2018-05-12 17:00:00,33,0,33
"20688",10501,"Grand Falls-Windsor","NL",48.92696,-55.65966,2018-05-12 18:00:00,35,0,35
"20689",10501,"Grand Falls-Windsor","NL",48.92696,-55.65966,2018-05-12 19:00:00,35,0,35
"20690",10501,"Grand Falls-Windsor","NL",48.92696,-55.65966,2018-05-12 20:00:00,34,0,34
"20691",10501,"Grand Falls-Windsor","NL",48.92696,-55.65966,2018-05-12 21:00:00,33,0,33
"20692",10501,"Grand Falls-Windsor","NL",48.92696,-55.65966,2018-05-12 22:00:00,32,0,32
"20693",10501,"Grand Falls-Windsor","NL",48.92696,-55.65966,2018-05-12 23:00:00,31,0,31
"20694",10501,"Grand Falls-Windsor","NL",48.92696,-55.65966,2018-05-13 00:00:00,32,0,32
"20695",10501,"Grand Falls-Windsor","NL",48.92696,-55.65966,2018-05-13 01:00:00,30,0,30
"20696",10501,"Grand Falls-Windsor","NL",48.92696,-55.65966,2018-05-13 02:00:00,29,1,30
"20697",10501,"Grand Falls-Windsor","NL",48.92696,-55.65966,2018-05-13 03:00:00,28,0,28
"20698",10501,"Grand Falls-Windsor","NL",48.92696,-55.65966,2018-05-13 04:00:00,28,0,28
"20699",10501,"Grand Falls-Windsor","NL",48.92696,-55.65966,2018-05-13 05:00:00,26,0,26
"20700",10501,"Grand Falls-Windsor","NL",48.92696,-55.65966,2018-05-13 06:00:00,27,0,27
"20701",10501,"Grand Falls-Windsor","NL",48.92696,-55.65966,2018-05-13 07:00:00,28,0,28
"20702",10501,"Grand Falls-Windsor","NL",48.92696,-55.65966,2018-05-13 08:00:00,30,0,30
"20703",10501,"Grand Falls-Windsor","NL",48.92696,-55.65966,2018-05-13 09:00:00,32,0,32
"20704",10501,"Grand Falls-Windsor","NL",48.92696,-55.65966,2018-05-13 10:00:00,33,0,33
"20705",10501,"Grand Falls-Windsor","NL",48.92696,-55.65966,2018-05-13 11:00:00,33,0,33
"20706",10501,"Grand Falls-Windsor","NL",48.92696,-55.65966,2018-05-13 12:00:00,36,0,36
"20707",10501,"Grand Falls-Windsor","NL",48.92696,-55.65966,2018-05-13 13:00:00,37,0,37
"20708",10501,"Grand Falls-Windsor","NL",48.92696,-55.65966,2018-05-13 14:00:00,37,0,37
"20709",10501,"Grand Falls-Windsor","NL",48.92696,-55.65966,2018-05-13 15:00:00,37,0,37
"20710",10501,"Grand Falls-Windsor","NL",48.92696,-55.65966,2018-05-13 16:00:00,38,0,38
"20711",10501,"Grand Falls-Windsor","NL",48.92696,-55.65966,2018-05-13 17:00:00,38,0,38
"20712",10501,"Grand Falls-Windsor","NL",48.92696,-55.65966,2018-05-13 18:00:00,39,0,39
"20713",10501,"Grand Falls-Windsor","NL",48.92696,-55.65966,2018-05-13 19:00:00,39,0,39
"20714",10501,"Grand Falls-Windsor","NL",48.92696,-55.65966,2018-05-13 20:00:00,39,0,39
"20715",10501,"Grand Falls-Windsor","NL",48.92696,-55.65966,2018-05-13 21:00:00,36,0,36
"20716",10501,"Grand Falls-Windsor","NL",48.92696,-55.65966,2018-05-13 22:00:00,30,0,30
"20717",10501,"Grand Falls-Windsor","NL",48.92696,-55.65966,2018-05-13 23:00:00,29,1,30
"20718",10501,"Grand Falls-Windsor","NL",48.92696,-55.65966,2018-05-14 00:00:00,32,0,32
"20719",10501,"Grand Falls-Windsor","NL",48.92696,-55.65966,2018-05-14 01:00:00,33,0,33
"20720",10501,"Grand Falls-Windsor","NL",48.92696,-55.65966,2018-05-14 02:00:00,34,0,34
"20721",10501,"Grand Falls-Windsor","NL",48.92696,-55.65966,2018-05-14 03:00:00,35,0,35
"20722",10501,"Grand Falls-Windsor","NL",48.92696,-55.65966,2018-05-14 04:00:00,33,0,33
"20723",10501,"Grand Falls-Windsor","NL",48.92696,-55.65966,2018-05-14 05:00:00,32,3,35
"20724",10501,"Grand Falls-Windsor","NL",48.92696,-55.65966,2018-05-14 06:00:00,29,3,32
"20725",10501,"Grand Falls-Windsor","NL",48.92696,-55.65966,2018-05-14 07:00:00,36,1,37
"20726",10501,"Grand Falls-Windsor","NL",48.92696,-55.65966,2018-05-14 08:00:00,36,0,36
"20727",10501,"Grand Falls-Windsor","NL",48.92696,-55.65966,2018-05-14 09:00:00,37,0,37
"20728",10501,"Grand Falls-Windsor","NL",48.92696,-55.65966,2018-05-14 10:00:00,37,0,37
"20729",10501,"Grand Falls-Windsor","NL",48.92696,-55.65966,2018-05-14 11:00:00,37,1,38
"20730",10501,"Grand Falls-Windsor","NL",48.92696,-55.65966,2018-05-14 12:00:00,37,0,37
"20731",10501,"Grand Falls-Windsor","NL",48.92696,-55.65966,2018-05-14 13:00:00,37,0,37
"20732",10501,"Grand Falls-Windsor","NL",48.92696,-55.65966,2018-05-14 14:00:00,38,0,38
"20733",10501,"Grand Falls-Windsor","NL",48.92696,-55.65966,2018-05-14 15:00:00,38,1,39
"20734",10501,"Grand Falls-Windsor","NL",48.92696,-55.65966,2018-05-14 16:00:00,39,0,39
"20735",10501,"Grand Falls-Windsor","NL",48.92696,-55.65966,2018-05-14 17:00:00,39,0,39
"20736",10501,"Grand Falls-Windsor","NL",48.92696,-55.65966,2018-05-14 18:00:00,39,0,39
"20737",10501,"Grand Falls-Windsor","NL",48.92696,-55.65966,2018-05-14 19:00:00,39,1,40
"20738",10501,"Grand Falls-Windsor","NL",48.92696,-55.65966,2018-05-14 20:00:00,37,0,37
"20739",10501,"Grand Falls-Windsor","NL",48.92696,-55.65966,2018-05-14 21:00:00,35,0,35
"20740",10501,"Grand Falls-Windsor","NL",48.92696,-55.65966,2018-05-14 22:00:00,34,0,34
"20741",10501,"Grand Falls-Windsor","NL",48.92696,-55.65966,2018-05-14 23:00:00,34,0,34
"20742",10501,"Grand Falls-Windsor","NL",48.92696,-55.65966,2018-05-15 00:00:00,32,0,32
"20743",10501,"Grand Falls-Windsor","NL",48.92696,-55.65966,2018-05-15 01:00:00,31,0,31
"20744",10501,"Grand Falls-Windsor","NL",48.92696,-55.65966,2018-05-15 02:00:00,31,0,31
"20745",10501,"Grand Falls-Windsor","NL",48.92696,-55.65966,2018-05-15 03:00:00,31,0,31
"20746",10501,"Grand Falls-Windsor","NL",48.92696,-55.65966,2018-05-15 04:00:00,31,0,31
"20747",10501,"Grand Falls-Windsor","NL",48.92696,-55.65966,2018-05-15 05:00:00,30,0,30
"20748",10501,"Grand Falls-Windsor","NL",48.92696,-55.65966,2018-05-15 06:00:00,28,0,28
"20749",10501,"Grand Falls-Windsor","NL",48.92696,-55.65966,2018-05-15 07:00:00,31,0,31
"20750",10501,"Grand Falls-Windsor","NL",48.92696,-55.65966,2018-05-15 08:00:00,NA,0,NA
"20751",10501,"Grand Falls-Windsor","NL",48.92696,-55.65966,2018-05-15 09:00:00,NA,0,NA
"20752",10501,"Grand Falls-Windsor","NL",48.92696,-55.65966,2018-05-15 10:00:00,NA,1,NA
"20753",10501,"Grand Falls-Windsor","NL",48.92696,-55.65966,2018-05-15 11:00:00,NA,0,NA
"20754",10501,"Grand Falls-Windsor","NL",48.92696,-55.65966,2018-05-15 12:00:00,NA,1,NA
"20755",10501,"Grand Falls-Windsor","NL",48.92696,-55.65966,2018-05-15 13:00:00,NA,1,NA
"20756",10501,"Grand Falls-Windsor","NL",48.92696,-55.65966,2018-05-15 14:00:00,NA,1,NA
"20757",10501,"Grand Falls-Windsor","NL",48.92696,-55.65966,2018-05-15 15:00:00,NA,0,NA
"20758",10501,"Grand Falls-Windsor","NL",48.92696,-55.65966,2018-05-15 16:00:00,NA,0,NA
"20759",10501,"Grand Falls-Windsor","NL",48.92696,-55.65966,2018-05-15 17:00:00,NA,0,NA
"20760",10501,"Grand Falls-Windsor","NL",48.92696,-55.65966,2018-05-15 18:00:00,NA,1,NA
"20761",10501,"Grand Falls-Windsor","NL",48.92696,-55.65966,2018-05-15 19:00:00,NA,0,NA
"20762",10501,"Grand Falls-Windsor","NL",48.92696,-55.65966,2018-05-15 20:00:00,NA,0,NA
"20763",10501,"Grand Falls-Windsor","NL",48.92696,-55.65966,2018-05-15 21:00:00,NA,0,NA
"20764",10501,"Grand Falls-Windsor","NL",48.92696,-55.65966,2018-05-15 22:00:00,NA,0,NA
"20765",10501,"Grand Falls-Windsor","NL",48.92696,-55.65966,2018-05-15 23:00:00,NA,0,NA
"20766",10501,"Grand Falls-Windsor","NL",48.92696,-55.65966,2018-05-16 00:00:00,NA,0,NA
"20767",10501,"Grand Falls-Windsor","NL",48.92696,-55.65966,2018-05-16 01:00:00,NA,0,NA
"20768",10501,"Grand Falls-Windsor","NL",48.92696,-55.65966,2018-05-16 02:00:00,NA,0,NA
"20769",10501,"Grand Falls-Windsor","NL",48.92696,-55.65966,2018-05-16 03:00:00,NA,0,NA
"20770",10501,"Grand Falls-Windsor","NL",48.92696,-55.65966,2018-05-16 04:00:00,NA,0,NA
"20771",10501,"Grand Falls-Windsor","NL",48.92696,-55.65966,2018-05-16 05:00:00,NA,0,NA
"20772",10501,"Grand Falls-Windsor","NL",48.92696,-55.65966,2018-05-16 06:00:00,NA,0,NA
"20773",10501,"Grand Falls-Windsor","NL",48.92696,-55.65966,2018-05-16 07:00:00,NA,0,NA
"20774",10501,"Grand Falls-Windsor","NL",48.92696,-55.65966,2018-05-16 08:00:00,NA,0,NA
"20775",10501,"Grand Falls-Windsor","NL",48.92696,-55.65966,2018-05-16 09:00:00,NA,0,NA
"20776",10501,"Grand Falls-Windsor","NL",48.92696,-55.65966,2018-05-16 10:00:00,NA,0,NA
"20777",10501,"Grand Falls-Windsor","NL",48.92696,-55.65966,2018-05-16 11:00:00,NA,1,NA
"20778",10501,"Grand Falls-Windsor","NL",48.92696,-55.65966,2018-05-16 12:00:00,NA,0,NA
"20779",10501,"Grand Falls-Windsor","NL",48.92696,-55.65966,2018-05-16 13:00:00,NA,0,NA
"20780",10501,"Grand Falls-Windsor","NL",48.92696,-55.65966,2018-05-16 14:00:00,NA,1,NA
"20781",10501,"Grand Falls-Windsor","NL",48.92696,-55.65966,2018-05-16 15:00:00,NA,0,NA
"20782",10501,"Grand Falls-Windsor","NL",48.92696,-55.65966,2018-05-16 16:00:00,NA,0,NA
"20783",10501,"Grand Falls-Windsor","NL",48.92696,-55.65966,2018-05-16 17:00:00,NA,0,NA
"20784",10501,"Grand Falls-Windsor","NL",48.92696,-55.65966,2018-05-16 18:00:00,NA,0,NA
"20785",10501,"Grand Falls-Windsor","NL",48.92696,-55.65966,2018-05-16 19:00:00,NA,0,NA
"20786",10501,"Grand Falls-Windsor","NL",48.92696,-55.65966,2018-05-16 20:00:00,NA,0,NA
"20787",10501,"Grand Falls-Windsor","NL",48.92696,-55.65966,2018-05-16 21:00:00,NA,0,NA
"20788",10501,"Grand Falls-Windsor","NL",48.92696,-55.65966,2018-05-16 22:00:00,NA,0,NA
"20789",10501,"Grand Falls-Windsor","NL",48.92696,-55.65966,2018-05-16 23:00:00,NA,1,NA
"20790",10501,"Grand Falls-Windsor","NL",48.92696,-55.65966,2018-05-17 00:00:00,NA,0,NA
"20791",10501,"Grand Falls-Windsor","NL",48.92696,-55.65966,2018-05-17 01:00:00,NA,0,NA
"20792",10501,"Grand Falls-Windsor","NL",48.92696,-55.65966,2018-05-17 02:00:00,NA,0,NA
"20793",10501,"Grand Falls-Windsor","NL",48.92696,-55.65966,2018-05-17 03:00:00,NA,0,NA
"20794",10501,"Grand Falls-Windsor","NL",48.92696,-55.65966,2018-05-17 04:00:00,NA,0,NA
"20795",10501,"Grand Falls-Windsor","NL",48.92696,-55.65966,2018-05-17 05:00:00,NA,0,NA
"20796",10501,"Grand Falls-Windsor","NL",48.92696,-55.65966,2018-05-17 06:00:00,NA,0,NA
"20797",10501,"Grand Falls-Windsor","NL",48.92696,-55.65966,2018-05-17 07:00:00,NA,0,NA
"20798",10501,"Grand Falls-Windsor","NL",48.92696,-55.65966,2018-05-17 08:00:00,NA,0,NA
"20799",10501,"Grand Falls-Windsor","NL",48.92696,-55.65966,2018-05-17 09:00:00,NA,0,NA
"20800",10501,"Grand Falls-Windsor","NL",48.92696,-55.65966,2018-05-17 10:00:00,NA,1,NA
"20801",10501,"Grand Falls-Windsor","NL",48.92696,-55.65966,2018-05-17 11:00:00,NA,0,NA
"20802",10501,"Grand Falls-Windsor","NL",48.92696,-55.65966,2018-05-17 12:00:00,NA,NA,NA
"20803",10501,"Grand Falls-Windsor","NL",48.92696,-55.65966,2018-05-17 13:00:00,33,NA,NA
"20804",10501,"Grand Falls-Windsor","NL",48.92696,-55.65966,2018-05-17 14:00:00,32,NA,NA
"20805",10501,"Grand Falls-Windsor","NL",48.92696,-55.65966,2018-05-17 15:00:00,27,NA,NA
"20806",10501,"Grand Falls-Windsor","NL",48.92696,-55.65966,2018-05-17 16:00:00,29,NA,NA
"20807",10501,"Grand Falls-Windsor","NL",48.92696,-55.65966,2018-05-17 17:00:00,29,0,29
"20808",10501,"Grand Falls-Windsor","NL",48.92696,-55.65966,2018-05-17 18:00:00,30,0,30
"20809",10501,"Grand Falls-Windsor","NL",48.92696,-55.65966,2018-05-17 19:00:00,30,0,30
"20810",10501,"Grand Falls-Windsor","NL",48.92696,-55.65966,2018-05-17 20:00:00,29,1,30
"20811",10501,"Grand Falls-Windsor","NL",48.92696,-55.65966,2018-05-17 21:00:00,28,1,29
"20812",10501,"Grand Falls-Windsor","NL",48.92696,-55.65966,2018-05-17 22:00:00,26,0,26
"20813",10501,"Grand Falls-Windsor","NL",48.92696,-55.65966,2018-05-17 23:00:00,25,1,26
"20814",10501,"Grand Falls-Windsor","NL",48.92696,-55.65966,2018-05-18 00:00:00,23,1,24
"20815",10501,"Grand Falls-Windsor","NL",48.92696,-55.65966,2018-05-18 01:00:00,22,1,23
"20816",10501,"Grand Falls-Windsor","NL",48.92696,-55.65966,2018-05-18 02:00:00,19,0,19
"20817",10501,"Grand Falls-Windsor","NL",48.92696,-55.65966,2018-05-18 03:00:00,17,0,17
"20818",10501,"Grand Falls-Windsor","NL",48.92696,-55.65966,2018-05-18 04:00:00,17,1,18
"20819",10501,"Grand Falls-Windsor","NL",48.92696,-55.65966,2018-05-18 05:00:00,16,1,17
"20820",10501,"Grand Falls-Windsor","NL",48.92696,-55.65966,2018-05-18 06:00:00,16,3,19
"20821",10501,"Grand Falls-Windsor","NL",48.92696,-55.65966,2018-05-18 07:00:00,19,0,19
"20822",10501,"Grand Falls-Windsor","NL",48.92696,-55.65966,2018-05-18 08:00:00,23,1,24
"20823",10501,"Grand Falls-Windsor","NL",48.92696,-55.65966,2018-05-18 09:00:00,28,1,29
"20824",10501,"Grand Falls-Windsor","NL",48.92696,-55.65966,2018-05-18 10:00:00,27,0,27
"20825",10501,"Grand Falls-Windsor","NL",48.92696,-55.65966,2018-05-18 11:00:00,27,1,28
"20826",10501,"Grand Falls-Windsor","NL",48.92696,-55.65966,2018-05-18 12:00:00,28,1,29
"20827",10501,"Grand Falls-Windsor","NL",48.92696,-55.65966,2018-05-18 13:00:00,29,1,30
"20828",10501,"Grand Falls-Windsor","NL",48.92696,-55.65966,2018-05-18 14:00:00,29,0,29
"20829",10501,"Grand Falls-Windsor","NL",48.92696,-55.65966,2018-05-18 15:00:00,30,1,31
"20830",10501,"Grand Falls-Windsor","NL",48.92696,-55.65966,2018-05-18 16:00:00,30,1,31
"20831",10501,"Grand Falls-Windsor","NL",48.92696,-55.65966,2018-05-18 17:00:00,31,0,31
"20832",10501,"Grand Falls-Windsor","NL",48.92696,-55.65966,2018-05-18 18:00:00,30,0,30
"20833",10501,"Grand Falls-Windsor","NL",48.92696,-55.65966,2018-05-18 19:00:00,28,1,29
"20834",10501,"Grand Falls-Windsor","NL",48.92696,-55.65966,2018-05-18 20:00:00,28,0,28
"20835",10501,"Grand Falls-Windsor","NL",48.92696,-55.65966,2018-05-18 21:00:00,27,1,28
"20836",10501,"Grand Falls-Windsor","NL",48.92696,-55.65966,2018-05-18 22:00:00,27,0,27
"20837",10501,"Grand Falls-Windsor","NL",48.92696,-55.65966,2018-05-18 23:00:00,26,0,26
"20838",10501,"Grand Falls-Windsor","NL",48.92696,-55.65966,2018-05-19 00:00:00,25,0,25
"20839",10501,"Grand Falls-Windsor","NL",48.92696,-55.65966,2018-05-19 01:00:00,25,0,25
"20840",10501,"Grand Falls-Windsor","NL",48.92696,-55.65966,2018-05-19 02:00:00,25,0,25
"20841",10501,"Grand Falls-Windsor","NL",48.92696,-55.65966,2018-05-19 03:00:00,25,0,25
"20842",10501,"Grand Falls-Windsor","NL",48.92696,-55.65966,2018-05-19 04:00:00,24,0,24
"20843",10501,"Grand Falls-Windsor","NL",48.92696,-55.65966,2018-05-19 05:00:00,24,0,24
"20844",10501,"Grand Falls-Windsor","NL",48.92696,-55.65966,2018-05-19 06:00:00,24,0,24
"20845",10501,"Grand Falls-Windsor","NL",48.92696,-55.65966,2018-05-19 07:00:00,24,0,24
"20846",10501,"Grand Falls-Windsor","NL",48.92696,-55.65966,2018-05-19 08:00:00,26,1,27
"20847",10501,"Grand Falls-Windsor","NL",48.92696,-55.65966,2018-05-19 09:00:00,27,1,28
"20848",10501,"Grand Falls-Windsor","NL",48.92696,-55.65966,2018-05-19 10:00:00,28,1,29
"20849",10501,"Grand Falls-Windsor","NL",48.92696,-55.65966,2018-05-19 11:00:00,29,0,29
"20850",10501,"Grand Falls-Windsor","NL",48.92696,-55.65966,2018-05-19 12:00:00,29,0,29
"20851",10501,"Grand Falls-Windsor","NL",48.92696,-55.65966,2018-05-19 13:00:00,31,0,31
"20852",10501,"Grand Falls-Windsor","NL",48.92696,-55.65966,2018-05-19 14:00:00,33,1,34
"20853",10501,"Grand Falls-Windsor","NL",48.92696,-55.65966,2018-05-19 15:00:00,35,0,35
"20854",10501,"Grand Falls-Windsor","NL",48.92696,-55.65966,2018-05-19 16:00:00,35,0,35
"20855",10501,"Grand Falls-Windsor","NL",48.92696,-55.65966,2018-05-19 17:00:00,35,1,36
"20856",10501,"Grand Falls-Windsor","NL",48.92696,-55.65966,2018-05-19 18:00:00,35,0,35
"20857",10501,"Grand Falls-Windsor","NL",48.92696,-55.65966,2018-05-19 19:00:00,34,0,34
"20858",10501,"Grand Falls-Windsor","NL",48.92696,-55.65966,2018-05-19 20:00:00,34,1,35
"20859",10501,"Grand Falls-Windsor","NL",48.92696,-55.65966,2018-05-19 21:00:00,31,1,32
"20860",10501,"Grand Falls-Windsor","NL",48.92696,-55.65966,2018-05-19 22:00:00,27,2,29
"20861",10501,"Grand Falls-Windsor","NL",48.92696,-55.65966,2018-05-19 23:00:00,26,1,27
"20862",10501,"Grand Falls-Windsor","NL",48.92696,-55.65966,2018-05-20 00:00:00,27,0,27
"20863",10501,"Grand Falls-Windsor","NL",48.92696,-55.65966,2018-05-20 01:00:00,26,0,26
"20864",10501,"Grand Falls-Windsor","NL",48.92696,-55.65966,2018-05-20 02:00:00,26,0,26
"20865",10501,"Grand Falls-Windsor","NL",48.92696,-55.65966,2018-05-20 03:00:00,25,0,25
"20866",10501,"Grand Falls-Windsor","NL",48.92696,-55.65966,2018-05-20 04:00:00,25,0,25
"20867",10501,"Grand Falls-Windsor","NL",48.92696,-55.65966,2018-05-20 05:00:00,24,0,24
"20868",10501,"Grand Falls-Windsor","NL",48.92696,-55.65966,2018-05-20 06:00:00,23,0,23
"20869",10501,"Grand Falls-Windsor","NL",48.92696,-55.65966,2018-05-20 07:00:00,25,0,25
"20870",10501,"Grand Falls-Windsor","NL",48.92696,-55.65966,2018-05-20 08:00:00,27,0,27
"20871",10501,"Grand Falls-Windsor","NL",48.92696,-55.65966,2018-05-20 09:00:00,31,1,32
"20872",10501,"Grand Falls-Windsor","NL",48.92696,-55.65966,2018-05-20 10:00:00,31,1,32
"20873",10501,"Grand Falls-Windsor","NL",48.92696,-55.65966,2018-05-20 11:00:00,32,0,32
"20874",10501,"Grand Falls-Windsor","NL",48.92696,-55.65966,2018-05-20 12:00:00,31,1,32
"20875",10501,"Grand Falls-Windsor","NL",48.92696,-55.65966,2018-05-20 13:00:00,29,0,29
"20876",10501,"Grand Falls-Windsor","NL",48.92696,-55.65966,2018-05-20 14:00:00,29,1,30
"20877",10501,"Grand Falls-Windsor","NL",48.92696,-55.65966,2018-05-20 15:00:00,29,0,29
"20878",10501,"Grand Falls-Windsor","NL",48.92696,-55.65966,2018-05-20 16:00:00,29,1,30
"20879",10501,"Grand Falls-Windsor","NL",48.92696,-55.65966,2018-05-20 17:00:00,28,0,28
"20880",10501,"Grand Falls-Windsor","NL",48.92696,-55.65966,2018-05-20 18:00:00,27,0,27
"20881",10501,"Grand Falls-Windsor","NL",48.92696,-55.65966,2018-05-20 19:00:00,29,0,29
"20882",10501,"Grand Falls-Windsor","NL",48.92696,-55.65966,2018-05-20 20:00:00,30,0,30
"20883",10501,"Grand Falls-Windsor","NL",48.92696,-55.65966,2018-05-20 21:00:00,29,0,29
"20884",10501,"Grand Falls-Windsor","NL",48.92696,-55.65966,2018-05-20 22:00:00,30,0,30
"20885",10501,"Grand Falls-Windsor","NL",48.92696,-55.65966,2018-05-20 23:00:00,29,0,29
"20886",10501,"Grand Falls-Windsor","NL",48.92696,-55.65966,2018-05-21 00:00:00,27,0,27
"20887",10501,"Grand Falls-Windsor","NL",48.92696,-55.65966,2018-05-21 01:00:00,26,0,26
"20888",10501,"Grand Falls-Windsor","NL",48.92696,-55.65966,2018-05-21 02:00:00,27,0,27
"20889",10501,"Grand Falls-Windsor","NL",48.92696,-55.65966,2018-05-21 03:00:00,26,0,26
"20890",10501,"Grand Falls-Windsor","NL",48.92696,-55.65966,2018-05-21 04:00:00,26,0,26
"20891",10501,"Grand Falls-Windsor","NL",48.92696,-55.65966,2018-05-21 05:00:00,25,0,25
"20892",10501,"Grand Falls-Windsor","NL",48.92696,-55.65966,2018-05-21 06:00:00,26,0,26
"20893",10501,"Grand Falls-Windsor","NL",48.92696,-55.65966,2018-05-21 07:00:00,26,0,26
"20894",10501,"Grand Falls-Windsor","NL",48.92696,-55.65966,2018-05-21 08:00:00,26,1,27
"20895",10501,"Grand Falls-Windsor","NL",48.92696,-55.65966,2018-05-21 09:00:00,27,0,27
"20896",10501,"Grand Falls-Windsor","NL",48.92696,-55.65966,2018-05-21 10:00:00,28,0,28
"20897",10501,"Grand Falls-Windsor","NL",48.92696,-55.65966,2018-05-21 11:00:00,31,1,32
"20898",10501,"Grand Falls-Windsor","NL",48.92696,-55.65966,2018-05-21 12:00:00,29,7,36
"20899",10501,"Grand Falls-Windsor","NL",48.92696,-55.65966,2018-05-21 13:00:00,33,1,34
"20900",10501,"Grand Falls-Windsor","NL",48.92696,-55.65966,2018-05-21 14:00:00,32,1,33
"20901",10501,"Grand Falls-Windsor","NL",48.92696,-55.65966,2018-05-21 15:00:00,32,0,32
"20902",10501,"Grand Falls-Windsor","NL",48.92696,-55.65966,2018-05-21 16:00:00,32,0,32
"20903",10501,"Grand Falls-Windsor","NL",48.92696,-55.65966,2018-05-21 17:00:00,32,0,32
"20904",10501,"Grand Falls-Windsor","NL",48.92696,-55.65966,2018-05-21 18:00:00,32,0,32
"20905",10501,"Grand Falls-Windsor","NL",48.92696,-55.65966,2018-05-21 19:00:00,34,1,35
"20906",10501,"Grand Falls-Windsor","NL",48.92696,-55.65966,2018-05-21 20:00:00,35,0,35
"20907",10501,"Grand Falls-Windsor","NL",48.92696,-55.65966,2018-05-21 21:00:00,32,1,33
"20908",10501,"Grand Falls-Windsor","NL",48.92696,-55.65966,2018-05-21 22:00:00,32,0,32
"20909",10501,"Grand Falls-Windsor","NL",48.92696,-55.65966,2018-05-21 23:00:00,30,0,30
"20910",10501,"Grand Falls-Windsor","NL",48.92696,-55.65966,2018-05-22 00:00:00,28,0,28
"20911",10501,"Grand Falls-Windsor","NL",48.92696,-55.65966,2018-05-22 01:00:00,29,0,29
"20912",10501,"Grand Falls-Windsor","NL",48.92696,-55.65966,2018-05-22 02:00:00,28,0,28
"20913",10501,"Grand Falls-Windsor","NL",48.92696,-55.65966,2018-05-22 03:00:00,26,0,26
"20914",10501,"Grand Falls-Windsor","NL",48.92696,-55.65966,2018-05-22 04:00:00,27,0,27
"20915",10501,"Grand Falls-Windsor","NL",48.92696,-55.65966,2018-05-22 05:00:00,26,0,26
"20916",10501,"Grand Falls-Windsor","NL",48.92696,-55.65966,2018-05-22 06:00:00,27,1,28
"20917",10501,"Grand Falls-Windsor","NL",48.92696,-55.65966,2018-05-22 07:00:00,30,1,31
"20918",10501,"Grand Falls-Windsor","NL",48.92696,-55.65966,2018-05-22 08:00:00,29,3,32
"20919",10501,"Grand Falls-Windsor","NL",48.92696,-55.65966,2018-05-22 09:00:00,30,1,31
"20920",10501,"Grand Falls-Windsor","NL",48.92696,-55.65966,2018-05-22 10:00:00,30,1,31
"20921",10501,"Grand Falls-Windsor","NL",48.92696,-55.65966,2018-05-22 11:00:00,30,1,31
"20922",10501,"Grand Falls-Windsor","NL",48.92696,-55.65966,2018-05-22 12:00:00,30,1,31
"20923",10501,"Grand Falls-Windsor","NL",48.92696,-55.65966,2018-05-22 13:00:00,29,1,30
"20924",10501,"Grand Falls-Windsor","NL",48.92696,-55.65966,2018-05-22 14:00:00,29,1,30
"20925",10501,"Grand Falls-Windsor","NL",48.92696,-55.65966,2018-05-22 15:00:00,29,0,29
"20926",10501,"Grand Falls-Windsor","NL",48.92696,-55.65966,2018-05-22 16:00:00,31,0,31
"20927",10501,"Grand Falls-Windsor","NL",48.92696,-55.65966,2018-05-22 17:00:00,32,1,33
"20928",10501,"Grand Falls-Windsor","NL",48.92696,-55.65966,2018-05-22 18:00:00,32,0,32
"20929",10501,"Grand Falls-Windsor","NL",48.92696,-55.65966,2018-05-22 19:00:00,31,1,32
"20930",10501,"Grand Falls-Windsor","NL",48.92696,-55.65966,2018-05-22 20:00:00,31,1,32
"20931",10501,"Grand Falls-Windsor","NL",48.92696,-55.65966,2018-05-22 21:00:00,31,1,32
"20932",10501,"Grand Falls-Windsor","NL",48.92696,-55.65966,2018-05-22 22:00:00,32,0,32
"20933",10501,"Grand Falls-Windsor","NL",48.92696,-55.65966,2018-05-22 23:00:00,34,1,35
"20934",10501,"Grand Falls-Windsor","NL",48.92696,-55.65966,2018-05-23 00:00:00,28,0,28
"20935",10501,"Grand Falls-Windsor","NL",48.92696,-55.65966,2018-05-23 01:00:00,31,0,31
"20936",10501,"Grand Falls-Windsor","NL",48.92696,-55.65966,2018-05-23 02:00:00,34,0,34
"20937",10501,"Grand Falls-Windsor","NL",48.92696,-55.65966,2018-05-23 03:00:00,33,0,33
"20938",10501,"Grand Falls-Windsor","NL",48.92696,-55.65966,2018-05-23 04:00:00,34,0,34
"20939",10501,"Grand Falls-Windsor","NL",48.92696,-55.65966,2018-05-23 05:00:00,32,0,32
"20940",10501,"Grand Falls-Windsor","NL",48.92696,-55.65966,2018-05-23 06:00:00,31,1,32
"20941",10501,"Grand Falls-Windsor","NL",48.92696,-55.65966,2018-05-23 07:00:00,29,1,30
"20942",10501,"Grand Falls-Windsor","NL",48.92696,-55.65966,2018-05-23 08:00:00,29,1,30
"20943",10501,"Grand Falls-Windsor","NL",48.92696,-55.65966,2018-05-23 09:00:00,27,1,28
"20944",10501,"Grand Falls-Windsor","NL",48.92696,-55.65966,2018-05-23 10:00:00,24,3,27
"20945",10501,"Grand Falls-Windsor","NL",48.92696,-55.65966,2018-05-23 11:00:00,NA,2,NA
"20946",10501,"Grand Falls-Windsor","NL",48.92696,-55.65966,2018-05-23 12:00:00,NA,2,NA
"20947",10501,"Grand Falls-Windsor","NL",48.92696,-55.65966,2018-05-23 13:00:00,NA,4,NA
"20948",10501,"Grand Falls-Windsor","NL",48.92696,-55.65966,2018-05-23 14:00:00,NA,2,NA
"20949",10501,"Grand Falls-Windsor","NL",48.92696,-55.65966,2018-05-23 15:00:00,NA,1,NA
"20950",10501,"Grand Falls-Windsor","NL",48.92696,-55.65966,2018-05-23 16:00:00,NA,1,NA
"20951",10501,"Grand Falls-Windsor","NL",48.92696,-55.65966,2018-05-23 17:00:00,NA,1,NA
"20952",10501,"Grand Falls-Windsor","NL",48.92696,-55.65966,2018-05-23 18:00:00,NA,1,NA
"20953",10501,"Grand Falls-Windsor","NL",48.92696,-55.65966,2018-05-23 19:00:00,NA,1,NA
"20954",10501,"Grand Falls-Windsor","NL",48.92696,-55.65966,2018-05-23 20:00:00,NA,1,NA
"20955",10501,"Grand Falls-Windsor","NL",48.92696,-55.65966,2018-05-23 21:00:00,NA,1,NA
"20956",10501,"Grand Falls-Windsor","NL",48.92696,-55.65966,2018-05-23 22:00:00,NA,1,NA
"20957",10501,"Grand Falls-Windsor","NL",48.92696,-55.65966,2018-05-23 23:00:00,NA,1,NA
"20958",10501,"Grand Falls-Windsor","NL",48.92696,-55.65966,2018-05-24 00:00:00,NA,1,NA
"20959",10501,"Grand Falls-Windsor","NL",48.92696,-55.65966,2018-05-24 01:00:00,NA,1,NA
"20960",10501,"Grand Falls-Windsor","NL",48.92696,-55.65966,2018-05-24 02:00:00,NA,0,NA
"20961",10501,"Grand Falls-Windsor","NL",48.92696,-55.65966,2018-05-24 03:00:00,NA,0,NA
"20962",10501,"Grand Falls-Windsor","NL",48.92696,-55.65966,2018-05-24 04:00:00,NA,1,NA
"20963",10501,"Grand Falls-Windsor","NL",48.92696,-55.65966,2018-05-24 05:00:00,NA,1,NA
"20964",10501,"Grand Falls-Windsor","NL",48.92696,-55.65966,2018-05-24 06:00:00,NA,1,NA
"20965",10501,"Grand Falls-Windsor","NL",48.92696,-55.65966,2018-05-24 07:00:00,NA,2,NA
"20966",10501,"Grand Falls-Windsor","NL",48.92696,-55.65966,2018-05-24 08:00:00,NA,2,NA
"20967",10501,"Grand Falls-Windsor","NL",48.92696,-55.65966,2018-05-24 09:00:00,NA,1,NA
"20968",10501,"Grand Falls-Windsor","NL",48.92696,-55.65966,2018-05-24 10:00:00,21,1,22
"20969",10501,"Grand Falls-Windsor","NL",48.92696,-55.65966,2018-05-24 11:00:00,27,2,29
"20970",10501,"Grand Falls-Windsor","NL",48.92696,-55.65966,2018-05-24 12:00:00,27,1,28
"20971",10501,"Grand Falls-Windsor","NL",48.92696,-55.65966,2018-05-24 13:00:00,27,1,28
"20972",10501,"Grand Falls-Windsor","NL",48.92696,-55.65966,2018-05-24 14:00:00,27,1,28
"20973",10501,"Grand Falls-Windsor","NL",48.92696,-55.65966,2018-05-24 15:00:00,27,2,29
"20974",10501,"Grand Falls-Windsor","NL",48.92696,-55.65966,2018-05-24 16:00:00,28,1,29
"20975",10501,"Grand Falls-Windsor","NL",48.92696,-55.65966,2018-05-24 17:00:00,27,1,28
"20976",10501,"Grand Falls-Windsor","NL",48.92696,-55.65966,2018-05-24 18:00:00,27,1,28
"20977",10501,"Grand Falls-Windsor","NL",48.92696,-55.65966,2018-05-24 19:00:00,26,1,27
"20978",10501,"Grand Falls-Windsor","NL",48.92696,-55.65966,2018-05-24 20:00:00,25,2,27
"20979",10501,"Grand Falls-Windsor","NL",48.92696,-55.65966,2018-05-24 21:00:00,24,2,26
"20980",10501,"Grand Falls-Windsor","NL",48.92696,-55.65966,2018-05-24 22:00:00,24,1,25
"20981",10501,"Grand Falls-Windsor","NL",48.92696,-55.65966,2018-05-24 23:00:00,23,1,24
"20982",10501,"Grand Falls-Windsor","NL",48.92696,-55.65966,2018-05-25 00:00:00,21,0,21
"20983",10501,"Grand Falls-Windsor","NL",48.92696,-55.65966,2018-05-25 01:00:00,19,1,20
"20984",10501,"Grand Falls-Windsor","NL",48.92696,-55.65966,2018-05-25 02:00:00,19,0,19
"20985",10501,"Grand Falls-Windsor","NL",48.92696,-55.65966,2018-05-25 03:00:00,18,0,18
"20986",10501,"Grand Falls-Windsor","NL",48.92696,-55.65966,2018-05-25 04:00:00,17,0,17
"20987",10501,"Grand Falls-Windsor","NL",48.92696,-55.65966,2018-05-25 05:00:00,17,0,17
"20988",10501,"Grand Falls-Windsor","NL",48.92696,-55.65966,2018-05-25 06:00:00,17,0,17
"20989",10501,"Grand Falls-Windsor","NL",48.92696,-55.65966,2018-05-25 07:00:00,17,1,18
"20990",10501,"Grand Falls-Windsor","NL",48.92696,-55.65966,2018-05-25 08:00:00,20,1,21
"20991",10501,"Grand Falls-Windsor","NL",48.92696,-55.65966,2018-05-25 09:00:00,22,1,23
"20992",10501,"Grand Falls-Windsor","NL",48.92696,-55.65966,2018-05-25 10:00:00,24,1,25
"20993",10501,"Grand Falls-Windsor","NL",48.92696,-55.65966,2018-05-25 11:00:00,25,0,25
"20994",10501,"Grand Falls-Windsor","NL",48.92696,-55.65966,2018-05-25 12:00:00,26,1,27
"20995",10501,"Grand Falls-Windsor","NL",48.92696,-55.65966,2018-05-25 13:00:00,27,0,27
"20996",10501,"Grand Falls-Windsor","NL",48.92696,-55.65966,2018-05-25 14:00:00,27,1,28
"20997",10501,"Grand Falls-Windsor","NL",48.92696,-55.65966,2018-05-25 15:00:00,27,1,28
"20998",10501,"Grand Falls-Windsor","NL",48.92696,-55.65966,2018-05-25 16:00:00,26,1,27
"20999",10501,"Grand Falls-Windsor","NL",48.92696,-55.65966,2018-05-25 17:00:00,26,1,27
"21000",10501,"Grand Falls-Windsor","NL",48.92696,-55.65966,2018-05-25 18:00:00,25,0,25
"21001",10501,"Grand Falls-Windsor","NL",48.92696,-55.65966,2018-05-25 19:00:00,25,0,25
"21002",10501,"Grand Falls-Windsor","NL",48.92696,-55.65966,2018-05-25 20:00:00,24,1,25
"21003",10501,"Grand Falls-Windsor","NL",48.92696,-55.65966,2018-05-25 21:00:00,25,1,26
"21004",10501,"Grand Falls-Windsor","NL",48.92696,-55.65966,2018-05-25 22:00:00,25,1,26
"21005",10501,"Grand Falls-Windsor","NL",48.92696,-55.65966,2018-05-25 23:00:00,25,1,26
"21006",10501,"Grand Falls-Windsor","NL",48.92696,-55.65966,2018-05-26 00:00:00,26,1,27
"21007",10501,"Grand Falls-Windsor","NL",48.92696,-55.65966,2018-05-26 01:00:00,25,1,26
"21008",10501,"Grand Falls-Windsor","NL",48.92696,-55.65966,2018-05-26 02:00:00,24,2,26
"21009",10501,"Grand Falls-Windsor","NL",48.92696,-55.65966,2018-05-26 03:00:00,22,2,24
"21010",10501,"Grand Falls-Windsor","NL",48.92696,-55.65966,2018-05-26 04:00:00,20,2,22
"21011",10501,"Grand Falls-Windsor","NL",48.92696,-55.65966,2018-05-26 05:00:00,20,2,22
"21012",10501,"Grand Falls-Windsor","NL",48.92696,-55.65966,2018-05-26 06:00:00,20,1,21
"21013",10501,"Grand Falls-Windsor","NL",48.92696,-55.65966,2018-05-26 07:00:00,21,1,22
"21014",10501,"Grand Falls-Windsor","NL",48.92696,-55.65966,2018-05-26 08:00:00,23,0,23
"21015",10501,"Grand Falls-Windsor","NL",48.92696,-55.65966,2018-05-26 09:00:00,24,1,25
"21016",10501,"Grand Falls-Windsor","NL",48.92696,-55.65966,2018-05-26 10:00:00,25,1,26
"21017",10501,"Grand Falls-Windsor","NL",48.92696,-55.65966,2018-05-26 11:00:00,25,1,26
"21018",10501,"Grand Falls-Windsor","NL",48.92696,-55.65966,2018-05-26 12:00:00,25,1,26
"21019",10501,"Grand Falls-Windsor","NL",48.92696,-55.65966,2018-05-26 13:00:00,25,1,26
"21020",10501,"Grand Falls-Windsor","NL",48.92696,-55.65966,2018-05-26 14:00:00,25,1,26
"21021",10501,"Grand Falls-Windsor","NL",48.92696,-55.65966,2018-05-26 15:00:00,24,1,25
"21022",10501,"Grand Falls-Windsor","NL",48.92696,-55.65966,2018-05-26 16:00:00,26,1,27
"21023",10501,"Grand Falls-Windsor","NL",48.92696,-55.65966,2018-05-26 17:00:00,27,1,28
"21024",10501,"Grand Falls-Windsor","NL",48.92696,-55.65966,2018-05-26 18:00:00,28,1,29
"21025",10501,"Grand Falls-Windsor","NL",48.92696,-55.65966,2018-05-26 19:00:00,28,1,29
"21026",10501,"Grand Falls-Windsor","NL",48.92696,-55.65966,2018-05-26 20:00:00,27,1,28
"21027",10501,"Grand Falls-Windsor","NL",48.92696,-55.65966,2018-05-26 21:00:00,28,1,29
"21028",10501,"Grand Falls-Windsor","NL",48.92696,-55.65966,2018-05-26 22:00:00,25,2,27
"21029",10501,"Grand Falls-Windsor","NL",48.92696,-55.65966,2018-05-26 23:00:00,24,1,25
"21030",10501,"Grand Falls-Windsor","NL",48.92696,-55.65966,2018-05-27 00:00:00,25,1,26
"21031",10501,"Grand Falls-Windsor","NL",48.92696,-55.65966,2018-05-27 01:00:00,24,1,25
"21032",10501,"Grand Falls-Windsor","NL",48.92696,-55.65966,2018-05-27 02:00:00,25,1,26
"21033",10501,"Grand Falls-Windsor","NL",48.92696,-55.65966,2018-05-27 03:00:00,24,1,25
"21034",10501,"Grand Falls-Windsor","NL",48.92696,-55.65966,2018-05-27 04:00:00,23,1,24
"21035",10501,"Grand Falls-Windsor","NL",48.92696,-55.65966,2018-05-27 05:00:00,23,0,23
"21036",10501,"Grand Falls-Windsor","NL",48.92696,-55.65966,2018-05-27 06:00:00,23,1,24
"21037",10501,"Grand Falls-Windsor","NL",48.92696,-55.65966,2018-05-27 07:00:00,24,1,25
"21038",10501,"Grand Falls-Windsor","NL",48.92696,-55.65966,2018-05-27 08:00:00,25,1,26
"21039",10501,"Grand Falls-Windsor","NL",48.92696,-55.65966,2018-05-27 09:00:00,26,0,26
"21040",10501,"Grand Falls-Windsor","NL",48.92696,-55.65966,2018-05-27 10:00:00,27,1,28
"21041",10501,"Grand Falls-Windsor","NL",48.92696,-55.65966,2018-05-27 11:00:00,27,1,28
"21042",10501,"Grand Falls-Windsor","NL",48.92696,-55.65966,2018-05-27 12:00:00,28,1,29
"21043",10501,"Grand Falls-Windsor","NL",48.92696,-55.65966,2018-05-27 13:00:00,30,1,31
"21044",10501,"Grand Falls-Windsor","NL",48.92696,-55.65966,2018-05-27 14:00:00,31,1,32
"21045",10501,"Grand Falls-Windsor","NL",48.92696,-55.65966,2018-05-27 15:00:00,32,1,33
"21046",10501,"Grand Falls-Windsor","NL",48.92696,-55.65966,2018-05-27 16:00:00,32,1,33
"21047",10501,"Grand Falls-Windsor","NL",48.92696,-55.65966,2018-05-27 17:00:00,33,1,34
"21048",10501,"Grand Falls-Windsor","NL",48.92696,-55.65966,2018-05-27 18:00:00,33,0,33
"21049",10501,"Grand Falls-Windsor","NL",48.92696,-55.65966,2018-05-27 19:00:00,32,1,33
"21050",10501,"Grand Falls-Windsor","NL",48.92696,-55.65966,2018-05-27 20:00:00,31,1,32
"21051",10501,"Grand Falls-Windsor","NL",48.92696,-55.65966,2018-05-27 21:00:00,27,1,28
"21052",10501,"Grand Falls-Windsor","NL",48.92696,-55.65966,2018-05-27 22:00:00,23,1,24
"21053",10501,"Grand Falls-Windsor","NL",48.92696,-55.65966,2018-05-27 23:00:00,21,1,22
"21054",10501,"Grand Falls-Windsor","NL",48.92696,-55.65966,2018-05-28 00:00:00,20,1,21
"21055",10501,"Grand Falls-Windsor","NL",48.92696,-55.65966,2018-05-28 01:00:00,15,1,16
"21056",10501,"Grand Falls-Windsor","NL",48.92696,-55.65966,2018-05-28 02:00:00,10,1,11
"21057",10501,"Grand Falls-Windsor","NL",48.92696,-55.65966,2018-05-28 03:00:00,11,1,12
"21058",10501,"Grand Falls-Windsor","NL",48.92696,-55.65966,2018-05-28 04:00:00,9,0,9
"21059",10501,"Grand Falls-Windsor","NL",48.92696,-55.65966,2018-05-28 05:00:00,8,1,9
"21060",10501,"Grand Falls-Windsor","NL",48.92696,-55.65966,2018-05-28 06:00:00,10,0,10
"21061",10501,"Grand Falls-Windsor","NL",48.92696,-55.65966,2018-05-28 07:00:00,13,2,15
"21062",10501,"Grand Falls-Windsor","NL",48.92696,-55.65966,2018-05-28 08:00:00,17,1,18
"21063",10501,"Grand Falls-Windsor","NL",48.92696,-55.65966,2018-05-28 09:00:00,24,1,25
"21064",10501,"Grand Falls-Windsor","NL",48.92696,-55.65966,2018-05-28 10:00:00,27,0,27
"21065",10501,"Grand Falls-Windsor","NL",48.92696,-55.65966,2018-05-28 11:00:00,30,1,31
"21066",10501,"Grand Falls-Windsor","NL",48.92696,-55.65966,2018-05-28 12:00:00,30,0,30
"21067",10501,"Grand Falls-Windsor","NL",48.92696,-55.65966,2018-05-28 13:00:00,32,1,33
"21068",10501,"Grand Falls-Windsor","NL",48.92696,-55.65966,2018-05-28 14:00:00,34,1,35
"21069",10501,"Grand Falls-Windsor","NL",48.92696,-55.65966,2018-05-28 15:00:00,33,1,34
"21070",10501,"Grand Falls-Windsor","NL",48.92696,-55.65966,2018-05-28 16:00:00,32,1,33
"21071",10501,"Grand Falls-Windsor","NL",48.92696,-55.65966,2018-05-28 17:00:00,32,1,33
"21072",10501,"Grand Falls-Windsor","NL",48.92696,-55.65966,2018-05-28 18:00:00,31,1,32
"21073",10501,"Grand Falls-Windsor","NL",48.92696,-55.65966,2018-05-28 19:00:00,31,0,31
"21074",10501,"Grand Falls-Windsor","NL",48.92696,-55.65966,2018-05-28 20:00:00,30,1,31
"21075",10501,"Grand Falls-Windsor","NL",48.92696,-55.65966,2018-05-28 21:00:00,29,0,29
"21076",10501,"Grand Falls-Windsor","NL",48.92696,-55.65966,2018-05-28 22:00:00,29,1,30
"21077",10501,"Grand Falls-Windsor","NL",48.92696,-55.65966,2018-05-28 23:00:00,31,0,31
"21078",10501,"Grand Falls-Windsor","NL",48.92696,-55.65966,2018-05-29 00:00:00,29,0,29
"21079",10501,"Grand Falls-Windsor","NL",48.92696,-55.65966,2018-05-29 01:00:00,28,0,28
"21080",10501,"Grand Falls-Windsor","NL",48.92696,-55.65966,2018-05-29 02:00:00,28,0,28
"21081",10501,"Grand Falls-Windsor","NL",48.92696,-55.65966,2018-05-29 03:00:00,27,0,27
"21082",10501,"Grand Falls-Windsor","NL",48.92696,-55.65966,2018-05-29 04:00:00,27,0,27
"21083",10501,"Grand Falls-Windsor","NL",48.92696,-55.65966,2018-05-29 05:00:00,26,1,27
"21084",10501,"Grand Falls-Windsor","NL",48.92696,-55.65966,2018-05-29 06:00:00,27,0,27
"21085",10501,"Grand Falls-Windsor","NL",48.92696,-55.65966,2018-05-29 07:00:00,28,0,28
"21086",10501,"Grand Falls-Windsor","NL",48.92696,-55.65966,2018-05-29 08:00:00,28,1,29
"21087",10501,"Grand Falls-Windsor","NL",48.92696,-55.65966,2018-05-29 09:00:00,29,0,29
"21088",10501,"Grand Falls-Windsor","NL",48.92696,-55.65966,2018-05-29 10:00:00,28,0,28
"21089",10501,"Grand Falls-Windsor","NL",48.92696,-55.65966,2018-05-29 11:00:00,27,1,28
"21090",10501,"Grand Falls-Windsor","NL",48.92696,-55.65966,2018-05-29 12:00:00,26,0,26
"21091",10501,"Grand Falls-Windsor","NL",48.92696,-55.65966,2018-05-29 13:00:00,26,0,26
"21092",10501,"Grand Falls-Windsor","NL",48.92696,-55.65966,2018-05-29 14:00:00,26,0,26
"21093",10501,"Grand Falls-Windsor","NL",48.92696,-55.65966,2018-05-29 15:00:00,26,0,26
"21094",10501,"Grand Falls-Windsor","NL",48.92696,-55.65966,2018-05-29 16:00:00,25,1,26
"21095",10501,"Grand Falls-Windsor","NL",48.92696,-55.65966,2018-05-29 17:00:00,25,1,26
"21096",10501,"Grand Falls-Windsor","NL",48.92696,-55.65966,2018-05-29 18:00:00,24,1,25
"21097",10501,"Grand Falls-Windsor","NL",48.92696,-55.65966,2018-05-29 19:00:00,23,1,24
"21098",10501,"Grand Falls-Windsor","NL",48.92696,-55.65966,2018-05-29 20:00:00,23,2,25
"21099",10501,"Grand Falls-Windsor","NL",48.92696,-55.65966,2018-05-29 21:00:00,21,3,24
"21100",10501,"Grand Falls-Windsor","NL",48.92696,-55.65966,2018-05-29 22:00:00,23,2,25
"21101",10501,"Grand Falls-Windsor","NL",48.92696,-55.65966,2018-05-29 23:00:00,25,0,25
"21102",10501,"Grand Falls-Windsor","NL",48.92696,-55.65966,2018-05-30 00:00:00,23,1,24
"21103",10501,"Grand Falls-Windsor","NL",48.92696,-55.65966,2018-05-30 01:00:00,23,0,23
"21104",10501,"Grand Falls-Windsor","NL",48.92696,-55.65966,2018-05-30 02:00:00,24,1,25
"21105",10501,"Grand Falls-Windsor","NL",48.92696,-55.65966,2018-05-30 03:00:00,24,0,24
"21106",10501,"Grand Falls-Windsor","NL",48.92696,-55.65966,2018-05-30 04:00:00,24,0,24
"21107",10501,"Grand Falls-Windsor","NL",48.92696,-55.65966,2018-05-30 05:00:00,24,1,25
"21108",10501,"Grand Falls-Windsor","NL",48.92696,-55.65966,2018-05-30 06:00:00,24,1,25
"21109",10501,"Grand Falls-Windsor","NL",48.92696,-55.65966,2018-05-30 07:00:00,24,1,25
"21110",10501,"Grand Falls-Windsor","NL",48.92696,-55.65966,2018-05-30 08:00:00,24,1,25
"21111",10501,"Grand Falls-Windsor","NL",48.92696,-55.65966,2018-05-30 09:00:00,25,1,26
"21112",10501,"Grand Falls-Windsor","NL",48.92696,-55.65966,2018-05-30 10:00:00,25,1,26
"21113",10501,"Grand Falls-Windsor","NL",48.92696,-55.65966,2018-05-30 11:00:00,25,1,26
"21114",10501,"Grand Falls-Windsor","NL",48.92696,-55.65966,2018-05-30 12:00:00,25,1,26
"21115",10501,"Grand Falls-Windsor","NL",48.92696,-55.65966,2018-05-30 13:00:00,25,1,26
"21116",10501,"Grand Falls-Windsor","NL",48.92696,-55.65966,2018-05-30 14:00:00,28,1,29
"21117",10501,"Grand Falls-Windsor","NL",48.92696,-55.65966,2018-05-30 15:00:00,29,1,30
"21118",10501,"Grand Falls-Windsor","NL",48.92696,-55.65966,2018-05-30 16:00:00,28,1,29
"21119",10501,"Grand Falls-Windsor","NL",48.92696,-55.65966,2018-05-30 17:00:00,28,1,29
"21120",10501,"Grand Falls-Windsor","NL",48.92696,-55.65966,2018-05-30 18:00:00,28,1,29
"21121",10501,"Grand Falls-Windsor","NL",48.92696,-55.65966,2018-05-30 19:00:00,27,0,27
"21122",10501,"Grand Falls-Windsor","NL",48.92696,-55.65966,2018-05-30 20:00:00,27,1,28
"21123",10501,"Grand Falls-Windsor","NL",48.92696,-55.65966,2018-05-30 21:00:00,26,1,27
"21124",10501,"Grand Falls-Windsor","NL",48.92696,-55.65966,2018-05-30 22:00:00,25,1,26
"21125",10501,"Grand Falls-Windsor","NL",48.92696,-55.65966,2018-05-30 23:00:00,25,1,26
"21126",10501,"Grand Falls-Windsor","NL",48.92696,-55.65966,2018-05-31 00:00:00,24,1,25
"21127",10501,"Grand Falls-Windsor","NL",48.92696,-55.65966,2018-05-31 01:00:00,24,0,24
"21128",10501,"Grand Falls-Windsor","NL",48.92696,-55.65966,2018-05-31 02:00:00,23,1,24
"21129",10501,"Grand Falls-Windsor","NL",48.92696,-55.65966,2018-05-31 03:00:00,23,1,24
"21130",10501,"Grand Falls-Windsor","NL",48.92696,-55.65966,2018-05-31 04:00:00,22,1,23
"21131",10501,"Grand Falls-Windsor","NL",48.92696,-55.65966,2018-05-31 05:00:00,21,1,22
"21132",10501,"Grand Falls-Windsor","NL",48.92696,-55.65966,2018-05-31 06:00:00,22,2,24
"21133",10501,"Grand Falls-Windsor","NL",48.92696,-55.65966,2018-05-31 07:00:00,24,1,25
"21134",10501,"Grand Falls-Windsor","NL",48.92696,-55.65966,2018-05-31 08:00:00,28,1,29
"21135",10501,"Grand Falls-Windsor","NL",48.92696,-55.65966,2018-05-31 09:00:00,29,1,30
"21136",10501,"Grand Falls-Windsor","NL",48.92696,-55.65966,2018-05-31 10:00:00,31,1,32
"21137",10501,"Grand Falls-Windsor","NL",48.92696,-55.65966,2018-05-31 11:00:00,34,1,35
"21138",10501,"Grand Falls-Windsor","NL",48.92696,-55.65966,2018-05-31 12:00:00,36,1,37
"21139",10501,"Grand Falls-Windsor","NL",48.92696,-55.65966,2018-05-31 13:00:00,38,1,39
"21140",10501,"Grand Falls-Windsor","NL",48.92696,-55.65966,2018-05-31 14:00:00,38,1,39
"21141",10501,"Grand Falls-Windsor","NL",48.92696,-55.65966,2018-05-31 15:00:00,41,1,42
"21142",10501,"Grand Falls-Windsor","NL",48.92696,-55.65966,2018-05-31 16:00:00,43,1,44
"21143",10501,"Grand Falls-Windsor","NL",48.92696,-55.65966,2018-05-31 17:00:00,46,1,47
"21144",10501,"Grand Falls-Windsor","NL",48.92696,-55.65966,2018-05-31 18:00:00,45,1,46
"21145",10501,"Grand Falls-Windsor","NL",48.92696,-55.65966,2018-05-31 19:00:00,42,1,43
"21146",10501,"Grand Falls-Windsor","NL",48.92696,-55.65966,2018-05-31 20:00:00,40,1,41
"21147",10501,"Grand Falls-Windsor","NL",48.92696,-55.65966,2018-05-31 21:00:00,40,2,42
"21148",10501,"Grand Falls-Windsor","NL",48.92696,-55.65966,2018-05-31 22:00:00,37,2,39
"21149",10501,"Grand Falls-Windsor","NL",48.92696,-55.65966,2018-05-31 23:00:00,35,1,36
"21150",10501,"Grand Falls-Windsor","NL",48.92696,-55.65966,2018-06-01 00:00:00,29,2,31
"21151",10501,"Grand Falls-Windsor","NL",48.92696,-55.65966,2018-06-01 01:00:00,27,1,28
"21152",10501,"Grand Falls-Windsor","NL",48.92696,-55.65966,2018-06-01 02:00:00,27,1,28
"21153",10501,"Grand Falls-Windsor","NL",48.92696,-55.65966,2018-06-01 03:00:00,28,1,29
"21154",10501,"Grand Falls-Windsor","NL",48.92696,-55.65966,2018-06-01 04:00:00,27,1,28
"21155",10501,"Grand Falls-Windsor","NL",48.92696,-55.65966,2018-06-01 05:00:00,26,0,26
"21156",10501,"Grand Falls-Windsor","NL",48.92696,-55.65966,2018-06-01 06:00:00,22,1,23
"21157",10501,"Grand Falls-Windsor","NL",48.92696,-55.65966,2018-06-01 07:00:00,21,2,23
"21158",10501,"Grand Falls-Windsor","NL",48.92696,-55.65966,2018-06-01 08:00:00,21,2,23
"21159",10501,"Grand Falls-Windsor","NL",48.92696,-55.65966,2018-06-01 09:00:00,24,2,26
"21160",10501,"Grand Falls-Windsor","NL",48.92696,-55.65966,2018-06-01 10:00:00,25,2,27
"21161",10501,"Grand Falls-Windsor","NL",48.92696,-55.65966,2018-06-01 11:00:00,24,1,25
"21162",10501,"Grand Falls-Windsor","NL",48.92696,-55.65966,2018-06-01 12:00:00,25,1,26
"21163",10501,"Grand Falls-Windsor","NL",48.92696,-55.65966,2018-06-01 13:00:00,25,1,26
"21164",10501,"Grand Falls-Windsor","NL",48.92696,-55.65966,2018-06-01 14:00:00,26,1,27
"21165",10501,"Grand Falls-Windsor","NL",48.92696,-55.65966,2018-06-01 15:00:00,27,1,28
"21166",10501,"Grand Falls-Windsor","NL",48.92696,-55.65966,2018-06-01 16:00:00,27,1,28
"21167",10501,"Grand Falls-Windsor","NL",48.92696,-55.65966,2018-06-01 17:00:00,27,1,28
"21168",10501,"Grand Falls-Windsor","NL",48.92696,-55.65966,2018-06-01 18:00:00,26,1,27
"21169",10501,"Grand Falls-Windsor","NL",48.92696,-55.65966,2018-06-01 19:00:00,26,1,27
"21170",10501,"Grand Falls-Windsor","NL",48.92696,-55.65966,2018-06-01 20:00:00,24,1,25
"21171",10501,"Grand Falls-Windsor","NL",48.92696,-55.65966,2018-06-01 21:00:00,23,2,25
"21172",10501,"Grand Falls-Windsor","NL",48.92696,-55.65966,2018-06-01 22:00:00,20,2,22
"21173",10501,"Grand Falls-Windsor","NL",48.92696,-55.65966,2018-06-01 23:00:00,19,2,21
"21174",10501,"Grand Falls-Windsor","NL",48.92696,-55.65966,2018-06-02 00:00:00,17,2,19
"21175",10501,"Grand Falls-Windsor","NL",48.92696,-55.65966,2018-06-02 01:00:00,11,1,12
"21176",10501,"Grand Falls-Windsor","NL",48.92696,-55.65966,2018-06-02 02:00:00,6,1,7
"21177",10501,"Grand Falls-Windsor","NL",48.92696,-55.65966,2018-06-02 03:00:00,10,1,11
"21178",10501,"Grand Falls-Windsor","NL",48.92696,-55.65966,2018-06-02 04:00:00,10,1,11
"21179",10501,"Grand Falls-Windsor","NL",48.92696,-55.65966,2018-06-02 05:00:00,9,1,10
"21180",10501,"Grand Falls-Windsor","NL",48.92696,-55.65966,2018-06-02 06:00:00,10,1,11
"21181",10501,"Grand Falls-Windsor","NL",48.92696,-55.65966,2018-06-02 07:00:00,10,1,11
"21182",10501,"Grand Falls-Windsor","NL",48.92696,-55.65966,2018-06-02 08:00:00,12,1,13
"21183",10501,"Grand Falls-Windsor","NL",48.92696,-55.65966,2018-06-02 09:00:00,15,0,15
"21184",10501,"Grand Falls-Windsor","NL",48.92696,-55.65966,2018-06-02 10:00:00,19,1,20
"21185",10501,"Grand Falls-Windsor","NL",48.92696,-55.65966,2018-06-02 11:00:00,22,1,23
"21186",10501,"Grand Falls-Windsor","NL",48.92696,-55.65966,2018-06-02 12:00:00,27,1,28
"21187",10501,"Grand Falls-Windsor","NL",48.92696,-55.65966,2018-06-02 13:00:00,24,1,25
"21188",10501,"Grand Falls-Windsor","NL",48.92696,-55.65966,2018-06-02 14:00:00,24,1,25
"21189",10501,"Grand Falls-Windsor","NL",48.92696,-55.65966,2018-06-02 15:00:00,27,1,28
"21190",10501,"Grand Falls-Windsor","NL",48.92696,-55.65966,2018-06-02 16:00:00,30,1,31
"21191",10501,"Grand Falls-Windsor","NL",48.92696,-55.65966,2018-06-02 17:00:00,28,1,29
"21192",10501,"Grand Falls-Windsor","NL",48.92696,-55.65966,2018-06-02 18:00:00,27,1,28
"21193",10501,"Grand Falls-Windsor","NL",48.92696,-55.65966,2018-06-02 19:00:00,24,1,25
"21194",10501,"Grand Falls-Windsor","NL",48.92696,-55.65966,2018-06-02 20:00:00,24,1,25
"21195",10501,"Grand Falls-Windsor","NL",48.92696,-55.65966,2018-06-02 21:00:00,25,1,26
"21196",10501,"Grand Falls-Windsor","NL",48.92696,-55.65966,2018-06-02 22:00:00,25,1,26
"21197",10501,"Grand Falls-Windsor","NL",48.92696,-55.65966,2018-06-02 23:00:00,25,1,26
"21198",10501,"Grand Falls-Windsor","NL",48.92696,-55.65966,2018-06-03 00:00:00,25,1,26
"21199",10501,"Grand Falls-Windsor","NL",48.92696,-55.65966,2018-06-03 01:00:00,25,1,26
"21200",10501,"Grand Falls-Windsor","NL",48.92696,-55.65966,2018-06-03 02:00:00,25,1,26
"21201",10501,"Grand Falls-Windsor","NL",48.92696,-55.65966,2018-06-03 03:00:00,25,1,26
"21202",10501,"Grand Falls-Windsor","NL",48.92696,-55.65966,2018-06-03 04:00:00,25,1,26
"21203",10501,"Grand Falls-Windsor","NL",48.92696,-55.65966,2018-06-03 05:00:00,25,0,25
"21204",10501,"Grand Falls-Windsor","NL",48.92696,-55.65966,2018-06-03 06:00:00,25,1,26
"21205",10501,"Grand Falls-Windsor","NL",48.92696,-55.65966,2018-06-03 07:00:00,24,1,25
"21206",10501,"Grand Falls-Windsor","NL",48.92696,-55.65966,2018-06-03 08:00:00,24,1,25
"21207",10501,"Grand Falls-Windsor","NL",48.92696,-55.65966,2018-06-03 09:00:00,24,1,25
"21208",10501,"Grand Falls-Windsor","NL",48.92696,-55.65966,2018-06-03 10:00:00,23,1,24
"21209",10501,"Grand Falls-Windsor","NL",48.92696,-55.65966,2018-06-03 11:00:00,23,1,24
"21210",10501,"Grand Falls-Windsor","NL",48.92696,-55.65966,2018-06-03 12:00:00,22,1,23
"21211",10501,"Grand Falls-Windsor","NL",48.92696,-55.65966,2018-06-03 13:00:00,22,1,23
"21212",10501,"Grand Falls-Windsor","NL",48.92696,-55.65966,2018-06-03 14:00:00,22,1,23
"21213",10501,"Grand Falls-Windsor","NL",48.92696,-55.65966,2018-06-03 15:00:00,22,1,23
"21214",10501,"Grand Falls-Windsor","NL",48.92696,-55.65966,2018-06-03 16:00:00,22,1,23
"21215",10501,"Grand Falls-Windsor","NL",48.92696,-55.65966,2018-06-03 17:00:00,21,1,22
"21216",10501,"Grand Falls-Windsor","NL",48.92696,-55.65966,2018-06-03 18:00:00,21,1,22
"21217",10501,"Grand Falls-Windsor","NL",48.92696,-55.65966,2018-06-03 19:00:00,21,1,22
"21218",10501,"Grand Falls-Windsor","NL",48.92696,-55.65966,2018-06-03 20:00:00,21,1,22
"21219",10501,"Grand Falls-Windsor","NL",48.92696,-55.65966,2018-06-03 21:00:00,21,1,22
"21220",10501,"Grand Falls-Windsor","NL",48.92696,-55.65966,2018-06-03 22:00:00,21,1,22
"21221",10501,"Grand Falls-Windsor","NL",48.92696,-55.65966,2018-06-03 23:00:00,22,1,23
"21222",10501,"Grand Falls-Windsor","NL",48.92696,-55.65966,2018-06-04 00:00:00,24,1,25
"21223",10501,"Grand Falls-Windsor","NL",48.92696,-55.65966,2018-06-04 01:00:00,24,0,24
"21224",10501,"Grand Falls-Windsor","NL",48.92696,-55.65966,2018-06-04 02:00:00,24,1,25
"21225",10501,"Grand Falls-Windsor","NL",48.92696,-55.65966,2018-06-04 03:00:00,24,0,24
"21226",10501,"Grand Falls-Windsor","NL",48.92696,-55.65966,2018-06-04 04:00:00,23,0,23
"21227",10501,"Grand Falls-Windsor","NL",48.92696,-55.65966,2018-06-04 05:00:00,22,0,22
"21228",10501,"Grand Falls-Windsor","NL",48.92696,-55.65966,2018-06-04 06:00:00,22,1,23
"21229",10501,"Grand Falls-Windsor","NL",48.92696,-55.65966,2018-06-04 07:00:00,21,1,22
"21230",10501,"Grand Falls-Windsor","NL",48.92696,-55.65966,2018-06-04 08:00:00,22,1,23
"21231",10501,"Grand Falls-Windsor","NL",48.92696,-55.65966,2018-06-04 09:00:00,23,1,24
"21232",10501,"Grand Falls-Windsor","NL",48.92696,-55.65966,2018-06-04 10:00:00,23,1,24
"21233",10501,"Grand Falls-Windsor","NL",48.92696,-55.65966,2018-06-04 11:00:00,23,1,24
"21234",10501,"Grand Falls-Windsor","NL",48.92696,-55.65966,2018-06-04 12:00:00,23,1,24
"21235",10501,"Grand Falls-Windsor","NL",48.92696,-55.65966,2018-06-04 13:00:00,24,0,24
"21236",10501,"Grand Falls-Windsor","NL",48.92696,-55.65966,2018-06-04 14:00:00,24,1,25
"21237",10501,"Grand Falls-Windsor","NL",48.92696,-55.65966,2018-06-04 15:00:00,25,1,26
"21238",10501,"Grand Falls-Windsor","NL",48.92696,-55.65966,2018-06-04 16:00:00,25,0,25
"21239",10501,"Grand Falls-Windsor","NL",48.92696,-55.65966,2018-06-04 17:00:00,25,1,26
"21240",10501,"Grand Falls-Windsor","NL",48.92696,-55.65966,2018-06-04 18:00:00,26,1,27
"21241",10501,"Grand Falls-Windsor","NL",48.92696,-55.65966,2018-06-04 19:00:00,27,1,28
"21242",10501,"Grand Falls-Windsor","NL",48.92696,-55.65966,2018-06-04 20:00:00,26,1,27
"21243",10501,"Grand Falls-Windsor","NL",48.92696,-55.65966,2018-06-04 21:00:00,25,1,26
"21244",10501,"Grand Falls-Windsor","NL",48.92696,-55.65966,2018-06-04 22:00:00,24,1,25
"21245",10501,"Grand Falls-Windsor","NL",48.92696,-55.65966,2018-06-04 23:00:00,22,1,23
"21246",10501,"Grand Falls-Windsor","NL",48.92696,-55.65966,2018-06-05 00:00:00,19,0,19
"21247",10501,"Grand Falls-Windsor","NL",48.92696,-55.65966,2018-06-05 01:00:00,18,0,18
"21248",10501,"Grand Falls-Windsor","NL",48.92696,-55.65966,2018-06-05 02:00:00,18,0,18
"21249",10501,"Grand Falls-Windsor","NL",48.92696,-55.65966,2018-06-05 03:00:00,17,0,17
"21250",10501,"Grand Falls-Windsor","NL",48.92696,-55.65966,2018-06-05 04:00:00,17,0,17
"21251",10501,"Grand Falls-Windsor","NL",48.92696,-55.65966,2018-06-05 05:00:00,17,0,17
"21252",10501,"Grand Falls-Windsor","NL",48.92696,-55.65966,2018-06-05 06:00:00,17,0,17
"21253",10501,"Grand Falls-Windsor","NL",48.92696,-55.65966,2018-06-05 07:00:00,19,0,19
"21254",10501,"Grand Falls-Windsor","NL",48.92696,-55.65966,2018-06-05 08:00:00,21,1,22
"21255",10501,"Grand Falls-Windsor","NL",48.92696,-55.65966,2018-06-05 09:00:00,24,1,25
"21256",10501,"Grand Falls-Windsor","NL",48.92696,-55.65966,2018-06-05 10:00:00,26,1,27
"21257",10501,"Grand Falls-Windsor","NL",48.92696,-55.65966,2018-06-05 11:00:00,26,1,27
"21258",10501,"Grand Falls-Windsor","NL",48.92696,-55.65966,2018-06-05 12:00:00,25,1,26
"21259",10501,"Grand Falls-Windsor","NL",48.92696,-55.65966,2018-06-05 13:00:00,26,1,27
"21260",10501,"Grand Falls-Windsor","NL",48.92696,-55.65966,2018-06-05 14:00:00,26,1,27
"21261",10501,"Grand Falls-Windsor","NL",48.92696,-55.65966,2018-06-05 15:00:00,26,1,27
"21262",10501,"Grand Falls-Windsor","NL",48.92696,-55.65966,2018-06-05 16:00:00,27,NA,NA
"21263",10501,"Grand Falls-Windsor","NL",48.92696,-55.65966,2018-06-05 17:00:00,28,1,29
"21264",10501,"Grand Falls-Windsor","NL",48.92696,-55.65966,2018-06-05 18:00:00,25,0,25
"21265",10501,"Grand Falls-Windsor","NL",48.92696,-55.65966,2018-06-05 19:00:00,24,0,24
"21266",10501,"Grand Falls-Windsor","NL",48.92696,-55.65966,2018-06-05 20:00:00,23,1,24
"21267",10501,"Grand Falls-Windsor","NL",48.92696,-55.65966,2018-06-05 21:00:00,23,0,23
"21268",10501,"Grand Falls-Windsor","NL",48.92696,-55.65966,2018-06-05 22:00:00,21,1,22
"21269",10501,"Grand Falls-Windsor","NL",48.92696,-55.65966,2018-06-05 23:00:00,17,1,18
"21270",10501,"Grand Falls-Windsor","NL",48.92696,-55.65966,2018-06-06 00:00:00,14,1,15
"21271",10501,"Grand Falls-Windsor","NL",48.92696,-55.65966,2018-06-06 01:00:00,10,1,11
"21272",10501,"Grand Falls-Windsor","NL",48.92696,-55.65966,2018-06-06 02:00:00,16,0,16
"21273",10501,"Grand Falls-Windsor","NL",48.92696,-55.65966,2018-06-06 03:00:00,16,1,17
"21274",10501,"Grand Falls-Windsor","NL",48.92696,-55.65966,2018-06-06 04:00:00,15,1,16
"21275",10501,"Grand Falls-Windsor","NL",48.92696,-55.65966,2018-06-06 05:00:00,11,1,12
"21276",10501,"Grand Falls-Windsor","NL",48.92696,-55.65966,2018-06-06 06:00:00,11,1,12
"21277",10501,"Grand Falls-Windsor","NL",48.92696,-55.65966,2018-06-06 07:00:00,15,3,18
"21278",10501,"Grand Falls-Windsor","NL",48.92696,-55.65966,2018-06-06 08:00:00,27,3,30
"21279",10501,"Grand Falls-Windsor","NL",48.92696,-55.65966,2018-06-06 09:00:00,24,2,26
"21280",10501,"Grand Falls-Windsor","NL",48.92696,-55.65966,2018-06-06 10:00:00,26,2,28
"21281",10501,"Grand Falls-Windsor","NL",48.92696,-55.65966,2018-06-06 11:00:00,26,3,29
"21282",10501,"Grand Falls-Windsor","NL",48.92696,-55.65966,2018-06-06 12:00:00,29,2,31
"21283",10501,"Grand Falls-Windsor","NL",48.92696,-55.65966,2018-06-06 13:00:00,27,2,29
"21284",10501,"Grand Falls-Windsor","NL",48.92696,-55.65966,2018-06-06 14:00:00,29,2,31
"21285",10501,"Grand Falls-Windsor","NL",48.92696,-55.65966,2018-06-06 15:00:00,31,2,33
"21286",10501,"Grand Falls-Windsor","NL",48.92696,-55.65966,2018-06-06 16:00:00,31,2,33
"21287",10501,"Grand Falls-Windsor","NL",48.92696,-55.65966,2018-06-06 17:00:00,30,2,32
"21288",10501,"Grand Falls-Windsor","NL",48.92696,-55.65966,2018-06-06 18:00:00,29,1,30
"21289",10501,"Grand Falls-Windsor","NL",48.92696,-55.65966,2018-06-06 19:00:00,28,1,29
"21290",10501,"Grand Falls-Windsor","NL",48.92696,-55.65966,2018-06-06 20:00:00,28,1,29
"21291",10501,"Grand Falls-Windsor","NL",48.92696,-55.65966,2018-06-06 21:00:00,24,2,26
"21292",10501,"Grand Falls-Windsor","NL",48.92696,-55.65966,2018-06-06 22:00:00,16,4,20
"21293",10501,"Grand Falls-Windsor","NL",48.92696,-55.65966,2018-06-06 23:00:00,10,2,12
"21294",10501,"Grand Falls-Windsor","NL",48.92696,-55.65966,2018-06-07 00:00:00,6,1,7
"21295",10501,"Grand Falls-Windsor","NL",48.92696,-55.65966,2018-06-07 01:00:00,2,1,3
"21296",10501,"Grand Falls-Windsor","NL",48.92696,-55.65966,2018-06-07 02:00:00,2,1,3
"21297",10501,"Grand Falls-Windsor","NL",48.92696,-55.65966,2018-06-07 03:00:00,3,1,4
"21298",10501,"Grand Falls-Windsor","NL",48.92696,-55.65966,2018-06-07 04:00:00,4,5,9
"21299",10501,"Grand Falls-Windsor","NL",48.92696,-55.65966,2018-06-07 05:00:00,3,1,4
"21300",10501,"Grand Falls-Windsor","NL",48.92696,-55.65966,2018-06-07 06:00:00,4,0,4
"21301",10501,"Grand Falls-Windsor","NL",48.92696,-55.65966,2018-06-07 07:00:00,6,1,7
"21302",10501,"Grand Falls-Windsor","NL",48.92696,-55.65966,2018-06-07 08:00:00,7,2,9
"21303",10501,"Grand Falls-Windsor","NL",48.92696,-55.65966,2018-06-07 09:00:00,12,2,14
"21304",10501,"Grand Falls-Windsor","NL",48.92696,-55.65966,2018-06-07 10:00:00,18,1,19
"21305",10501,"Grand Falls-Windsor","NL",48.92696,-55.65966,2018-06-07 11:00:00,20,1,21
"21306",10501,"Grand Falls-Windsor","NL",48.92696,-55.65966,2018-06-07 12:00:00,22,1,23
"21307",10501,"Grand Falls-Windsor","NL",48.92696,-55.65966,2018-06-07 13:00:00,24,1,25
"21308",10501,"Grand Falls-Windsor","NL",48.92696,-55.65966,2018-06-07 14:00:00,26,0,26
"21309",10501,"Grand Falls-Windsor","NL",48.92696,-55.65966,2018-06-07 15:00:00,25,1,26
"21310",10501,"Grand Falls-Windsor","NL",48.92696,-55.65966,2018-06-07 16:00:00,25,1,26
"21311",10501,"Grand Falls-Windsor","NL",48.92696,-55.65966,2018-06-07 17:00:00,25,1,26
"21312",10501,"Grand Falls-Windsor","NL",48.92696,-55.65966,2018-06-07 18:00:00,25,1,26
"21313",10501,"Grand Falls-Windsor","NL",48.92696,-55.65966,2018-06-07 19:00:00,24,1,25
"21314",10501,"Grand Falls-Windsor","NL",48.92696,-55.65966,2018-06-07 20:00:00,23,1,24
"21315",10501,"Grand Falls-Windsor","NL",48.92696,-55.65966,2018-06-07 21:00:00,21,2,23
"21316",10501,"Grand Falls-Windsor","NL",48.92696,-55.65966,2018-06-07 22:00:00,18,3,21
"21317",10501,"Grand Falls-Windsor","NL",48.92696,-55.65966,2018-06-07 23:00:00,15,3,18
"21318",10501,"Grand Falls-Windsor","NL",48.92696,-55.65966,2018-06-08 00:00:00,12,4,16
"21319",10501,"Grand Falls-Windsor","NL",48.92696,-55.65966,2018-06-08 01:00:00,10,2,12
"21320",10501,"Grand Falls-Windsor","NL",48.92696,-55.65966,2018-06-08 02:00:00,4,0,4
"21321",10501,"Grand Falls-Windsor","NL",48.92696,-55.65966,2018-06-08 03:00:00,4,0,4
"21322",10501,"Grand Falls-Windsor","NL",48.92696,-55.65966,2018-06-08 04:00:00,5,1,6
"21323",10501,"Grand Falls-Windsor","NL",48.92696,-55.65966,2018-06-08 05:00:00,3,1,4
"21324",10501,"Grand Falls-Windsor","NL",48.92696,-55.65966,2018-06-08 06:00:00,7,1,8
"21325",10501,"Grand Falls-Windsor","NL",48.92696,-55.65966,2018-06-08 07:00:00,10,1,11
"21326",10501,"Grand Falls-Windsor","NL",48.92696,-55.65966,2018-06-08 08:00:00,15,1,16
"21327",10501,"Grand Falls-Windsor","NL",48.92696,-55.65966,2018-06-08 09:00:00,21,1,22
"21328",10501,"Grand Falls-Windsor","NL",48.92696,-55.65966,2018-06-08 10:00:00,27,0,27
"21329",10501,"Grand Falls-Windsor","NL",48.92696,-55.65966,2018-06-08 11:00:00,30,0,30
"21330",10501,"Grand Falls-Windsor","NL",48.92696,-55.65966,2018-06-08 12:00:00,31,1,32
"21331",10501,"Grand Falls-Windsor","NL",48.92696,-55.65966,2018-06-08 13:00:00,34,0,34
"21332",10501,"Grand Falls-Windsor","NL",48.92696,-55.65966,2018-06-08 14:00:00,35,1,36
"21333",10501,"Grand Falls-Windsor","NL",48.92696,-55.65966,2018-06-08 15:00:00,30,0,30
"21334",10501,"Grand Falls-Windsor","NL",48.92696,-55.65966,2018-06-08 16:00:00,31,1,32
"21335",10501,"Grand Falls-Windsor","NL",48.92696,-55.65966,2018-06-08 17:00:00,32,1,33
"21336",10501,"Grand Falls-Windsor","NL",48.92696,-55.65966,2018-06-08 18:00:00,31,0,31
"21337",10501,"Grand Falls-Windsor","NL",48.92696,-55.65966,2018-06-08 19:00:00,34,1,35
"21338",10501,"Grand Falls-Windsor","NL",48.92696,-55.65966,2018-06-08 20:00:00,35,1,36
"21339",10501,"Grand Falls-Windsor","NL",48.92696,-55.65966,2018-06-08 21:00:00,33,0,33
"21340",10501,"Grand Falls-Windsor","NL",48.92696,-55.65966,2018-06-08 22:00:00,29,1,30
"21341",10501,"Grand Falls-Windsor","NL",48.92696,-55.65966,2018-06-08 23:00:00,28,1,29
"21342",10501,"Grand Falls-Windsor","NL",48.92696,-55.65966,2018-06-09 00:00:00,28,1,29
"21343",10501,"Grand Falls-Windsor","NL",48.92696,-55.65966,2018-06-09 01:00:00,27,1,28
"21344",10501,"Grand Falls-Windsor","NL",48.92696,-55.65966,2018-06-09 02:00:00,26,0,26
"21345",10501,"Grand Falls-Windsor","NL",48.92696,-55.65966,2018-06-09 03:00:00,26,1,27
"21346",10501,"Grand Falls-Windsor","NL",48.92696,-55.65966,2018-06-09 04:00:00,27,1,28
"21347",10501,"Grand Falls-Windsor","NL",48.92696,-55.65966,2018-06-09 05:00:00,26,0,26
"21348",10501,"Grand Falls-Windsor","NL",48.92696,-55.65966,2018-06-09 06:00:00,27,0,27
"21349",10501,"Grand Falls-Windsor","NL",48.92696,-55.65966,2018-06-09 07:00:00,28,1,29
"21350",10501,"Grand Falls-Windsor","NL",48.92696,-55.65966,2018-06-09 08:00:00,28,0,28
"21351",10501,"Grand Falls-Windsor","NL",48.92696,-55.65966,2018-06-09 09:00:00,28,0,28
"21352",10501,"Grand Falls-Windsor","NL",48.92696,-55.65966,2018-06-09 10:00:00,27,1,28
"21353",10501,"Grand Falls-Windsor","NL",48.92696,-55.65966,2018-06-09 11:00:00,27,1,28
"21354",10501,"Grand Falls-Windsor","NL",48.92696,-55.65966,2018-06-09 12:00:00,28,1,29
"21355",10501,"Grand Falls-Windsor","NL",48.92696,-55.65966,2018-06-09 13:00:00,30,1,31
"21356",10501,"Grand Falls-Windsor","NL",48.92696,-55.65966,2018-06-09 14:00:00,27,1,28
"21357",10501,"Grand Falls-Windsor","NL",48.92696,-55.65966,2018-06-09 15:00:00,28,1,29
"21358",10501,"Grand Falls-Windsor","NL",48.92696,-55.65966,2018-06-09 16:00:00,29,1,30
"21359",10501,"Grand Falls-Windsor","NL",48.92696,-55.65966,2018-06-09 17:00:00,30,1,31
"21360",10501,"Grand Falls-Windsor","NL",48.92696,-55.65966,2018-06-09 18:00:00,30,1,31
"21361",10501,"Grand Falls-Windsor","NL",48.92696,-55.65966,2018-06-09 19:00:00,34,1,35
"21362",10501,"Grand Falls-Windsor","NL",48.92696,-55.65966,2018-06-09 20:00:00,31,0,31
"21363",10501,"Grand Falls-Windsor","NL",48.92696,-55.65966,2018-06-09 21:00:00,29,1,30
"21364",10501,"Grand Falls-Windsor","NL",48.92696,-55.65966,2018-06-09 22:00:00,26,0,26
"21365",10501,"Grand Falls-Windsor","NL",48.92696,-55.65966,2018-06-09 23:00:00,23,0,23
"21366",10501,"Grand Falls-Windsor","NL",48.92696,-55.65966,2018-06-10 00:00:00,22,0,22
"21367",10501,"Grand Falls-Windsor","NL",48.92696,-55.65966,2018-06-10 01:00:00,21,0,21
"21368",10501,"Grand Falls-Windsor","NL",48.92696,-55.65966,2018-06-10 02:00:00,19,0,19
"21369",10501,"Grand Falls-Windsor","NL",48.92696,-55.65966,2018-06-10 03:00:00,18,0,18
"21370",10501,"Grand Falls-Windsor","NL",48.92696,-55.65966,2018-06-10 04:00:00,18,0,18
"21371",10501,"Grand Falls-Windsor","NL",48.92696,-55.65966,2018-06-10 05:00:00,17,0,17
"21372",10501,"Grand Falls-Windsor","NL",48.92696,-55.65966,2018-06-10 06:00:00,17,0,17
"21373",10501,"Grand Falls-Windsor","NL",48.92696,-55.65966,2018-06-10 07:00:00,17,0,17
"21374",10501,"Grand Falls-Windsor","NL",48.92696,-55.65966,2018-06-10 08:00:00,17,0,17
"21375",10501,"Grand Falls-Windsor","NL",48.92696,-55.65966,2018-06-10 09:00:00,19,0,19
"21376",10501,"Grand Falls-Windsor","NL",48.92696,-55.65966,2018-06-10 10:00:00,20,1,21
"21377",10501,"Grand Falls-Windsor","NL",48.92696,-55.65966,2018-06-10 11:00:00,21,0,21
"21378",10501,"Grand Falls-Windsor","NL",48.92696,-55.65966,2018-06-10 12:00:00,22,1,23
"21379",10501,"Grand Falls-Windsor","NL",48.92696,-55.65966,2018-06-10 13:00:00,22,0,22
"21380",10501,"Grand Falls-Windsor","NL",48.92696,-55.65966,2018-06-10 14:00:00,22,1,23
"21381",10501,"Grand Falls-Windsor","NL",48.92696,-55.65966,2018-06-10 15:00:00,22,1,23
"21382",10501,"Grand Falls-Windsor","NL",48.92696,-55.65966,2018-06-10 16:00:00,22,0,22
"21383",10501,"Grand Falls-Windsor","NL",48.92696,-55.65966,2018-06-10 17:00:00,21,1,22
"21384",10501,"Grand Falls-Windsor","NL",48.92696,-55.65966,2018-06-10 18:00:00,21,1,22
"21385",10501,"Grand Falls-Windsor","NL",48.92696,-55.65966,2018-06-10 19:00:00,21,0,21
"21386",10501,"Grand Falls-Windsor","NL",48.92696,-55.65966,2018-06-10 20:00:00,20,1,21
"21387",10501,"Grand Falls-Windsor","NL",48.92696,-55.65966,2018-06-10 21:00:00,19,1,20
"21388",10501,"Grand Falls-Windsor","NL",48.92696,-55.65966,2018-06-10 22:00:00,18,1,19
"21389",10501,"Grand Falls-Windsor","NL",48.92696,-55.65966,2018-06-10 23:00:00,17,1,18
"21390",10501,"Grand Falls-Windsor","NL",48.92696,-55.65966,2018-06-11 00:00:00,15,1,16
"21391",10501,"Grand Falls-Windsor","NL",48.92696,-55.65966,2018-06-11 01:00:00,15,1,16
"21392",10501,"Grand Falls-Windsor","NL",48.92696,-55.65966,2018-06-11 02:00:00,16,1,17
"21393",10501,"Grand Falls-Windsor","NL",48.92696,-55.65966,2018-06-11 03:00:00,15,0,15
"21394",10501,"Grand Falls-Windsor","NL",48.92696,-55.65966,2018-06-11 04:00:00,15,0,15
"21395",10501,"Grand Falls-Windsor","NL",48.92696,-55.65966,2018-06-11 05:00:00,16,1,17
"21396",10501,"Grand Falls-Windsor","NL",48.92696,-55.65966,2018-06-11 06:00:00,17,1,18
"21397",10501,"Grand Falls-Windsor","NL",48.92696,-55.65966,2018-06-11 07:00:00,18,1,19
"21398",10501,"Grand Falls-Windsor","NL",48.92696,-55.65966,2018-06-11 08:00:00,19,1,20
"21399",10501,"Grand Falls-Windsor","NL",48.92696,-55.65966,2018-06-11 09:00:00,21,1,22
"21400",10501,"Grand Falls-Windsor","NL",48.92696,-55.65966,2018-06-11 10:00:00,21,1,22
"21401",10501,"Grand Falls-Windsor","NL",48.92696,-55.65966,2018-06-11 11:00:00,22,0,22
"21402",10501,"Grand Falls-Windsor","NL",48.92696,-55.65966,2018-06-11 12:00:00,23,1,24
"21403",10501,"Grand Falls-Windsor","NL",48.92696,-55.65966,2018-06-11 13:00:00,24,1,25
"21404",10501,"Grand Falls-Windsor","NL",48.92696,-55.65966,2018-06-11 14:00:00,24,1,25
"21405",10501,"Grand Falls-Windsor","NL",48.92696,-55.65966,2018-06-11 15:00:00,24,1,25
"21406",10501,"Grand Falls-Windsor","NL",48.92696,-55.65966,2018-06-11 16:00:00,25,1,26
"21407",10501,"Grand Falls-Windsor","NL",48.92696,-55.65966,2018-06-11 17:00:00,25,1,26
"21408",10501,"Grand Falls-Windsor","NL",48.92696,-55.65966,2018-06-11 18:00:00,23,1,24
"21409",10501,"Grand Falls-Windsor","NL",48.92696,-55.65966,2018-06-11 19:00:00,22,1,23
"21410",10501,"Grand Falls-Windsor","NL",48.92696,-55.65966,2018-06-11 20:00:00,22,2,24
"21411",10501,"Grand Falls-Windsor","NL",48.92696,-55.65966,2018-06-11 21:00:00,22,1,23
"21412",10501,"Grand Falls-Windsor","NL",48.92696,-55.65966,2018-06-11 22:00:00,21,1,22
"21413",10501,"Grand Falls-Windsor","NL",48.92696,-55.65966,2018-06-11 23:00:00,20,1,21
"21414",10501,"Grand Falls-Windsor","NL",48.92696,-55.65966,2018-06-12 00:00:00,20,1,21
"21415",10501,"Grand Falls-Windsor","NL",48.92696,-55.65966,2018-06-12 01:00:00,20,1,21
"21416",10501,"Grand Falls-Windsor","NL",48.92696,-55.65966,2018-06-12 02:00:00,21,1,22
"21417",10501,"Grand Falls-Windsor","NL",48.92696,-55.65966,2018-06-12 03:00:00,21,1,22
"21418",10501,"Grand Falls-Windsor","NL",48.92696,-55.65966,2018-06-12 04:00:00,19,1,20
"21419",10501,"Grand Falls-Windsor","NL",48.92696,-55.65966,2018-06-12 05:00:00,15,1,16
"21420",10501,"Grand Falls-Windsor","NL",48.92696,-55.65966,2018-06-12 06:00:00,16,1,17
"21421",10501,"Grand Falls-Windsor","NL",48.92696,-55.65966,2018-06-12 07:00:00,21,1,22
"21422",10501,"Grand Falls-Windsor","NL",48.92696,-55.65966,2018-06-12 08:00:00,21,1,22
"21423",10501,"Grand Falls-Windsor","NL",48.92696,-55.65966,2018-06-12 09:00:00,21,1,22
"21424",10501,"Grand Falls-Windsor","NL",48.92696,-55.65966,2018-06-12 10:00:00,21,1,22
"21425",10501,"Grand Falls-Windsor","NL",48.92696,-55.65966,2018-06-12 11:00:00,22,0,22
"21426",10501,"Grand Falls-Windsor","NL",48.92696,-55.65966,2018-06-12 12:00:00,23,1,24
"21427",10501,"Grand Falls-Windsor","NL",48.92696,-55.65966,2018-06-12 13:00:00,23,1,24
"21428",10501,"Grand Falls-Windsor","NL",48.92696,-55.65966,2018-06-12 14:00:00,26,1,27
"21429",10501,"Grand Falls-Windsor","NL",48.92696,-55.65966,2018-06-12 15:00:00,28,1,29
"21430",10501,"Grand Falls-Windsor","NL",48.92696,-55.65966,2018-06-12 16:00:00,26,1,27
"21431",10501,"Grand Falls-Windsor","NL",48.92696,-55.65966,2018-06-12 17:00:00,28,1,29
"21432",10501,"Grand Falls-Windsor","NL",48.92696,-55.65966,2018-06-12 18:00:00,30,1,31
"21433",10501,"Grand Falls-Windsor","NL",48.92696,-55.65966,2018-06-12 19:00:00,28,0,28
"21434",10501,"Grand Falls-Windsor","NL",48.92696,-55.65966,2018-06-12 20:00:00,25,1,26
"21435",10501,"Grand Falls-Windsor","NL",48.92696,-55.65966,2018-06-12 21:00:00,24,1,25
"21436",10501,"Grand Falls-Windsor","NL",48.92696,-55.65966,2018-06-12 22:00:00,25,1,26
"21437",10501,"Grand Falls-Windsor","NL",48.92696,-55.65966,2018-06-12 23:00:00,26,1,27
"21438",10501,"Grand Falls-Windsor","NL",48.92696,-55.65966,2018-06-13 00:00:00,25,1,26
"21439",10501,"Grand Falls-Windsor","NL",48.92696,-55.65966,2018-06-13 01:00:00,24,0,24
"21440",10501,"Grand Falls-Windsor","NL",48.92696,-55.65966,2018-06-13 02:00:00,24,0,24
"21441",10501,"Grand Falls-Windsor","NL",48.92696,-55.65966,2018-06-13 03:00:00,24,0,24
"21442",10501,"Grand Falls-Windsor","NL",48.92696,-55.65966,2018-06-13 04:00:00,23,0,23
"21443",10501,"Grand Falls-Windsor","NL",48.92696,-55.65966,2018-06-13 05:00:00,24,0,24
"21444",10501,"Grand Falls-Windsor","NL",48.92696,-55.65966,2018-06-13 06:00:00,26,0,26
"21445",10501,"Grand Falls-Windsor","NL",48.92696,-55.65966,2018-06-13 07:00:00,27,0,27
"21446",10501,"Grand Falls-Windsor","NL",48.92696,-55.65966,2018-06-13 08:00:00,26,0,26
"21447",10501,"Grand Falls-Windsor","NL",48.92696,-55.65966,2018-06-13 09:00:00,27,1,28
"21448",10501,"Grand Falls-Windsor","NL",48.92696,-55.65966,2018-06-13 10:00:00,27,1,28
"21449",10501,"Grand Falls-Windsor","NL",48.92696,-55.65966,2018-06-13 11:00:00,28,0,28
"21450",10501,"Grand Falls-Windsor","NL",48.92696,-55.65966,2018-06-13 12:00:00,29,0,29
"21451",10501,"Grand Falls-Windsor","NL",48.92696,-55.65966,2018-06-13 13:00:00,27,1,28
"21452",10501,"Grand Falls-Windsor","NL",48.92696,-55.65966,2018-06-13 14:00:00,25,1,26
"21453",10501,"Grand Falls-Windsor","NL",48.92696,-55.65966,2018-06-13 15:00:00,23,1,24
"21454",10501,"Grand Falls-Windsor","NL",48.92696,-55.65966,2018-06-13 16:00:00,23,0,23
"21455",10501,"Grand Falls-Windsor","NL",48.92696,-55.65966,2018-06-13 17:00:00,25,1,26
"21456",10501,"Grand Falls-Windsor","NL",48.92696,-55.65966,2018-06-13 18:00:00,28,0,28
"21457",10501,"Grand Falls-Windsor","NL",48.92696,-55.65966,2018-06-13 19:00:00,29,1,30
"21458",10501,"Grand Falls-Windsor","NL",48.92696,-55.65966,2018-06-13 20:00:00,27,0,27
"21459",10501,"Grand Falls-Windsor","NL",48.92696,-55.65966,2018-06-13 21:00:00,25,1,26
"21460",10501,"Grand Falls-Windsor","NL",48.92696,-55.65966,2018-06-13 22:00:00,22,0,22
"21461",10501,"Grand Falls-Windsor","NL",48.92696,-55.65966,2018-06-13 23:00:00,22,1,23
"21462",10501,"Grand Falls-Windsor","NL",48.92696,-55.65966,2018-06-14 00:00:00,22,0,22
"21463",10501,"Grand Falls-Windsor","NL",48.92696,-55.65966,2018-06-14 01:00:00,22,0,22
"21464",10501,"Grand Falls-Windsor","NL",48.92696,-55.65966,2018-06-14 02:00:00,22,0,22
"21465",10501,"Grand Falls-Windsor","NL",48.92696,-55.65966,2018-06-14 03:00:00,23,1,24
"21466",10501,"Grand Falls-Windsor","NL",48.92696,-55.65966,2018-06-14 04:00:00,23,1,24
"21467",10501,"Grand Falls-Windsor","NL",48.92696,-55.65966,2018-06-14 05:00:00,23,1,24
"21468",10501,"Grand Falls-Windsor","NL",48.92696,-55.65966,2018-06-14 06:00:00,22,1,23
"21469",10501,"Grand Falls-Windsor","NL",48.92696,-55.65966,2018-06-14 07:00:00,22,1,23
"21470",10501,"Grand Falls-Windsor","NL",48.92696,-55.65966,2018-06-14 08:00:00,23,1,24
"21471",10501,"Grand Falls-Windsor","NL",48.92696,-55.65966,2018-06-14 09:00:00,23,1,24
"21472",10501,"Grand Falls-Windsor","NL",48.92696,-55.65966,2018-06-14 10:00:00,23,1,24
"21473",10501,"Grand Falls-Windsor","NL",48.92696,-55.65966,2018-06-14 11:00:00,23,1,24
"21474",10501,"Grand Falls-Windsor","NL",48.92696,-55.65966,2018-06-14 12:00:00,24,1,25
"21475",10501,"Grand Falls-Windsor","NL",48.92696,-55.65966,2018-06-14 13:00:00,25,0,25
"21476",10501,"Grand Falls-Windsor","NL",48.92696,-55.65966,2018-06-14 14:00:00,26,0,26
"21477",10501,"Grand Falls-Windsor","NL",48.92696,-55.65966,2018-06-14 15:00:00,26,1,27
"21478",10501,"Grand Falls-Windsor","NL",48.92696,-55.65966,2018-06-14 16:00:00,27,1,28
"21479",10501,"Grand Falls-Windsor","NL",48.92696,-55.65966,2018-06-14 17:00:00,28,1,29
"21480",10501,"Grand Falls-Windsor","NL",48.92696,-55.65966,2018-06-14 18:00:00,27,0,27
"21481",10501,"Grand Falls-Windsor","NL",48.92696,-55.65966,2018-06-14 19:00:00,27,1,28
"21482",10501,"Grand Falls-Windsor","NL",48.92696,-55.65966,2018-06-14 20:00:00,24,1,25
"21483",10501,"Grand Falls-Windsor","NL",48.92696,-55.65966,2018-06-14 21:00:00,22,1,23
"21484",10501,"Grand Falls-Windsor","NL",48.92696,-55.65966,2018-06-14 22:00:00,19,2,21
"21485",10501,"Grand Falls-Windsor","NL",48.92696,-55.65966,2018-06-14 23:00:00,17,1,18
"21486",10501,"Grand Falls-Windsor","NL",48.92696,-55.65966,2018-06-15 00:00:00,17,1,18
"21487",10501,"Grand Falls-Windsor","NL",48.92696,-55.65966,2018-06-15 01:00:00,17,0,17
"21488",10501,"Grand Falls-Windsor","NL",48.92696,-55.65966,2018-06-15 02:00:00,15,0,15
"21489",10501,"Grand Falls-Windsor","NL",48.92696,-55.65966,2018-06-15 03:00:00,10,0,10
"21490",10501,"Grand Falls-Windsor","NL",48.92696,-55.65966,2018-06-15 04:00:00,10,0,10
"21491",10501,"Grand Falls-Windsor","NL",48.92696,-55.65966,2018-06-15 05:00:00,5,1,6
"21492",10501,"Grand Falls-Windsor","NL",48.92696,-55.65966,2018-06-15 06:00:00,6,0,6
"21493",10501,"Grand Falls-Windsor","NL",48.92696,-55.65966,2018-06-15 07:00:00,10,0,10
"21494",10501,"Grand Falls-Windsor","NL",48.92696,-55.65966,2018-06-15 08:00:00,15,1,16
"21495",10501,"Grand Falls-Windsor","NL",48.92696,-55.65966,2018-06-15 09:00:00,21,1,22
"21496",10501,"Grand Falls-Windsor","NL",48.92696,-55.65966,2018-06-15 10:00:00,23,1,24
"21497",10501,"Grand Falls-Windsor","NL",48.92696,-55.65966,2018-06-15 11:00:00,25,1,26
"21498",10501,"Grand Falls-Windsor","NL",48.92696,-55.65966,2018-06-15 12:00:00,26,0,26
"21499",10501,"Grand Falls-Windsor","NL",48.92696,-55.65966,2018-06-15 13:00:00,27,1,28
"21500",10501,"Grand Falls-Windsor","NL",48.92696,-55.65966,2018-06-15 14:00:00,29,1,30
"21501",10501,"Grand Falls-Windsor","NL",48.92696,-55.65966,2018-06-15 15:00:00,30,1,31
"21502",10501,"Grand Falls-Windsor","NL",48.92696,-55.65966,2018-06-15 16:00:00,31,1,32
"21503",10501,"Grand Falls-Windsor","NL",48.92696,-55.65966,2018-06-15 17:00:00,29,1,30
"21504",10501,"Grand Falls-Windsor","NL",48.92696,-55.65966,2018-06-15 18:00:00,28,1,29
"21505",10501,"Grand Falls-Windsor","NL",48.92696,-55.65966,2018-06-15 19:00:00,28,1,29
"21506",10501,"Grand Falls-Windsor","NL",48.92696,-55.65966,2018-06-15 20:00:00,22,1,23
"21507",10501,"Grand Falls-Windsor","NL",48.92696,-55.65966,2018-06-15 21:00:00,21,1,22
"21508",10501,"Grand Falls-Windsor","NL",48.92696,-55.65966,2018-06-15 22:00:00,20,1,21
"21509",10501,"Grand Falls-Windsor","NL",48.92696,-55.65966,2018-06-15 23:00:00,20,1,21
"21510",10501,"Grand Falls-Windsor","NL",48.92696,-55.65966,2018-06-16 00:00:00,20,1,21
"21511",10501,"Grand Falls-Windsor","NL",48.92696,-55.65966,2018-06-16 01:00:00,20,1,21
"21512",10501,"Grand Falls-Windsor","NL",48.92696,-55.65966,2018-06-16 02:00:00,20,1,21
"21513",10501,"Grand Falls-Windsor","NL",48.92696,-55.65966,2018-06-16 03:00:00,21,0,21
"21514",10501,"Grand Falls-Windsor","NL",48.92696,-55.65966,2018-06-16 04:00:00,21,1,22
"21515",10501,"Grand Falls-Windsor","NL",48.92696,-55.65966,2018-06-16 05:00:00,22,2,24
"21516",10501,"Grand Falls-Windsor","NL",48.92696,-55.65966,2018-06-16 06:00:00,22,0,22
"21517",10501,"Grand Falls-Windsor","NL",48.92696,-55.65966,2018-06-16 07:00:00,23,1,24
"21518",10501,"Grand Falls-Windsor","NL",48.92696,-55.65966,2018-06-16 08:00:00,24,1,25
"21519",10501,"Grand Falls-Windsor","NL",48.92696,-55.65966,2018-06-16 09:00:00,25,0,25
"21520",10501,"Grand Falls-Windsor","NL",48.92696,-55.65966,2018-06-16 10:00:00,26,1,27
"21521",10501,"Grand Falls-Windsor","NL",48.92696,-55.65966,2018-06-16 11:00:00,26,1,27
"21522",10501,"Grand Falls-Windsor","NL",48.92696,-55.65966,2018-06-16 12:00:00,26,0,26
"21523",10501,"Grand Falls-Windsor","NL",48.92696,-55.65966,2018-06-16 13:00:00,26,0,26
"21524",10501,"Grand Falls-Windsor","NL",48.92696,-55.65966,2018-06-16 14:00:00,26,1,27
"21525",10501,"Grand Falls-Windsor","NL",48.92696,-55.65966,2018-06-16 15:00:00,26,1,27
"21526",10501,"Grand Falls-Windsor","NL",48.92696,-55.65966,2018-06-16 16:00:00,26,1,27
"21527",10501,"Grand Falls-Windsor","NL",48.92696,-55.65966,2018-06-16 17:00:00,26,1,27
"21528",10501,"Grand Falls-Windsor","NL",48.92696,-55.65966,2018-06-16 18:00:00,26,1,27
"21529",10501,"Grand Falls-Windsor","NL",48.92696,-55.65966,2018-06-16 19:00:00,26,1,27
"21530",10501,"Grand Falls-Windsor","NL",48.92696,-55.65966,2018-06-16 20:00:00,26,1,27
"21531",10501,"Grand Falls-Windsor","NL",48.92696,-55.65966,2018-06-16 21:00:00,25,1,26
"21532",10501,"Grand Falls-Windsor","NL",48.92696,-55.65966,2018-06-16 22:00:00,25,1,26
"21533",10501,"Grand Falls-Windsor","NL",48.92696,-55.65966,2018-06-16 23:00:00,24,1,25
"21534",10501,"Grand Falls-Windsor","NL",48.92696,-55.65966,2018-06-17 00:00:00,22,1,23
"21535",10501,"Grand Falls-Windsor","NL",48.92696,-55.65966,2018-06-17 01:00:00,21,1,22
"21536",10501,"Grand Falls-Windsor","NL",48.92696,-55.65966,2018-06-17 02:00:00,20,1,21
"21537",10501,"Grand Falls-Windsor","NL",48.92696,-55.65966,2018-06-17 03:00:00,19,1,20
"21538",10501,"Grand Falls-Windsor","NL",48.92696,-55.65966,2018-06-17 04:00:00,18,1,19
"21539",10501,"Grand Falls-Windsor","NL",48.92696,-55.65966,2018-06-17 05:00:00,15,1,16
"21540",10501,"Grand Falls-Windsor","NL",48.92696,-55.65966,2018-06-17 06:00:00,17,1,18
"21541",10501,"Grand Falls-Windsor","NL",48.92696,-55.65966,2018-06-17 07:00:00,21,1,22
"21542",10501,"Grand Falls-Windsor","NL",48.92696,-55.65966,2018-06-17 08:00:00,23,1,24
"21543",10501,"Grand Falls-Windsor","NL",48.92696,-55.65966,2018-06-17 09:00:00,26,1,27
"21544",10501,"Grand Falls-Windsor","NL",48.92696,-55.65966,2018-06-17 10:00:00,25,0,25
"21545",10501,"Grand Falls-Windsor","NL",48.92696,-55.65966,2018-06-17 11:00:00,26,0,26
"21546",10501,"Grand Falls-Windsor","NL",48.92696,-55.65966,2018-06-17 12:00:00,25,1,26
"21547",10501,"Grand Falls-Windsor","NL",48.92696,-55.65966,2018-06-17 13:00:00,25,1,26
"21548",10501,"Grand Falls-Windsor","NL",48.92696,-55.65966,2018-06-17 14:00:00,25,1,26
"21549",10501,"Grand Falls-Windsor","NL",48.92696,-55.65966,2018-06-17 15:00:00,25,1,26
"21550",10501,"Grand Falls-Windsor","NL",48.92696,-55.65966,2018-06-17 16:00:00,25,1,26
"21551",10501,"Grand Falls-Windsor","NL",48.92696,-55.65966,2018-06-17 17:00:00,25,1,26
"21552",10501,"Grand Falls-Windsor","NL",48.92696,-55.65966,2018-06-17 18:00:00,24,1,25
"21553",10501,"Grand Falls-Windsor","NL",48.92696,-55.65966,2018-06-17 19:00:00,24,1,25
"21554",10501,"Grand Falls-Windsor","NL",48.92696,-55.65966,2018-06-17 20:00:00,24,0,24
"21555",10501,"Grand Falls-Windsor","NL",48.92696,-55.65966,2018-06-17 21:00:00,19,3,22
"21556",10501,"Grand Falls-Windsor","NL",48.92696,-55.65966,2018-06-17 22:00:00,17,2,19
"21557",10501,"Grand Falls-Windsor","NL",48.92696,-55.65966,2018-06-17 23:00:00,14,0,14
"21558",10501,"Grand Falls-Windsor","NL",48.92696,-55.65966,2018-06-18 00:00:00,14,1,15
"21559",10501,"Grand Falls-Windsor","NL",48.92696,-55.65966,2018-06-18 01:00:00,13,1,14
"21560",10501,"Grand Falls-Windsor","NL",48.92696,-55.65966,2018-06-18 02:00:00,13,1,14
"21561",10501,"Grand Falls-Windsor","NL",48.92696,-55.65966,2018-06-18 03:00:00,12,1,13
"21562",10501,"Grand Falls-Windsor","NL",48.92696,-55.65966,2018-06-18 04:00:00,14,0,14
"21563",10501,"Grand Falls-Windsor","NL",48.92696,-55.65966,2018-06-18 05:00:00,13,0,13
"21564",10501,"Grand Falls-Windsor","NL",48.92696,-55.65966,2018-06-18 06:00:00,13,0,13
"21565",10501,"Grand Falls-Windsor","NL",48.92696,-55.65966,2018-06-18 07:00:00,15,1,16
"21566",10501,"Grand Falls-Windsor","NL",48.92696,-55.65966,2018-06-18 08:00:00,21,1,22
"21567",10501,"Grand Falls-Windsor","NL",48.92696,-55.65966,2018-06-18 09:00:00,23,0,23
"21568",10501,"Grand Falls-Windsor","NL",48.92696,-55.65966,2018-06-18 10:00:00,24,0,24
"21569",10501,"Grand Falls-Windsor","NL",48.92696,-55.65966,2018-06-18 11:00:00,24,1,25
"21570",10501,"Grand Falls-Windsor","NL",48.92696,-55.65966,2018-06-18 12:00:00,23,1,24
"21571",10501,"Grand Falls-Windsor","NL",48.92696,-55.65966,2018-06-18 13:00:00,20,1,21
"21572",10501,"Grand Falls-Windsor","NL",48.92696,-55.65966,2018-06-18 14:00:00,22,NA,NA
"21573",10501,"Grand Falls-Windsor","NL",48.92696,-55.65966,2018-06-18 15:00:00,22,0,22
"21574",10501,"Grand Falls-Windsor","NL",48.92696,-55.65966,2018-06-18 16:00:00,22,0,22
"21575",10501,"Grand Falls-Windsor","NL",48.92696,-55.65966,2018-06-18 17:00:00,22,1,23
"21576",10501,"Grand Falls-Windsor","NL",48.92696,-55.65966,2018-06-18 18:00:00,23,0,23
"21577",10501,"Grand Falls-Windsor","NL",48.92696,-55.65966,2018-06-18 19:00:00,23,0,23
"21578",10501,"Grand Falls-Windsor","NL",48.92696,-55.65966,2018-06-18 20:00:00,23,0,23
"21579",10501,"Grand Falls-Windsor","NL",48.92696,-55.65966,2018-06-18 21:00:00,23,0,23
"21580",10501,"Grand Falls-Windsor","NL",48.92696,-55.65966,2018-06-18 22:00:00,23,0,23
"21581",10501,"Grand Falls-Windsor","NL",48.92696,-55.65966,2018-06-18 23:00:00,23,0,23
"21582",10501,"Grand Falls-Windsor","NL",48.92696,-55.65966,2018-06-19 00:00:00,24,0,24
"21583",10501,"Grand Falls-Windsor","NL",48.92696,-55.65966,2018-06-19 01:00:00,23,0,23
"21584",10501,"Grand Falls-Windsor","NL",48.92696,-55.65966,2018-06-19 02:00:00,22,0,22
"21585",10501,"Grand Falls-Windsor","NL",48.92696,-55.65966,2018-06-19 03:00:00,22,0,22
"21586",10501,"Grand Falls-Windsor","NL",48.92696,-55.65966,2018-06-19 04:00:00,24,0,24
"21587",10501,"Grand Falls-Windsor","NL",48.92696,-55.65966,2018-06-19 05:00:00,29,0,29
"21588",10501,"Grand Falls-Windsor","NL",48.92696,-55.65966,2018-06-19 06:00:00,29,0,29
"21589",10501,"Grand Falls-Windsor","NL",48.92696,-55.65966,2018-06-19 07:00:00,29,0,29
"21590",10501,"Grand Falls-Windsor","NL",48.92696,-55.65966,2018-06-19 08:00:00,28,1,29
"21591",10501,"Grand Falls-Windsor","NL",48.92696,-55.65966,2018-06-19 09:00:00,27,0,27
"21592",10501,"Grand Falls-Windsor","NL",48.92696,-55.65966,2018-06-19 10:00:00,29,1,30
"21593",10501,"Grand Falls-Windsor","NL",48.92696,-55.65966,2018-06-19 11:00:00,29,0,29
"21594",10501,"Grand Falls-Windsor","NL",48.92696,-55.65966,2018-06-19 12:00:00,28,1,29
"21595",10501,"Grand Falls-Windsor","NL",48.92696,-55.65966,2018-06-19 13:00:00,28,1,29
"21596",10501,"Grand Falls-Windsor","NL",48.92696,-55.65966,2018-06-19 14:00:00,27,0,27
"21597",10501,"Grand Falls-Windsor","NL",48.92696,-55.65966,2018-06-19 15:00:00,25,1,26
"21598",10501,"Grand Falls-Windsor","NL",48.92696,-55.65966,2018-06-19 16:00:00,23,1,24
"21599",10501,"Grand Falls-Windsor","NL",48.92696,-55.65966,2018-06-19 17:00:00,19,1,20
"21600",10501,"Grand Falls-Windsor","NL",48.92696,-55.65966,2018-06-19 18:00:00,21,1,22
"21601",10501,"Grand Falls-Windsor","NL",48.92696,-55.65966,2018-06-19 19:00:00,19,15,34
"21602",10501,"Grand Falls-Windsor","NL",48.92696,-55.65966,2018-06-19 20:00:00,20,2,22
"21603",10501,"Grand Falls-Windsor","NL",48.92696,-55.65966,2018-06-19 21:00:00,18,2,20
"21604",10501,"Grand Falls-Windsor","NL",48.92696,-55.65966,2018-06-19 22:00:00,14,2,16
"21605",10501,"Grand Falls-Windsor","NL",48.92696,-55.65966,2018-06-19 23:00:00,8,3,11
"21606",10501,"Grand Falls-Windsor","NL",48.92696,-55.65966,2018-06-20 00:00:00,10,1,11
"21607",10501,"Grand Falls-Windsor","NL",48.92696,-55.65966,2018-06-20 01:00:00,10,0,10
"21608",10501,"Grand Falls-Windsor","NL",48.92696,-55.65966,2018-06-20 02:00:00,8,1,9
"21609",10501,"Grand Falls-Windsor","NL",48.92696,-55.65966,2018-06-20 03:00:00,7,1,8
"21610",10501,"Grand Falls-Windsor","NL",48.92696,-55.65966,2018-06-20 04:00:00,6,1,7
"21611",10501,"Grand Falls-Windsor","NL",48.92696,-55.65966,2018-06-20 05:00:00,6,0,6
"21612",10501,"Grand Falls-Windsor","NL",48.92696,-55.65966,2018-06-20 06:00:00,5,1,6
"21613",10501,"Grand Falls-Windsor","NL",48.92696,-55.65966,2018-06-20 07:00:00,5,1,6
"21614",10501,"Grand Falls-Windsor","NL",48.92696,-55.65966,2018-06-20 08:00:00,5,1,6
"21615",10501,"Grand Falls-Windsor","NL",48.92696,-55.65966,2018-06-20 09:00:00,12,0,12
"21616",10501,"Grand Falls-Windsor","NL",48.92696,-55.65966,2018-06-20 10:00:00,13,0,13
"21617",10501,"Grand Falls-Windsor","NL",48.92696,-55.65966,2018-06-20 11:00:00,19,1,20
"21618",10501,"Grand Falls-Windsor","NL",48.92696,-55.65966,2018-06-20 12:00:00,20,1,21
"21619",10501,"Grand Falls-Windsor","NL",48.92696,-55.65966,2018-06-20 13:00:00,21,1,22
"21620",10501,"Grand Falls-Windsor","NL",48.92696,-55.65966,2018-06-20 14:00:00,22,1,23
"21621",10501,"Grand Falls-Windsor","NL",48.92696,-55.65966,2018-06-20 15:00:00,23,1,24
"21622",10501,"Grand Falls-Windsor","NL",48.92696,-55.65966,2018-06-20 16:00:00,25,1,26
"21623",10501,"Grand Falls-Windsor","NL",48.92696,-55.65966,2018-06-20 17:00:00,24,0,24
"21624",10501,"Grand Falls-Windsor","NL",48.92696,-55.65966,2018-06-20 18:00:00,24,0,24
"21625",10501,"Grand Falls-Windsor","NL",48.92696,-55.65966,2018-06-20 19:00:00,24,0,24
"21626",10501,"Grand Falls-Windsor","NL",48.92696,-55.65966,2018-06-20 20:00:00,24,0,24
"21627",10501,"Grand Falls-Windsor","NL",48.92696,-55.65966,2018-06-20 21:00:00,25,1,26
"21628",10501,"Grand Falls-Windsor","NL",48.92696,-55.65966,2018-06-20 22:00:00,23,1,24
"21629",10501,"Grand Falls-Windsor","NL",48.92696,-55.65966,2018-06-20 23:00:00,21,0,21
"21630",10501,"Grand Falls-Windsor","NL",48.92696,-55.65966,2018-06-21 00:00:00,18,1,19
"21631",10501,"Grand Falls-Windsor","NL",48.92696,-55.65966,2018-06-21 01:00:00,18,1,19
"21632",10501,"Grand Falls-Windsor","NL",48.92696,-55.65966,2018-06-21 02:00:00,22,0,22
"21633",10501,"Grand Falls-Windsor","NL",48.92696,-55.65966,2018-06-21 03:00:00,21,0,21
"21634",10501,"Grand Falls-Windsor","NL",48.92696,-55.65966,2018-06-21 04:00:00,20,1,21
"21635",10501,"Grand Falls-Windsor","NL",48.92696,-55.65966,2018-06-21 05:00:00,18,0,18
"21636",10501,"Grand Falls-Windsor","NL",48.92696,-55.65966,2018-06-21 06:00:00,16,1,17
"21637",10501,"Grand Falls-Windsor","NL",48.92696,-55.65966,2018-06-21 07:00:00,16,1,17
"21638",10501,"Grand Falls-Windsor","NL",48.92696,-55.65966,2018-06-21 08:00:00,16,1,17
"21639",10501,"Grand Falls-Windsor","NL",48.92696,-55.65966,2018-06-21 09:00:00,15,1,16
"21640",10501,"Grand Falls-Windsor","NL",48.92696,-55.65966,2018-06-21 10:00:00,16,1,17
"21641",10501,"Grand Falls-Windsor","NL",48.92696,-55.65966,2018-06-21 11:00:00,17,1,18
"21642",10501,"Grand Falls-Windsor","NL",48.92696,-55.65966,2018-06-21 12:00:00,18,1,19
"21643",10501,"Grand Falls-Windsor","NL",48.92696,-55.65966,2018-06-21 13:00:00,24,1,25
"21644",10501,"Grand Falls-Windsor","NL",48.92696,-55.65966,2018-06-21 14:00:00,25,1,26
"21645",10501,"Grand Falls-Windsor","NL",48.92696,-55.65966,2018-06-21 15:00:00,26,1,27
"21646",10501,"Grand Falls-Windsor","NL",48.92696,-55.65966,2018-06-21 16:00:00,27,1,28
"21647",10501,"Grand Falls-Windsor","NL",48.92696,-55.65966,2018-06-21 17:00:00,29,1,30
"21648",10501,"Grand Falls-Windsor","NL",48.92696,-55.65966,2018-06-21 18:00:00,30,1,31
"21649",10501,"Grand Falls-Windsor","NL",48.92696,-55.65966,2018-06-21 19:00:00,28,1,29
"21650",10501,"Grand Falls-Windsor","NL",48.92696,-55.65966,2018-06-21 20:00:00,28,0,28
"21651",10501,"Grand Falls-Windsor","NL",48.92696,-55.65966,2018-06-21 21:00:00,28,1,29
"21652",10501,"Grand Falls-Windsor","NL",48.92696,-55.65966,2018-06-21 22:00:00,26,1,27
"21653",10501,"Grand Falls-Windsor","NL",48.92696,-55.65966,2018-06-21 23:00:00,23,0,23
"21654",10501,"Grand Falls-Windsor","NL",48.92696,-55.65966,2018-06-22 00:00:00,19,0,19
"21655",10501,"Grand Falls-Windsor","NL",48.92696,-55.65966,2018-06-22 01:00:00,17,1,18
"21656",10501,"Grand Falls-Windsor","NL",48.92696,-55.65966,2018-06-22 02:00:00,15,1,16
"21657",10501,"Grand Falls-Windsor","NL",48.92696,-55.65966,2018-06-22 03:00:00,12,0,12
"21658",10501,"Grand Falls-Windsor","NL",48.92696,-55.65966,2018-06-22 04:00:00,10,2,12
"21659",10501,"Grand Falls-Windsor","NL",48.92696,-55.65966,2018-06-22 05:00:00,9,1,10
"21660",10501,"Grand Falls-Windsor","NL",48.92696,-55.65966,2018-06-22 06:00:00,8,3,11
"21661",10501,"Grand Falls-Windsor","NL",48.92696,-55.65966,2018-06-22 07:00:00,11,1,12
"21662",10501,"Grand Falls-Windsor","NL",48.92696,-55.65966,2018-06-22 08:00:00,14,2,16
"21663",10501,"Grand Falls-Windsor","NL",48.92696,-55.65966,2018-06-22 09:00:00,13,2,15
"21664",10501,"Grand Falls-Windsor","NL",48.92696,-55.65966,2018-06-22 10:00:00,14,1,15
"21665",10501,"Grand Falls-Windsor","NL",48.92696,-55.65966,2018-06-22 11:00:00,16,1,17
"21666",10501,"Grand Falls-Windsor","NL",48.92696,-55.65966,2018-06-22 12:00:00,17,1,18
"21667",10501,"Grand Falls-Windsor","NL",48.92696,-55.65966,2018-06-22 13:00:00,19,1,20
"21668",10501,"Grand Falls-Windsor","NL",48.92696,-55.65966,2018-06-22 14:00:00,21,1,22
"21669",10501,"Grand Falls-Windsor","NL",48.92696,-55.65966,2018-06-22 15:00:00,21,1,22
"21670",10501,"Grand Falls-Windsor","NL",48.92696,-55.65966,2018-06-22 16:00:00,23,1,24
"21671",10501,"Grand Falls-Windsor","NL",48.92696,-55.65966,2018-06-22 17:00:00,23,1,24
"21672",10501,"Grand Falls-Windsor","NL",48.92696,-55.65966,2018-06-22 18:00:00,26,1,27
"21673",10501,"Grand Falls-Windsor","NL",48.92696,-55.65966,2018-06-22 19:00:00,28,0,28
"21674",10501,"Grand Falls-Windsor","NL",48.92696,-55.65966,2018-06-22 20:00:00,26,1,27
"21675",10501,"Grand Falls-Windsor","NL",48.92696,-55.65966,2018-06-22 21:00:00,23,2,25
"21676",10501,"Grand Falls-Windsor","NL",48.92696,-55.65966,2018-06-22 22:00:00,18,1,19
"21677",10501,"Grand Falls-Windsor","NL",48.92696,-55.65966,2018-06-22 23:00:00,14,1,15
"21678",10501,"Grand Falls-Windsor","NL",48.92696,-55.65966,2018-06-23 00:00:00,17,0,17
"21679",10501,"Grand Falls-Windsor","NL",48.92696,-55.65966,2018-06-23 01:00:00,16,1,17
"21680",10501,"Grand Falls-Windsor","NL",48.92696,-55.65966,2018-06-23 02:00:00,17,1,18
"21681",10501,"Grand Falls-Windsor","NL",48.92696,-55.65966,2018-06-23 03:00:00,20,0,20
"21682",10501,"Grand Falls-Windsor","NL",48.92696,-55.65966,2018-06-23 04:00:00,21,0,21
"21683",10501,"Grand Falls-Windsor","NL",48.92696,-55.65966,2018-06-23 05:00:00,19,0,19
"21684",10501,"Grand Falls-Windsor","NL",48.92696,-55.65966,2018-06-23 06:00:00,18,0,18
"21685",10501,"Grand Falls-Windsor","NL",48.92696,-55.65966,2018-06-23 07:00:00,23,1,24
"21686",10501,"Grand Falls-Windsor","NL",48.92696,-55.65966,2018-06-23 08:00:00,25,0,25
"21687",10501,"Grand Falls-Windsor","NL",48.92696,-55.65966,2018-06-23 09:00:00,25,1,26
"21688",10501,"Grand Falls-Windsor","NL",48.92696,-55.65966,2018-06-23 10:00:00,26,0,26
"21689",10501,"Grand Falls-Windsor","NL",48.92696,-55.65966,2018-06-23 11:00:00,26,1,27
"21690",10501,"Grand Falls-Windsor","NL",48.92696,-55.65966,2018-06-23 12:00:00,26,0,26
"21691",10501,"Grand Falls-Windsor","NL",48.92696,-55.65966,2018-06-23 13:00:00,26,0,26
"21692",10501,"Grand Falls-Windsor","NL",48.92696,-55.65966,2018-06-23 14:00:00,26,1,27
"21693",10501,"Grand Falls-Windsor","NL",48.92696,-55.65966,2018-06-23 15:00:00,26,0,26
"21694",10501,"Grand Falls-Windsor","NL",48.92696,-55.65966,2018-06-23 16:00:00,26,1,27
"21695",10501,"Grand Falls-Windsor","NL",48.92696,-55.65966,2018-06-23 17:00:00,27,1,28
"21696",10501,"Grand Falls-Windsor","NL",48.92696,-55.65966,2018-06-23 18:00:00,28,1,29
"21697",10501,"Grand Falls-Windsor","NL",48.92696,-55.65966,2018-06-23 19:00:00,29,0,29
"21698",10501,"Grand Falls-Windsor","NL",48.92696,-55.65966,2018-06-23 20:00:00,29,1,30
"21699",10501,"Grand Falls-Windsor","NL",48.92696,-55.65966,2018-06-23 21:00:00,30,1,31
"21700",10501,"Grand Falls-Windsor","NL",48.92696,-55.65966,2018-06-23 22:00:00,29,1,30
"21701",10501,"Grand Falls-Windsor","NL",48.92696,-55.65966,2018-06-23 23:00:00,28,1,29
"21702",10501,"Grand Falls-Windsor","NL",48.92696,-55.65966,2018-06-24 00:00:00,28,0,28
"21703",10501,"Grand Falls-Windsor","NL",48.92696,-55.65966,2018-06-24 01:00:00,27,0,27
"21704",10501,"Grand Falls-Windsor","NL",48.92696,-55.65966,2018-06-24 02:00:00,27,0,27
"21705",10501,"Grand Falls-Windsor","NL",48.92696,-55.65966,2018-06-24 03:00:00,28,0,28
"21706",10501,"Grand Falls-Windsor","NL",48.92696,-55.65966,2018-06-24 04:00:00,25,0,25
"21707",10501,"Grand Falls-Windsor","NL",48.92696,-55.65966,2018-06-24 05:00:00,23,0,23
"21708",10501,"Grand Falls-Windsor","NL",48.92696,-55.65966,2018-06-24 06:00:00,21,0,21
"21709",10501,"Grand Falls-Windsor","NL",48.92696,-55.65966,2018-06-24 07:00:00,21,0,21
"21710",10501,"Grand Falls-Windsor","NL",48.92696,-55.65966,2018-06-24 08:00:00,22,1,23
"21711",10501,"Grand Falls-Windsor","NL",48.92696,-55.65966,2018-06-24 09:00:00,22,0,22
"21712",10501,"Grand Falls-Windsor","NL",48.92696,-55.65966,2018-06-24 10:00:00,22,1,23
"21713",10501,"Grand Falls-Windsor","NL",48.92696,-55.65966,2018-06-24 11:00:00,22,1,23
"21714",10501,"Grand Falls-Windsor","NL",48.92696,-55.65966,2018-06-24 12:00:00,22,0,22
"21715",10501,"Grand Falls-Windsor","NL",48.92696,-55.65966,2018-06-24 13:00:00,22,0,22
"21716",10501,"Grand Falls-Windsor","NL",48.92696,-55.65966,2018-06-24 14:00:00,23,1,24
"21717",10501,"Grand Falls-Windsor","NL",48.92696,-55.65966,2018-06-24 15:00:00,24,1,25
"21718",10501,"Grand Falls-Windsor","NL",48.92696,-55.65966,2018-06-24 16:00:00,23,1,24
"21719",10501,"Grand Falls-Windsor","NL",48.92696,-55.65966,2018-06-24 17:00:00,23,1,24
"21720",10501,"Grand Falls-Windsor","NL",48.92696,-55.65966,2018-06-24 18:00:00,23,1,24
"21721",10501,"Grand Falls-Windsor","NL",48.92696,-55.65966,2018-06-24 19:00:00,22,1,23
"21722",10501,"Grand Falls-Windsor","NL",48.92696,-55.65966,2018-06-24 20:00:00,21,1,22
"21723",10501,"Grand Falls-Windsor","NL",48.92696,-55.65966,2018-06-24 21:00:00,21,1,22
"21724",10501,"Grand Falls-Windsor","NL",48.92696,-55.65966,2018-06-24 22:00:00,21,1,22
"21725",10501,"Grand Falls-Windsor","NL",48.92696,-55.65966,2018-06-24 23:00:00,21,0,21
"21726",10501,"Grand Falls-Windsor","NL",48.92696,-55.65966,2018-06-25 00:00:00,21,1,22
"21727",10501,"Grand Falls-Windsor","NL",48.92696,-55.65966,2018-06-25 01:00:00,20,1,21
"21728",10501,"Grand Falls-Windsor","NL",48.92696,-55.65966,2018-06-25 02:00:00,20,1,21
"21729",10501,"Grand Falls-Windsor","NL",48.92696,-55.65966,2018-06-25 03:00:00,20,0,20
"21730",10501,"Grand Falls-Windsor","NL",48.92696,-55.65966,2018-06-25 04:00:00,20,0,20
"21731",10501,"Grand Falls-Windsor","NL",48.92696,-55.65966,2018-06-25 05:00:00,19,1,20
"21732",10501,"Grand Falls-Windsor","NL",48.92696,-55.65966,2018-06-25 06:00:00,18,1,19
"21733",10501,"Grand Falls-Windsor","NL",48.92696,-55.65966,2018-06-25 07:00:00,18,1,19
"21734",10501,"Grand Falls-Windsor","NL",48.92696,-55.65966,2018-06-25 08:00:00,18,1,19
"21735",10501,"Grand Falls-Windsor","NL",48.92696,-55.65966,2018-06-25 09:00:00,18,1,19
"21736",10501,"Grand Falls-Windsor","NL",48.92696,-55.65966,2018-06-25 10:00:00,19,1,20
"21737",10501,"Grand Falls-Windsor","NL",48.92696,-55.65966,2018-06-25 11:00:00,18,4,22
"21738",10501,"Grand Falls-Windsor","NL",48.92696,-55.65966,2018-06-25 12:00:00,20,1,21
"21739",10501,"Grand Falls-Windsor","NL",48.92696,-55.65966,2018-06-25 13:00:00,20,1,21
"21740",10501,"Grand Falls-Windsor","NL",48.92696,-55.65966,2018-06-25 14:00:00,19,1,20
"21741",10501,"Grand Falls-Windsor","NL",48.92696,-55.65966,2018-06-25 15:00:00,19,1,20
"21742",10501,"Grand Falls-Windsor","NL",48.92696,-55.65966,2018-06-25 16:00:00,19,1,20
"21743",10501,"Grand Falls-Windsor","NL",48.92696,-55.65966,2018-06-25 17:00:00,17,2,19
"21744",10501,"Grand Falls-Windsor","NL",48.92696,-55.65966,2018-06-25 18:00:00,17,1,18
"21745",10501,"Grand Falls-Windsor","NL",48.92696,-55.65966,2018-06-25 19:00:00,17,2,19
"21746",10501,"Grand Falls-Windsor","NL",48.92696,-55.65966,2018-06-25 20:00:00,18,1,19
"21747",10501,"Grand Falls-Windsor","NL",48.92696,-55.65966,2018-06-25 21:00:00,19,1,20
"21748",10501,"Grand Falls-Windsor","NL",48.92696,-55.65966,2018-06-25 22:00:00,19,1,20
"21749",10501,"Grand Falls-Windsor","NL",48.92696,-55.65966,2018-06-25 23:00:00,19,0,19
"21750",10501,"Grand Falls-Windsor","NL",48.92696,-55.65966,2018-06-26 00:00:00,20,1,21
"21751",10501,"Grand Falls-Windsor","NL",48.92696,-55.65966,2018-06-26 01:00:00,20,1,21
"21752",10501,"Grand Falls-Windsor","NL",48.92696,-55.65966,2018-06-26 02:00:00,20,1,21
"21753",10501,"Grand Falls-Windsor","NL",48.92696,-55.65966,2018-06-26 03:00:00,20,0,20
"21754",10501,"Grand Falls-Windsor","NL",48.92696,-55.65966,2018-06-26 04:00:00,19,1,20
"21755",10501,"Grand Falls-Windsor","NL",48.92696,-55.65966,2018-06-26 05:00:00,19,0,19
"21756",10501,"Grand Falls-Windsor","NL",48.92696,-55.65966,2018-06-26 06:00:00,18,1,19
"21757",10501,"Grand Falls-Windsor","NL",48.92696,-55.65966,2018-06-26 07:00:00,17,2,19
"21758",10501,"Grand Falls-Windsor","NL",48.92696,-55.65966,2018-06-26 08:00:00,20,3,23
"21759",10501,"Grand Falls-Windsor","NL",48.92696,-55.65966,2018-06-26 09:00:00,21,2,23
"21760",10501,"Grand Falls-Windsor","NL",48.92696,-55.65966,2018-06-26 10:00:00,21,1,22
"21761",10501,"Grand Falls-Windsor","NL",48.92696,-55.65966,2018-06-26 11:00:00,19,2,21
"21762",10501,"Grand Falls-Windsor","NL",48.92696,-55.65966,2018-06-26 12:00:00,20,2,22
"21763",10501,"Grand Falls-Windsor","NL",48.92696,-55.65966,2018-06-26 13:00:00,21,1,22
"21764",10501,"Grand Falls-Windsor","NL",48.92696,-55.65966,2018-06-26 14:00:00,21,1,22
"21765",10501,"Grand Falls-Windsor","NL",48.92696,-55.65966,2018-06-26 15:00:00,20,1,21
"21766",10501,"Grand Falls-Windsor","NL",48.92696,-55.65966,2018-06-26 16:00:00,20,1,21
"21767",10501,"Grand Falls-Windsor","NL",48.92696,-55.65966,2018-06-26 17:00:00,21,1,22
"21768",10501,"Grand Falls-Windsor","NL",48.92696,-55.65966,2018-06-26 18:00:00,21,1,22
"21769",10501,"Grand Falls-Windsor","NL",48.92696,-55.65966,2018-06-26 19:00:00,21,1,22
"21770",10501,"Grand Falls-Windsor","NL",48.92696,-55.65966,2018-06-26 20:00:00,20,1,21
"21771",10501,"Grand Falls-Windsor","NL",48.92696,-55.65966,2018-06-26 21:00:00,20,1,21
"21772",10501,"Grand Falls-Windsor","NL",48.92696,-55.65966,2018-06-26 22:00:00,19,1,20
"21773",10501,"Grand Falls-Windsor","NL",48.92696,-55.65966,2018-06-26 23:00:00,20,1,21
"21774",10501,"Grand Falls-Windsor","NL",48.92696,-55.65966,2018-06-27 00:00:00,19,0,19
"21775",10501,"Grand Falls-Windsor","NL",48.92696,-55.65966,2018-06-27 01:00:00,17,1,18
"21776",10501,"Grand Falls-Windsor","NL",48.92696,-55.65966,2018-06-27 02:00:00,12,2,14
"21777",10501,"Grand Falls-Windsor","NL",48.92696,-55.65966,2018-06-27 03:00:00,10,5,15
"21778",10501,"Grand Falls-Windsor","NL",48.92696,-55.65966,2018-06-27 04:00:00,11,0,11
"21779",10501,"Grand Falls-Windsor","NL",48.92696,-55.65966,2018-06-27 05:00:00,9,3,12
"21780",10501,"Grand Falls-Windsor","NL",48.92696,-55.65966,2018-06-27 06:00:00,10,2,12
"21781",10501,"Grand Falls-Windsor","NL",48.92696,-55.65966,2018-06-27 07:00:00,9,5,14
"21782",10501,"Grand Falls-Windsor","NL",48.92696,-55.65966,2018-06-27 08:00:00,12,1,13
"21783",10501,"Grand Falls-Windsor","NL",48.92696,-55.65966,2018-06-27 09:00:00,16,0,16
"21784",10501,"Grand Falls-Windsor","NL",48.92696,-55.65966,2018-06-27 10:00:00,17,0,17
"21785",10501,"Grand Falls-Windsor","NL",48.92696,-55.65966,2018-06-27 11:00:00,19,0,19
"21786",10501,"Grand Falls-Windsor","NL",48.92696,-55.65966,2018-06-27 12:00:00,18,0,18
"21787",10501,"Grand Falls-Windsor","NL",48.92696,-55.65966,2018-06-27 13:00:00,18,0,18
"21788",10501,"Grand Falls-Windsor","NL",48.92696,-55.65966,2018-06-27 14:00:00,22,1,23
"21789",10501,"Grand Falls-Windsor","NL",48.92696,-55.65966,2018-06-27 15:00:00,24,1,25
"21790",10501,"Grand Falls-Windsor","NL",48.92696,-55.65966,2018-06-27 16:00:00,24,0,24
"21791",10501,"Grand Falls-Windsor","NL",48.92696,-55.65966,2018-06-27 17:00:00,25,1,26
"21792",10501,"Grand Falls-Windsor","NL",48.92696,-55.65966,2018-06-27 18:00:00,26,1,27
"21793",10501,"Grand Falls-Windsor","NL",48.92696,-55.65966,2018-06-27 19:00:00,25,1,26
"21794",10501,"Grand Falls-Windsor","NL",48.92696,-55.65966,2018-06-27 20:00:00,24,1,25
"21795",10501,"Grand Falls-Windsor","NL",48.92696,-55.65966,2018-06-27 21:00:00,24,1,25
"21796",10501,"Grand Falls-Windsor","NL",48.92696,-55.65966,2018-06-27 22:00:00,23,1,24
"21797",10501,"Grand Falls-Windsor","NL",48.92696,-55.65966,2018-06-27 23:00:00,19,2,21
"21798",10501,"Grand Falls-Windsor","NL",48.92696,-55.65966,2018-06-28 00:00:00,15,1,16
"21799",10501,"Grand Falls-Windsor","NL",48.92696,-55.65966,2018-06-28 01:00:00,15,1,16
"21800",10501,"Grand Falls-Windsor","NL",48.92696,-55.65966,2018-06-28 02:00:00,15,1,16
"21801",10501,"Grand Falls-Windsor","NL",48.92696,-55.65966,2018-06-28 03:00:00,13,0,13
"21802",10501,"Grand Falls-Windsor","NL",48.92696,-55.65966,2018-06-28 04:00:00,12,1,13
"21803",10501,"Grand Falls-Windsor","NL",48.92696,-55.65966,2018-06-28 05:00:00,11,0,11
"21804",10501,"Grand Falls-Windsor","NL",48.92696,-55.65966,2018-06-28 06:00:00,11,0,11
"21805",10501,"Grand Falls-Windsor","NL",48.92696,-55.65966,2018-06-28 07:00:00,11,1,12
"21806",10501,"Grand Falls-Windsor","NL",48.92696,-55.65966,2018-06-28 08:00:00,12,1,13
"21807",10501,"Grand Falls-Windsor","NL",48.92696,-55.65966,2018-06-28 09:00:00,11,1,12
"21808",10501,"Grand Falls-Windsor","NL",48.92696,-55.65966,2018-06-28 10:00:00,13,1,14
"21809",10501,"Grand Falls-Windsor","NL",48.92696,-55.65966,2018-06-28 11:00:00,17,1,18
"21810",10501,"Grand Falls-Windsor","NL",48.92696,-55.65966,2018-06-28 12:00:00,27,1,28
"21811",10501,"Grand Falls-Windsor","NL",48.92696,-55.65966,2018-06-28 13:00:00,29,1,30
"21812",10501,"Grand Falls-Windsor","NL",48.92696,-55.65966,2018-06-28 14:00:00,31,1,32
"21813",10501,"Grand Falls-Windsor","NL",48.92696,-55.65966,2018-06-28 15:00:00,31,1,32
"21814",10501,"Grand Falls-Windsor","NL",48.92696,-55.65966,2018-06-28 16:00:00,34,1,35
"21815",10501,"Grand Falls-Windsor","NL",48.92696,-55.65966,2018-06-28 17:00:00,35,1,36
"21816",10501,"Grand Falls-Windsor","NL",48.92696,-55.65966,2018-06-28 18:00:00,38,1,39
"21817",10501,"Grand Falls-Windsor","NL",48.92696,-55.65966,2018-06-28 19:00:00,39,1,40
"21818",10501,"Grand Falls-Windsor","NL",48.92696,-55.65966,2018-06-28 20:00:00,37,1,38
"21819",10501,"Grand Falls-Windsor","NL",48.92696,-55.65966,2018-06-28 21:00:00,33,1,34
"21820",10501,"Grand Falls-Windsor","NL",48.92696,-55.65966,2018-06-28 22:00:00,31,1,32
"21821",10501,"Grand Falls-Windsor","NL",48.92696,-55.65966,2018-06-28 23:00:00,28,1,29
"21822",10501,"Grand Falls-Windsor","NL",48.92696,-55.65966,2018-06-29 00:00:00,27,0,27
"21823",10501,"Grand Falls-Windsor","NL",48.92696,-55.65966,2018-06-29 01:00:00,27,1,28
"21824",10501,"Grand Falls-Windsor","NL",48.92696,-55.65966,2018-06-29 02:00:00,27,0,27
"21825",10501,"Grand Falls-Windsor","NL",48.92696,-55.65966,2018-06-29 03:00:00,26,0,26
"21826",10501,"Grand Falls-Windsor","NL",48.92696,-55.65966,2018-06-29 04:00:00,27,0,27
"21827",10501,"Grand Falls-Windsor","NL",48.92696,-55.65966,2018-06-29 05:00:00,25,0,25
"21828",10501,"Grand Falls-Windsor","NL",48.92696,-55.65966,2018-06-29 06:00:00,24,1,25
"21829",10501,"Grand Falls-Windsor","NL",48.92696,-55.65966,2018-06-29 07:00:00,24,0,24
"21830",10501,"Grand Falls-Windsor","NL",48.92696,-55.65966,2018-06-29 08:00:00,26,0,26
"21831",10501,"Grand Falls-Windsor","NL",48.92696,-55.65966,2018-06-29 09:00:00,26,0,26
"21832",10501,"Grand Falls-Windsor","NL",48.92696,-55.65966,2018-06-29 10:00:00,28,0,28
"21833",10501,"Grand Falls-Windsor","NL",48.92696,-55.65966,2018-06-29 11:00:00,28,0,28
"21834",10501,"Grand Falls-Windsor","NL",48.92696,-55.65966,2018-06-29 12:00:00,28,1,29
"21835",10501,"Grand Falls-Windsor","NL",48.92696,-55.65966,2018-06-29 13:00:00,28,1,29
"21836",10501,"Grand Falls-Windsor","NL",48.92696,-55.65966,2018-06-29 14:00:00,28,1,29
"21837",10501,"Grand Falls-Windsor","NL",48.92696,-55.65966,2018-06-29 15:00:00,28,0,28
"21838",10501,"Grand Falls-Windsor","NL",48.92696,-55.65966,2018-06-29 16:00:00,27,1,28
"21839",10501,"Grand Falls-Windsor","NL",48.92696,-55.65966,2018-06-29 17:00:00,29,0,29
"21840",10501,"Grand Falls-Windsor","NL",48.92696,-55.65966,2018-06-29 18:00:00,NA,NA,NA
"21841",10501,"Grand Falls-Windsor","NL",48.92696,-55.65966,2018-06-29 19:00:00,NA,NA,NA
"21842",10501,"Grand Falls-Windsor","NL",48.92696,-55.65966,2018-06-29 20:00:00,NA,NA,NA
"21843",10501,"Grand Falls-Windsor","NL",48.92696,-55.65966,2018-06-29 21:00:00,NA,NA,NA
"21844",10501,"Grand Falls-Windsor","NL",48.92696,-55.65966,2018-06-29 22:00:00,NA,NA,NA
"21845",10501,"Grand Falls-Windsor","NL",48.92696,-55.65966,2018-06-29 23:00:00,NA,NA,NA
"21846",10501,"Grand Falls-Windsor","NL",48.92696,-55.65966,2018-06-30 00:00:00,NA,NA,NA
"21847",10501,"Grand Falls-Windsor","NL",48.92696,-55.65966,2018-06-30 01:00:00,NA,NA,NA
"21848",10501,"Grand Falls-Windsor","NL",48.92696,-55.65966,2018-06-30 02:00:00,NA,NA,NA
"21849",10501,"Grand Falls-Windsor","NL",48.92696,-55.65966,2018-06-30 03:00:00,NA,NA,NA
"21850",10501,"Grand Falls-Windsor","NL",48.92696,-55.65966,2018-06-30 04:00:00,NA,NA,NA
"21851",10501,"Grand Falls-Windsor","NL",48.92696,-55.65966,2018-06-30 05:00:00,NA,NA,NA
"21852",10501,"Grand Falls-Windsor","NL",48.92696,-55.65966,2018-06-30 06:00:00,NA,NA,NA
"21853",10501,"Grand Falls-Windsor","NL",48.92696,-55.65966,2018-06-30 07:00:00,NA,NA,NA
"21854",10501,"Grand Falls-Windsor","NL",48.92696,-55.65966,2018-06-30 08:00:00,NA,NA,NA
"21855",10501,"Grand Falls-Windsor","NL",48.92696,-55.65966,2018-06-30 09:00:00,NA,NA,NA
"21856",10501,"Grand Falls-Windsor","NL",48.92696,-55.65966,2018-06-30 10:00:00,NA,NA,NA
"21857",10501,"Grand Falls-Windsor","NL",48.92696,-55.65966,2018-06-30 11:00:00,NA,NA,NA
"21858",10501,"Grand Falls-Windsor","NL",48.92696,-55.65966,2018-06-30 12:00:00,NA,NA,NA
"21859",10501,"Grand Falls-Windsor","NL",48.92696,-55.65966,2018-06-30 13:00:00,NA,NA,NA
"21860",10501,"Grand Falls-Windsor","NL",48.92696,-55.65966,2018-06-30 14:00:00,NA,NA,NA
"21861",10501,"Grand Falls-Windsor","NL",48.92696,-55.65966,2018-06-30 15:00:00,NA,NA,NA
"21862",10501,"Grand Falls-Windsor","NL",48.92696,-55.65966,2018-06-30 16:00:00,NA,NA,NA
"21863",10501,"Grand Falls-Windsor","NL",48.92696,-55.65966,2018-06-30 17:00:00,NA,NA,NA
"21864",10501,"Grand Falls-Windsor","NL",48.92696,-55.65966,2018-06-30 18:00:00,NA,NA,NA
"21865",10501,"Grand Falls-Windsor","NL",48.92696,-55.65966,2018-06-30 19:00:00,NA,NA,NA
"21866",10501,"Grand Falls-Windsor","NL",48.92696,-55.65966,2018-06-30 20:00:00,NA,NA,NA
"21867",10501,"Grand Falls-Windsor","NL",48.92696,-55.65966,2018-06-30 21:00:00,NA,NA,NA
"21868",10501,"Grand Falls-Windsor","NL",48.92696,-55.65966,2018-06-30 22:00:00,NA,NA,NA
"21869",10501,"Grand Falls-Windsor","NL",48.92696,-55.65966,2018-06-30 23:00:00,NA,NA,NA
"21870",10501,"Grand Falls-Windsor","NL",48.92696,-55.65966,2018-07-01 00:00:00,NA,NA,NA
"21871",10501,"Grand Falls-Windsor","NL",48.92696,-55.65966,2018-07-01 01:00:00,NA,NA,NA
"21872",10501,"Grand Falls-Windsor","NL",48.92696,-55.65966,2018-07-01 02:00:00,NA,NA,NA
"21873",10501,"Grand Falls-Windsor","NL",48.92696,-55.65966,2018-07-01 03:00:00,NA,NA,NA
"21874",10501,"Grand Falls-Windsor","NL",48.92696,-55.65966,2018-07-01 04:00:00,NA,NA,NA
"21875",10501,"Grand Falls-Windsor","NL",48.92696,-55.65966,2018-07-01 05:00:00,NA,NA,NA
"21876",10501,"Grand Falls-Windsor","NL",48.92696,-55.65966,2018-07-01 06:00:00,NA,NA,NA
"21877",10501,"Grand Falls-Windsor","NL",48.92696,-55.65966,2018-07-01 07:00:00,NA,NA,NA
"21878",10501,"Grand Falls-Windsor","NL",48.92696,-55.65966,2018-07-01 08:00:00,NA,NA,NA
"21879",10501,"Grand Falls-Windsor","NL",48.92696,-55.65966,2018-07-01 09:00:00,NA,NA,NA
"21880",10501,"Grand Falls-Windsor","NL",48.92696,-55.65966,2018-07-01 10:00:00,NA,NA,NA
"21881",10501,"Grand Falls-Windsor","NL",48.92696,-55.65966,2018-07-01 11:00:00,NA,NA,NA
"21882",10501,"Grand Falls-Windsor","NL",48.92696,-55.65966,2018-07-01 12:00:00,NA,NA,NA
"21883",10501,"Grand Falls-Windsor","NL",48.92696,-55.65966,2018-07-01 13:00:00,NA,NA,NA
"21884",10501,"Grand Falls-Windsor","NL",48.92696,-55.65966,2018-07-01 14:00:00,NA,NA,NA
"21885",10501,"Grand Falls-Windsor","NL",48.92696,-55.65966,2018-07-01 15:00:00,NA,NA,NA
"21886",10501,"Grand Falls-Windsor","NL",48.92696,-55.65966,2018-07-01 16:00:00,NA,NA,NA
"21887",10501,"Grand Falls-Windsor","NL",48.92696,-55.65966,2018-07-01 17:00:00,NA,NA,NA
"21888",10501,"Grand Falls-Windsor","NL",48.92696,-55.65966,2018-07-01 18:00:00,17,1,18
"21889",10501,"Grand Falls-Windsor","NL",48.92696,-55.65966,2018-07-01 19:00:00,16,1,17
"21890",10501,"Grand Falls-Windsor","NL",48.92696,-55.65966,2018-07-01 20:00:00,13,1,14
"21891",10501,"Grand Falls-Windsor","NL",48.92696,-55.65966,2018-07-01 21:00:00,10,2,12
"21892",10501,"Grand Falls-Windsor","NL",48.92696,-55.65966,2018-07-01 22:00:00,9,2,11
"21893",10501,"Grand Falls-Windsor","NL",48.92696,-55.65966,2018-07-01 23:00:00,7,1,8
"21894",10501,"Grand Falls-Windsor","NL",48.92696,-55.65966,2018-07-02 00:00:00,7,1,8
"21895",10501,"Grand Falls-Windsor","NL",48.92696,-55.65966,2018-07-02 01:00:00,8,1,9
"21896",10501,"Grand Falls-Windsor","NL",48.92696,-55.65966,2018-07-02 02:00:00,8,1,9
"21897",10501,"Grand Falls-Windsor","NL",48.92696,-55.65966,2018-07-02 03:00:00,8,0,8
"21898",10501,"Grand Falls-Windsor","NL",48.92696,-55.65966,2018-07-02 04:00:00,10,1,11
"21899",10501,"Grand Falls-Windsor","NL",48.92696,-55.65966,2018-07-02 05:00:00,11,1,12
"21900",10501,"Grand Falls-Windsor","NL",48.92696,-55.65966,2018-07-02 06:00:00,12,1,13
"21901",10501,"Grand Falls-Windsor","NL",48.92696,-55.65966,2018-07-02 07:00:00,12,1,13
"21902",10501,"Grand Falls-Windsor","NL",48.92696,-55.65966,2018-07-02 08:00:00,12,1,13
"21903",10501,"Grand Falls-Windsor","NL",48.92696,-55.65966,2018-07-02 09:00:00,12,0,12
"21904",10501,"Grand Falls-Windsor","NL",48.92696,-55.65966,2018-07-02 10:00:00,14,1,15
"21905",10501,"Grand Falls-Windsor","NL",48.92696,-55.65966,2018-07-02 11:00:00,14,0,14
"21906",10501,"Grand Falls-Windsor","NL",48.92696,-55.65966,2018-07-02 12:00:00,14,0,14
"21907",10501,"Grand Falls-Windsor","NL",48.92696,-55.65966,2018-07-02 13:00:00,15,0,15
"21908",10501,"Grand Falls-Windsor","NL",48.92696,-55.65966,2018-07-02 14:00:00,17,1,18
"21909",10501,"Grand Falls-Windsor","NL",48.92696,-55.65966,2018-07-02 15:00:00,19,1,20
"21910",10501,"Grand Falls-Windsor","NL",48.92696,-55.65966,2018-07-02 16:00:00,20,1,21
"21911",10501,"Grand Falls-Windsor","NL",48.92696,-55.65966,2018-07-02 17:00:00,21,1,22
"21912",10501,"Grand Falls-Windsor","NL",48.92696,-55.65966,2018-07-02 18:00:00,21,1,22
"21913",10501,"Grand Falls-Windsor","NL",48.92696,-55.65966,2018-07-02 19:00:00,16,1,17
"21914",10501,"Grand Falls-Windsor","NL",48.92696,-55.65966,2018-07-02 20:00:00,12,2,14
"21915",10501,"Grand Falls-Windsor","NL",48.92696,-55.65966,2018-07-02 21:00:00,11,2,13
"21916",10501,"Grand Falls-Windsor","NL",48.92696,-55.65966,2018-07-02 22:00:00,10,2,12
"21917",10501,"Grand Falls-Windsor","NL",48.92696,-55.65966,2018-07-02 23:00:00,17,1,18
"21918",10501,"Grand Falls-Windsor","NL",48.92696,-55.65966,2018-07-03 00:00:00,17,1,18
"21919",10501,"Grand Falls-Windsor","NL",48.92696,-55.65966,2018-07-03 01:00:00,16,0,16
"21920",10501,"Grand Falls-Windsor","NL",48.92696,-55.65966,2018-07-03 02:00:00,16,1,17
"21921",10501,"Grand Falls-Windsor","NL",48.92696,-55.65966,2018-07-03 03:00:00,17,0,17
"21922",10501,"Grand Falls-Windsor","NL",48.92696,-55.65966,2018-07-03 04:00:00,16,0,16
"21923",10501,"Grand Falls-Windsor","NL",48.92696,-55.65966,2018-07-03 05:00:00,15,0,15
"21924",10501,"Grand Falls-Windsor","NL",48.92696,-55.65966,2018-07-03 06:00:00,16,0,16
"21925",10501,"Grand Falls-Windsor","NL",48.92696,-55.65966,2018-07-03 07:00:00,20,0,20
"21926",10501,"Grand Falls-Windsor","NL",48.92696,-55.65966,2018-07-03 08:00:00,22,1,23
"21927",10501,"Grand Falls-Windsor","NL",48.92696,-55.65966,2018-07-03 09:00:00,22,0,22
"21928",10501,"Grand Falls-Windsor","NL",48.92696,-55.65966,2018-07-03 10:00:00,23,0,23
"21929",10501,"Grand Falls-Windsor","NL",48.92696,-55.65966,2018-07-03 11:00:00,23,1,24
"21930",10501,"Grand Falls-Windsor","NL",48.92696,-55.65966,2018-07-03 12:00:00,26,1,27
"21931",10501,"Grand Falls-Windsor","NL",48.92696,-55.65966,2018-07-03 13:00:00,28,1,29
"21932",10501,"Grand Falls-Windsor","NL",48.92696,-55.65966,2018-07-03 14:00:00,30,1,31
"21933",10501,"Grand Falls-Windsor","NL",48.92696,-55.65966,2018-07-03 15:00:00,30,1,31
"21934",10501,"Grand Falls-Windsor","NL",48.92696,-55.65966,2018-07-03 16:00:00,30,1,31
"21935",10501,"Grand Falls-Windsor","NL",48.92696,-55.65966,2018-07-03 17:00:00,30,1,31
"21936",10501,"Grand Falls-Windsor","NL",48.92696,-55.65966,2018-07-03 18:00:00,33,1,34
"21937",10501,"Grand Falls-Windsor","NL",48.92696,-55.65966,2018-07-03 19:00:00,30,1,31
"21938",10501,"Grand Falls-Windsor","NL",48.92696,-55.65966,2018-07-03 20:00:00,29,1,30
"21939",10501,"Grand Falls-Windsor","NL",48.92696,-55.65966,2018-07-03 21:00:00,29,1,30
"21940",10501,"Grand Falls-Windsor","NL",48.92696,-55.65966,2018-07-03 22:00:00,30,1,31
"21941",10501,"Grand Falls-Windsor","NL",48.92696,-55.65966,2018-07-03 23:00:00,27,1,28
"21942",10501,"Grand Falls-Windsor","NL",48.92696,-55.65966,2018-07-04 00:00:00,27,1,28
"21943",10501,"Grand Falls-Windsor","NL",48.92696,-55.65966,2018-07-04 01:00:00,26,1,27
"21944",10501,"Grand Falls-Windsor","NL",48.92696,-55.65966,2018-07-04 02:00:00,24,0,24
"21945",10501,"Grand Falls-Windsor","NL",48.92696,-55.65966,2018-07-04 03:00:00,22,0,22
"21946",10501,"Grand Falls-Windsor","NL",48.92696,-55.65966,2018-07-04 04:00:00,21,1,22
"21947",10501,"Grand Falls-Windsor","NL",48.92696,-55.65966,2018-07-04 05:00:00,19,1,20
"21948",10501,"Grand Falls-Windsor","NL",48.92696,-55.65966,2018-07-04 06:00:00,21,1,22
"21949",10501,"Grand Falls-Windsor","NL",48.92696,-55.65966,2018-07-04 07:00:00,24,1,25
"21950",10501,"Grand Falls-Windsor","NL",48.92696,-55.65966,2018-07-04 08:00:00,23,1,24
"21951",10501,"Grand Falls-Windsor","NL",48.92696,-55.65966,2018-07-04 09:00:00,25,1,26
"21952",10501,"Grand Falls-Windsor","NL",48.92696,-55.65966,2018-07-04 10:00:00,28,1,29
"21953",10501,"Grand Falls-Windsor","NL",48.92696,-55.65966,2018-07-04 11:00:00,30,1,31
"21954",10501,"Grand Falls-Windsor","NL",48.92696,-55.65966,2018-07-04 12:00:00,30,1,31
"21955",10501,"Grand Falls-Windsor","NL",48.92696,-55.65966,2018-07-04 13:00:00,31,1,32
"21956",10501,"Grand Falls-Windsor","NL",48.92696,-55.65966,2018-07-04 14:00:00,31,1,32
"21957",10501,"Grand Falls-Windsor","NL",48.92696,-55.65966,2018-07-04 15:00:00,32,1,33
"21958",10501,"Grand Falls-Windsor","NL",48.92696,-55.65966,2018-07-04 16:00:00,34,1,35
"21959",10501,"Grand Falls-Windsor","NL",48.92696,-55.65966,2018-07-04 17:00:00,35,1,36
"21960",10501,"Grand Falls-Windsor","NL",48.92696,-55.65966,2018-07-04 18:00:00,36,1,37
"21961",10501,"Grand Falls-Windsor","NL",48.92696,-55.65966,2018-07-04 19:00:00,34,1,35
"21962",10501,"Grand Falls-Windsor","NL",48.92696,-55.65966,2018-07-04 20:00:00,31,1,32
"21963",10501,"Grand Falls-Windsor","NL",48.92696,-55.65966,2018-07-04 21:00:00,30,1,31
"21964",10501,"Grand Falls-Windsor","NL",48.92696,-55.65966,2018-07-04 22:00:00,24,4,28
"21965",10501,"Grand Falls-Windsor","NL",48.92696,-55.65966,2018-07-04 23:00:00,19,2,21
"21966",10501,"Grand Falls-Windsor","NL",48.92696,-55.65966,2018-07-05 00:00:00,11,1,12
"21967",10501,"Grand Falls-Windsor","NL",48.92696,-55.65966,2018-07-05 01:00:00,10,1,11
"21968",10501,"Grand Falls-Windsor","NL",48.92696,-55.65966,2018-07-05 02:00:00,8,1,9
"21969",10501,"Grand Falls-Windsor","NL",48.92696,-55.65966,2018-07-05 03:00:00,11,0,11
"21970",10501,"Grand Falls-Windsor","NL",48.92696,-55.65966,2018-07-05 04:00:00,4,1,5
"21971",10501,"Grand Falls-Windsor","NL",48.92696,-55.65966,2018-07-05 05:00:00,5,1,6
"21972",10501,"Grand Falls-Windsor","NL",48.92696,-55.65966,2018-07-05 06:00:00,7,1,8
"21973",10501,"Grand Falls-Windsor","NL",48.92696,-55.65966,2018-07-05 07:00:00,12,0,12
"21974",10501,"Grand Falls-Windsor","NL",48.92696,-55.65966,2018-07-05 08:00:00,18,1,19
"21975",10501,"Grand Falls-Windsor","NL",48.92696,-55.65966,2018-07-05 09:00:00,23,1,24
"21976",10501,"Grand Falls-Windsor","NL",48.92696,-55.65966,2018-07-05 10:00:00,24,1,25
"21977",10501,"Grand Falls-Windsor","NL",48.92696,-55.65966,2018-07-05 11:00:00,26,1,27
"21978",10501,"Grand Falls-Windsor","NL",48.92696,-55.65966,2018-07-05 12:00:00,27,1,28
"21979",10501,"Grand Falls-Windsor","NL",48.92696,-55.65966,2018-07-05 13:00:00,29,1,30
"21980",10501,"Grand Falls-Windsor","NL",48.92696,-55.65966,2018-07-05 14:00:00,27,1,28
"21981",10501,"Grand Falls-Windsor","NL",48.92696,-55.65966,2018-07-05 15:00:00,24,1,25
"21982",10501,"Grand Falls-Windsor","NL",48.92696,-55.65966,2018-07-05 16:00:00,24,1,25
"21983",10501,"Grand Falls-Windsor","NL",48.92696,-55.65966,2018-07-05 17:00:00,25,1,26
"21984",10501,"Grand Falls-Windsor","NL",48.92696,-55.65966,2018-07-05 18:00:00,25,1,26
"21985",10501,"Grand Falls-Windsor","NL",48.92696,-55.65966,2018-07-05 19:00:00,24,1,25
"21986",10501,"Grand Falls-Windsor","NL",48.92696,-55.65966,2018-07-05 20:00:00,23,2,25
"21987",10501,"Grand Falls-Windsor","NL",48.92696,-55.65966,2018-07-05 21:00:00,21,3,24
"21988",10501,"Grand Falls-Windsor","NL",48.92696,-55.65966,2018-07-05 22:00:00,16,3,19
"21989",10501,"Grand Falls-Windsor","NL",48.92696,-55.65966,2018-07-05 23:00:00,12,2,14
"21990",10501,"Grand Falls-Windsor","NL",48.92696,-55.65966,2018-07-06 00:00:00,6,2,8
"21991",10501,"Grand Falls-Windsor","NL",48.92696,-55.65966,2018-07-06 01:00:00,7,1,8
"21992",10501,"Grand Falls-Windsor","NL",48.92696,-55.65966,2018-07-06 02:00:00,14,0,14
"21993",10501,"Grand Falls-Windsor","NL",48.92696,-55.65966,2018-07-06 03:00:00,15,1,16
"21994",10501,"Grand Falls-Windsor","NL",48.92696,-55.65966,2018-07-06 04:00:00,17,0,17
"21995",10501,"Grand Falls-Windsor","NL",48.92696,-55.65966,2018-07-06 05:00:00,17,0,17
"21996",10501,"Grand Falls-Windsor","NL",48.92696,-55.65966,2018-07-06 06:00:00,16,1,17
"21997",10501,"Grand Falls-Windsor","NL",48.92696,-55.65966,2018-07-06 07:00:00,17,1,18
"21998",10501,"Grand Falls-Windsor","NL",48.92696,-55.65966,2018-07-06 08:00:00,23,1,24
"21999",10501,"Grand Falls-Windsor","NL",48.92696,-55.65966,2018-07-06 09:00:00,26,0,26
"22000",10501,"Grand Falls-Windsor","NL",48.92696,-55.65966,2018-07-06 10:00:00,27,0,27
"22001",10501,"Grand Falls-Windsor","NL",48.92696,-55.65966,2018-07-06 11:00:00,28,0,28
"22002",10501,"Grand Falls-Windsor","NL",48.92696,-55.65966,2018-07-06 12:00:00,30,1,31
"22003",10501,"Grand Falls-Windsor","NL",48.92696,-55.65966,2018-07-06 13:00:00,32,1,33
"22004",10501,"Grand Falls-Windsor","NL",48.92696,-55.65966,2018-07-06 14:00:00,30,1,31
"22005",10501,"Grand Falls-Windsor","NL",48.92696,-55.65966,2018-07-06 15:00:00,25,1,26
"22006",10501,"Grand Falls-Windsor","NL",48.92696,-55.65966,2018-07-06 16:00:00,NA,1,NA
"22007",10501,"Grand Falls-Windsor","NL",48.92696,-55.65966,2018-07-06 17:00:00,NA,1,NA
"22008",10501,"Grand Falls-Windsor","NL",48.92696,-55.65966,2018-07-06 18:00:00,NA,1,NA
"22009",10501,"Grand Falls-Windsor","NL",48.92696,-55.65966,2018-07-06 19:00:00,NA,1,NA
"22010",10501,"Grand Falls-Windsor","NL",48.92696,-55.65966,2018-07-06 20:00:00,NA,1,NA
"22011",10501,"Grand Falls-Windsor","NL",48.92696,-55.65966,2018-07-06 21:00:00,NA,1,NA
"22012",10501,"Grand Falls-Windsor","NL",48.92696,-55.65966,2018-07-06 22:00:00,NA,1,NA
"22013",10501,"Grand Falls-Windsor","NL",48.92696,-55.65966,2018-07-06 23:00:00,NA,1,NA
"22014",10501,"Grand Falls-Windsor","NL",48.92696,-55.65966,2018-07-07 00:00:00,NA,1,NA
"22015",10501,"Grand Falls-Windsor","NL",48.92696,-55.65966,2018-07-07 01:00:00,NA,1,NA
"22016",10501,"Grand Falls-Windsor","NL",48.92696,-55.65966,2018-07-07 02:00:00,NA,0,NA
"22017",10501,"Grand Falls-Windsor","NL",48.92696,-55.65966,2018-07-07 03:00:00,NA,0,NA
"22018",10501,"Grand Falls-Windsor","NL",48.92696,-55.65966,2018-07-07 04:00:00,NA,0,NA
"22019",10501,"Grand Falls-Windsor","NL",48.92696,-55.65966,2018-07-07 05:00:00,NA,0,NA
"22020",10501,"Grand Falls-Windsor","NL",48.92696,-55.65966,2018-07-07 06:00:00,NA,0,NA
"22021",10501,"Grand Falls-Windsor","NL",48.92696,-55.65966,2018-07-07 07:00:00,NA,0,NA
"22022",10501,"Grand Falls-Windsor","NL",48.92696,-55.65966,2018-07-07 08:00:00,NA,0,NA
"22023",10501,"Grand Falls-Windsor","NL",48.92696,-55.65966,2018-07-07 09:00:00,NA,0,NA
"22024",10501,"Grand Falls-Windsor","NL",48.92696,-55.65966,2018-07-07 10:00:00,NA,1,NA
"22025",10501,"Grand Falls-Windsor","NL",48.92696,-55.65966,2018-07-07 11:00:00,NA,1,NA
"22026",10501,"Grand Falls-Windsor","NL",48.92696,-55.65966,2018-07-07 12:00:00,NA,1,NA
"22027",10501,"Grand Falls-Windsor","NL",48.92696,-55.65966,2018-07-07 13:00:00,NA,0,NA
"22028",10501,"Grand Falls-Windsor","NL",48.92696,-55.65966,2018-07-07 14:00:00,NA,0,NA
"22029",10501,"Grand Falls-Windsor","NL",48.92696,-55.65966,2018-07-07 15:00:00,NA,0,NA
"22030",10501,"Grand Falls-Windsor","NL",48.92696,-55.65966,2018-07-07 16:00:00,NA,0,NA
"22031",10501,"Grand Falls-Windsor","NL",48.92696,-55.65966,2018-07-07 17:00:00,NA,0,NA
"22032",10501,"Grand Falls-Windsor","NL",48.92696,-55.65966,2018-07-07 18:00:00,NA,0,NA
"22033",10501,"Grand Falls-Windsor","NL",48.92696,-55.65966,2018-07-07 19:00:00,NA,0,NA
"22034",10501,"Grand Falls-Windsor","NL",48.92696,-55.65966,2018-07-07 20:00:00,NA,0,NA
"22035",10501,"Grand Falls-Windsor","NL",48.92696,-55.65966,2018-07-07 21:00:00,NA,1,NA
"22036",10501,"Grand Falls-Windsor","NL",48.92696,-55.65966,2018-07-07 22:00:00,NA,0,NA
"22037",10501,"Grand Falls-Windsor","NL",48.92696,-55.65966,2018-07-07 23:00:00,NA,0,NA
"22038",10501,"Grand Falls-Windsor","NL",48.92696,-55.65966,2018-07-08 00:00:00,NA,1,NA
"22039",10501,"Grand Falls-Windsor","NL",48.92696,-55.65966,2018-07-08 01:00:00,NA,0,NA
"22040",10501,"Grand Falls-Windsor","NL",48.92696,-55.65966,2018-07-08 02:00:00,NA,0,NA
"22041",10501,"Grand Falls-Windsor","NL",48.92696,-55.65966,2018-07-08 03:00:00,NA,0,NA
"22042",10501,"Grand Falls-Windsor","NL",48.92696,-55.65966,2018-07-08 04:00:00,NA,0,NA
"22043",10501,"Grand Falls-Windsor","NL",48.92696,-55.65966,2018-07-08 05:00:00,NA,1,NA
"22044",10501,"Grand Falls-Windsor","NL",48.92696,-55.65966,2018-07-08 06:00:00,NA,1,NA
"22045",10501,"Grand Falls-Windsor","NL",48.92696,-55.65966,2018-07-08 07:00:00,NA,0,NA
"22046",10501,"Grand Falls-Windsor","NL",48.92696,-55.65966,2018-07-08 08:00:00,NA,0,NA
"22047",10501,"Grand Falls-Windsor","NL",48.92696,-55.65966,2018-07-08 09:00:00,NA,0,NA
"22048",10501,"Grand Falls-Windsor","NL",48.92696,-55.65966,2018-07-08 10:00:00,NA,0,NA
"22049",10501,"Grand Falls-Windsor","NL",48.92696,-55.65966,2018-07-08 11:00:00,NA,0,NA
"22050",10501,"Grand Falls-Windsor","NL",48.92696,-55.65966,2018-07-08 12:00:00,NA,1,NA
"22051",10501,"Grand Falls-Windsor","NL",48.92696,-55.65966,2018-07-08 13:00:00,NA,0,NA
"22052",10501,"Grand Falls-Windsor","NL",48.92696,-55.65966,2018-07-08 14:00:00,NA,1,NA
"22053",10501,"Grand Falls-Windsor","NL",48.92696,-55.65966,2018-07-08 15:00:00,NA,1,NA
"22054",10501,"Grand Falls-Windsor","NL",48.92696,-55.65966,2018-07-08 16:00:00,NA,1,NA
"22055",10501,"Grand Falls-Windsor","NL",48.92696,-55.65966,2018-07-08 17:00:00,NA,1,NA
"22056",10501,"Grand Falls-Windsor","NL",48.92696,-55.65966,2018-07-08 18:00:00,NA,1,NA
"22057",10501,"Grand Falls-Windsor","NL",48.92696,-55.65966,2018-07-08 19:00:00,NA,1,NA
"22058",10501,"Grand Falls-Windsor","NL",48.92696,-55.65966,2018-07-08 20:00:00,NA,1,NA
"22059",10501,"Grand Falls-Windsor","NL",48.92696,-55.65966,2018-07-08 21:00:00,NA,1,NA
"22060",10501,"Grand Falls-Windsor","NL",48.92696,-55.65966,2018-07-08 22:00:00,NA,0,NA
"22061",10501,"Grand Falls-Windsor","NL",48.92696,-55.65966,2018-07-08 23:00:00,NA,1,NA
"22062",10501,"Grand Falls-Windsor","NL",48.92696,-55.65966,2018-07-09 00:00:00,NA,1,NA
"22063",10501,"Grand Falls-Windsor","NL",48.92696,-55.65966,2018-07-09 01:00:00,NA,1,NA
"22064",10501,"Grand Falls-Windsor","NL",48.92696,-55.65966,2018-07-09 02:00:00,NA,1,NA
"22065",10501,"Grand Falls-Windsor","NL",48.92696,-55.65966,2018-07-09 03:00:00,NA,0,NA
"22066",10501,"Grand Falls-Windsor","NL",48.92696,-55.65966,2018-07-09 04:00:00,NA,0,NA
"22067",10501,"Grand Falls-Windsor","NL",48.92696,-55.65966,2018-07-09 05:00:00,NA,0,NA
"22068",10501,"Grand Falls-Windsor","NL",48.92696,-55.65966,2018-07-09 06:00:00,NA,1,NA
"22069",10501,"Grand Falls-Windsor","NL",48.92696,-55.65966,2018-07-09 07:00:00,NA,1,NA
"22070",10501,"Grand Falls-Windsor","NL",48.92696,-55.65966,2018-07-09 08:00:00,NA,1,NA
"22071",10501,"Grand Falls-Windsor","NL",48.92696,-55.65966,2018-07-09 09:00:00,NA,0,NA
"22072",10501,"Grand Falls-Windsor","NL",48.92696,-55.65966,2018-07-09 10:00:00,NA,1,NA
"22073",10501,"Grand Falls-Windsor","NL",48.92696,-55.65966,2018-07-09 11:00:00,NA,1,NA
"22074",10501,"Grand Falls-Windsor","NL",48.92696,-55.65966,2018-07-09 12:00:00,NA,1,NA
"22075",10501,"Grand Falls-Windsor","NL",48.92696,-55.65966,2018-07-09 13:00:00,NA,1,NA
"22076",10501,"Grand Falls-Windsor","NL",48.92696,-55.65966,2018-07-09 14:00:00,NA,1,NA
"22077",10501,"Grand Falls-Windsor","NL",48.92696,-55.65966,2018-07-09 15:00:00,NA,1,NA
"22078",10501,"Grand Falls-Windsor","NL",48.92696,-55.65966,2018-07-09 16:00:00,NA,1,NA
"22079",10501,"Grand Falls-Windsor","NL",48.92696,-55.65966,2018-07-09 17:00:00,NA,1,NA
"22080",10501,"Grand Falls-Windsor","NL",48.92696,-55.65966,2018-07-09 18:00:00,NA,0,NA
"22081",10501,"Grand Falls-Windsor","NL",48.92696,-55.65966,2018-07-09 19:00:00,NA,0,NA
"22082",10501,"Grand Falls-Windsor","NL",48.92696,-55.65966,2018-07-09 20:00:00,NA,1,NA
"22083",10501,"Grand Falls-Windsor","NL",48.92696,-55.65966,2018-07-09 21:00:00,NA,1,NA
"22084",10501,"Grand Falls-Windsor","NL",48.92696,-55.65966,2018-07-09 22:00:00,NA,1,NA
"22085",10501,"Grand Falls-Windsor","NL",48.92696,-55.65966,2018-07-09 23:00:00,NA,1,NA
"22086",10501,"Grand Falls-Windsor","NL",48.92696,-55.65966,2018-07-10 00:00:00,NA,1,NA
"22087",10501,"Grand Falls-Windsor","NL",48.92696,-55.65966,2018-07-10 01:00:00,NA,1,NA
"22088",10501,"Grand Falls-Windsor","NL",48.92696,-55.65966,2018-07-10 02:00:00,NA,0,NA
"22089",10501,"Grand Falls-Windsor","NL",48.92696,-55.65966,2018-07-10 03:00:00,NA,1,NA
"22090",10501,"Grand Falls-Windsor","NL",48.92696,-55.65966,2018-07-10 04:00:00,NA,1,NA
"22091",10501,"Grand Falls-Windsor","NL",48.92696,-55.65966,2018-07-10 05:00:00,NA,1,NA
"22092",10501,"Grand Falls-Windsor","NL",48.92696,-55.65966,2018-07-10 06:00:00,NA,1,NA
"22093",10501,"Grand Falls-Windsor","NL",48.92696,-55.65966,2018-07-10 07:00:00,NA,1,NA
"22094",10501,"Grand Falls-Windsor","NL",48.92696,-55.65966,2018-07-10 08:00:00,NA,1,NA
"22095",10501,"Grand Falls-Windsor","NL",48.92696,-55.65966,2018-07-10 09:00:00,NA,1,NA
"22096",10501,"Grand Falls-Windsor","NL",48.92696,-55.65966,2018-07-10 10:00:00,NA,1,NA
"22097",10501,"Grand Falls-Windsor","NL",48.92696,-55.65966,2018-07-10 11:00:00,NA,1,NA
"22098",10501,"Grand Falls-Windsor","NL",48.92696,-55.65966,2018-07-10 12:00:00,NA,1,NA
"22099",10501,"Grand Falls-Windsor","NL",48.92696,-55.65966,2018-07-10 13:00:00,NA,1,NA
"22100",10501,"Grand Falls-Windsor","NL",48.92696,-55.65966,2018-07-10 14:00:00,NA,1,NA
"22101",10501,"Grand Falls-Windsor","NL",48.92696,-55.65966,2018-07-10 15:00:00,NA,1,NA
"22102",10501,"Grand Falls-Windsor","NL",48.92696,-55.65966,2018-07-10 16:00:00,NA,1,NA
"22103",10501,"Grand Falls-Windsor","NL",48.92696,-55.65966,2018-07-10 17:00:00,NA,1,NA
"22104",10501,"Grand Falls-Windsor","NL",48.92696,-55.65966,2018-07-10 18:00:00,NA,0,NA
"22105",10501,"Grand Falls-Windsor","NL",48.92696,-55.65966,2018-07-10 19:00:00,NA,1,NA
"22106",10501,"Grand Falls-Windsor","NL",48.92696,-55.65966,2018-07-10 20:00:00,NA,1,NA
"22107",10501,"Grand Falls-Windsor","NL",48.92696,-55.65966,2018-07-10 21:00:00,NA,1,NA
"22108",10501,"Grand Falls-Windsor","NL",48.92696,-55.65966,2018-07-10 22:00:00,NA,1,NA
"22109",10501,"Grand Falls-Windsor","NL",48.92696,-55.65966,2018-07-10 23:00:00,NA,1,NA
"22110",10501,"Grand Falls-Windsor","NL",48.92696,-55.65966,2018-07-11 00:00:00,NA,0,NA
"22111",10501,"Grand Falls-Windsor","NL",48.92696,-55.65966,2018-07-11 01:00:00,NA,1,NA
"22112",10501,"Grand Falls-Windsor","NL",48.92696,-55.65966,2018-07-11 02:00:00,NA,0,NA
"22113",10501,"Grand Falls-Windsor","NL",48.92696,-55.65966,2018-07-11 03:00:00,NA,1,NA
"22114",10501,"Grand Falls-Windsor","NL",48.92696,-55.65966,2018-07-11 04:00:00,NA,2,NA
"22115",10501,"Grand Falls-Windsor","NL",48.92696,-55.65966,2018-07-11 05:00:00,NA,1,NA
"22116",10501,"Grand Falls-Windsor","NL",48.92696,-55.65966,2018-07-11 06:00:00,NA,1,NA
"22117",10501,"Grand Falls-Windsor","NL",48.92696,-55.65966,2018-07-11 07:00:00,NA,1,NA
"22118",10501,"Grand Falls-Windsor","NL",48.92696,-55.65966,2018-07-11 08:00:00,NA,1,NA
"22119",10501,"Grand Falls-Windsor","NL",48.92696,-55.65966,2018-07-11 09:00:00,NA,1,NA
"22120",10501,"Grand Falls-Windsor","NL",48.92696,-55.65966,2018-07-11 10:00:00,NA,1,NA
"22121",10501,"Grand Falls-Windsor","NL",48.92696,-55.65966,2018-07-11 11:00:00,NA,1,NA
"22122",10501,"Grand Falls-Windsor","NL",48.92696,-55.65966,2018-07-11 12:00:00,NA,1,NA
"22123",10501,"Grand Falls-Windsor","NL",48.92696,-55.65966,2018-07-11 13:00:00,NA,1,NA
"22124",10501,"Grand Falls-Windsor","NL",48.92696,-55.65966,2018-07-11 14:00:00,NA,1,NA
"22125",10501,"Grand Falls-Windsor","NL",48.92696,-55.65966,2018-07-11 15:00:00,34,1,35
"22126",10501,"Grand Falls-Windsor","NL",48.92696,-55.65966,2018-07-11 16:00:00,33,1,34
"22127",10501,"Grand Falls-Windsor","NL",48.92696,-55.65966,2018-07-11 17:00:00,26,1,27
"22128",10501,"Grand Falls-Windsor","NL",48.92696,-55.65966,2018-07-11 18:00:00,24,1,25
"22129",10501,"Grand Falls-Windsor","NL",48.92696,-55.65966,2018-07-11 19:00:00,28,1,29
"22130",10501,"Grand Falls-Windsor","NL",48.92696,-55.65966,2018-07-11 20:00:00,27,1,28
"22131",10501,"Grand Falls-Windsor","NL",48.92696,-55.65966,2018-07-11 21:00:00,25,1,26
"22132",10501,"Grand Falls-Windsor","NL",48.92696,-55.65966,2018-07-11 22:00:00,25,1,26
"22133",10501,"Grand Falls-Windsor","NL",48.92696,-55.65966,2018-07-11 23:00:00,26,1,27
"22134",10501,"Grand Falls-Windsor","NL",48.92696,-55.65966,2018-07-12 00:00:00,27,1,28
"22135",10501,"Grand Falls-Windsor","NL",48.92696,-55.65966,2018-07-12 01:00:00,25,0,25
"22136",10501,"Grand Falls-Windsor","NL",48.92696,-55.65966,2018-07-12 02:00:00,23,1,24
"22137",10501,"Grand Falls-Windsor","NL",48.92696,-55.65966,2018-07-12 03:00:00,20,1,21
"22138",10501,"Grand Falls-Windsor","NL",48.92696,-55.65966,2018-07-12 04:00:00,14,1,15
"22139",10501,"Grand Falls-Windsor","NL",48.92696,-55.65966,2018-07-12 05:00:00,13,1,14
"22140",10501,"Grand Falls-Windsor","NL",48.92696,-55.65966,2018-07-12 06:00:00,13,1,14
"22141",10501,"Grand Falls-Windsor","NL",48.92696,-55.65966,2018-07-12 07:00:00,15,2,17
"22142",10501,"Grand Falls-Windsor","NL",48.92696,-55.65966,2018-07-12 08:00:00,14,1,15
"22143",10501,"Grand Falls-Windsor","NL",48.92696,-55.65966,2018-07-12 09:00:00,17,1,18
"22144",10501,"Grand Falls-Windsor","NL",48.92696,-55.65966,2018-07-12 10:00:00,18,2,20
"22145",10501,"Grand Falls-Windsor","NL",48.92696,-55.65966,2018-07-12 11:00:00,17,1,18
"22146",10501,"Grand Falls-Windsor","NL",48.92696,-55.65966,2018-07-12 12:00:00,18,1,19
"22147",10501,"Grand Falls-Windsor","NL",48.92696,-55.65966,2018-07-12 13:00:00,18,1,19
"22148",10501,"Grand Falls-Windsor","NL",48.92696,-55.65966,2018-07-12 14:00:00,19,1,20
"22149",10501,"Grand Falls-Windsor","NL",48.92696,-55.65966,2018-07-12 15:00:00,18,1,19
"22150",10501,"Grand Falls-Windsor","NL",48.92696,-55.65966,2018-07-12 16:00:00,18,1,19
"22151",10501,"Grand Falls-Windsor","NL",48.92696,-55.65966,2018-07-12 17:00:00,19,1,20
"22152",10501,"Grand Falls-Windsor","NL",48.92696,-55.65966,2018-07-12 18:00:00,19,1,20
"22153",10501,"Grand Falls-Windsor","NL",48.92696,-55.65966,2018-07-12 19:00:00,18,1,19
"22154",10501,"Grand Falls-Windsor","NL",48.92696,-55.65966,2018-07-12 20:00:00,18,1,19
"22155",10501,"Grand Falls-Windsor","NL",48.92696,-55.65966,2018-07-12 21:00:00,19,1,20
"22156",10501,"Grand Falls-Windsor","NL",48.92696,-55.65966,2018-07-12 22:00:00,19,1,20
"22157",10501,"Grand Falls-Windsor","NL",48.92696,-55.65966,2018-07-12 23:00:00,19,1,20
"22158",10501,"Grand Falls-Windsor","NL",48.92696,-55.65966,2018-07-13 00:00:00,19,1,20
"22159",10501,"Grand Falls-Windsor","NL",48.92696,-55.65966,2018-07-13 01:00:00,18,0,18
"22160",10501,"Grand Falls-Windsor","NL",48.92696,-55.65966,2018-07-13 02:00:00,18,0,18
"22161",10501,"Grand Falls-Windsor","NL",48.92696,-55.65966,2018-07-13 03:00:00,17,0,17
"22162",10501,"Grand Falls-Windsor","NL",48.92696,-55.65966,2018-07-13 04:00:00,15,0,15
"22163",10501,"Grand Falls-Windsor","NL",48.92696,-55.65966,2018-07-13 05:00:00,18,1,19
"22164",10501,"Grand Falls-Windsor","NL",48.92696,-55.65966,2018-07-13 06:00:00,13,2,15
"22165",10501,"Grand Falls-Windsor","NL",48.92696,-55.65966,2018-07-13 07:00:00,12,5,17
"22166",10501,"Grand Falls-Windsor","NL",48.92696,-55.65966,2018-07-13 08:00:00,14,1,15
"22167",10501,"Grand Falls-Windsor","NL",48.92696,-55.65966,2018-07-13 09:00:00,15,1,16
"22168",10501,"Grand Falls-Windsor","NL",48.92696,-55.65966,2018-07-13 10:00:00,15,1,16
"22169",10501,"Grand Falls-Windsor","NL",48.92696,-55.65966,2018-07-13 11:00:00,15,1,16
"22170",10501,"Grand Falls-Windsor","NL",48.92696,-55.65966,2018-07-13 12:00:00,15,1,16
"22171",10501,"Grand Falls-Windsor","NL",48.92696,-55.65966,2018-07-13 13:00:00,15,1,16
"22172",10501,"Grand Falls-Windsor","NL",48.92696,-55.65966,2018-07-13 14:00:00,16,1,17
"22173",10501,"Grand Falls-Windsor","NL",48.92696,-55.65966,2018-07-13 15:00:00,16,1,17
"22174",10501,"Grand Falls-Windsor","NL",48.92696,-55.65966,2018-07-13 16:00:00,15,2,17
"22175",10501,"Grand Falls-Windsor","NL",48.92696,-55.65966,2018-07-13 17:00:00,14,0,14
"22176",10501,"Grand Falls-Windsor","NL",48.92696,-55.65966,2018-07-13 18:00:00,14,1,15
"22177",10501,"Grand Falls-Windsor","NL",48.92696,-55.65966,2018-07-13 19:00:00,14,0,14
"22178",10501,"Grand Falls-Windsor","NL",48.92696,-55.65966,2018-07-13 20:00:00,17,0,17
"22179",10501,"Grand Falls-Windsor","NL",48.92696,-55.65966,2018-07-13 21:00:00,17,1,18
"22180",10501,"Grand Falls-Windsor","NL",48.92696,-55.65966,2018-07-13 22:00:00,15,0,15
"22181",10501,"Grand Falls-Windsor","NL",48.92696,-55.65966,2018-07-13 23:00:00,13,0,13
"22182",10501,"Grand Falls-Windsor","NL",48.92696,-55.65966,2018-07-14 00:00:00,12,1,13
"22183",10501,"Grand Falls-Windsor","NL",48.92696,-55.65966,2018-07-14 01:00:00,11,0,11
"22184",10501,"Grand Falls-Windsor","NL",48.92696,-55.65966,2018-07-14 02:00:00,10,0,10
"22185",10501,"Grand Falls-Windsor","NL",48.92696,-55.65966,2018-07-14 03:00:00,8,1,9
"22186",10501,"Grand Falls-Windsor","NL",48.92696,-55.65966,2018-07-14 04:00:00,7,0,7
"22187",10501,"Grand Falls-Windsor","NL",48.92696,-55.65966,2018-07-14 05:00:00,6,0,6
"22188",10501,"Grand Falls-Windsor","NL",48.92696,-55.65966,2018-07-14 06:00:00,7,0,7
"22189",10501,"Grand Falls-Windsor","NL",48.92696,-55.65966,2018-07-14 07:00:00,8,0,8
"22190",10501,"Grand Falls-Windsor","NL",48.92696,-55.65966,2018-07-14 08:00:00,9,0,9
"22191",10501,"Grand Falls-Windsor","NL",48.92696,-55.65966,2018-07-14 09:00:00,12,1,13
"22192",10501,"Grand Falls-Windsor","NL",48.92696,-55.65966,2018-07-14 10:00:00,18,1,19
"22193",10501,"Grand Falls-Windsor","NL",48.92696,-55.65966,2018-07-14 11:00:00,19,0,19
"22194",10501,"Grand Falls-Windsor","NL",48.92696,-55.65966,2018-07-14 12:00:00,20,1,21
"22195",10501,"Grand Falls-Windsor","NL",48.92696,-55.65966,2018-07-14 13:00:00,22,0,22
"22196",10501,"Grand Falls-Windsor","NL",48.92696,-55.65966,2018-07-14 14:00:00,23,0,23
"22197",10501,"Grand Falls-Windsor","NL",48.92696,-55.65966,2018-07-14 15:00:00,23,0,23
"22198",10501,"Grand Falls-Windsor","NL",48.92696,-55.65966,2018-07-14 16:00:00,22,0,22
"22199",10501,"Grand Falls-Windsor","NL",48.92696,-55.65966,2018-07-14 17:00:00,23,0,23
"22200",10501,"Grand Falls-Windsor","NL",48.92696,-55.65966,2018-07-14 18:00:00,24,0,24
"22201",10501,"Grand Falls-Windsor","NL",48.92696,-55.65966,2018-07-14 19:00:00,25,0,25
"22202",10501,"Grand Falls-Windsor","NL",48.92696,-55.65966,2018-07-14 20:00:00,21,0,21
"22203",10501,"Grand Falls-Windsor","NL",48.92696,-55.65966,2018-07-14 21:00:00,18,0,18
"22204",10501,"Grand Falls-Windsor","NL",48.92696,-55.65966,2018-07-14 22:00:00,17,0,17
"22205",10501,"Grand Falls-Windsor","NL",48.92696,-55.65966,2018-07-14 23:00:00,15,1,16
"22206",10501,"Grand Falls-Windsor","NL",48.92696,-55.65966,2018-07-15 00:00:00,14,0,14
"22207",10501,"Grand Falls-Windsor","NL",48.92696,-55.65966,2018-07-15 01:00:00,14,0,14
"22208",10501,"Grand Falls-Windsor","NL",48.92696,-55.65966,2018-07-15 02:00:00,15,0,15
"22209",10501,"Grand Falls-Windsor","NL",48.92696,-55.65966,2018-07-15 03:00:00,15,0,15
"22210",10501,"Grand Falls-Windsor","NL",48.92696,-55.65966,2018-07-15 04:00:00,15,0,15
"22211",10501,"Grand Falls-Windsor","NL",48.92696,-55.65966,2018-07-15 05:00:00,15,1,16
"22212",10501,"Grand Falls-Windsor","NL",48.92696,-55.65966,2018-07-15 06:00:00,15,0,15
"22213",10501,"Grand Falls-Windsor","NL",48.92696,-55.65966,2018-07-15 07:00:00,15,0,15
"22214",10501,"Grand Falls-Windsor","NL",48.92696,-55.65966,2018-07-15 08:00:00,14,1,15
"22215",10501,"Grand Falls-Windsor","NL",48.92696,-55.65966,2018-07-15 09:00:00,12,1,13
"22216",10501,"Grand Falls-Windsor","NL",48.92696,-55.65966,2018-07-15 10:00:00,11,0,11
"22217",10501,"Grand Falls-Windsor","NL",48.92696,-55.65966,2018-07-15 11:00:00,12,0,12
"22218",10501,"Grand Falls-Windsor","NL",48.92696,-55.65966,2018-07-15 12:00:00,11,1,12
"22219",10501,"Grand Falls-Windsor","NL",48.92696,-55.65966,2018-07-15 13:00:00,12,1,13
"22220",10501,"Grand Falls-Windsor","NL",48.92696,-55.65966,2018-07-15 14:00:00,12,1,13
"22221",10501,"Grand Falls-Windsor","NL",48.92696,-55.65966,2018-07-15 15:00:00,12,0,12
"22222",10501,"Grand Falls-Windsor","NL",48.92696,-55.65966,2018-07-15 16:00:00,15,0,15
"22223",10501,"Grand Falls-Windsor","NL",48.92696,-55.65966,2018-07-15 17:00:00,18,0,18
"22224",10501,"Grand Falls-Windsor","NL",48.92696,-55.65966,2018-07-15 18:00:00,18,1,19
"22225",10501,"Grand Falls-Windsor","NL",48.92696,-55.65966,2018-07-15 19:00:00,20,1,21
"22226",10501,"Grand Falls-Windsor","NL",48.92696,-55.65966,2018-07-15 20:00:00,21,2,23
"22227",10501,"Grand Falls-Windsor","NL",48.92696,-55.65966,2018-07-15 21:00:00,20,0,20
"22228",10501,"Grand Falls-Windsor","NL",48.92696,-55.65966,2018-07-15 22:00:00,21,1,22
"22229",10501,"Grand Falls-Windsor","NL",48.92696,-55.65966,2018-07-15 23:00:00,19,0,19
"22230",10501,"Grand Falls-Windsor","NL",48.92696,-55.65966,2018-07-16 00:00:00,18,0,18
"22231",10501,"Grand Falls-Windsor","NL",48.92696,-55.65966,2018-07-16 01:00:00,16,0,16
"22232",10501,"Grand Falls-Windsor","NL",48.92696,-55.65966,2018-07-16 02:00:00,14,0,14
"22233",10501,"Grand Falls-Windsor","NL",48.92696,-55.65966,2018-07-16 03:00:00,13,1,14
"22234",10501,"Grand Falls-Windsor","NL",48.92696,-55.65966,2018-07-16 04:00:00,11,0,11
"22235",10501,"Grand Falls-Windsor","NL",48.92696,-55.65966,2018-07-16 05:00:00,12,1,13
"22236",10501,"Grand Falls-Windsor","NL",48.92696,-55.65966,2018-07-16 06:00:00,11,1,12
"22237",10501,"Grand Falls-Windsor","NL",48.92696,-55.65966,2018-07-16 07:00:00,13,0,13
"22238",10501,"Grand Falls-Windsor","NL",48.92696,-55.65966,2018-07-16 08:00:00,14,0,14
"22239",10501,"Grand Falls-Windsor","NL",48.92696,-55.65966,2018-07-16 09:00:00,14,1,15
"22240",10501,"Grand Falls-Windsor","NL",48.92696,-55.65966,2018-07-16 10:00:00,15,1,16
"22241",10501,"Grand Falls-Windsor","NL",48.92696,-55.65966,2018-07-16 11:00:00,18,1,19
"22242",10501,"Grand Falls-Windsor","NL",48.92696,-55.65966,2018-07-16 12:00:00,21,0,21
"22243",10501,"Grand Falls-Windsor","NL",48.92696,-55.65966,2018-07-16 13:00:00,18,1,19
"22244",10501,"Grand Falls-Windsor","NL",48.92696,-55.65966,2018-07-16 14:00:00,18,0,18
"22245",10501,"Grand Falls-Windsor","NL",48.92696,-55.65966,2018-07-16 15:00:00,23,1,24
"22246",10501,"Grand Falls-Windsor","NL",48.92696,-55.65966,2018-07-16 16:00:00,23,1,24
"22247",10501,"Grand Falls-Windsor","NL",48.92696,-55.65966,2018-07-16 17:00:00,24,0,24
"22248",10501,"Grand Falls-Windsor","NL",48.92696,-55.65966,2018-07-16 18:00:00,25,1,26
"22249",10501,"Grand Falls-Windsor","NL",48.92696,-55.65966,2018-07-16 19:00:00,24,1,25
"22250",10501,"Grand Falls-Windsor","NL",48.92696,-55.65966,2018-07-16 20:00:00,22,1,23
"22251",10501,"Grand Falls-Windsor","NL",48.92696,-55.65966,2018-07-16 21:00:00,21,1,22
"22252",10501,"Grand Falls-Windsor","NL",48.92696,-55.65966,2018-07-16 22:00:00,19,1,20
"22253",10501,"Grand Falls-Windsor","NL",48.92696,-55.65966,2018-07-16 23:00:00,19,0,19
"22254",10501,"Grand Falls-Windsor","NL",48.92696,-55.65966,2018-07-17 00:00:00,19,0,19
"22255",10501,"Grand Falls-Windsor","NL",48.92696,-55.65966,2018-07-17 01:00:00,19,0,19
"22256",10501,"Grand Falls-Windsor","NL",48.92696,-55.65966,2018-07-17 02:00:00,16,0,16
"22257",10501,"Grand Falls-Windsor","NL",48.92696,-55.65966,2018-07-17 03:00:00,15,0,15
"22258",10501,"Grand Falls-Windsor","NL",48.92696,-55.65966,2018-07-17 04:00:00,14,0,14
"22259",10501,"Grand Falls-Windsor","NL",48.92696,-55.65966,2018-07-17 05:00:00,14,1,15
"22260",10501,"Grand Falls-Windsor","NL",48.92696,-55.65966,2018-07-17 06:00:00,12,1,13
"22261",10501,"Grand Falls-Windsor","NL",48.92696,-55.65966,2018-07-17 07:00:00,13,1,14
"22262",10501,"Grand Falls-Windsor","NL",48.92696,-55.65966,2018-07-17 08:00:00,15,1,16
"22263",10501,"Grand Falls-Windsor","NL",48.92696,-55.65966,2018-07-17 09:00:00,18,1,19
"22264",10501,"Grand Falls-Windsor","NL",48.92696,-55.65966,2018-07-17 10:00:00,18,0,18
"22265",10501,"Grand Falls-Windsor","NL",48.92696,-55.65966,2018-07-17 11:00:00,12,1,13
"22266",10501,"Grand Falls-Windsor","NL",48.92696,-55.65966,2018-07-17 12:00:00,17,1,18
"22267",10501,"Grand Falls-Windsor","NL",48.92696,-55.65966,2018-07-17 13:00:00,19,1,20
"22268",10501,"Grand Falls-Windsor","NL",48.92696,-55.65966,2018-07-17 14:00:00,23,1,24
"22269",10501,"Grand Falls-Windsor","NL",48.92696,-55.65966,2018-07-17 15:00:00,23,1,24
"22270",10501,"Grand Falls-Windsor","NL",48.92696,-55.65966,2018-07-17 16:00:00,23,1,24
"22271",10501,"Grand Falls-Windsor","NL",48.92696,-55.65966,2018-07-17 17:00:00,23,1,24
"22272",10501,"Grand Falls-Windsor","NL",48.92696,-55.65966,2018-07-17 18:00:00,22,1,23
"22273",10501,"Grand Falls-Windsor","NL",48.92696,-55.65966,2018-07-17 19:00:00,20,1,21
"22274",10501,"Grand Falls-Windsor","NL",48.92696,-55.65966,2018-07-17 20:00:00,22,1,23
"22275",10501,"Grand Falls-Windsor","NL",48.92696,-55.65966,2018-07-17 21:00:00,21,0,21
"22276",10501,"Grand Falls-Windsor","NL",48.92696,-55.65966,2018-07-17 22:00:00,19,0,19
"22277",10501,"Grand Falls-Windsor","NL",48.92696,-55.65966,2018-07-17 23:00:00,18,0,18
"22278",10501,"Grand Falls-Windsor","NL",48.92696,-55.65966,2018-07-18 00:00:00,18,1,19
"22279",10501,"Grand Falls-Windsor","NL",48.92696,-55.65966,2018-07-18 01:00:00,17,0,17
"22280",10501,"Grand Falls-Windsor","NL",48.92696,-55.65966,2018-07-18 02:00:00,17,0,17
"22281",10501,"Grand Falls-Windsor","NL",48.92696,-55.65966,2018-07-18 03:00:00,15,1,16
"22282",10501,"Grand Falls-Windsor","NL",48.92696,-55.65966,2018-07-18 04:00:00,17,1,18
"22283",10501,"Grand Falls-Windsor","NL",48.92696,-55.65966,2018-07-18 05:00:00,20,1,21
"22284",10501,"Grand Falls-Windsor","NL",48.92696,-55.65966,2018-07-18 06:00:00,25,0,25
"22285",10501,"Grand Falls-Windsor","NL",48.92696,-55.65966,2018-07-18 07:00:00,25,1,26
"22286",10501,"Grand Falls-Windsor","NL",48.92696,-55.65966,2018-07-18 08:00:00,26,1,27
"22287",10501,"Grand Falls-Windsor","NL",48.92696,-55.65966,2018-07-18 09:00:00,27,1,28
"22288",10501,"Grand Falls-Windsor","NL",48.92696,-55.65966,2018-07-18 10:00:00,23,0,23
"22289",10501,"Grand Falls-Windsor","NL",48.92696,-55.65966,2018-07-18 11:00:00,21,1,22
"22290",10501,"Grand Falls-Windsor","NL",48.92696,-55.65966,2018-07-18 12:00:00,19,1,20
"22291",10501,"Grand Falls-Windsor","NL",48.92696,-55.65966,2018-07-18 13:00:00,18,0,18
"22292",10501,"Grand Falls-Windsor","NL",48.92696,-55.65966,2018-07-18 14:00:00,17,1,18
"22293",10501,"Grand Falls-Windsor","NL",48.92696,-55.65966,2018-07-18 15:00:00,17,0,17
"22294",10501,"Grand Falls-Windsor","NL",48.92696,-55.65966,2018-07-18 16:00:00,19,0,19
"22295",10501,"Grand Falls-Windsor","NL",48.92696,-55.65966,2018-07-18 17:00:00,20,1,21
"22296",10501,"Grand Falls-Windsor","NL",48.92696,-55.65966,2018-07-18 18:00:00,21,1,22
"22297",10501,"Grand Falls-Windsor","NL",48.92696,-55.65966,2018-07-18 19:00:00,22,1,23
"22298",10501,"Grand Falls-Windsor","NL",48.92696,-55.65966,2018-07-18 20:00:00,19,1,20
"22299",10501,"Grand Falls-Windsor","NL",48.92696,-55.65966,2018-07-18 21:00:00,17,0,17
"22300",10501,"Grand Falls-Windsor","NL",48.92696,-55.65966,2018-07-18 22:00:00,19,1,20
"22301",10501,"Grand Falls-Windsor","NL",48.92696,-55.65966,2018-07-18 23:00:00,19,0,19
"22302",10501,"Grand Falls-Windsor","NL",48.92696,-55.65966,2018-07-19 00:00:00,18,0,18
"22303",10501,"Grand Falls-Windsor","NL",48.92696,-55.65966,2018-07-19 01:00:00,17,1,18
"22304",10501,"Grand Falls-Windsor","NL",48.92696,-55.65966,2018-07-19 02:00:00,10,1,11
"22305",10501,"Grand Falls-Windsor","NL",48.92696,-55.65966,2018-07-19 03:00:00,12,1,13
"22306",10501,"Grand Falls-Windsor","NL",48.92696,-55.65966,2018-07-19 04:00:00,12,0,12
"22307",10501,"Grand Falls-Windsor","NL",48.92696,-55.65966,2018-07-19 05:00:00,13,1,14
"22308",10501,"Grand Falls-Windsor","NL",48.92696,-55.65966,2018-07-19 06:00:00,14,1,15
"22309",10501,"Grand Falls-Windsor","NL",48.92696,-55.65966,2018-07-19 07:00:00,13,1,14
"22310",10501,"Grand Falls-Windsor","NL",48.92696,-55.65966,2018-07-19 08:00:00,12,1,13
"22311",10501,"Grand Falls-Windsor","NL",48.92696,-55.65966,2018-07-19 09:00:00,13,1,14
"22312",10501,"Grand Falls-Windsor","NL",48.92696,-55.65966,2018-07-19 10:00:00,14,1,15
"22313",10501,"Grand Falls-Windsor","NL",48.92696,-55.65966,2018-07-19 11:00:00,14,1,15
"22314",10501,"Grand Falls-Windsor","NL",48.92696,-55.65966,2018-07-19 12:00:00,12,1,13
"22315",10501,"Grand Falls-Windsor","NL",48.92696,-55.65966,2018-07-19 13:00:00,14,0,14
"22316",10501,"Grand Falls-Windsor","NL",48.92696,-55.65966,2018-07-19 14:00:00,15,1,16
"22317",10501,"Grand Falls-Windsor","NL",48.92696,-55.65966,2018-07-19 15:00:00,14,1,15
"22318",10501,"Grand Falls-Windsor","NL",48.92696,-55.65966,2018-07-19 16:00:00,15,1,16
"22319",10501,"Grand Falls-Windsor","NL",48.92696,-55.65966,2018-07-19 17:00:00,15,0,15
"22320",10501,"Grand Falls-Windsor","NL",48.92696,-55.65966,2018-07-19 18:00:00,15,1,16
"22321",10501,"Grand Falls-Windsor","NL",48.92696,-55.65966,2018-07-19 19:00:00,15,1,16
"22322",10501,"Grand Falls-Windsor","NL",48.92696,-55.65966,2018-07-19 20:00:00,13,1,14
"22323",10501,"Grand Falls-Windsor","NL",48.92696,-55.65966,2018-07-19 21:00:00,13,1,14
"22324",10501,"Grand Falls-Windsor","NL",48.92696,-55.65966,2018-07-19 22:00:00,12,1,13
"22325",10501,"Grand Falls-Windsor","NL",48.92696,-55.65966,2018-07-19 23:00:00,11,1,12
"22326",10501,"Grand Falls-Windsor","NL",48.92696,-55.65966,2018-07-20 00:00:00,9,1,10
"22327",10501,"Grand Falls-Windsor","NL",48.92696,-55.65966,2018-07-20 01:00:00,9,1,10
"22328",10501,"Grand Falls-Windsor","NL",48.92696,-55.65966,2018-07-20 02:00:00,9,1,10
"22329",10501,"Grand Falls-Windsor","NL",48.92696,-55.65966,2018-07-20 03:00:00,8,0,8
"22330",10501,"Grand Falls-Windsor","NL",48.92696,-55.65966,2018-07-20 04:00:00,7,2,9
"22331",10501,"Grand Falls-Windsor","NL",48.92696,-55.65966,2018-07-20 05:00:00,6,1,7
"22332",10501,"Grand Falls-Windsor","NL",48.92696,-55.65966,2018-07-20 06:00:00,5,0,5
"22333",10501,"Grand Falls-Windsor","NL",48.92696,-55.65966,2018-07-20 07:00:00,5,0,5
"22334",10501,"Grand Falls-Windsor","NL",48.92696,-55.65966,2018-07-20 08:00:00,7,1,8
"22335",10501,"Grand Falls-Windsor","NL",48.92696,-55.65966,2018-07-20 09:00:00,12,1,13
"22336",10501,"Grand Falls-Windsor","NL",48.92696,-55.65966,2018-07-20 10:00:00,15,1,16
"22337",10501,"Grand Falls-Windsor","NL",48.92696,-55.65966,2018-07-20 11:00:00,17,1,18
"22338",10501,"Grand Falls-Windsor","NL",48.92696,-55.65966,2018-07-20 12:00:00,19,1,20
"22339",10501,"Grand Falls-Windsor","NL",48.92696,-55.65966,2018-07-20 13:00:00,20,1,21
"22340",10501,"Grand Falls-Windsor","NL",48.92696,-55.65966,2018-07-20 14:00:00,21,1,22
"22341",10501,"Grand Falls-Windsor","NL",48.92696,-55.65966,2018-07-20 15:00:00,22,1,23
"22342",10501,"Grand Falls-Windsor","NL",48.92696,-55.65966,2018-07-20 16:00:00,22,1,23
"22343",10501,"Grand Falls-Windsor","NL",48.92696,-55.65966,2018-07-20 17:00:00,22,2,24
"22344",10501,"Grand Falls-Windsor","NL",48.92696,-55.65966,2018-07-20 18:00:00,22,1,23
"22345",10501,"Grand Falls-Windsor","NL",48.92696,-55.65966,2018-07-20 19:00:00,22,1,23
"22346",10501,"Grand Falls-Windsor","NL",48.92696,-55.65966,2018-07-20 20:00:00,22,1,23
"22347",10501,"Grand Falls-Windsor","NL",48.92696,-55.65966,2018-07-20 21:00:00,17,1,18
"22348",10501,"Grand Falls-Windsor","NL",48.92696,-55.65966,2018-07-20 22:00:00,16,1,17
"22349",10501,"Grand Falls-Windsor","NL",48.92696,-55.65966,2018-07-20 23:00:00,17,1,18
"22350",10501,"Grand Falls-Windsor","NL",48.92696,-55.65966,2018-07-21 00:00:00,18,1,19
"22351",10501,"Grand Falls-Windsor","NL",48.92696,-55.65966,2018-07-21 01:00:00,15,1,16
"22352",10501,"Grand Falls-Windsor","NL",48.92696,-55.65966,2018-07-21 02:00:00,18,0,18
"22353",10501,"Grand Falls-Windsor","NL",48.92696,-55.65966,2018-07-21 03:00:00,19,1,20
"22354",10501,"Grand Falls-Windsor","NL",48.92696,-55.65966,2018-07-21 04:00:00,17,1,18
"22355",10501,"Grand Falls-Windsor","NL",48.92696,-55.65966,2018-07-21 05:00:00,15,1,16
"22356",10501,"Grand Falls-Windsor","NL",48.92696,-55.65966,2018-07-21 06:00:00,13,1,14
"22357",10501,"Grand Falls-Windsor","NL",48.92696,-55.65966,2018-07-21 07:00:00,12,0,12
"22358",10501,"Grand Falls-Windsor","NL",48.92696,-55.65966,2018-07-21 08:00:00,12,1,13
"22359",10501,"Grand Falls-Windsor","NL",48.92696,-55.65966,2018-07-21 09:00:00,15,1,16
"22360",10501,"Grand Falls-Windsor","NL",48.92696,-55.65966,2018-07-21 10:00:00,18,1,19
"22361",10501,"Grand Falls-Windsor","NL",48.92696,-55.65966,2018-07-21 11:00:00,20,1,21
"22362",10501,"Grand Falls-Windsor","NL",48.92696,-55.65966,2018-07-21 12:00:00,21,1,22
"22363",10501,"Grand Falls-Windsor","NL",48.92696,-55.65966,2018-07-21 13:00:00,22,1,23
"22364",10501,"Grand Falls-Windsor","NL",48.92696,-55.65966,2018-07-21 14:00:00,22,1,23
"22365",10501,"Grand Falls-Windsor","NL",48.92696,-55.65966,2018-07-21 15:00:00,22,1,23
"22366",10501,"Grand Falls-Windsor","NL",48.92696,-55.65966,2018-07-21 16:00:00,20,1,21
"22367",10501,"Grand Falls-Windsor","NL",48.92696,-55.65966,2018-07-21 17:00:00,21,1,22
"22368",10501,"Grand Falls-Windsor","NL",48.92696,-55.65966,2018-07-21 18:00:00,21,0,21
"22369",10501,"Grand Falls-Windsor","NL",48.92696,-55.65966,2018-07-21 19:00:00,22,1,23
"22370",10501,"Grand Falls-Windsor","NL",48.92696,-55.65966,2018-07-21 20:00:00,21,1,22
"22371",10501,"Grand Falls-Windsor","NL",48.92696,-55.65966,2018-07-21 21:00:00,19,1,20
"22372",10501,"Grand Falls-Windsor","NL",48.92696,-55.65966,2018-07-21 22:00:00,22,1,23
"22373",10501,"Grand Falls-Windsor","NL",48.92696,-55.65966,2018-07-21 23:00:00,22,1,23
"22374",10501,"Grand Falls-Windsor","NL",48.92696,-55.65966,2018-07-22 00:00:00,23,1,24
"22375",10501,"Grand Falls-Windsor","NL",48.92696,-55.65966,2018-07-22 01:00:00,24,0,24
"22376",10501,"Grand Falls-Windsor","NL",48.92696,-55.65966,2018-07-22 02:00:00,24,1,25
"22377",10501,"Grand Falls-Windsor","NL",48.92696,-55.65966,2018-07-22 03:00:00,26,1,27
"22378",10501,"Grand Falls-Windsor","NL",48.92696,-55.65966,2018-07-22 04:00:00,21,0,21
"22379",10501,"Grand Falls-Windsor","NL",48.92696,-55.65966,2018-07-22 05:00:00,16,0,16
"22380",10501,"Grand Falls-Windsor","NL",48.92696,-55.65966,2018-07-22 06:00:00,13,0,13
"22381",10501,"Grand Falls-Windsor","NL",48.92696,-55.65966,2018-07-22 07:00:00,10,1,11
"22382",10501,"Grand Falls-Windsor","NL",48.92696,-55.65966,2018-07-22 08:00:00,13,0,13
"22383",10501,"Grand Falls-Windsor","NL",48.92696,-55.65966,2018-07-22 09:00:00,15,0,15
"22384",10501,"Grand Falls-Windsor","NL",48.92696,-55.65966,2018-07-22 10:00:00,14,0,14
"22385",10501,"Grand Falls-Windsor","NL",48.92696,-55.65966,2018-07-22 11:00:00,14,1,15
"22386",10501,"Grand Falls-Windsor","NL",48.92696,-55.65966,2018-07-22 12:00:00,16,0,16
"22387",10501,"Grand Falls-Windsor","NL",48.92696,-55.65966,2018-07-22 13:00:00,16,0,16
"22388",10501,"Grand Falls-Windsor","NL",48.92696,-55.65966,2018-07-22 14:00:00,18,1,19
"22389",10501,"Grand Falls-Windsor","NL",48.92696,-55.65966,2018-07-22 15:00:00,20,0,20
"22390",10501,"Grand Falls-Windsor","NL",48.92696,-55.65966,2018-07-22 16:00:00,18,0,18
"22391",10501,"Grand Falls-Windsor","NL",48.92696,-55.65966,2018-07-22 17:00:00,19,0,19
"22392",10501,"Grand Falls-Windsor","NL",48.92696,-55.65966,2018-07-22 18:00:00,18,1,19
"22393",10501,"Grand Falls-Windsor","NL",48.92696,-55.65966,2018-07-22 19:00:00,17,1,18
"22394",10501,"Grand Falls-Windsor","NL",48.92696,-55.65966,2018-07-22 20:00:00,16,1,17
"22395",10501,"Grand Falls-Windsor","NL",48.92696,-55.65966,2018-07-22 21:00:00,12,1,13
"22396",10501,"Grand Falls-Windsor","NL",48.92696,-55.65966,2018-07-22 22:00:00,11,1,12
"22397",10501,"Grand Falls-Windsor","NL",48.92696,-55.65966,2018-07-22 23:00:00,9,0,9
"22398",10501,"Grand Falls-Windsor","NL",48.92696,-55.65966,2018-07-23 00:00:00,8,1,9
"22399",10501,"Grand Falls-Windsor","NL",48.92696,-55.65966,2018-07-23 01:00:00,6,1,7
"22400",10501,"Grand Falls-Windsor","NL",48.92696,-55.65966,2018-07-23 02:00:00,4,0,4
"22401",10501,"Grand Falls-Windsor","NL",48.92696,-55.65966,2018-07-23 03:00:00,6,0,6
"22402",10501,"Grand Falls-Windsor","NL",48.92696,-55.65966,2018-07-23 04:00:00,7,0,7
"22403",10501,"Grand Falls-Windsor","NL",48.92696,-55.65966,2018-07-23 05:00:00,7,1,8
"22404",10501,"Grand Falls-Windsor","NL",48.92696,-55.65966,2018-07-23 06:00:00,7,2,9
"22405",10501,"Grand Falls-Windsor","NL",48.92696,-55.65966,2018-07-23 07:00:00,9,1,10
"22406",10501,"Grand Falls-Windsor","NL",48.92696,-55.65966,2018-07-23 08:00:00,11,1,12
"22407",10501,"Grand Falls-Windsor","NL",48.92696,-55.65966,2018-07-23 09:00:00,10,1,11
"22408",10501,"Grand Falls-Windsor","NL",48.92696,-55.65966,2018-07-23 10:00:00,8,1,9
"22409",10501,"Grand Falls-Windsor","NL",48.92696,-55.65966,2018-07-23 11:00:00,10,0,10
"22410",10501,"Grand Falls-Windsor","NL",48.92696,-55.65966,2018-07-23 12:00:00,14,0,14
"22411",10501,"Grand Falls-Windsor","NL",48.92696,-55.65966,2018-07-23 13:00:00,11,1,12
"22412",10501,"Grand Falls-Windsor","NL",48.92696,-55.65966,2018-07-23 14:00:00,8,1,9
"22413",10501,"Grand Falls-Windsor","NL",48.92696,-55.65966,2018-07-23 15:00:00,12,1,13
"22414",10501,"Grand Falls-Windsor","NL",48.92696,-55.65966,2018-07-23 16:00:00,11,1,12
"22415",10501,"Grand Falls-Windsor","NL",48.92696,-55.65966,2018-07-23 17:00:00,11,1,12
"22416",10501,"Grand Falls-Windsor","NL",48.92696,-55.65966,2018-07-23 18:00:00,10,1,11
"22417",10501,"Grand Falls-Windsor","NL",48.92696,-55.65966,2018-07-23 19:00:00,10,1,11
"22418",10501,"Grand Falls-Windsor","NL",48.92696,-55.65966,2018-07-23 20:00:00,9,1,10
"22419",10501,"Grand Falls-Windsor","NL",48.92696,-55.65966,2018-07-23 21:00:00,11,1,12
"22420",10501,"Grand Falls-Windsor","NL",48.92696,-55.65966,2018-07-23 22:00:00,12,1,13
"22421",10501,"Grand Falls-Windsor","NL",48.92696,-55.65966,2018-07-23 23:00:00,5,1,6
"22422",10501,"Grand Falls-Windsor","NL",48.92696,-55.65966,2018-07-24 00:00:00,10,1,11
"22423",10501,"Grand Falls-Windsor","NL",48.92696,-55.65966,2018-07-24 01:00:00,12,1,13
"22424",10501,"Grand Falls-Windsor","NL",48.92696,-55.65966,2018-07-24 02:00:00,13,0,13
"22425",10501,"Grand Falls-Windsor","NL",48.92696,-55.65966,2018-07-24 03:00:00,13,1,14
"22426",10501,"Grand Falls-Windsor","NL",48.92696,-55.65966,2018-07-24 04:00:00,12,1,13
"22427",10501,"Grand Falls-Windsor","NL",48.92696,-55.65966,2018-07-24 05:00:00,12,1,13
"22428",10501,"Grand Falls-Windsor","NL",48.92696,-55.65966,2018-07-24 06:00:00,11,1,12
"22429",10501,"Grand Falls-Windsor","NL",48.92696,-55.65966,2018-07-24 07:00:00,9,0,9
"22430",10501,"Grand Falls-Windsor","NL",48.92696,-55.65966,2018-07-24 08:00:00,10,1,11
"22431",10501,"Grand Falls-Windsor","NL",48.92696,-55.65966,2018-07-24 09:00:00,10,1,11
"22432",10501,"Grand Falls-Windsor","NL",48.92696,-55.65966,2018-07-24 10:00:00,10,1,11
"22433",10501,"Grand Falls-Windsor","NL",48.92696,-55.65966,2018-07-24 11:00:00,10,1,11
"22434",10501,"Grand Falls-Windsor","NL",48.92696,-55.65966,2018-07-24 12:00:00,10,1,11
"22435",10501,"Grand Falls-Windsor","NL",48.92696,-55.65966,2018-07-24 13:00:00,10,1,11
"22436",10501,"Grand Falls-Windsor","NL",48.92696,-55.65966,2018-07-24 14:00:00,8,1,9
"22437",10501,"Grand Falls-Windsor","NL",48.92696,-55.65966,2018-07-24 15:00:00,6,1,7
"22438",10501,"Grand Falls-Windsor","NL",48.92696,-55.65966,2018-07-24 16:00:00,8,1,9
"22439",10501,"Grand Falls-Windsor","NL",48.92696,-55.65966,2018-07-24 17:00:00,8,1,9
"22440",10501,"Grand Falls-Windsor","NL",48.92696,-55.65966,2018-07-24 18:00:00,8,1,9
"22441",10501,"Grand Falls-Windsor","NL",48.92696,-55.65966,2018-07-24 19:00:00,6,1,7
"22442",10501,"Grand Falls-Windsor","NL",48.92696,-55.65966,2018-07-24 20:00:00,5,0,5
"22443",10501,"Grand Falls-Windsor","NL",48.92696,-55.65966,2018-07-24 21:00:00,4,1,5
"22444",10501,"Grand Falls-Windsor","NL",48.92696,-55.65966,2018-07-24 22:00:00,6,0,6
"22445",10501,"Grand Falls-Windsor","NL",48.92696,-55.65966,2018-07-24 23:00:00,6,1,7
"22446",10501,"Grand Falls-Windsor","NL",48.92696,-55.65966,2018-07-25 00:00:00,7,1,8
"22447",10501,"Grand Falls-Windsor","NL",48.92696,-55.65966,2018-07-25 01:00:00,7,0,7
"22448",10501,"Grand Falls-Windsor","NL",48.92696,-55.65966,2018-07-25 02:00:00,5,1,6
"22449",10501,"Grand Falls-Windsor","NL",48.92696,-55.65966,2018-07-25 03:00:00,7,1,8
"22450",10501,"Grand Falls-Windsor","NL",48.92696,-55.65966,2018-07-25 04:00:00,7,0,7
"22451",10501,"Grand Falls-Windsor","NL",48.92696,-55.65966,2018-07-25 05:00:00,8,0,8
"22452",10501,"Grand Falls-Windsor","NL",48.92696,-55.65966,2018-07-25 06:00:00,4,0,4
"22453",10501,"Grand Falls-Windsor","NL",48.92696,-55.65966,2018-07-25 07:00:00,3,0,3
"22454",10501,"Grand Falls-Windsor","NL",48.92696,-55.65966,2018-07-25 08:00:00,9,0,9
"22455",10501,"Grand Falls-Windsor","NL",48.92696,-55.65966,2018-07-25 09:00:00,8,0,8
"22456",10501,"Grand Falls-Windsor","NL",48.92696,-55.65966,2018-07-25 10:00:00,6,0,6
"22457",10501,"Grand Falls-Windsor","NL",48.92696,-55.65966,2018-07-25 11:00:00,11,1,12
"22458",10501,"Grand Falls-Windsor","NL",48.92696,-55.65966,2018-07-25 12:00:00,11,1,12
"22459",10501,"Grand Falls-Windsor","NL",48.92696,-55.65966,2018-07-25 13:00:00,6,0,6
"22460",10501,"Grand Falls-Windsor","NL",48.92696,-55.65966,2018-07-25 14:00:00,10,0,10
"22461",10501,"Grand Falls-Windsor","NL",48.92696,-55.65966,2018-07-25 15:00:00,11,1,12
"22462",10501,"Grand Falls-Windsor","NL",48.92696,-55.65966,2018-07-25 16:00:00,12,1,13
"22463",10501,"Grand Falls-Windsor","NL",48.92696,-55.65966,2018-07-25 17:00:00,13,1,14
"22464",10501,"Grand Falls-Windsor","NL",48.92696,-55.65966,2018-07-25 18:00:00,14,1,15
"22465",10501,"Grand Falls-Windsor","NL",48.92696,-55.65966,2018-07-25 19:00:00,15,1,16
"22466",10501,"Grand Falls-Windsor","NL",48.92696,-55.65966,2018-07-25 20:00:00,15,0,15
"22467",10501,"Grand Falls-Windsor","NL",48.92696,-55.65966,2018-07-25 21:00:00,15,1,16
"22468",10501,"Grand Falls-Windsor","NL",48.92696,-55.65966,2018-07-25 22:00:00,13,0,13
"22469",10501,"Grand Falls-Windsor","NL",48.92696,-55.65966,2018-07-25 23:00:00,12,0,12
"22470",10501,"Grand Falls-Windsor","NL",48.92696,-55.65966,2018-07-26 00:00:00,10,0,10
"22471",10501,"Grand Falls-Windsor","NL",48.92696,-55.65966,2018-07-26 01:00:00,10,0,10
"22472",10501,"Grand Falls-Windsor","NL",48.92696,-55.65966,2018-07-26 02:00:00,11,0,11
"22473",10501,"Grand Falls-Windsor","NL",48.92696,-55.65966,2018-07-26 03:00:00,9,0,9
"22474",10501,"Grand Falls-Windsor","NL",48.92696,-55.65966,2018-07-26 04:00:00,9,0,9
"22475",10501,"Grand Falls-Windsor","NL",48.92696,-55.65966,2018-07-26 05:00:00,10,0,10
"22476",10501,"Grand Falls-Windsor","NL",48.92696,-55.65966,2018-07-26 06:00:00,10,0,10
"22477",10501,"Grand Falls-Windsor","NL",48.92696,-55.65966,2018-07-26 07:00:00,10,1,11
"22478",10501,"Grand Falls-Windsor","NL",48.92696,-55.65966,2018-07-26 08:00:00,11,1,12
"22479",10501,"Grand Falls-Windsor","NL",48.92696,-55.65966,2018-07-26 09:00:00,11,1,12
"22480",10501,"Grand Falls-Windsor","NL",48.92696,-55.65966,2018-07-26 10:00:00,14,0,14
"22481",10501,"Grand Falls-Windsor","NL",48.92696,-55.65966,2018-07-26 11:00:00,13,0,13
"22482",10501,"Grand Falls-Windsor","NL",48.92696,-55.65966,2018-07-26 12:00:00,11,1,12
"22483",10501,"Grand Falls-Windsor","NL",48.92696,-55.65966,2018-07-26 13:00:00,13,1,14
"22484",10501,"Grand Falls-Windsor","NL",48.92696,-55.65966,2018-07-26 14:00:00,15,1,16
"22485",10501,"Grand Falls-Windsor","NL",48.92696,-55.65966,2018-07-26 15:00:00,15,1,16
"22486",10501,"Grand Falls-Windsor","NL",48.92696,-55.65966,2018-07-26 16:00:00,15,1,16
"22487",10501,"Grand Falls-Windsor","NL",48.92696,-55.65966,2018-07-26 17:00:00,15,0,15
"22488",10501,"Grand Falls-Windsor","NL",48.92696,-55.65966,2018-07-26 18:00:00,15,0,15
"22489",10501,"Grand Falls-Windsor","NL",48.92696,-55.65966,2018-07-26 19:00:00,15,0,15
"22490",10501,"Grand Falls-Windsor","NL",48.92696,-55.65966,2018-07-26 20:00:00,14,1,15
"22491",10501,"Grand Falls-Windsor","NL",48.92696,-55.65966,2018-07-26 21:00:00,14,0,14
"22492",10501,"Grand Falls-Windsor","NL",48.92696,-55.65966,2018-07-26 22:00:00,14,1,15
"22493",10501,"Grand Falls-Windsor","NL",48.92696,-55.65966,2018-07-26 23:00:00,13,0,13
"22494",10501,"Grand Falls-Windsor","NL",48.92696,-55.65966,2018-07-27 00:00:00,13,0,13
"22495",10501,"Grand Falls-Windsor","NL",48.92696,-55.65966,2018-07-27 01:00:00,13,1,14
"22496",10501,"Grand Falls-Windsor","NL",48.92696,-55.65966,2018-07-27 02:00:00,13,1,14
"22497",10501,"Grand Falls-Windsor","NL",48.92696,-55.65966,2018-07-27 03:00:00,12,0,12
"22498",10501,"Grand Falls-Windsor","NL",48.92696,-55.65966,2018-07-27 04:00:00,14,0,14
"22499",10501,"Grand Falls-Windsor","NL",48.92696,-55.65966,2018-07-27 05:00:00,14,0,14
"22500",10501,"Grand Falls-Windsor","NL",48.92696,-55.65966,2018-07-27 06:00:00,13,1,14
"22501",10501,"Grand Falls-Windsor","NL",48.92696,-55.65966,2018-07-27 07:00:00,16,0,16
"22502",10501,"Grand Falls-Windsor","NL",48.92696,-55.65966,2018-07-27 08:00:00,17,0,17
"22503",10501,"Grand Falls-Windsor","NL",48.92696,-55.65966,2018-07-27 09:00:00,17,0,17
"22504",10501,"Grand Falls-Windsor","NL",48.92696,-55.65966,2018-07-27 10:00:00,16,1,17
"22505",10501,"Grand Falls-Windsor","NL",48.92696,-55.65966,2018-07-27 11:00:00,17,1,18
"22506",10501,"Grand Falls-Windsor","NL",48.92696,-55.65966,2018-07-27 12:00:00,19,0,19
"22507",10501,"Grand Falls-Windsor","NL",48.92696,-55.65966,2018-07-27 13:00:00,19,1,20
"22508",10501,"Grand Falls-Windsor","NL",48.92696,-55.65966,2018-07-27 14:00:00,20,1,21
"22509",10501,"Grand Falls-Windsor","NL",48.92696,-55.65966,2018-07-27 15:00:00,21,1,22
"22510",10501,"Grand Falls-Windsor","NL",48.92696,-55.65966,2018-07-27 16:00:00,12,1,13
"22511",10501,"Grand Falls-Windsor","NL",48.92696,-55.65966,2018-07-27 17:00:00,12,1,13
"22512",10501,"Grand Falls-Windsor","NL",48.92696,-55.65966,2018-07-27 18:00:00,13,1,14
"22513",10501,"Grand Falls-Windsor","NL",48.92696,-55.65966,2018-07-27 19:00:00,11,1,12
"22514",10501,"Grand Falls-Windsor","NL",48.92696,-55.65966,2018-07-27 20:00:00,13,1,14
"22515",10501,"Grand Falls-Windsor","NL",48.92696,-55.65966,2018-07-27 21:00:00,14,1,15
"22516",10501,"Grand Falls-Windsor","NL",48.92696,-55.65966,2018-07-27 22:00:00,15,1,16
"22517",10501,"Grand Falls-Windsor","NL",48.92696,-55.65966,2018-07-27 23:00:00,16,1,17
"22518",10501,"Grand Falls-Windsor","NL",48.92696,-55.65966,2018-07-28 00:00:00,17,1,18
"22519",10501,"Grand Falls-Windsor","NL",48.92696,-55.65966,2018-07-28 01:00:00,18,1,19
"22520",10501,"Grand Falls-Windsor","NL",48.92696,-55.65966,2018-07-28 02:00:00,15,1,16
"22521",10501,"Grand Falls-Windsor","NL",48.92696,-55.65966,2018-07-28 03:00:00,14,1,15
"22522",10501,"Grand Falls-Windsor","NL",48.92696,-55.65966,2018-07-28 04:00:00,14,0,14
"22523",10501,"Grand Falls-Windsor","NL",48.92696,-55.65966,2018-07-28 05:00:00,14,1,15
"22524",10501,"Grand Falls-Windsor","NL",48.92696,-55.65966,2018-07-28 06:00:00,12,1,13
"22525",10501,"Grand Falls-Windsor","NL",48.92696,-55.65966,2018-07-28 07:00:00,11,1,12
"22526",10501,"Grand Falls-Windsor","NL",48.92696,-55.65966,2018-07-28 08:00:00,9,1,10
"22527",10501,"Grand Falls-Windsor","NL",48.92696,-55.65966,2018-07-28 09:00:00,7,0,7
"22528",10501,"Grand Falls-Windsor","NL",48.92696,-55.65966,2018-07-28 10:00:00,7,0,7
"22529",10501,"Grand Falls-Windsor","NL",48.92696,-55.65966,2018-07-28 11:00:00,6,1,7
"22530",10501,"Grand Falls-Windsor","NL",48.92696,-55.65966,2018-07-28 12:00:00,7,0,7
"22531",10501,"Grand Falls-Windsor","NL",48.92696,-55.65966,2018-07-28 13:00:00,10,1,11
"22532",10501,"Grand Falls-Windsor","NL",48.92696,-55.65966,2018-07-28 14:00:00,11,1,12
"22533",10501,"Grand Falls-Windsor","NL",48.92696,-55.65966,2018-07-28 15:00:00,12,0,12
"22534",10501,"Grand Falls-Windsor","NL",48.92696,-55.65966,2018-07-28 16:00:00,13,1,14
"22535",10501,"Grand Falls-Windsor","NL",48.92696,-55.65966,2018-07-28 17:00:00,17,1,18
"22536",10501,"Grand Falls-Windsor","NL",48.92696,-55.65966,2018-07-28 18:00:00,18,0,18
"22537",10501,"Grand Falls-Windsor","NL",48.92696,-55.65966,2018-07-28 19:00:00,17,1,18
"22538",10501,"Grand Falls-Windsor","NL",48.92696,-55.65966,2018-07-28 20:00:00,15,1,16
"22539",10501,"Grand Falls-Windsor","NL",48.92696,-55.65966,2018-07-28 21:00:00,17,0,17
"22540",10501,"Grand Falls-Windsor","NL",48.92696,-55.65966,2018-07-28 22:00:00,17,1,18
"22541",10501,"Grand Falls-Windsor","NL",48.92696,-55.65966,2018-07-28 23:00:00,15,1,16
"22542",10501,"Grand Falls-Windsor","NL",48.92696,-55.65966,2018-07-29 00:00:00,13,1,14
"22543",10501,"Grand Falls-Windsor","NL",48.92696,-55.65966,2018-07-29 01:00:00,12,1,13
"22544",10501,"Grand Falls-Windsor","NL",48.92696,-55.65966,2018-07-29 02:00:00,10,0,10
"22545",10501,"Grand Falls-Windsor","NL",48.92696,-55.65966,2018-07-29 03:00:00,12,0,12
"22546",10501,"Grand Falls-Windsor","NL",48.92696,-55.65966,2018-07-29 04:00:00,14,0,14
"22547",10501,"Grand Falls-Windsor","NL",48.92696,-55.65966,2018-07-29 05:00:00,13,1,14
"22548",10501,"Grand Falls-Windsor","NL",48.92696,-55.65966,2018-07-29 06:00:00,12,0,12
"22549",10501,"Grand Falls-Windsor","NL",48.92696,-55.65966,2018-07-29 07:00:00,11,0,11
"22550",10501,"Grand Falls-Windsor","NL",48.92696,-55.65966,2018-07-29 08:00:00,12,1,13
"22551",10501,"Grand Falls-Windsor","NL",48.92696,-55.65966,2018-07-29 09:00:00,14,1,15
"22552",10501,"Grand Falls-Windsor","NL",48.92696,-55.65966,2018-07-29 10:00:00,12,0,12
"22553",10501,"Grand Falls-Windsor","NL",48.92696,-55.65966,2018-07-29 11:00:00,15,0,15
"22554",10501,"Grand Falls-Windsor","NL",48.92696,-55.65966,2018-07-29 12:00:00,18,0,18
"22555",10501,"Grand Falls-Windsor","NL",48.92696,-55.65966,2018-07-29 13:00:00,19,0,19
"22556",10501,"Grand Falls-Windsor","NL",48.92696,-55.65966,2018-07-29 14:00:00,16,0,16
"22557",10501,"Grand Falls-Windsor","NL",48.92696,-55.65966,2018-07-29 15:00:00,17,0,17
"22558",10501,"Grand Falls-Windsor","NL",48.92696,-55.65966,2018-07-29 16:00:00,18,1,19
"22559",10501,"Grand Falls-Windsor","NL",48.92696,-55.65966,2018-07-29 17:00:00,18,0,18
"22560",10501,"Grand Falls-Windsor","NL",48.92696,-55.65966,2018-07-29 18:00:00,15,0,15
"22561",10501,"Grand Falls-Windsor","NL",48.92696,-55.65966,2018-07-29 19:00:00,20,1,21
"22562",10501,"Grand Falls-Windsor","NL",48.92696,-55.65966,2018-07-29 20:00:00,27,1,28
"22563",10501,"Grand Falls-Windsor","NL",48.92696,-55.65966,2018-07-29 21:00:00,27,1,28
"22564",10501,"Grand Falls-Windsor","NL",48.92696,-55.65966,2018-07-29 22:00:00,22,1,23
"22565",10501,"Grand Falls-Windsor","NL",48.92696,-55.65966,2018-07-29 23:00:00,16,0,16
"22566",10501,"Grand Falls-Windsor","NL",48.92696,-55.65966,2018-07-30 00:00:00,13,0,13
"22567",10501,"Grand Falls-Windsor","NL",48.92696,-55.65966,2018-07-30 01:00:00,6,1,7
"22568",10501,"Grand Falls-Windsor","NL",48.92696,-55.65966,2018-07-30 02:00:00,6,0,6
"22569",10501,"Grand Falls-Windsor","NL",48.92696,-55.65966,2018-07-30 03:00:00,5,1,6
"22570",10501,"Grand Falls-Windsor","NL",48.92696,-55.65966,2018-07-30 04:00:00,5,1,6
"22571",10501,"Grand Falls-Windsor","NL",48.92696,-55.65966,2018-07-30 05:00:00,7,1,8
"22572",10501,"Grand Falls-Windsor","NL",48.92696,-55.65966,2018-07-30 06:00:00,4,1,5
"22573",10501,"Grand Falls-Windsor","NL",48.92696,-55.65966,2018-07-30 07:00:00,7,1,8
"22574",10501,"Grand Falls-Windsor","NL",48.92696,-55.65966,2018-07-30 08:00:00,6,1,7
"22575",10501,"Grand Falls-Windsor","NL",48.92696,-55.65966,2018-07-30 09:00:00,17,0,17
"22576",10501,"Grand Falls-Windsor","NL",48.92696,-55.65966,2018-07-30 10:00:00,24,1,25
"22577",10501,"Grand Falls-Windsor","NL",48.92696,-55.65966,2018-07-30 11:00:00,28,1,29
"22578",10501,"Grand Falls-Windsor","NL",48.92696,-55.65966,2018-07-30 12:00:00,31,1,32
"22579",10501,"Grand Falls-Windsor","NL",48.92696,-55.65966,2018-07-30 13:00:00,36,1,37
"22580",10501,"Grand Falls-Windsor","NL",48.92696,-55.65966,2018-07-30 14:00:00,34,1,35
"22581",10501,"Grand Falls-Windsor","NL",48.92696,-55.65966,2018-07-30 15:00:00,32,2,34
"22582",10501,"Grand Falls-Windsor","NL",48.92696,-55.65966,2018-07-30 16:00:00,26,1,27
"22583",10501,"Grand Falls-Windsor","NL",48.92696,-55.65966,2018-07-30 17:00:00,24,1,25
"22584",10501,"Grand Falls-Windsor","NL",48.92696,-55.65966,2018-07-30 18:00:00,22,1,23
"22585",10501,"Grand Falls-Windsor","NL",48.92696,-55.65966,2018-07-30 19:00:00,20,0,20
"22586",10501,"Grand Falls-Windsor","NL",48.92696,-55.65966,2018-07-30 20:00:00,17,1,18
"22587",10501,"Grand Falls-Windsor","NL",48.92696,-55.65966,2018-07-30 21:00:00,17,1,18
"22588",10501,"Grand Falls-Windsor","NL",48.92696,-55.65966,2018-07-30 22:00:00,18,0,18
"22589",10501,"Grand Falls-Windsor","NL",48.92696,-55.65966,2018-07-30 23:00:00,16,1,17
"22590",10501,"Grand Falls-Windsor","NL",48.92696,-55.65966,2018-07-31 00:00:00,15,0,15
"22591",10501,"Grand Falls-Windsor","NL",48.92696,-55.65966,2018-07-31 01:00:00,14,1,15
"22592",10501,"Grand Falls-Windsor","NL",48.92696,-55.65966,2018-07-31 02:00:00,14,1,15
"22593",10501,"Grand Falls-Windsor","NL",48.92696,-55.65966,2018-07-31 03:00:00,12,1,13
"22594",10501,"Grand Falls-Windsor","NL",48.92696,-55.65966,2018-07-31 04:00:00,11,0,11
"22595",10501,"Grand Falls-Windsor","NL",48.92696,-55.65966,2018-07-31 05:00:00,10,0,10
"22596",10501,"Grand Falls-Windsor","NL",48.92696,-55.65966,2018-07-31 06:00:00,10,1,11
"22597",10501,"Grand Falls-Windsor","NL",48.92696,-55.65966,2018-07-31 07:00:00,11,1,12
"22598",10501,"Grand Falls-Windsor","NL",48.92696,-55.65966,2018-07-31 08:00:00,12,0,12
"22599",10501,"Grand Falls-Windsor","NL",48.92696,-55.65966,2018-07-31 09:00:00,14,1,15
"22600",10501,"Grand Falls-Windsor","NL",48.92696,-55.65966,2018-07-31 10:00:00,16,1,17
"22601",10501,"Grand Falls-Windsor","NL",48.92696,-55.65966,2018-07-31 11:00:00,19,1,20
"22602",10501,"Grand Falls-Windsor","NL",48.92696,-55.65966,2018-07-31 12:00:00,22,1,23
"22603",10501,"Grand Falls-Windsor","NL",48.92696,-55.65966,2018-07-31 13:00:00,24,1,25
"22604",10501,"Grand Falls-Windsor","NL",48.92696,-55.65966,2018-07-31 14:00:00,25,1,26
"22605",10501,"Grand Falls-Windsor","NL",48.92696,-55.65966,2018-07-31 15:00:00,26,1,27
"22606",10501,"Grand Falls-Windsor","NL",48.92696,-55.65966,2018-07-31 16:00:00,28,1,29
"22607",10501,"Grand Falls-Windsor","NL",48.92696,-55.65966,2018-07-31 17:00:00,29,1,30
"22608",10501,"Grand Falls-Windsor","NL",48.92696,-55.65966,2018-07-31 18:00:00,26,1,27
"22609",10501,"Grand Falls-Windsor","NL",48.92696,-55.65966,2018-07-31 19:00:00,23,1,24
"22610",10501,"Grand Falls-Windsor","NL",48.92696,-55.65966,2018-07-31 20:00:00,20,2,22
"22611",10501,"Grand Falls-Windsor","NL",48.92696,-55.65966,2018-07-31 21:00:00,19,1,20
"22612",10501,"Grand Falls-Windsor","NL",48.92696,-55.65966,2018-07-31 22:00:00,17,1,18
"22613",10501,"Grand Falls-Windsor","NL",48.92696,-55.65966,2018-07-31 23:00:00,14,1,15
"22614",10501,"Grand Falls-Windsor","NL",48.92696,-55.65966,2018-08-01 00:00:00,9,1,10
"22615",10501,"Grand Falls-Windsor","NL",48.92696,-55.65966,2018-08-01 01:00:00,11,1,12
"22616",10501,"Grand Falls-Windsor","NL",48.92696,-55.65966,2018-08-01 02:00:00,13,1,14
"22617",10501,"Grand Falls-Windsor","NL",48.92696,-55.65966,2018-08-01 03:00:00,14,0,14
"22618",10501,"Grand Falls-Windsor","NL",48.92696,-55.65966,2018-08-01 04:00:00,13,0,13
"22619",10501,"Grand Falls-Windsor","NL",48.92696,-55.65966,2018-08-01 05:00:00,11,1,12
"22620",10501,"Grand Falls-Windsor","NL",48.92696,-55.65966,2018-08-01 06:00:00,12,2,14
"22621",10501,"Grand Falls-Windsor","NL",48.92696,-55.65966,2018-08-01 07:00:00,13,1,14
"22622",10501,"Grand Falls-Windsor","NL",48.92696,-55.65966,2018-08-01 08:00:00,13,1,14
"22623",10501,"Grand Falls-Windsor","NL",48.92696,-55.65966,2018-08-01 09:00:00,15,0,15
"22624",10501,"Grand Falls-Windsor","NL",48.92696,-55.65966,2018-08-01 10:00:00,17,1,18
"22625",10501,"Grand Falls-Windsor","NL",48.92696,-55.65966,2018-08-01 11:00:00,19,1,20
"22626",10501,"Grand Falls-Windsor","NL",48.92696,-55.65966,2018-08-01 12:00:00,22,1,23
"22627",10501,"Grand Falls-Windsor","NL",48.92696,-55.65966,2018-08-01 13:00:00,23,1,24
"22628",10501,"Grand Falls-Windsor","NL",48.92696,-55.65966,2018-08-01 14:00:00,24,1,25
"22629",10501,"Grand Falls-Windsor","NL",48.92696,-55.65966,2018-08-01 15:00:00,25,1,26
"22630",10501,"Grand Falls-Windsor","NL",48.92696,-55.65966,2018-08-01 16:00:00,24,1,25
"22631",10501,"Grand Falls-Windsor","NL",48.92696,-55.65966,2018-08-01 17:00:00,23,1,24
"22632",10501,"Grand Falls-Windsor","NL",48.92696,-55.65966,2018-08-01 18:00:00,23,1,24
"22633",10501,"Grand Falls-Windsor","NL",48.92696,-55.65966,2018-08-01 19:00:00,23,1,24
"22634",10501,"Grand Falls-Windsor","NL",48.92696,-55.65966,2018-08-01 20:00:00,24,1,25
"22635",10501,"Grand Falls-Windsor","NL",48.92696,-55.65966,2018-08-01 21:00:00,21,1,22
"22636",10501,"Grand Falls-Windsor","NL",48.92696,-55.65966,2018-08-01 22:00:00,17,1,18
"22637",10501,"Grand Falls-Windsor","NL",48.92696,-55.65966,2018-08-01 23:00:00,14,1,15
"22638",10501,"Grand Falls-Windsor","NL",48.92696,-55.65966,2018-08-02 00:00:00,11,1,12
"22639",10501,"Grand Falls-Windsor","NL",48.92696,-55.65966,2018-08-02 01:00:00,9,1,10
"22640",10501,"Grand Falls-Windsor","NL",48.92696,-55.65966,2018-08-02 02:00:00,10,1,11
"22641",10501,"Grand Falls-Windsor","NL",48.92696,-55.65966,2018-08-02 03:00:00,12,1,13
"22642",10501,"Grand Falls-Windsor","NL",48.92696,-55.65966,2018-08-02 04:00:00,9,1,10
"22643",10501,"Grand Falls-Windsor","NL",48.92696,-55.65966,2018-08-02 05:00:00,7,1,8
"22644",10501,"Grand Falls-Windsor","NL",48.92696,-55.65966,2018-08-02 06:00:00,9,1,10
"22645",10501,"Grand Falls-Windsor","NL",48.92696,-55.65966,2018-08-02 07:00:00,9,1,10
"22646",10501,"Grand Falls-Windsor","NL",48.92696,-55.65966,2018-08-02 08:00:00,11,1,12
"22647",10501,"Grand Falls-Windsor","NL",48.92696,-55.65966,2018-08-02 09:00:00,12,1,13
"22648",10501,"Grand Falls-Windsor","NL",48.92696,-55.65966,2018-08-02 10:00:00,21,1,22
"22649",10501,"Grand Falls-Windsor","NL",48.92696,-55.65966,2018-08-02 11:00:00,22,1,23
"22650",10501,"Grand Falls-Windsor","NL",48.92696,-55.65966,2018-08-02 12:00:00,23,1,24
"22651",10501,"Grand Falls-Windsor","NL",48.92696,-55.65966,2018-08-02 13:00:00,23,1,24
"22652",10501,"Grand Falls-Windsor","NL",48.92696,-55.65966,2018-08-02 14:00:00,27,1,28
"22653",10501,"Grand Falls-Windsor","NL",48.92696,-55.65966,2018-08-02 15:00:00,29,1,30
"22654",10501,"Grand Falls-Windsor","NL",48.92696,-55.65966,2018-08-02 16:00:00,29,1,30
"22655",10501,"Grand Falls-Windsor","NL",48.92696,-55.65966,2018-08-02 17:00:00,28,1,29
"22656",10501,"Grand Falls-Windsor","NL",48.92696,-55.65966,2018-08-02 18:00:00,29,1,30
"22657",10501,"Grand Falls-Windsor","NL",48.92696,-55.65966,2018-08-02 19:00:00,27,1,28
"22658",10501,"Grand Falls-Windsor","NL",48.92696,-55.65966,2018-08-02 20:00:00,26,1,27
"22659",10501,"Grand Falls-Windsor","NL",48.92696,-55.65966,2018-08-02 21:00:00,23,0,23
"22660",10501,"Grand Falls-Windsor","NL",48.92696,-55.65966,2018-08-02 22:00:00,23,0,23
"22661",10501,"Grand Falls-Windsor","NL",48.92696,-55.65966,2018-08-02 23:00:00,21,1,22
"22662",10501,"Grand Falls-Windsor","NL",48.92696,-55.65966,2018-08-03 00:00:00,20,0,20
"22663",10501,"Grand Falls-Windsor","NL",48.92696,-55.65966,2018-08-03 01:00:00,18,0,18
"22664",10501,"Grand Falls-Windsor","NL",48.92696,-55.65966,2018-08-03 02:00:00,16,0,16
"22665",10501,"Grand Falls-Windsor","NL",48.92696,-55.65966,2018-08-03 03:00:00,17,1,18
"22666",10501,"Grand Falls-Windsor","NL",48.92696,-55.65966,2018-08-03 04:00:00,18,0,18
"22667",10501,"Grand Falls-Windsor","NL",48.92696,-55.65966,2018-08-03 05:00:00,16,1,17
"22668",10501,"Grand Falls-Windsor","NL",48.92696,-55.65966,2018-08-03 06:00:00,15,0,15
"22669",10501,"Grand Falls-Windsor","NL",48.92696,-55.65966,2018-08-03 07:00:00,17,0,17
"22670",10501,"Grand Falls-Windsor","NL",48.92696,-55.65966,2018-08-03 08:00:00,18,1,19
"22671",10501,"Grand Falls-Windsor","NL",48.92696,-55.65966,2018-08-03 09:00:00,20,1,21
"22672",10501,"Grand Falls-Windsor","NL",48.92696,-55.65966,2018-08-03 10:00:00,21,1,22
"22673",10501,"Grand Falls-Windsor","NL",48.92696,-55.65966,2018-08-03 11:00:00,21,1,22
"22674",10501,"Grand Falls-Windsor","NL",48.92696,-55.65966,2018-08-03 12:00:00,12,1,13
"22675",10501,"Grand Falls-Windsor","NL",48.92696,-55.65966,2018-08-03 13:00:00,12,1,13
"22676",10501,"Grand Falls-Windsor","NL",48.92696,-55.65966,2018-08-03 14:00:00,13,1,14
"22677",10501,"Grand Falls-Windsor","NL",48.92696,-55.65966,2018-08-03 15:00:00,13,1,14
"22678",10501,"Grand Falls-Windsor","NL",48.92696,-55.65966,2018-08-03 16:00:00,14,1,15
"22679",10501,"Grand Falls-Windsor","NL",48.92696,-55.65966,2018-08-03 17:00:00,13,1,14
"22680",10501,"Grand Falls-Windsor","NL",48.92696,-55.65966,2018-08-03 18:00:00,14,1,15
"22681",10501,"Grand Falls-Windsor","NL",48.92696,-55.65966,2018-08-03 19:00:00,14,1,15
"22682",10501,"Grand Falls-Windsor","NL",48.92696,-55.65966,2018-08-03 20:00:00,14,1,15
"22683",10501,"Grand Falls-Windsor","NL",48.92696,-55.65966,2018-08-03 21:00:00,13,1,14
"22684",10501,"Grand Falls-Windsor","NL",48.92696,-55.65966,2018-08-03 22:00:00,13,1,14
"22685",10501,"Grand Falls-Windsor","NL",48.92696,-55.65966,2018-08-03 23:00:00,12,1,13
"22686",10501,"Grand Falls-Windsor","NL",48.92696,-55.65966,2018-08-04 00:00:00,12,1,13
"22687",10501,"Grand Falls-Windsor","NL",48.92696,-55.65966,2018-08-04 01:00:00,12,1,13
"22688",10501,"Grand Falls-Windsor","NL",48.92696,-55.65966,2018-08-04 02:00:00,12,1,13
"22689",10501,"Grand Falls-Windsor","NL",48.92696,-55.65966,2018-08-04 03:00:00,11,1,12
"22690",10501,"Grand Falls-Windsor","NL",48.92696,-55.65966,2018-08-04 04:00:00,10,1,11
"22691",10501,"Grand Falls-Windsor","NL",48.92696,-55.65966,2018-08-04 05:00:00,10,1,11
"22692",10501,"Grand Falls-Windsor","NL",48.92696,-55.65966,2018-08-04 06:00:00,9,0,9
"22693",10501,"Grand Falls-Windsor","NL",48.92696,-55.65966,2018-08-04 07:00:00,8,0,8
"22694",10501,"Grand Falls-Windsor","NL",48.92696,-55.65966,2018-08-04 08:00:00,7,1,8
"22695",10501,"Grand Falls-Windsor","NL",48.92696,-55.65966,2018-08-04 09:00:00,8,0,8
"22696",10501,"Grand Falls-Windsor","NL",48.92696,-55.65966,2018-08-04 10:00:00,7,0,7
"22697",10501,"Grand Falls-Windsor","NL",48.92696,-55.65966,2018-08-04 11:00:00,7,1,8
"22698",10501,"Grand Falls-Windsor","NL",48.92696,-55.65966,2018-08-04 12:00:00,8,1,9
"22699",10501,"Grand Falls-Windsor","NL",48.92696,-55.65966,2018-08-04 13:00:00,11,0,11
"22700",10501,"Grand Falls-Windsor","NL",48.92696,-55.65966,2018-08-04 14:00:00,14,1,15
"22701",10501,"Grand Falls-Windsor","NL",48.92696,-55.65966,2018-08-04 15:00:00,19,1,20
"22702",10501,"Grand Falls-Windsor","NL",48.92696,-55.65966,2018-08-04 16:00:00,19,1,20
"22703",10501,"Grand Falls-Windsor","NL",48.92696,-55.65966,2018-08-04 17:00:00,19,0,19
"22704",10501,"Grand Falls-Windsor","NL",48.92696,-55.65966,2018-08-04 18:00:00,18,1,19
"22705",10501,"Grand Falls-Windsor","NL",48.92696,-55.65966,2018-08-04 19:00:00,15,1,16
"22706",10501,"Grand Falls-Windsor","NL",48.92696,-55.65966,2018-08-04 20:00:00,14,1,15
"22707",10501,"Grand Falls-Windsor","NL",48.92696,-55.65966,2018-08-04 21:00:00,13,1,14
"22708",10501,"Grand Falls-Windsor","NL",48.92696,-55.65966,2018-08-04 22:00:00,14,0,14
"22709",10501,"Grand Falls-Windsor","NL",48.92696,-55.65966,2018-08-04 23:00:00,15,1,16
"22710",10501,"Grand Falls-Windsor","NL",48.92696,-55.65966,2018-08-05 00:00:00,16,1,17
"22711",10501,"Grand Falls-Windsor","NL",48.92696,-55.65966,2018-08-05 01:00:00,17,0,17
"22712",10501,"Grand Falls-Windsor","NL",48.92696,-55.65966,2018-08-05 02:00:00,14,0,14
"22713",10501,"Grand Falls-Windsor","NL",48.92696,-55.65966,2018-08-05 03:00:00,17,0,17
"22714",10501,"Grand Falls-Windsor","NL",48.92696,-55.65966,2018-08-05 04:00:00,17,0,17
"22715",10501,"Grand Falls-Windsor","NL",48.92696,-55.65966,2018-08-05 05:00:00,16,0,16
"22716",10501,"Grand Falls-Windsor","NL",48.92696,-55.65966,2018-08-05 06:00:00,15,0,15
"22717",10501,"Grand Falls-Windsor","NL",48.92696,-55.65966,2018-08-05 07:00:00,16,0,16
"22718",10501,"Grand Falls-Windsor","NL",48.92696,-55.65966,2018-08-05 08:00:00,16,0,16
"22719",10501,"Grand Falls-Windsor","NL",48.92696,-55.65966,2018-08-05 09:00:00,16,0,16
"22720",10501,"Grand Falls-Windsor","NL",48.92696,-55.65966,2018-08-05 10:00:00,14,1,15
"22721",10501,"Grand Falls-Windsor","NL",48.92696,-55.65966,2018-08-05 11:00:00,14,0,14
"22722",10501,"Grand Falls-Windsor","NL",48.92696,-55.65966,2018-08-05 12:00:00,14,1,15
"22723",10501,"Grand Falls-Windsor","NL",48.92696,-55.65966,2018-08-05 13:00:00,13,1,14
"22724",10501,"Grand Falls-Windsor","NL",48.92696,-55.65966,2018-08-05 14:00:00,13,1,14
"22725",10501,"Grand Falls-Windsor","NL",48.92696,-55.65966,2018-08-05 15:00:00,13,1,14
"22726",10501,"Grand Falls-Windsor","NL",48.92696,-55.65966,2018-08-05 16:00:00,12,0,12
"22727",10501,"Grand Falls-Windsor","NL",48.92696,-55.65966,2018-08-05 17:00:00,13,0,13
"22728",10501,"Grand Falls-Windsor","NL",48.92696,-55.65966,2018-08-05 18:00:00,15,0,15
"22729",10501,"Grand Falls-Windsor","NL",48.92696,-55.65966,2018-08-05 19:00:00,15,0,15
"22730",10501,"Grand Falls-Windsor","NL",48.92696,-55.65966,2018-08-05 20:00:00,15,0,15
"22731",10501,"Grand Falls-Windsor","NL",48.92696,-55.65966,2018-08-05 21:00:00,16,0,16
"22732",10501,"Grand Falls-Windsor","NL",48.92696,-55.65966,2018-08-05 22:00:00,16,0,16
"22733",10501,"Grand Falls-Windsor","NL",48.92696,-55.65966,2018-08-05 23:00:00,15,1,16
"22734",10501,"Grand Falls-Windsor","NL",48.92696,-55.65966,2018-08-06 00:00:00,14,0,14
"22735",10501,"Grand Falls-Windsor","NL",48.92696,-55.65966,2018-08-06 01:00:00,14,0,14
"22736",10501,"Grand Falls-Windsor","NL",48.92696,-55.65966,2018-08-06 02:00:00,14,0,14
"22737",10501,"Grand Falls-Windsor","NL",48.92696,-55.65966,2018-08-06 03:00:00,13,1,14
"22738",10501,"Grand Falls-Windsor","NL",48.92696,-55.65966,2018-08-06 04:00:00,14,0,14
"22739",10501,"Grand Falls-Windsor","NL",48.92696,-55.65966,2018-08-06 05:00:00,13,0,13
"22740",10501,"Grand Falls-Windsor","NL",48.92696,-55.65966,2018-08-06 06:00:00,14,0,14
"22741",10501,"Grand Falls-Windsor","NL",48.92696,-55.65966,2018-08-06 07:00:00,14,1,15
"22742",10501,"Grand Falls-Windsor","NL",48.92696,-55.65966,2018-08-06 08:00:00,14,0,14
"22743",10501,"Grand Falls-Windsor","NL",48.92696,-55.65966,2018-08-06 09:00:00,14,0,14
"22744",10501,"Grand Falls-Windsor","NL",48.92696,-55.65966,2018-08-06 10:00:00,15,1,16
"22745",10501,"Grand Falls-Windsor","NL",48.92696,-55.65966,2018-08-06 11:00:00,16,0,16
"22746",10501,"Grand Falls-Windsor","NL",48.92696,-55.65966,2018-08-06 12:00:00,17,1,18
"22747",10501,"Grand Falls-Windsor","NL",48.92696,-55.65966,2018-08-06 13:00:00,18,0,18
"22748",10501,"Grand Falls-Windsor","NL",48.92696,-55.65966,2018-08-06 14:00:00,17,1,18
"22749",10501,"Grand Falls-Windsor","NL",48.92696,-55.65966,2018-08-06 15:00:00,17,1,18
"22750",10501,"Grand Falls-Windsor","NL",48.92696,-55.65966,2018-08-06 16:00:00,17,0,17
"22751",10501,"Grand Falls-Windsor","NL",48.92696,-55.65966,2018-08-06 17:00:00,17,0,17
"22752",10501,"Grand Falls-Windsor","NL",48.92696,-55.65966,2018-08-06 18:00:00,18,2,20
"22753",10501,"Grand Falls-Windsor","NL",48.92696,-55.65966,2018-08-06 19:00:00,18,0,18
"22754",10501,"Grand Falls-Windsor","NL",48.92696,-55.65966,2018-08-06 20:00:00,18,0,18
"22755",10501,"Grand Falls-Windsor","NL",48.92696,-55.65966,2018-08-06 21:00:00,17,0,17
"22756",10501,"Grand Falls-Windsor","NL",48.92696,-55.65966,2018-08-06 22:00:00,17,0,17
"22757",10501,"Grand Falls-Windsor","NL",48.92696,-55.65966,2018-08-06 23:00:00,16,0,16
"22758",10501,"Grand Falls-Windsor","NL",48.92696,-55.65966,2018-08-07 00:00:00,14,1,15
"22759",10501,"Grand Falls-Windsor","NL",48.92696,-55.65966,2018-08-07 01:00:00,14,0,14
"22760",10501,"Grand Falls-Windsor","NL",48.92696,-55.65966,2018-08-07 02:00:00,16,0,16
"22761",10501,"Grand Falls-Windsor","NL",48.92696,-55.65966,2018-08-07 03:00:00,16,0,16
"22762",10501,"Grand Falls-Windsor","NL",48.92696,-55.65966,2018-08-07 04:00:00,16,0,16
"22763",10501,"Grand Falls-Windsor","NL",48.92696,-55.65966,2018-08-07 05:00:00,16,0,16
"22764",10501,"Grand Falls-Windsor","NL",48.92696,-55.65966,2018-08-07 06:00:00,14,1,15
"22765",10501,"Grand Falls-Windsor","NL",48.92696,-55.65966,2018-08-07 07:00:00,14,1,15
"22766",10501,"Grand Falls-Windsor","NL",48.92696,-55.65966,2018-08-07 08:00:00,11,1,12
"22767",10501,"Grand Falls-Windsor","NL",48.92696,-55.65966,2018-08-07 09:00:00,11,1,12
"22768",10501,"Grand Falls-Windsor","NL",48.92696,-55.65966,2018-08-07 10:00:00,13,1,14
"22769",10501,"Grand Falls-Windsor","NL",48.92696,-55.65966,2018-08-07 11:00:00,14,0,14
"22770",10501,"Grand Falls-Windsor","NL",48.92696,-55.65966,2018-08-07 12:00:00,17,1,18
"22771",10501,"Grand Falls-Windsor","NL",48.92696,-55.65966,2018-08-07 13:00:00,19,1,20
"22772",10501,"Grand Falls-Windsor","NL",48.92696,-55.65966,2018-08-07 14:00:00,21,1,22
"22773",10501,"Grand Falls-Windsor","NL",48.92696,-55.65966,2018-08-07 15:00:00,21,1,22
"22774",10501,"Grand Falls-Windsor","NL",48.92696,-55.65966,2018-08-07 16:00:00,21,1,22
"22775",10501,"Grand Falls-Windsor","NL",48.92696,-55.65966,2018-08-07 17:00:00,22,1,23
"22776",10501,"Grand Falls-Windsor","NL",48.92696,-55.65966,2018-08-07 18:00:00,21,1,22
"22777",10501,"Grand Falls-Windsor","NL",48.92696,-55.65966,2018-08-07 19:00:00,19,1,20
"22778",10501,"Grand Falls-Windsor","NL",48.92696,-55.65966,2018-08-07 20:00:00,14,1,15
"22779",10501,"Grand Falls-Windsor","NL",48.92696,-55.65966,2018-08-07 21:00:00,15,0,15
"22780",10501,"Grand Falls-Windsor","NL",48.92696,-55.65966,2018-08-07 22:00:00,17,0,17
"22781",10501,"Grand Falls-Windsor","NL",48.92696,-55.65966,2018-08-07 23:00:00,17,0,17
"22782",10501,"Grand Falls-Windsor","NL",48.92696,-55.65966,2018-08-08 00:00:00,18,0,18
"22783",10501,"Grand Falls-Windsor","NL",48.92696,-55.65966,2018-08-08 01:00:00,17,0,17
"22784",10501,"Grand Falls-Windsor","NL",48.92696,-55.65966,2018-08-08 02:00:00,17,0,17
"22785",10501,"Grand Falls-Windsor","NL",48.92696,-55.65966,2018-08-08 03:00:00,16,0,16
"22786",10501,"Grand Falls-Windsor","NL",48.92696,-55.65966,2018-08-08 04:00:00,16,0,16
"22787",10501,"Grand Falls-Windsor","NL",48.92696,-55.65966,2018-08-08 05:00:00,17,0,17
"22788",10501,"Grand Falls-Windsor","NL",48.92696,-55.65966,2018-08-08 06:00:00,17,0,17
"22789",10501,"Grand Falls-Windsor","NL",48.92696,-55.65966,2018-08-08 07:00:00,16,1,17
"22790",10501,"Grand Falls-Windsor","NL",48.92696,-55.65966,2018-08-08 08:00:00,16,0,16
"22791",10501,"Grand Falls-Windsor","NL",48.92696,-55.65966,2018-08-08 09:00:00,14,1,15
"22792",10501,"Grand Falls-Windsor","NL",48.92696,-55.65966,2018-08-08 10:00:00,14,1,15
"22793",10501,"Grand Falls-Windsor","NL",48.92696,-55.65966,2018-08-08 11:00:00,23,1,24
"22794",10501,"Grand Falls-Windsor","NL",48.92696,-55.65966,2018-08-08 12:00:00,NA,0,NA
"22795",10501,"Grand Falls-Windsor","NL",48.92696,-55.65966,2018-08-08 13:00:00,NA,1,NA
"22796",10501,"Grand Falls-Windsor","NL",48.92696,-55.65966,2018-08-08 14:00:00,NA,NA,NA
"22797",10501,"Grand Falls-Windsor","NL",48.92696,-55.65966,2018-08-08 15:00:00,26,NA,NA
"22798",10501,"Grand Falls-Windsor","NL",48.92696,-55.65966,2018-08-08 16:00:00,28,NA,NA
"22799",10501,"Grand Falls-Windsor","NL",48.92696,-55.65966,2018-08-08 17:00:00,34,NA,NA
"22800",10501,"Grand Falls-Windsor","NL",48.92696,-55.65966,2018-08-08 18:00:00,31,NA,NA
"22801",10501,"Grand Falls-Windsor","NL",48.92696,-55.65966,2018-08-08 19:00:00,29,NA,NA
"22802",10501,"Grand Falls-Windsor","NL",48.92696,-55.65966,2018-08-08 20:00:00,28,NA,NA
"22803",10501,"Grand Falls-Windsor","NL",48.92696,-55.65966,2018-08-08 21:00:00,23,NA,NA
"22804",10501,"Grand Falls-Windsor","NL",48.92696,-55.65966,2018-08-08 22:00:00,18,NA,NA
"22805",10501,"Grand Falls-Windsor","NL",48.92696,-55.65966,2018-08-08 23:00:00,17,NA,NA
"22806",10501,"Grand Falls-Windsor","NL",48.92696,-55.65966,2018-08-09 00:00:00,17,NA,NA
"22807",10501,"Grand Falls-Windsor","NL",48.92696,-55.65966,2018-08-09 01:00:00,18,NA,NA
"22808",10501,"Grand Falls-Windsor","NL",48.92696,-55.65966,2018-08-09 02:00:00,17,NA,NA
"22809",10501,"Grand Falls-Windsor","NL",48.92696,-55.65966,2018-08-09 03:00:00,17,NA,NA
"22810",10501,"Grand Falls-Windsor","NL",48.92696,-55.65966,2018-08-09 04:00:00,11,NA,NA
"22811",10501,"Grand Falls-Windsor","NL",48.92696,-55.65966,2018-08-09 05:00:00,6,NA,NA
"22812",10501,"Grand Falls-Windsor","NL",48.92696,-55.65966,2018-08-09 06:00:00,7,NA,NA
"22813",10501,"Grand Falls-Windsor","NL",48.92696,-55.65966,2018-08-09 07:00:00,10,NA,NA
"22814",10501,"Grand Falls-Windsor","NL",48.92696,-55.65966,2018-08-09 08:00:00,10,NA,NA
"22815",10501,"Grand Falls-Windsor","NL",48.92696,-55.65966,2018-08-09 09:00:00,16,NA,NA
"22816",10501,"Grand Falls-Windsor","NL",48.92696,-55.65966,2018-08-09 10:00:00,NA,NA,NA
"22817",10501,"Grand Falls-Windsor","NL",48.92696,-55.65966,2018-08-09 11:00:00,24,NA,NA
"22818",10501,"Grand Falls-Windsor","NL",48.92696,-55.65966,2018-08-09 12:00:00,28,0,28
"22819",10501,"Grand Falls-Windsor","NL",48.92696,-55.65966,2018-08-09 13:00:00,29,1,30
"22820",10501,"Grand Falls-Windsor","NL",48.92696,-55.65966,2018-08-09 14:00:00,31,0,31
"22821",10501,"Grand Falls-Windsor","NL",48.92696,-55.65966,2018-08-09 15:00:00,31,1,32
"22822",10501,"Grand Falls-Windsor","NL",48.92696,-55.65966,2018-08-09 16:00:00,31,1,32
"22823",10501,"Grand Falls-Windsor","NL",48.92696,-55.65966,2018-08-09 17:00:00,31,2,33
"22824",10501,"Grand Falls-Windsor","NL",48.92696,-55.65966,2018-08-09 18:00:00,29,1,30
"22825",10501,"Grand Falls-Windsor","NL",48.92696,-55.65966,2018-08-09 19:00:00,24,1,25
"22826",10501,"Grand Falls-Windsor","NL",48.92696,-55.65966,2018-08-09 20:00:00,23,1,24
"22827",10501,"Grand Falls-Windsor","NL",48.92696,-55.65966,2018-08-09 21:00:00,22,1,23
"22828",10501,"Grand Falls-Windsor","NL",48.92696,-55.65966,2018-08-09 22:00:00,19,1,20
"22829",10501,"Grand Falls-Windsor","NL",48.92696,-55.65966,2018-08-09 23:00:00,18,0,18
"22830",10501,"Grand Falls-Windsor","NL",48.92696,-55.65966,2018-08-10 00:00:00,19,0,19
"22831",10501,"Grand Falls-Windsor","NL",48.92696,-55.65966,2018-08-10 01:00:00,19,0,19
"22832",10501,"Grand Falls-Windsor","NL",48.92696,-55.65966,2018-08-10 02:00:00,19,0,19
"22833",10501,"Grand Falls-Windsor","NL",48.92696,-55.65966,2018-08-10 03:00:00,20,0,20
"22834",10501,"Grand Falls-Windsor","NL",48.92696,-55.65966,2018-08-10 04:00:00,19,0,19
"22835",10501,"Grand Falls-Windsor","NL",48.92696,-55.65966,2018-08-10 05:00:00,21,0,21
"22836",10501,"Grand Falls-Windsor","NL",48.92696,-55.65966,2018-08-10 06:00:00,23,0,23
"22837",10501,"Grand Falls-Windsor","NL",48.92696,-55.65966,2018-08-10 07:00:00,25,0,25
"22838",10501,"Grand Falls-Windsor","NL",48.92696,-55.65966,2018-08-10 08:00:00,26,1,27
"22839",10501,"Grand Falls-Windsor","NL",48.92696,-55.65966,2018-08-10 09:00:00,28,1,29
"22840",10501,"Grand Falls-Windsor","NL",48.92696,-55.65966,2018-08-10 10:00:00,30,0,30
"22841",10501,"Grand Falls-Windsor","NL",48.92696,-55.65966,2018-08-10 11:00:00,32,0,32
"22842",10501,"Grand Falls-Windsor","NL",48.92696,-55.65966,2018-08-10 12:00:00,36,0,36
"22843",10501,"Grand Falls-Windsor","NL",48.92696,-55.65966,2018-08-10 13:00:00,37,0,37
"22844",10501,"Grand Falls-Windsor","NL",48.92696,-55.65966,2018-08-10 14:00:00,34,0,34
"22845",10501,"Grand Falls-Windsor","NL",48.92696,-55.65966,2018-08-10 15:00:00,35,0,35
"22846",10501,"Grand Falls-Windsor","NL",48.92696,-55.65966,2018-08-10 16:00:00,33,0,33
"22847",10501,"Grand Falls-Windsor","NL",48.92696,-55.65966,2018-08-10 17:00:00,33,0,33
"22848",10501,"Grand Falls-Windsor","NL",48.92696,-55.65966,2018-08-10 18:00:00,32,0,32
"22849",10501,"Grand Falls-Windsor","NL",48.92696,-55.65966,2018-08-10 19:00:00,33,1,34
"22850",10501,"Grand Falls-Windsor","NL",48.92696,-55.65966,2018-08-10 20:00:00,31,0,31
"22851",10501,"Grand Falls-Windsor","NL",48.92696,-55.65966,2018-08-10 21:00:00,32,0,32
"22852",10501,"Grand Falls-Windsor","NL",48.92696,-55.65966,2018-08-10 22:00:00,38,1,39
"22853",10501,"Grand Falls-Windsor","NL",48.92696,-55.65966,2018-08-10 23:00:00,38,1,39
"22854",10501,"Grand Falls-Windsor","NL",48.92696,-55.65966,2018-08-11 00:00:00,31,1,32
"22855",10501,"Grand Falls-Windsor","NL",48.92696,-55.65966,2018-08-11 01:00:00,25,1,26
"22856",10501,"Grand Falls-Windsor","NL",48.92696,-55.65966,2018-08-11 02:00:00,24,0,24
"22857",10501,"Grand Falls-Windsor","NL",48.92696,-55.65966,2018-08-11 03:00:00,24,0,24
"22858",10501,"Grand Falls-Windsor","NL",48.92696,-55.65966,2018-08-11 04:00:00,23,0,23
"22859",10501,"Grand Falls-Windsor","NL",48.92696,-55.65966,2018-08-11 05:00:00,23,0,23
"22860",10501,"Grand Falls-Windsor","NL",48.92696,-55.65966,2018-08-11 06:00:00,19,0,19
"22861",10501,"Grand Falls-Windsor","NL",48.92696,-55.65966,2018-08-11 07:00:00,20,0,20
"22862",10501,"Grand Falls-Windsor","NL",48.92696,-55.65966,2018-08-11 08:00:00,20,0,20
"22863",10501,"Grand Falls-Windsor","NL",48.92696,-55.65966,2018-08-11 09:00:00,20,0,20
"22864",10501,"Grand Falls-Windsor","NL",48.92696,-55.65966,2018-08-11 10:00:00,22,0,22
"22865",10501,"Grand Falls-Windsor","NL",48.92696,-55.65966,2018-08-11 11:00:00,22,0,22
"22866",10501,"Grand Falls-Windsor","NL",48.92696,-55.65966,2018-08-11 12:00:00,22,0,22
"22867",10501,"Grand Falls-Windsor","NL",48.92696,-55.65966,2018-08-11 13:00:00,24,0,24
"22868",10501,"Grand Falls-Windsor","NL",48.92696,-55.65966,2018-08-11 14:00:00,25,0,25
"22869",10501,"Grand Falls-Windsor","NL",48.92696,-55.65966,2018-08-11 15:00:00,25,0,25
"22870",10501,"Grand Falls-Windsor","NL",48.92696,-55.65966,2018-08-11 16:00:00,23,0,23
"22871",10501,"Grand Falls-Windsor","NL",48.92696,-55.65966,2018-08-11 17:00:00,20,1,21
"22872",10501,"Grand Falls-Windsor","NL",48.92696,-55.65966,2018-08-11 18:00:00,18,6,24
"22873",10501,"Grand Falls-Windsor","NL",48.92696,-55.65966,2018-08-11 19:00:00,20,0,20
"22874",10501,"Grand Falls-Windsor","NL",48.92696,-55.65966,2018-08-11 20:00:00,19,0,19
"22875",10501,"Grand Falls-Windsor","NL",48.92696,-55.65966,2018-08-11 21:00:00,16,1,17
"22876",10501,"Grand Falls-Windsor","NL",48.92696,-55.65966,2018-08-11 22:00:00,16,0,16
"22877",10501,"Grand Falls-Windsor","NL",48.92696,-55.65966,2018-08-11 23:00:00,14,0,14
"22878",10501,"Grand Falls-Windsor","NL",48.92696,-55.65966,2018-08-12 00:00:00,12,0,12
"22879",10501,"Grand Falls-Windsor","NL",48.92696,-55.65966,2018-08-12 01:00:00,11,0,11
"22880",10501,"Grand Falls-Windsor","NL",48.92696,-55.65966,2018-08-12 02:00:00,11,0,11
"22881",10501,"Grand Falls-Windsor","NL",48.92696,-55.65966,2018-08-12 03:00:00,9,1,10
"22882",10501,"Grand Falls-Windsor","NL",48.92696,-55.65966,2018-08-12 04:00:00,9,0,9
"22883",10501,"Grand Falls-Windsor","NL",48.92696,-55.65966,2018-08-12 05:00:00,7,0,7
"22884",10501,"Grand Falls-Windsor","NL",48.92696,-55.65966,2018-08-12 06:00:00,9,0,9
"22885",10501,"Grand Falls-Windsor","NL",48.92696,-55.65966,2018-08-12 07:00:00,9,0,9
"22886",10501,"Grand Falls-Windsor","NL",48.92696,-55.65966,2018-08-12 08:00:00,10,0,10
"22887",10501,"Grand Falls-Windsor","NL",48.92696,-55.65966,2018-08-12 09:00:00,12,0,12
"22888",10501,"Grand Falls-Windsor","NL",48.92696,-55.65966,2018-08-12 10:00:00,14,0,14
"22889",10501,"Grand Falls-Windsor","NL",48.92696,-55.65966,2018-08-12 11:00:00,17,0,17
"22890",10501,"Grand Falls-Windsor","NL",48.92696,-55.65966,2018-08-12 12:00:00,22,0,22
"22891",10501,"Grand Falls-Windsor","NL",48.92696,-55.65966,2018-08-12 13:00:00,26,0,26
"22892",10501,"Grand Falls-Windsor","NL",48.92696,-55.65966,2018-08-12 14:00:00,27,0,27
"22893",10501,"Grand Falls-Windsor","NL",48.92696,-55.65966,2018-08-12 15:00:00,31,0,31
"22894",10501,"Grand Falls-Windsor","NL",48.92696,-55.65966,2018-08-12 16:00:00,36,0,36
"22895",10501,"Grand Falls-Windsor","NL",48.92696,-55.65966,2018-08-12 17:00:00,37,1,38
"22896",10501,"Grand Falls-Windsor","NL",48.92696,-55.65966,2018-08-12 18:00:00,36,0,36
"22897",10501,"Grand Falls-Windsor","NL",48.92696,-55.65966,2018-08-12 19:00:00,30,1,31
"22898",10501,"Grand Falls-Windsor","NL",48.92696,-55.65966,2018-08-12 20:00:00,26,1,27
"22899",10501,"Grand Falls-Windsor","NL",48.92696,-55.65966,2018-08-12 21:00:00,24,1,25
"22900",10501,"Grand Falls-Windsor","NL",48.92696,-55.65966,2018-08-12 22:00:00,22,1,23
"22901",10501,"Grand Falls-Windsor","NL",48.92696,-55.65966,2018-08-12 23:00:00,17,0,17
"22902",10501,"Grand Falls-Windsor","NL",48.92696,-55.65966,2018-08-13 00:00:00,15,0,15
"22903",10501,"Grand Falls-Windsor","NL",48.92696,-55.65966,2018-08-13 01:00:00,14,0,14
"22904",10501,"Grand Falls-Windsor","NL",48.92696,-55.65966,2018-08-13 02:00:00,11,0,11
"22905",10501,"Grand Falls-Windsor","NL",48.92696,-55.65966,2018-08-13 03:00:00,7,1,8
"22906",10501,"Grand Falls-Windsor","NL",48.92696,-55.65966,2018-08-13 04:00:00,8,0,8
"22907",10501,"Grand Falls-Windsor","NL",48.92696,-55.65966,2018-08-13 05:00:00,10,0,10
"22908",10501,"Grand Falls-Windsor","NL",48.92696,-55.65966,2018-08-13 06:00:00,10,1,11
"22909",10501,"Grand Falls-Windsor","NL",48.92696,-55.65966,2018-08-13 07:00:00,11,2,13
"22910",10501,"Grand Falls-Windsor","NL",48.92696,-55.65966,2018-08-13 08:00:00,19,1,20
"22911",10501,"Grand Falls-Windsor","NL",48.92696,-55.65966,2018-08-13 09:00:00,22,1,23
"22912",10501,"Grand Falls-Windsor","NL",48.92696,-55.65966,2018-08-13 10:00:00,21,1,22
"22913",10501,"Grand Falls-Windsor","NL",48.92696,-55.65966,2018-08-13 11:00:00,21,1,22
"22914",10501,"Grand Falls-Windsor","NL",48.92696,-55.65966,2018-08-13 12:00:00,23,0,23
"22915",10501,"Grand Falls-Windsor","NL",48.92696,-55.65966,2018-08-13 13:00:00,24,0,24
"22916",10501,"Grand Falls-Windsor","NL",48.92696,-55.65966,2018-08-13 14:00:00,24,1,25
"22917",10501,"Grand Falls-Windsor","NL",48.92696,-55.65966,2018-08-13 15:00:00,25,2,27
"22918",10501,"Grand Falls-Windsor","NL",48.92696,-55.65966,2018-08-13 16:00:00,25,1,26
"22919",10501,"Grand Falls-Windsor","NL",48.92696,-55.65966,2018-08-13 17:00:00,25,1,26
"22920",10501,"Grand Falls-Windsor","NL",48.92696,-55.65966,2018-08-13 18:00:00,25,0,25
"22921",10501,"Grand Falls-Windsor","NL",48.92696,-55.65966,2018-08-13 19:00:00,25,0,25
"22922",10501,"Grand Falls-Windsor","NL",48.92696,-55.65966,2018-08-13 20:00:00,26,0,26
"22923",10501,"Grand Falls-Windsor","NL",48.92696,-55.65966,2018-08-13 21:00:00,27,1,28
"22924",10501,"Grand Falls-Windsor","NL",48.92696,-55.65966,2018-08-13 22:00:00,27,1,28
"22925",10501,"Grand Falls-Windsor","NL",48.92696,-55.65966,2018-08-13 23:00:00,26,1,27
"22926",10501,"Grand Falls-Windsor","NL",48.92696,-55.65966,2018-08-14 00:00:00,25,1,26
"22927",10501,"Grand Falls-Windsor","NL",48.92696,-55.65966,2018-08-14 01:00:00,21,0,21
"22928",10501,"Grand Falls-Windsor","NL",48.92696,-55.65966,2018-08-14 02:00:00,21,1,22
"22929",10501,"Grand Falls-Windsor","NL",48.92696,-55.65966,2018-08-14 03:00:00,NA,NA,NA
"22930",10501,"Grand Falls-Windsor","NL",48.92696,-55.65966,2018-08-14 04:00:00,NA,NA,NA
"22931",10501,"Grand Falls-Windsor","NL",48.92696,-55.65966,2018-08-14 05:00:00,NA,NA,NA
"22932",10501,"Grand Falls-Windsor","NL",48.92696,-55.65966,2018-08-14 06:00:00,NA,NA,NA
"22933",10501,"Grand Falls-Windsor","NL",48.92696,-55.65966,2018-08-14 07:00:00,NA,NA,NA
"22934",10501,"Grand Falls-Windsor","NL",48.92696,-55.65966,2018-08-14 08:00:00,NA,NA,NA
"22935",10501,"Grand Falls-Windsor","NL",48.92696,-55.65966,2018-08-14 09:00:00,NA,NA,NA
"22936",10501,"Grand Falls-Windsor","NL",48.92696,-55.65966,2018-08-14 10:00:00,NA,NA,NA
"22937",10501,"Grand Falls-Windsor","NL",48.92696,-55.65966,2018-08-14 11:00:00,NA,NA,NA
"22938",10501,"Grand Falls-Windsor","NL",48.92696,-55.65966,2018-08-14 12:00:00,NA,NA,NA
"22939",10501,"Grand Falls-Windsor","NL",48.92696,-55.65966,2018-08-14 13:00:00,NA,NA,NA
"22940",10501,"Grand Falls-Windsor","NL",48.92696,-55.65966,2018-08-14 14:00:00,NA,NA,NA
"22941",10501,"Grand Falls-Windsor","NL",48.92696,-55.65966,2018-08-14 15:00:00,NA,NA,NA
"22942",10501,"Grand Falls-Windsor","NL",48.92696,-55.65966,2018-08-14 16:00:00,NA,NA,NA
"22943",10501,"Grand Falls-Windsor","NL",48.92696,-55.65966,2018-08-14 17:00:00,NA,NA,NA
"22944",10501,"Grand Falls-Windsor","NL",48.92696,-55.65966,2018-08-14 18:00:00,NA,NA,NA
"22945",10501,"Grand Falls-Windsor","NL",48.92696,-55.65966,2018-08-14 19:00:00,NA,NA,NA
"22946",10501,"Grand Falls-Windsor","NL",48.92696,-55.65966,2018-08-14 20:00:00,NA,NA,NA
"22947",10501,"Grand Falls-Windsor","NL",48.92696,-55.65966,2018-08-14 21:00:00,NA,NA,NA
"22948",10501,"Grand Falls-Windsor","NL",48.92696,-55.65966,2018-08-14 22:00:00,NA,NA,NA
"22949",10501,"Grand Falls-Windsor","NL",48.92696,-55.65966,2018-08-14 23:00:00,NA,NA,NA
"22950",10501,"Grand Falls-Windsor","NL",48.92696,-55.65966,2018-08-15 00:00:00,NA,NA,NA
"22951",10501,"Grand Falls-Windsor","NL",48.92696,-55.65966,2018-08-15 01:00:00,NA,NA,NA
"22952",10501,"Grand Falls-Windsor","NL",48.92696,-55.65966,2018-08-15 02:00:00,NA,NA,NA
"22953",10501,"Grand Falls-Windsor","NL",48.92696,-55.65966,2018-08-15 03:00:00,NA,NA,NA
"22954",10501,"Grand Falls-Windsor","NL",48.92696,-55.65966,2018-08-15 04:00:00,NA,NA,NA
"22955",10501,"Grand Falls-Windsor","NL",48.92696,-55.65966,2018-08-15 05:00:00,NA,NA,NA
"22956",10501,"Grand Falls-Windsor","NL",48.92696,-55.65966,2018-08-15 06:00:00,NA,NA,NA
"22957",10501,"Grand Falls-Windsor","NL",48.92696,-55.65966,2018-08-15 07:00:00,NA,NA,NA
"22958",10501,"Grand Falls-Windsor","NL",48.92696,-55.65966,2018-08-15 08:00:00,NA,NA,NA
"22959",10501,"Grand Falls-Windsor","NL",48.92696,-55.65966,2018-08-15 09:00:00,NA,NA,NA
"22960",10501,"Grand Falls-Windsor","NL",48.92696,-55.65966,2018-08-15 10:00:00,NA,NA,NA
"22961",10501,"Grand Falls-Windsor","NL",48.92696,-55.65966,2018-08-15 11:00:00,NA,NA,NA
"22962",10501,"Grand Falls-Windsor","NL",48.92696,-55.65966,2018-08-15 12:00:00,NA,NA,NA
"22963",10501,"Grand Falls-Windsor","NL",48.92696,-55.65966,2018-08-15 13:00:00,NA,NA,NA
"22964",10501,"Grand Falls-Windsor","NL",48.92696,-55.65966,2018-08-15 14:00:00,NA,NA,NA
"22965",10501,"Grand Falls-Windsor","NL",48.92696,-55.65966,2018-08-15 15:00:00,NA,NA,NA
"22966",10501,"Grand Falls-Windsor","NL",48.92696,-55.65966,2018-08-15 16:00:00,NA,NA,NA
"22967",10501,"Grand Falls-Windsor","NL",48.92696,-55.65966,2018-08-15 17:00:00,NA,NA,NA
"22968",10501,"Grand Falls-Windsor","NL",48.92696,-55.65966,2018-08-15 18:00:00,NA,NA,NA
"22969",10501,"Grand Falls-Windsor","NL",48.92696,-55.65966,2018-08-15 19:00:00,NA,NA,NA
"22970",10501,"Grand Falls-Windsor","NL",48.92696,-55.65966,2018-08-15 20:00:00,NA,NA,NA
"22971",10501,"Grand Falls-Windsor","NL",48.92696,-55.65966,2018-08-15 21:00:00,NA,NA,NA
"22972",10501,"Grand Falls-Windsor","NL",48.92696,-55.65966,2018-08-15 22:00:00,NA,NA,NA
"22973",10501,"Grand Falls-Windsor","NL",48.92696,-55.65966,2018-08-15 23:00:00,NA,NA,NA
"22974",10501,"Grand Falls-Windsor","NL",48.92696,-55.65966,2018-08-16 00:00:00,NA,NA,NA
"22975",10501,"Grand Falls-Windsor","NL",48.92696,-55.65966,2018-08-16 01:00:00,NA,NA,NA
"22976",10501,"Grand Falls-Windsor","NL",48.92696,-55.65966,2018-08-16 02:00:00,NA,NA,NA
"22977",10501,"Grand Falls-Windsor","NL",48.92696,-55.65966,2018-08-16 03:00:00,NA,NA,NA
"22978",10501,"Grand Falls-Windsor","NL",48.92696,-55.65966,2018-08-16 04:00:00,NA,NA,NA
"22979",10501,"Grand Falls-Windsor","NL",48.92696,-55.65966,2018-08-16 05:00:00,NA,NA,NA
"22980",10501,"Grand Falls-Windsor","NL",48.92696,-55.65966,2018-08-16 06:00:00,NA,NA,NA
"22981",10501,"Grand Falls-Windsor","NL",48.92696,-55.65966,2018-08-16 07:00:00,NA,NA,NA
"22982",10501,"Grand Falls-Windsor","NL",48.92696,-55.65966,2018-08-16 08:00:00,NA,NA,NA
"22983",10501,"Grand Falls-Windsor","NL",48.92696,-55.65966,2018-08-16 09:00:00,NA,NA,NA
"22984",10501,"Grand Falls-Windsor","NL",48.92696,-55.65966,2018-08-16 10:00:00,NA,NA,NA
"22985",10501,"Grand Falls-Windsor","NL",48.92696,-55.65966,2018-08-16 11:00:00,NA,NA,NA
"22986",10501,"Grand Falls-Windsor","NL",48.92696,-55.65966,2018-08-16 12:00:00,NA,NA,NA
"22987",10501,"Grand Falls-Windsor","NL",48.92696,-55.65966,2018-08-16 13:00:00,NA,NA,NA
"22988",10501,"Grand Falls-Windsor","NL",48.92696,-55.65966,2018-08-16 14:00:00,NA,NA,NA
"22989",10501,"Grand Falls-Windsor","NL",48.92696,-55.65966,2018-08-16 15:00:00,NA,NA,NA
"22990",10501,"Grand Falls-Windsor","NL",48.92696,-55.65966,2018-08-16 16:00:00,NA,NA,NA
"22991",10501,"Grand Falls-Windsor","NL",48.92696,-55.65966,2018-08-16 17:00:00,NA,NA,NA
"22992",10501,"Grand Falls-Windsor","NL",48.92696,-55.65966,2018-08-16 18:00:00,NA,NA,NA
"22993",10501,"Grand Falls-Windsor","NL",48.92696,-55.65966,2018-08-16 19:00:00,NA,NA,NA
"22994",10501,"Grand Falls-Windsor","NL",48.92696,-55.65966,2018-08-16 20:00:00,NA,NA,NA
"22995",10501,"Grand Falls-Windsor","NL",48.92696,-55.65966,2018-08-16 21:00:00,NA,NA,NA
"22996",10501,"Grand Falls-Windsor","NL",48.92696,-55.65966,2018-08-16 22:00:00,NA,NA,NA
"22997",10501,"Grand Falls-Windsor","NL",48.92696,-55.65966,2018-08-16 23:00:00,NA,NA,NA
"22998",10501,"Grand Falls-Windsor","NL",48.92696,-55.65966,2018-08-17 00:00:00,NA,NA,NA
"22999",10501,"Grand Falls-Windsor","NL",48.92696,-55.65966,2018-08-17 01:00:00,NA,NA,NA
"23000",10501,"Grand Falls-Windsor","NL",48.92696,-55.65966,2018-08-17 02:00:00,NA,NA,NA
"23001",10501,"Grand Falls-Windsor","NL",48.92696,-55.65966,2018-08-17 03:00:00,NA,NA,NA
"23002",10501,"Grand Falls-Windsor","NL",48.92696,-55.65966,2018-08-17 04:00:00,NA,NA,NA
"23003",10501,"Grand Falls-Windsor","NL",48.92696,-55.65966,2018-08-17 05:00:00,NA,NA,NA
"23004",10501,"Grand Falls-Windsor","NL",48.92696,-55.65966,2018-08-17 06:00:00,NA,NA,NA
"23005",10501,"Grand Falls-Windsor","NL",48.92696,-55.65966,2018-08-17 07:00:00,NA,NA,NA
"23006",10501,"Grand Falls-Windsor","NL",48.92696,-55.65966,2018-08-17 08:00:00,NA,NA,NA
"23007",10501,"Grand Falls-Windsor","NL",48.92696,-55.65966,2018-08-17 09:00:00,NA,NA,NA
"23008",10501,"Grand Falls-Windsor","NL",48.92696,-55.65966,2018-08-17 10:00:00,NA,NA,NA
"23009",10501,"Grand Falls-Windsor","NL",48.92696,-55.65966,2018-08-17 11:00:00,NA,NA,NA
"23010",10501,"Grand Falls-Windsor","NL",48.92696,-55.65966,2018-08-17 12:00:00,NA,NA,NA
"23011",10501,"Grand Falls-Windsor","NL",48.92696,-55.65966,2018-08-17 13:00:00,NA,NA,NA
"23012",10501,"Grand Falls-Windsor","NL",48.92696,-55.65966,2018-08-17 14:00:00,NA,NA,NA
"23013",10501,"Grand Falls-Windsor","NL",48.92696,-55.65966,2018-08-17 15:00:00,NA,NA,NA
"23014",10501,"Grand Falls-Windsor","NL",48.92696,-55.65966,2018-08-17 16:00:00,NA,NA,NA
"23015",10501,"Grand Falls-Windsor","NL",48.92696,-55.65966,2018-08-17 17:00:00,NA,NA,NA
"23016",10501,"Grand Falls-Windsor","NL",48.92696,-55.65966,2018-08-17 18:00:00,NA,NA,NA
"23017",10501,"Grand Falls-Windsor","NL",48.92696,-55.65966,2018-08-17 19:00:00,NA,NA,NA
"23018",10501,"Grand Falls-Windsor","NL",48.92696,-55.65966,2018-08-17 20:00:00,NA,NA,NA
"23019",10501,"Grand Falls-Windsor","NL",48.92696,-55.65966,2018-08-17 21:00:00,NA,NA,NA
"23020",10501,"Grand Falls-Windsor","NL",48.92696,-55.65966,2018-08-17 22:00:00,NA,NA,NA
"23021",10501,"Grand Falls-Windsor","NL",48.92696,-55.65966,2018-08-17 23:00:00,NA,NA,NA
"23022",10501,"Grand Falls-Windsor","NL",48.92696,-55.65966,2018-08-18 00:00:00,NA,NA,NA
"23023",10501,"Grand Falls-Windsor","NL",48.92696,-55.65966,2018-08-18 01:00:00,NA,NA,NA
"23024",10501,"Grand Falls-Windsor","NL",48.92696,-55.65966,2018-08-18 02:00:00,NA,NA,NA
"23025",10501,"Grand Falls-Windsor","NL",48.92696,-55.65966,2018-08-18 03:00:00,NA,NA,NA
"23026",10501,"Grand Falls-Windsor","NL",48.92696,-55.65966,2018-08-18 04:00:00,NA,NA,NA
"23027",10501,"Grand Falls-Windsor","NL",48.92696,-55.65966,2018-08-18 05:00:00,NA,NA,NA
"23028",10501,"Grand Falls-Windsor","NL",48.92696,-55.65966,2018-08-18 06:00:00,NA,NA,NA
"23029",10501,"Grand Falls-Windsor","NL",48.92696,-55.65966,2018-08-18 07:00:00,NA,NA,NA
"23030",10501,"Grand Falls-Windsor","NL",48.92696,-55.65966,2018-08-18 08:00:00,NA,NA,NA
"23031",10501,"Grand Falls-Windsor","NL",48.92696,-55.65966,2018-08-18 09:00:00,NA,NA,NA
"23032",10501,"Grand Falls-Windsor","NL",48.92696,-55.65966,2018-08-18 10:00:00,NA,NA,NA
"23033",10501,"Grand Falls-Windsor","NL",48.92696,-55.65966,2018-08-18 11:00:00,NA,NA,NA
"23034",10501,"Grand Falls-Windsor","NL",48.92696,-55.65966,2018-08-18 12:00:00,NA,NA,NA
"23035",10501,"Grand Falls-Windsor","NL",48.92696,-55.65966,2018-08-18 13:00:00,NA,NA,NA
"23036",10501,"Grand Falls-Windsor","NL",48.92696,-55.65966,2018-08-18 14:00:00,NA,NA,NA
"23037",10501,"Grand Falls-Windsor","NL",48.92696,-55.65966,2018-08-18 15:00:00,NA,NA,NA
"23038",10501,"Grand Falls-Windsor","NL",48.92696,-55.65966,2018-08-18 16:00:00,NA,NA,NA
"23039",10501,"Grand Falls-Windsor","NL",48.92696,-55.65966,2018-08-18 17:00:00,NA,NA,NA
"23040",10501,"Grand Falls-Windsor","NL",48.92696,-55.65966,2018-08-18 18:00:00,NA,NA,NA
"23041",10501,"Grand Falls-Windsor","NL",48.92696,-55.65966,2018-08-18 19:00:00,NA,NA,NA
"23042",10501,"Grand Falls-Windsor","NL",48.92696,-55.65966,2018-08-18 20:00:00,NA,NA,NA
"23043",10501,"Grand Falls-Windsor","NL",48.92696,-55.65966,2018-08-18 21:00:00,NA,NA,NA
"23044",10501,"Grand Falls-Windsor","NL",48.92696,-55.65966,2018-08-18 22:00:00,NA,NA,NA
"23045",10501,"Grand Falls-Windsor","NL",48.92696,-55.65966,2018-08-18 23:00:00,NA,NA,NA
"23046",10501,"Grand Falls-Windsor","NL",48.92696,-55.65966,2018-08-19 00:00:00,NA,NA,NA
"23047",10501,"Grand Falls-Windsor","NL",48.92696,-55.65966,2018-08-19 01:00:00,NA,NA,NA
"23048",10501,"Grand Falls-Windsor","NL",48.92696,-55.65966,2018-08-19 02:00:00,NA,NA,NA
"23049",10501,"Grand Falls-Windsor","NL",48.92696,-55.65966,2018-08-19 03:00:00,NA,NA,NA
"23050",10501,"Grand Falls-Windsor","NL",48.92696,-55.65966,2018-08-19 04:00:00,NA,NA,NA
"23051",10501,"Grand Falls-Windsor","NL",48.92696,-55.65966,2018-08-19 05:00:00,NA,NA,NA
"23052",10501,"Grand Falls-Windsor","NL",48.92696,-55.65966,2018-08-19 06:00:00,NA,NA,NA
"23053",10501,"Grand Falls-Windsor","NL",48.92696,-55.65966,2018-08-19 07:00:00,NA,NA,NA
"23054",10501,"Grand Falls-Windsor","NL",48.92696,-55.65966,2018-08-19 08:00:00,NA,NA,NA
"23055",10501,"Grand Falls-Windsor","NL",48.92696,-55.65966,2018-08-19 09:00:00,NA,NA,NA
"23056",10501,"Grand Falls-Windsor","NL",48.92696,-55.65966,2018-08-19 10:00:00,NA,NA,NA
"23057",10501,"Grand Falls-Windsor","NL",48.92696,-55.65966,2018-08-19 11:00:00,NA,NA,NA
"23058",10501,"Grand Falls-Windsor","NL",48.92696,-55.65966,2018-08-19 12:00:00,NA,NA,NA
"23059",10501,"Grand Falls-Windsor","NL",48.92696,-55.65966,2018-08-19 13:00:00,NA,NA,NA
"23060",10501,"Grand Falls-Windsor","NL",48.92696,-55.65966,2018-08-19 14:00:00,NA,NA,NA
"23061",10501,"Grand Falls-Windsor","NL",48.92696,-55.65966,2018-08-19 15:00:00,NA,NA,NA
"23062",10501,"Grand Falls-Windsor","NL",48.92696,-55.65966,2018-08-19 16:00:00,NA,NA,NA
"23063",10501,"Grand Falls-Windsor","NL",48.92696,-55.65966,2018-08-19 17:00:00,NA,NA,NA
"23064",10501,"Grand Falls-Windsor","NL",48.92696,-55.65966,2018-08-19 18:00:00,NA,NA,NA
"23065",10501,"Grand Falls-Windsor","NL",48.92696,-55.65966,2018-08-19 19:00:00,NA,NA,NA
"23066",10501,"Grand Falls-Windsor","NL",48.92696,-55.65966,2018-08-19 20:00:00,NA,NA,NA
"23067",10501,"Grand Falls-Windsor","NL",48.92696,-55.65966,2018-08-19 21:00:00,NA,NA,NA
"23068",10501,"Grand Falls-Windsor","NL",48.92696,-55.65966,2018-08-19 22:00:00,NA,NA,NA
"23069",10501,"Grand Falls-Windsor","NL",48.92696,-55.65966,2018-08-19 23:00:00,NA,NA,NA
"23070",10501,"Grand Falls-Windsor","NL",48.92696,-55.65966,2018-08-20 00:00:00,NA,NA,NA
"23071",10501,"Grand Falls-Windsor","NL",48.92696,-55.65966,2018-08-20 01:00:00,NA,NA,NA
"23072",10501,"Grand Falls-Windsor","NL",48.92696,-55.65966,2018-08-20 02:00:00,NA,NA,NA
"23073",10501,"Grand Falls-Windsor","NL",48.92696,-55.65966,2018-08-20 03:00:00,NA,NA,NA
"23074",10501,"Grand Falls-Windsor","NL",48.92696,-55.65966,2018-08-20 04:00:00,NA,NA,NA
"23075",10501,"Grand Falls-Windsor","NL",48.92696,-55.65966,2018-08-20 05:00:00,NA,NA,NA
"23076",10501,"Grand Falls-Windsor","NL",48.92696,-55.65966,2018-08-20 06:00:00,NA,NA,NA
"23077",10501,"Grand Falls-Windsor","NL",48.92696,-55.65966,2018-08-20 07:00:00,NA,NA,NA
"23078",10501,"Grand Falls-Windsor","NL",48.92696,-55.65966,2018-08-20 08:00:00,NA,NA,NA
"23079",10501,"Grand Falls-Windsor","NL",48.92696,-55.65966,2018-08-20 09:00:00,NA,NA,NA
"23080",10501,"Grand Falls-Windsor","NL",48.92696,-55.65966,2018-08-20 10:00:00,NA,NA,NA
"23081",10501,"Grand Falls-Windsor","NL",48.92696,-55.65966,2018-08-20 11:00:00,NA,NA,NA
"23082",10501,"Grand Falls-Windsor","NL",48.92696,-55.65966,2018-08-20 12:00:00,NA,NA,NA
"23083",10501,"Grand Falls-Windsor","NL",48.92696,-55.65966,2018-08-20 13:00:00,NA,NA,NA
"23084",10501,"Grand Falls-Windsor","NL",48.92696,-55.65966,2018-08-20 14:00:00,NA,NA,NA
"23085",10501,"Grand Falls-Windsor","NL",48.92696,-55.65966,2018-08-20 15:00:00,NA,NA,NA
"23086",10501,"Grand Falls-Windsor","NL",48.92696,-55.65966,2018-08-20 16:00:00,NA,NA,NA
"23087",10501,"Grand Falls-Windsor","NL",48.92696,-55.65966,2018-08-20 17:00:00,NA,NA,NA
"23088",10501,"Grand Falls-Windsor","NL",48.92696,-55.65966,2018-08-20 18:00:00,NA,NA,NA
"23089",10501,"Grand Falls-Windsor","NL",48.92696,-55.65966,2018-08-20 19:00:00,NA,NA,NA
"23090",10501,"Grand Falls-Windsor","NL",48.92696,-55.65966,2018-08-20 20:00:00,NA,NA,NA
"23091",10501,"Grand Falls-Windsor","NL",48.92696,-55.65966,2018-08-20 21:00:00,NA,NA,NA
"23092",10501,"Grand Falls-Windsor","NL",48.92696,-55.65966,2018-08-20 22:00:00,NA,NA,NA
"23093",10501,"Grand Falls-Windsor","NL",48.92696,-55.65966,2018-08-20 23:00:00,NA,NA,NA
"23094",10501,"Grand Falls-Windsor","NL",48.92696,-55.65966,2018-08-21 00:00:00,NA,NA,NA
"23095",10501,"Grand Falls-Windsor","NL",48.92696,-55.65966,2018-08-21 01:00:00,NA,NA,NA
"23096",10501,"Grand Falls-Windsor","NL",48.92696,-55.65966,2018-08-21 02:00:00,NA,NA,NA
"23097",10501,"Grand Falls-Windsor","NL",48.92696,-55.65966,2018-08-21 03:00:00,NA,NA,NA
"23098",10501,"Grand Falls-Windsor","NL",48.92696,-55.65966,2018-08-21 04:00:00,NA,NA,NA
"23099",10501,"Grand Falls-Windsor","NL",48.92696,-55.65966,2018-08-21 05:00:00,NA,NA,NA
"23100",10501,"Grand Falls-Windsor","NL",48.92696,-55.65966,2018-08-21 06:00:00,NA,NA,NA
"23101",10501,"Grand Falls-Windsor","NL",48.92696,-55.65966,2018-08-21 07:00:00,NA,NA,NA
"23102",10501,"Grand Falls-Windsor","NL",48.92696,-55.65966,2018-08-21 08:00:00,NA,NA,NA
"23103",10501,"Grand Falls-Windsor","NL",48.92696,-55.65966,2018-08-21 09:00:00,NA,NA,NA
"23104",10501,"Grand Falls-Windsor","NL",48.92696,-55.65966,2018-08-21 10:00:00,NA,NA,NA
"23105",10501,"Grand Falls-Windsor","NL",48.92696,-55.65966,2018-08-21 11:00:00,NA,NA,NA
"23106",10501,"Grand Falls-Windsor","NL",48.92696,-55.65966,2018-08-21 12:00:00,NA,NA,NA
"23107",10501,"Grand Falls-Windsor","NL",48.92696,-55.65966,2018-08-21 13:00:00,NA,NA,NA
"23108",10501,"Grand Falls-Windsor","NL",48.92696,-55.65966,2018-08-21 14:00:00,NA,NA,NA
"23109",10501,"Grand Falls-Windsor","NL",48.92696,-55.65966,2018-08-21 15:00:00,NA,NA,NA
"23110",10501,"Grand Falls-Windsor","NL",48.92696,-55.65966,2018-08-21 16:00:00,NA,NA,NA
"23111",10501,"Grand Falls-Windsor","NL",48.92696,-55.65966,2018-08-21 17:00:00,NA,NA,NA
"23112",10501,"Grand Falls-Windsor","NL",48.92696,-55.65966,2018-08-21 18:00:00,NA,NA,NA
"23113",10501,"Grand Falls-Windsor","NL",48.92696,-55.65966,2018-08-21 19:00:00,NA,NA,NA
"23114",10501,"Grand Falls-Windsor","NL",48.92696,-55.65966,2018-08-21 20:00:00,NA,NA,NA
"23115",10501,"Grand Falls-Windsor","NL",48.92696,-55.65966,2018-08-21 21:00:00,NA,NA,NA
"23116",10501,"Grand Falls-Windsor","NL",48.92696,-55.65966,2018-08-21 22:00:00,NA,NA,NA
"23117",10501,"Grand Falls-Windsor","NL",48.92696,-55.65966,2018-08-21 23:00:00,NA,NA,NA
"23118",10501,"Grand Falls-Windsor","NL",48.92696,-55.65966,2018-08-22 00:00:00,NA,NA,NA
"23119",10501,"Grand Falls-Windsor","NL",48.92696,-55.65966,2018-08-22 01:00:00,NA,NA,NA
"23120",10501,"Grand Falls-Windsor","NL",48.92696,-55.65966,2018-08-22 02:00:00,NA,NA,NA
"23121",10501,"Grand Falls-Windsor","NL",48.92696,-55.65966,2018-08-22 03:00:00,NA,NA,NA
"23122",10501,"Grand Falls-Windsor","NL",48.92696,-55.65966,2018-08-22 04:00:00,NA,NA,NA
"23123",10501,"Grand Falls-Windsor","NL",48.92696,-55.65966,2018-08-22 05:00:00,NA,NA,NA
"23124",10501,"Grand Falls-Windsor","NL",48.92696,-55.65966,2018-08-22 06:00:00,NA,NA,NA
"23125",10501,"Grand Falls-Windsor","NL",48.92696,-55.65966,2018-08-22 07:00:00,NA,NA,NA
"23126",10501,"Grand Falls-Windsor","NL",48.92696,-55.65966,2018-08-22 08:00:00,NA,NA,NA
"23127",10501,"Grand Falls-Windsor","NL",48.92696,-55.65966,2018-08-22 09:00:00,NA,NA,NA
"23128",10501,"Grand Falls-Windsor","NL",48.92696,-55.65966,2018-08-22 10:00:00,NA,NA,NA
"23129",10501,"Grand Falls-Windsor","NL",48.92696,-55.65966,2018-08-22 11:00:00,NA,NA,NA
"23130",10501,"Grand Falls-Windsor","NL",48.92696,-55.65966,2018-08-22 12:00:00,NA,NA,NA
"23131",10501,"Grand Falls-Windsor","NL",48.92696,-55.65966,2018-08-22 13:00:00,NA,NA,NA
"23132",10501,"Grand Falls-Windsor","NL",48.92696,-55.65966,2018-08-22 14:00:00,NA,NA,NA
"23133",10501,"Grand Falls-Windsor","NL",48.92696,-55.65966,2018-08-22 15:00:00,NA,NA,NA
"23134",10501,"Grand Falls-Windsor","NL",48.92696,-55.65966,2018-08-22 16:00:00,NA,NA,NA
"23135",10501,"Grand Falls-Windsor","NL",48.92696,-55.65966,2018-08-22 17:00:00,NA,NA,NA
"23136",10501,"Grand Falls-Windsor","NL",48.92696,-55.65966,2018-08-22 18:00:00,NA,NA,NA
"23137",10501,"Grand Falls-Windsor","NL",48.92696,-55.65966,2018-08-22 19:00:00,NA,NA,NA
"23138",10501,"Grand Falls-Windsor","NL",48.92696,-55.65966,2018-08-22 20:00:00,NA,NA,NA
"23139",10501,"Grand Falls-Windsor","NL",48.92696,-55.65966,2018-08-22 21:00:00,NA,NA,NA
"23140",10501,"Grand Falls-Windsor","NL",48.92696,-55.65966,2018-08-22 22:00:00,NA,NA,NA
"23141",10501,"Grand Falls-Windsor","NL",48.92696,-55.65966,2018-08-22 23:00:00,NA,NA,NA
"23142",10501,"Grand Falls-Windsor","NL",48.92696,-55.65966,2018-08-23 00:00:00,NA,NA,NA
"23143",10501,"Grand Falls-Windsor","NL",48.92696,-55.65966,2018-08-23 01:00:00,NA,NA,NA
"23144",10501,"Grand Falls-Windsor","NL",48.92696,-55.65966,2018-08-23 02:00:00,NA,NA,NA
"23145",10501,"Grand Falls-Windsor","NL",48.92696,-55.65966,2018-08-23 03:00:00,NA,NA,NA
"23146",10501,"Grand Falls-Windsor","NL",48.92696,-55.65966,2018-08-23 04:00:00,NA,NA,NA
"23147",10501,"Grand Falls-Windsor","NL",48.92696,-55.65966,2018-08-23 05:00:00,NA,NA,NA
"23148",10501,"Grand Falls-Windsor","NL",48.92696,-55.65966,2018-08-23 06:00:00,NA,NA,NA
"23149",10501,"Grand Falls-Windsor","NL",48.92696,-55.65966,2018-08-23 07:00:00,NA,NA,NA
"23150",10501,"Grand Falls-Windsor","NL",48.92696,-55.65966,2018-08-23 08:00:00,NA,NA,NA
"23151",10501,"Grand Falls-Windsor","NL",48.92696,-55.65966,2018-08-23 09:00:00,NA,NA,NA
"23152",10501,"Grand Falls-Windsor","NL",48.92696,-55.65966,2018-08-23 10:00:00,NA,NA,NA
"23153",10501,"Grand Falls-Windsor","NL",48.92696,-55.65966,2018-08-23 11:00:00,NA,NA,NA
"23154",10501,"Grand Falls-Windsor","NL",48.92696,-55.65966,2018-08-23 12:00:00,NA,NA,NA
"23155",10501,"Grand Falls-Windsor","NL",48.92696,-55.65966,2018-08-23 13:00:00,NA,NA,NA
"23156",10501,"Grand Falls-Windsor","NL",48.92696,-55.65966,2018-08-23 14:00:00,NA,NA,NA
"23157",10501,"Grand Falls-Windsor","NL",48.92696,-55.65966,2018-08-23 15:00:00,NA,NA,NA
"23158",10501,"Grand Falls-Windsor","NL",48.92696,-55.65966,2018-08-23 16:00:00,NA,NA,NA
"23159",10501,"Grand Falls-Windsor","NL",48.92696,-55.65966,2018-08-23 17:00:00,NA,NA,NA
"23160",10501,"Grand Falls-Windsor","NL",48.92696,-55.65966,2018-08-23 18:00:00,NA,NA,NA
"23161",10501,"Grand Falls-Windsor","NL",48.92696,-55.65966,2018-08-23 19:00:00,NA,NA,NA
"23162",10501,"Grand Falls-Windsor","NL",48.92696,-55.65966,2018-08-23 20:00:00,NA,NA,NA
"23163",10501,"Grand Falls-Windsor","NL",48.92696,-55.65966,2018-08-23 21:00:00,NA,NA,NA
"23164",10501,"Grand Falls-Windsor","NL",48.92696,-55.65966,2018-08-23 22:00:00,NA,NA,NA
"23165",10501,"Grand Falls-Windsor","NL",48.92696,-55.65966,2018-08-23 23:00:00,NA,NA,NA
"23166",10501,"Grand Falls-Windsor","NL",48.92696,-55.65966,2018-08-24 00:00:00,NA,NA,NA
"23167",10501,"Grand Falls-Windsor","NL",48.92696,-55.65966,2018-08-24 01:00:00,NA,NA,NA
"23168",10501,"Grand Falls-Windsor","NL",48.92696,-55.65966,2018-08-24 02:00:00,NA,NA,NA
"23169",10501,"Grand Falls-Windsor","NL",48.92696,-55.65966,2018-08-24 03:00:00,NA,NA,NA
"23170",10501,"Grand Falls-Windsor","NL",48.92696,-55.65966,2018-08-24 04:00:00,NA,NA,NA
"23171",10501,"Grand Falls-Windsor","NL",48.92696,-55.65966,2018-08-24 05:00:00,NA,NA,NA
"23172",10501,"Grand Falls-Windsor","NL",48.92696,-55.65966,2018-08-24 06:00:00,NA,NA,NA
"23173",10501,"Grand Falls-Windsor","NL",48.92696,-55.65966,2018-08-24 07:00:00,NA,NA,NA
"23174",10501,"Grand Falls-Windsor","NL",48.92696,-55.65966,2018-08-24 08:00:00,NA,NA,NA
"23175",10501,"Grand Falls-Windsor","NL",48.92696,-55.65966,2018-08-24 09:00:00,NA,NA,NA
"23176",10501,"Grand Falls-Windsor","NL",48.92696,-55.65966,2018-08-24 10:00:00,NA,NA,NA
"23177",10501,"Grand Falls-Windsor","NL",48.92696,-55.65966,2018-08-24 11:00:00,NA,NA,NA
"23178",10501,"Grand Falls-Windsor","NL",48.92696,-55.65966,2018-08-24 12:00:00,NA,NA,NA
"23179",10501,"Grand Falls-Windsor","NL",48.92696,-55.65966,2018-08-24 13:00:00,NA,NA,NA
"23180",10501,"Grand Falls-Windsor","NL",48.92696,-55.65966,2018-08-24 14:00:00,28,NA,NA
"23181",10501,"Grand Falls-Windsor","NL",48.92696,-55.65966,2018-08-24 15:00:00,30,1,31
"23182",10501,"Grand Falls-Windsor","NL",48.92696,-55.65966,2018-08-24 16:00:00,31,0,31
"23183",10501,"Grand Falls-Windsor","NL",48.92696,-55.65966,2018-08-24 17:00:00,31,0,31
"23184",10501,"Grand Falls-Windsor","NL",48.92696,-55.65966,2018-08-24 18:00:00,30,0,30
"23185",10501,"Grand Falls-Windsor","NL",48.92696,-55.65966,2018-08-24 19:00:00,30,0,30
"23186",10501,"Grand Falls-Windsor","NL",48.92696,-55.65966,2018-08-24 20:00:00,26,0,26
"23187",10501,"Grand Falls-Windsor","NL",48.92696,-55.65966,2018-08-24 21:00:00,27,1,28
"23188",10501,"Grand Falls-Windsor","NL",48.92696,-55.65966,2018-08-24 22:00:00,28,0,28
"23189",10501,"Grand Falls-Windsor","NL",48.92696,-55.65966,2018-08-24 23:00:00,25,0,25
"23190",10501,"Grand Falls-Windsor","NL",48.92696,-55.65966,2018-08-25 00:00:00,26,0,26
"23191",10501,"Grand Falls-Windsor","NL",48.92696,-55.65966,2018-08-25 01:00:00,24,0,24
"23192",10501,"Grand Falls-Windsor","NL",48.92696,-55.65966,2018-08-25 02:00:00,23,0,23
"23193",10501,"Grand Falls-Windsor","NL",48.92696,-55.65966,2018-08-25 03:00:00,22,0,22
"23194",10501,"Grand Falls-Windsor","NL",48.92696,-55.65966,2018-08-25 04:00:00,20,0,20
"23195",10501,"Grand Falls-Windsor","NL",48.92696,-55.65966,2018-08-25 05:00:00,19,0,19
"23196",10501,"Grand Falls-Windsor","NL",48.92696,-55.65966,2018-08-25 06:00:00,14,1,15
"23197",10501,"Grand Falls-Windsor","NL",48.92696,-55.65966,2018-08-25 07:00:00,11,1,12
"23198",10501,"Grand Falls-Windsor","NL",48.92696,-55.65966,2018-08-25 08:00:00,13,1,14
"23199",10501,"Grand Falls-Windsor","NL",48.92696,-55.65966,2018-08-25 09:00:00,15,0,15
"23200",10501,"Grand Falls-Windsor","NL",48.92696,-55.65966,2018-08-25 10:00:00,21,1,22
"23201",10501,"Grand Falls-Windsor","NL",48.92696,-55.65966,2018-08-25 11:00:00,25,0,25
"23202",10501,"Grand Falls-Windsor","NL",48.92696,-55.65966,2018-08-25 12:00:00,28,0,28
"23203",10501,"Grand Falls-Windsor","NL",48.92696,-55.65966,2018-08-25 13:00:00,29,0,29
"23204",10501,"Grand Falls-Windsor","NL",48.92696,-55.65966,2018-08-25 14:00:00,28,0,28
"23205",10501,"Grand Falls-Windsor","NL",48.92696,-55.65966,2018-08-25 15:00:00,28,0,28
"23206",10501,"Grand Falls-Windsor","NL",48.92696,-55.65966,2018-08-25 16:00:00,30,0,30
"23207",10501,"Grand Falls-Windsor","NL",48.92696,-55.65966,2018-08-25 17:00:00,30,0,30
"23208",10501,"Grand Falls-Windsor","NL",48.92696,-55.65966,2018-08-25 18:00:00,31,0,31
"23209",10501,"Grand Falls-Windsor","NL",48.92696,-55.65966,2018-08-25 19:00:00,32,0,32
"23210",10501,"Grand Falls-Windsor","NL",48.92696,-55.65966,2018-08-25 20:00:00,31,0,31
"23211",10501,"Grand Falls-Windsor","NL",48.92696,-55.65966,2018-08-25 21:00:00,30,0,30
"23212",10501,"Grand Falls-Windsor","NL",48.92696,-55.65966,2018-08-25 22:00:00,28,0,28
"23213",10501,"Grand Falls-Windsor","NL",48.92696,-55.65966,2018-08-25 23:00:00,27,0,27
"23214",10501,"Grand Falls-Windsor","NL",48.92696,-55.65966,2018-08-26 00:00:00,27,0,27
"23215",10501,"Grand Falls-Windsor","NL",48.92696,-55.65966,2018-08-26 01:00:00,30,0,30
"23216",10501,"Grand Falls-Windsor","NL",48.92696,-55.65966,2018-08-26 02:00:00,32,0,32
"23217",10501,"Grand Falls-Windsor","NL",48.92696,-55.65966,2018-08-26 03:00:00,33,0,33
"23218",10501,"Grand Falls-Windsor","NL",48.92696,-55.65966,2018-08-26 04:00:00,31,0,31
"23219",10501,"Grand Falls-Windsor","NL",48.92696,-55.65966,2018-08-26 05:00:00,30,0,30
"23220",10501,"Grand Falls-Windsor","NL",48.92696,-55.65966,2018-08-26 06:00:00,29,0,29
"23221",10501,"Grand Falls-Windsor","NL",48.92696,-55.65966,2018-08-26 07:00:00,29,0,29
"23222",10501,"Grand Falls-Windsor","NL",48.92696,-55.65966,2018-08-26 08:00:00,30,0,30
"23223",10501,"Grand Falls-Windsor","NL",48.92696,-55.65966,2018-08-26 09:00:00,30,0,30
"23224",10501,"Grand Falls-Windsor","NL",48.92696,-55.65966,2018-08-26 10:00:00,33,0,33
"23225",10501,"Grand Falls-Windsor","NL",48.92696,-55.65966,2018-08-26 11:00:00,38,0,38
"23226",10501,"Grand Falls-Windsor","NL",48.92696,-55.65966,2018-08-26 12:00:00,42,1,43
"23227",10501,"Grand Falls-Windsor","NL",48.92696,-55.65966,2018-08-26 13:00:00,43,1,44
"23228",10501,"Grand Falls-Windsor","NL",48.92696,-55.65966,2018-08-26 14:00:00,43,0,43
"23229",10501,"Grand Falls-Windsor","NL",48.92696,-55.65966,2018-08-26 15:00:00,43,0,43
"23230",10501,"Grand Falls-Windsor","NL",48.92696,-55.65966,2018-08-26 16:00:00,45,0,45
"23231",10501,"Grand Falls-Windsor","NL",48.92696,-55.65966,2018-08-26 17:00:00,45,0,45
"23232",10501,"Grand Falls-Windsor","NL",48.92696,-55.65966,2018-08-26 18:00:00,44,1,45
"23233",10501,"Grand Falls-Windsor","NL",48.92696,-55.65966,2018-08-26 19:00:00,40,1,41
"23234",10501,"Grand Falls-Windsor","NL",48.92696,-55.65966,2018-08-26 20:00:00,35,0,35
"23235",10501,"Grand Falls-Windsor","NL",48.92696,-55.65966,2018-08-26 21:00:00,35,1,36
"23236",10501,"Grand Falls-Windsor","NL",48.92696,-55.65966,2018-08-26 22:00:00,33,1,34
"23237",10501,"Grand Falls-Windsor","NL",48.92696,-55.65966,2018-08-26 23:00:00,31,1,32
"23238",10501,"Grand Falls-Windsor","NL",48.92696,-55.65966,2018-08-27 00:00:00,27,1,28
"23239",10501,"Grand Falls-Windsor","NL",48.92696,-55.65966,2018-08-27 01:00:00,23,1,24
"23240",10501,"Grand Falls-Windsor","NL",48.92696,-55.65966,2018-08-27 02:00:00,22,0,22
"23241",10501,"Grand Falls-Windsor","NL",48.92696,-55.65966,2018-08-27 03:00:00,15,2,17
"23242",10501,"Grand Falls-Windsor","NL",48.92696,-55.65966,2018-08-27 04:00:00,10,1,11
"23243",10501,"Grand Falls-Windsor","NL",48.92696,-55.65966,2018-08-27 05:00:00,11,1,12
"23244",10501,"Grand Falls-Windsor","NL",48.92696,-55.65966,2018-08-27 06:00:00,12,1,13
"23245",10501,"Grand Falls-Windsor","NL",48.92696,-55.65966,2018-08-27 07:00:00,12,2,14
"23246",10501,"Grand Falls-Windsor","NL",48.92696,-55.65966,2018-08-27 08:00:00,16,1,17
"23247",10501,"Grand Falls-Windsor","NL",48.92696,-55.65966,2018-08-27 09:00:00,18,1,19
"23248",10501,"Grand Falls-Windsor","NL",48.92696,-55.65966,2018-08-27 10:00:00,23,0,23
"23249",10501,"Grand Falls-Windsor","NL",48.92696,-55.65966,2018-08-27 11:00:00,29,0,29
"23250",10501,"Grand Falls-Windsor","NL",48.92696,-55.65966,2018-08-27 12:00:00,31,0,31
"23251",10501,"Grand Falls-Windsor","NL",48.92696,-55.65966,2018-08-27 13:00:00,38,1,39
"23252",10501,"Grand Falls-Windsor","NL",48.92696,-55.65966,2018-08-27 14:00:00,41,0,41
"23253",10501,"Grand Falls-Windsor","NL",48.92696,-55.65966,2018-08-27 15:00:00,45,0,45
"23254",10501,"Grand Falls-Windsor","NL",48.92696,-55.65966,2018-08-27 16:00:00,46,0,46
"23255",10501,"Grand Falls-Windsor","NL",48.92696,-55.65966,2018-08-27 17:00:00,46,0,46
"23256",10501,"Grand Falls-Windsor","NL",48.92696,-55.65966,2018-08-27 18:00:00,42,0,42
"23257",10501,"Grand Falls-Windsor","NL",48.92696,-55.65966,2018-08-27 19:00:00,38,1,39
"23258",10501,"Grand Falls-Windsor","NL",48.92696,-55.65966,2018-08-27 20:00:00,25,5,30
"23259",10501,"Grand Falls-Windsor","NL",48.92696,-55.65966,2018-08-27 21:00:00,22,3,25
"23260",10501,"Grand Falls-Windsor","NL",48.92696,-55.65966,2018-08-27 22:00:00,18,1,19
"23261",10501,"Grand Falls-Windsor","NL",48.92696,-55.65966,2018-08-27 23:00:00,15,1,16
"23262",10501,"Grand Falls-Windsor","NL",48.92696,-55.65966,2018-08-28 00:00:00,14,1,15
"23263",10501,"Grand Falls-Windsor","NL",48.92696,-55.65966,2018-08-28 01:00:00,13,0,13
"23264",10501,"Grand Falls-Windsor","NL",48.92696,-55.65966,2018-08-28 02:00:00,11,0,11
"23265",10501,"Grand Falls-Windsor","NL",48.92696,-55.65966,2018-08-28 03:00:00,12,0,12
"23266",10501,"Grand Falls-Windsor","NL",48.92696,-55.65966,2018-08-28 04:00:00,13,0,13
"23267",10501,"Grand Falls-Windsor","NL",48.92696,-55.65966,2018-08-28 05:00:00,12,0,12
"23268",10501,"Grand Falls-Windsor","NL",48.92696,-55.65966,2018-08-28 06:00:00,12,0,12
"23269",10501,"Grand Falls-Windsor","NL",48.92696,-55.65966,2018-08-28 07:00:00,15,1,16
"23270",10501,"Grand Falls-Windsor","NL",48.92696,-55.65966,2018-08-28 08:00:00,22,0,22
"23271",10501,"Grand Falls-Windsor","NL",48.92696,-55.65966,2018-08-28 09:00:00,23,1,24
"23272",10501,"Grand Falls-Windsor","NL",48.92696,-55.65966,2018-08-28 10:00:00,29,1,30
"23273",10501,"Grand Falls-Windsor","NL",48.92696,-55.65966,2018-08-28 11:00:00,30,1,31
"23274",10501,"Grand Falls-Windsor","NL",48.92696,-55.65966,2018-08-28 12:00:00,36,1,37
"23275",10501,"Grand Falls-Windsor","NL",48.92696,-55.65966,2018-08-28 13:00:00,38,1,39
"23276",10501,"Grand Falls-Windsor","NL",48.92696,-55.65966,2018-08-28 14:00:00,36,0,36
"23277",10501,"Grand Falls-Windsor","NL",48.92696,-55.65966,2018-08-28 15:00:00,40,1,41
"23278",10501,"Grand Falls-Windsor","NL",48.92696,-55.65966,2018-08-28 16:00:00,43,1,44
"23279",10501,"Grand Falls-Windsor","NL",48.92696,-55.65966,2018-08-28 17:00:00,42,1,43
"23280",10501,"Grand Falls-Windsor","NL",48.92696,-55.65966,2018-08-28 18:00:00,41,1,42
"23281",10501,"Grand Falls-Windsor","NL",48.92696,-55.65966,2018-08-28 19:00:00,34,1,35
"23282",10501,"Grand Falls-Windsor","NL",48.92696,-55.65966,2018-08-28 20:00:00,26,2,28
"23283",10501,"Grand Falls-Windsor","NL",48.92696,-55.65966,2018-08-28 21:00:00,28,1,29
"23284",10501,"Grand Falls-Windsor","NL",48.92696,-55.65966,2018-08-28 22:00:00,30,0,30
"23285",10501,"Grand Falls-Windsor","NL",48.92696,-55.65966,2018-08-28 23:00:00,30,0,30
"23286",10501,"Grand Falls-Windsor","NL",48.92696,-55.65966,2018-08-29 00:00:00,31,0,31
"23287",10501,"Grand Falls-Windsor","NL",48.92696,-55.65966,2018-08-29 01:00:00,35,0,35
"23288",10501,"Grand Falls-Windsor","NL",48.92696,-55.65966,2018-08-29 02:00:00,37,0,37
"23289",10501,"Grand Falls-Windsor","NL",48.92696,-55.65966,2018-08-29 03:00:00,36,0,36
"23290",10501,"Grand Falls-Windsor","NL",48.92696,-55.65966,2018-08-29 04:00:00,37,0,37
"23291",10501,"Grand Falls-Windsor","NL",48.92696,-55.65966,2018-08-29 05:00:00,37,0,37
"23292",10501,"Grand Falls-Windsor","NL",48.92696,-55.65966,2018-08-29 06:00:00,36,0,36
"23293",10501,"Grand Falls-Windsor","NL",48.92696,-55.65966,2018-08-29 07:00:00,37,0,37
"23294",10501,"Grand Falls-Windsor","NL",48.92696,-55.65966,2018-08-29 08:00:00,37,0,37
"23295",10501,"Grand Falls-Windsor","NL",48.92696,-55.65966,2018-08-29 09:00:00,39,0,39
"23296",10501,"Grand Falls-Windsor","NL",48.92696,-55.65966,2018-08-29 10:00:00,40,0,40
"23297",10501,"Grand Falls-Windsor","NL",48.92696,-55.65966,2018-08-29 11:00:00,40,0,40
"23298",10501,"Grand Falls-Windsor","NL",48.92696,-55.65966,2018-08-29 12:00:00,35,0,35
"23299",10501,"Grand Falls-Windsor","NL",48.92696,-55.65966,2018-08-29 13:00:00,34,0,34
"23300",10501,"Grand Falls-Windsor","NL",48.92696,-55.65966,2018-08-29 14:00:00,36,1,37
"23301",10501,"Grand Falls-Windsor","NL",48.92696,-55.65966,2018-08-29 15:00:00,25,1,26
"23302",10501,"Grand Falls-Windsor","NL",48.92696,-55.65966,2018-08-29 16:00:00,22,0,22
"23303",10501,"Grand Falls-Windsor","NL",48.92696,-55.65966,2018-08-29 17:00:00,23,1,24
"23304",10501,"Grand Falls-Windsor","NL",48.92696,-55.65966,2018-08-29 18:00:00,23,1,24
"23305",10501,"Grand Falls-Windsor","NL",48.92696,-55.65966,2018-08-29 19:00:00,22,1,23
"23306",10501,"Grand Falls-Windsor","NL",48.92696,-55.65966,2018-08-29 20:00:00,24,1,25
"23307",10501,"Grand Falls-Windsor","NL",48.92696,-55.65966,2018-08-29 21:00:00,24,1,25
"23308",10501,"Grand Falls-Windsor","NL",48.92696,-55.65966,2018-08-29 22:00:00,22,1,23
"23309",10501,"Grand Falls-Windsor","NL",48.92696,-55.65966,2018-08-29 23:00:00,21,0,21
"23310",10501,"Grand Falls-Windsor","NL",48.92696,-55.65966,2018-08-30 00:00:00,21,0,21
"23311",10501,"Grand Falls-Windsor","NL",48.92696,-55.65966,2018-08-30 01:00:00,20,0,20
"23312",10501,"Grand Falls-Windsor","NL",48.92696,-55.65966,2018-08-30 02:00:00,19,0,19
"23313",10501,"Grand Falls-Windsor","NL",48.92696,-55.65966,2018-08-30 03:00:00,18,0,18
"23314",10501,"Grand Falls-Windsor","NL",48.92696,-55.65966,2018-08-30 04:00:00,19,0,19
"23315",10501,"Grand Falls-Windsor","NL",48.92696,-55.65966,2018-08-30 05:00:00,20,0,20
"23316",10501,"Grand Falls-Windsor","NL",48.92696,-55.65966,2018-08-30 06:00:00,20,0,20
"23317",10501,"Grand Falls-Windsor","NL",48.92696,-55.65966,2018-08-30 07:00:00,21,0,21
"23318",10501,"Grand Falls-Windsor","NL",48.92696,-55.65966,2018-08-30 08:00:00,20,1,21
"23319",10501,"Grand Falls-Windsor","NL",48.92696,-55.65966,2018-08-30 09:00:00,19,1,20
"23320",10501,"Grand Falls-Windsor","NL",48.92696,-55.65966,2018-08-30 10:00:00,18,2,20
"23321",10501,"Grand Falls-Windsor","NL",48.92696,-55.65966,2018-08-30 11:00:00,20,1,21
"23322",10501,"Grand Falls-Windsor","NL",48.92696,-55.65966,2018-08-30 12:00:00,20,0,20
"23323",10501,"Grand Falls-Windsor","NL",48.92696,-55.65966,2018-08-30 13:00:00,20,1,21
"23324",10501,"Grand Falls-Windsor","NL",48.92696,-55.65966,2018-08-30 14:00:00,20,0,20
"23325",10501,"Grand Falls-Windsor","NL",48.92696,-55.65966,2018-08-30 15:00:00,20,1,21
"23326",10501,"Grand Falls-Windsor","NL",48.92696,-55.65966,2018-08-30 16:00:00,18,1,19
"23327",10501,"Grand Falls-Windsor","NL",48.92696,-55.65966,2018-08-30 17:00:00,17,1,18
"23328",10501,"Grand Falls-Windsor","NL",48.92696,-55.65966,2018-08-30 18:00:00,16,1,17
"23329",10501,"Grand Falls-Windsor","NL",48.92696,-55.65966,2018-08-30 19:00:00,16,1,17
"23330",10501,"Grand Falls-Windsor","NL",48.92696,-55.65966,2018-08-30 20:00:00,15,1,16
"23331",10501,"Grand Falls-Windsor","NL",48.92696,-55.65966,2018-08-30 21:00:00,14,0,14
"23332",10501,"Grand Falls-Windsor","NL",48.92696,-55.65966,2018-08-30 22:00:00,15,1,16
"23333",10501,"Grand Falls-Windsor","NL",48.92696,-55.65966,2018-08-30 23:00:00,16,1,17
"23334",10501,"Grand Falls-Windsor","NL",48.92696,-55.65966,2018-08-31 00:00:00,19,1,20
"23335",10501,"Grand Falls-Windsor","NL",48.92696,-55.65966,2018-08-31 01:00:00,21,0,21
"23336",10501,"Grand Falls-Windsor","NL",48.92696,-55.65966,2018-08-31 02:00:00,21,0,21
"23337",10501,"Grand Falls-Windsor","NL",48.92696,-55.65966,2018-08-31 03:00:00,24,0,24
"23338",10501,"Grand Falls-Windsor","NL",48.92696,-55.65966,2018-08-31 04:00:00,24,0,24
"23339",10501,"Grand Falls-Windsor","NL",48.92696,-55.65966,2018-08-31 05:00:00,24,0,24
"23340",10501,"Grand Falls-Windsor","NL",48.92696,-55.65966,2018-08-31 06:00:00,24,1,25
"23341",10501,"Grand Falls-Windsor","NL",48.92696,-55.65966,2018-08-31 07:00:00,25,1,26
"23342",10501,"Grand Falls-Windsor","NL",48.92696,-55.65966,2018-08-31 08:00:00,26,3,29
"23343",10501,"Grand Falls-Windsor","NL",48.92696,-55.65966,2018-08-31 09:00:00,26,1,27
"23344",10501,"Grand Falls-Windsor","NL",48.92696,-55.65966,2018-08-31 10:00:00,25,1,26
"23345",10501,"Grand Falls-Windsor","NL",48.92696,-55.65966,2018-08-31 11:00:00,25,1,26
"23346",10501,"Grand Falls-Windsor","NL",48.92696,-55.65966,2018-08-31 12:00:00,27,1,28
"23347",10501,"Grand Falls-Windsor","NL",48.92696,-55.65966,2018-08-31 13:00:00,30,1,31
"23348",10501,"Grand Falls-Windsor","NL",48.92696,-55.65966,2018-08-31 14:00:00,31,1,32
"23349",10501,"Grand Falls-Windsor","NL",48.92696,-55.65966,2018-08-31 15:00:00,30,1,31
"23350",10501,"Grand Falls-Windsor","NL",48.92696,-55.65966,2018-08-31 16:00:00,29,0,29
"23351",10501,"Grand Falls-Windsor","NL",48.92696,-55.65966,2018-08-31 17:00:00,27,0,27
"23352",10501,"Grand Falls-Windsor","NL",48.92696,-55.65966,2018-08-31 18:00:00,25,1,26
"23353",10501,"Grand Falls-Windsor","NL",48.92696,-55.65966,2018-08-31 19:00:00,23,1,24
"23354",10501,"Grand Falls-Windsor","NL",48.92696,-55.65966,2018-08-31 20:00:00,22,2,24
"23355",10501,"Grand Falls-Windsor","NL",48.92696,-55.65966,2018-08-31 21:00:00,23,1,24
"23356",10501,"Grand Falls-Windsor","NL",48.92696,-55.65966,2018-08-31 22:00:00,23,1,24
"23357",10501,"Grand Falls-Windsor","NL",48.92696,-55.65966,2018-08-31 23:00:00,23,1,24
"23358",10501,"Grand Falls-Windsor","NL",48.92696,-55.65966,2018-09-01 00:00:00,19,1,20
"23359",10501,"Grand Falls-Windsor","NL",48.92696,-55.65966,2018-09-01 01:00:00,13,1,14
"23360",10501,"Grand Falls-Windsor","NL",48.92696,-55.65966,2018-09-01 02:00:00,8,0,8
"23361",10501,"Grand Falls-Windsor","NL",48.92696,-55.65966,2018-09-01 03:00:00,7,0,7
"23362",10501,"Grand Falls-Windsor","NL",48.92696,-55.65966,2018-09-01 04:00:00,7,0,7
"23363",10501,"Grand Falls-Windsor","NL",48.92696,-55.65966,2018-09-01 05:00:00,8,0,8
"23364",10501,"Grand Falls-Windsor","NL",48.92696,-55.65966,2018-09-01 06:00:00,5,0,5
"23365",10501,"Grand Falls-Windsor","NL",48.92696,-55.65966,2018-09-01 07:00:00,7,0,7
"23366",10501,"Grand Falls-Windsor","NL",48.92696,-55.65966,2018-09-01 08:00:00,10,0,10
"23367",10501,"Grand Falls-Windsor","NL",48.92696,-55.65966,2018-09-01 09:00:00,16,1,17
"23368",10501,"Grand Falls-Windsor","NL",48.92696,-55.65966,2018-09-01 10:00:00,19,1,20
"23369",10501,"Grand Falls-Windsor","NL",48.92696,-55.65966,2018-09-01 11:00:00,22,0,22
"23370",10501,"Grand Falls-Windsor","NL",48.92696,-55.65966,2018-09-01 12:00:00,25,0,25
"23371",10501,"Grand Falls-Windsor","NL",48.92696,-55.65966,2018-09-01 13:00:00,26,0,26
"23372",10501,"Grand Falls-Windsor","NL",48.92696,-55.65966,2018-09-01 14:00:00,28,0,28
"23373",10501,"Grand Falls-Windsor","NL",48.92696,-55.65966,2018-09-01 15:00:00,29,0,29
"23374",10501,"Grand Falls-Windsor","NL",48.92696,-55.65966,2018-09-01 16:00:00,30,0,30
"23375",10501,"Grand Falls-Windsor","NL",48.92696,-55.65966,2018-09-01 17:00:00,30,0,30
"23376",10501,"Grand Falls-Windsor","NL",48.92696,-55.65966,2018-09-01 18:00:00,29,0,29
"23377",10501,"Grand Falls-Windsor","NL",48.92696,-55.65966,2018-09-01 19:00:00,27,0,27
"23378",10501,"Grand Falls-Windsor","NL",48.92696,-55.65966,2018-09-01 20:00:00,25,0,25
"23379",10501,"Grand Falls-Windsor","NL",48.92696,-55.65966,2018-09-01 21:00:00,24,0,24
"23380",10501,"Grand Falls-Windsor","NL",48.92696,-55.65966,2018-09-01 22:00:00,24,0,24
"23381",10501,"Grand Falls-Windsor","NL",48.92696,-55.65966,2018-09-01 23:00:00,23,0,23
"23382",10501,"Grand Falls-Windsor","NL",48.92696,-55.65966,2018-09-02 00:00:00,22,0,22
"23383",10501,"Grand Falls-Windsor","NL",48.92696,-55.65966,2018-09-02 01:00:00,20,0,20
"23384",10501,"Grand Falls-Windsor","NL",48.92696,-55.65966,2018-09-02 02:00:00,21,0,21
"23385",10501,"Grand Falls-Windsor","NL",48.92696,-55.65966,2018-09-02 03:00:00,17,0,17
"23386",10501,"Grand Falls-Windsor","NL",48.92696,-55.65966,2018-09-02 04:00:00,13,0,13
"23387",10501,"Grand Falls-Windsor","NL",48.92696,-55.65966,2018-09-02 05:00:00,14,0,14
"23388",10501,"Grand Falls-Windsor","NL",48.92696,-55.65966,2018-09-02 06:00:00,15,0,15
"23389",10501,"Grand Falls-Windsor","NL",48.92696,-55.65966,2018-09-02 07:00:00,17,0,17
"23390",10501,"Grand Falls-Windsor","NL",48.92696,-55.65966,2018-09-02 08:00:00,18,1,19
"23391",10501,"Grand Falls-Windsor","NL",48.92696,-55.65966,2018-09-02 09:00:00,28,0,28
"23392",10501,"Grand Falls-Windsor","NL",48.92696,-55.65966,2018-09-02 10:00:00,32,0,32
"23393",10501,"Grand Falls-Windsor","NL",48.92696,-55.65966,2018-09-02 11:00:00,31,0,31
"23394",10501,"Grand Falls-Windsor","NL",48.92696,-55.65966,2018-09-02 12:00:00,30,0,30
"23395",10501,"Grand Falls-Windsor","NL",48.92696,-55.65966,2018-09-02 13:00:00,29,0,29
"23396",10501,"Grand Falls-Windsor","NL",48.92696,-55.65966,2018-09-02 14:00:00,30,0,30
"23397",10501,"Grand Falls-Windsor","NL",48.92696,-55.65966,2018-09-02 15:00:00,30,0,30
"23398",10501,"Grand Falls-Windsor","NL",48.92696,-55.65966,2018-09-02 16:00:00,31,0,31
"23399",10501,"Grand Falls-Windsor","NL",48.92696,-55.65966,2018-09-02 17:00:00,31,0,31
"23400",10501,"Grand Falls-Windsor","NL",48.92696,-55.65966,2018-09-02 18:00:00,31,0,31
"23401",10501,"Grand Falls-Windsor","NL",48.92696,-55.65966,2018-09-02 19:00:00,31,0,31
"23402",10501,"Grand Falls-Windsor","NL",48.92696,-55.65966,2018-09-02 20:00:00,31,0,31
"23403",10501,"Grand Falls-Windsor","NL",48.92696,-55.65966,2018-09-02 21:00:00,31,0,31
"23404",10501,"Grand Falls-Windsor","NL",48.92696,-55.65966,2018-09-02 22:00:00,31,0,31
"23405",10501,"Grand Falls-Windsor","NL",48.92696,-55.65966,2018-09-02 23:00:00,30,0,30
"23406",10501,"Grand Falls-Windsor","NL",48.92696,-55.65966,2018-09-03 00:00:00,28,0,28
"23407",10501,"Grand Falls-Windsor","NL",48.92696,-55.65966,2018-09-03 01:00:00,26,0,26
"23408",10501,"Grand Falls-Windsor","NL",48.92696,-55.65966,2018-09-03 02:00:00,24,0,24
"23409",10501,"Grand Falls-Windsor","NL",48.92696,-55.65966,2018-09-03 03:00:00,21,0,21
"23410",10501,"Grand Falls-Windsor","NL",48.92696,-55.65966,2018-09-03 04:00:00,18,0,18
"23411",10501,"Grand Falls-Windsor","NL",48.92696,-55.65966,2018-09-03 05:00:00,18,0,18
"23412",10501,"Grand Falls-Windsor","NL",48.92696,-55.65966,2018-09-03 06:00:00,16,0,16
"23413",10501,"Grand Falls-Windsor","NL",48.92696,-55.65966,2018-09-03 07:00:00,14,0,14
"23414",10501,"Grand Falls-Windsor","NL",48.92696,-55.65966,2018-09-03 08:00:00,15,0,15
"23415",10501,"Grand Falls-Windsor","NL",48.92696,-55.65966,2018-09-03 09:00:00,18,0,18
"23416",10501,"Grand Falls-Windsor","NL",48.92696,-55.65966,2018-09-03 10:00:00,25,0,25
"23417",10501,"Grand Falls-Windsor","NL",48.92696,-55.65966,2018-09-03 11:00:00,30,0,30
"23418",10501,"Grand Falls-Windsor","NL",48.92696,-55.65966,2018-09-03 12:00:00,34,0,34
"23419",10501,"Grand Falls-Windsor","NL",48.92696,-55.65966,2018-09-03 13:00:00,38,0,38
"23420",10501,"Grand Falls-Windsor","NL",48.92696,-55.65966,2018-09-03 14:00:00,38,0,38
"23421",10501,"Grand Falls-Windsor","NL",48.92696,-55.65966,2018-09-03 15:00:00,35,0,35
"23422",10501,"Grand Falls-Windsor","NL",48.92696,-55.65966,2018-09-03 16:00:00,35,0,35
"23423",10501,"Grand Falls-Windsor","NL",48.92696,-55.65966,2018-09-03 17:00:00,36,0,36
"23424",10501,"Grand Falls-Windsor","NL",48.92696,-55.65966,2018-09-03 18:00:00,35,0,35
"23425",10501,"Grand Falls-Windsor","NL",48.92696,-55.65966,2018-09-03 19:00:00,35,0,35
"23426",10501,"Grand Falls-Windsor","NL",48.92696,-55.65966,2018-09-03 20:00:00,33,0,33
"23427",10501,"Grand Falls-Windsor","NL",48.92696,-55.65966,2018-09-03 21:00:00,33,1,34
"23428",10501,"Grand Falls-Windsor","NL",48.92696,-55.65966,2018-09-03 22:00:00,32,0,32
"23429",10501,"Grand Falls-Windsor","NL",48.92696,-55.65966,2018-09-03 23:00:00,30,0,30
"23430",10501,"Grand Falls-Windsor","NL",48.92696,-55.65966,2018-09-04 00:00:00,31,0,31
"23431",10501,"Grand Falls-Windsor","NL",48.92696,-55.65966,2018-09-04 01:00:00,28,0,28
"23432",10501,"Grand Falls-Windsor","NL",48.92696,-55.65966,2018-09-04 02:00:00,28,0,28
"23433",10501,"Grand Falls-Windsor","NL",48.92696,-55.65966,2018-09-04 03:00:00,31,0,31
"23434",10501,"Grand Falls-Windsor","NL",48.92696,-55.65966,2018-09-04 04:00:00,32,0,32
"23435",10501,"Grand Falls-Windsor","NL",48.92696,-55.65966,2018-09-04 05:00:00,32,0,32
"23436",10501,"Grand Falls-Windsor","NL",48.92696,-55.65966,2018-09-04 06:00:00,33,0,33
"23437",10501,"Grand Falls-Windsor","NL",48.92696,-55.65966,2018-09-04 07:00:00,33,0,33
"23438",10501,"Grand Falls-Windsor","NL",48.92696,-55.65966,2018-09-04 08:00:00,32,0,32
"23439",10501,"Grand Falls-Windsor","NL",48.92696,-55.65966,2018-09-04 09:00:00,29,0,29
"23440",10501,"Grand Falls-Windsor","NL",48.92696,-55.65966,2018-09-04 10:00:00,27,0,27
"23441",10501,"Grand Falls-Windsor","NL",48.92696,-55.65966,2018-09-04 11:00:00,27,0,27
"23442",10501,"Grand Falls-Windsor","NL",48.92696,-55.65966,2018-09-04 12:00:00,26,0,26
"23443",10501,"Grand Falls-Windsor","NL",48.92696,-55.65966,2018-09-04 13:00:00,24,0,24
"23444",10501,"Grand Falls-Windsor","NL",48.92696,-55.65966,2018-09-04 14:00:00,30,0,30
"23445",10501,"Grand Falls-Windsor","NL",48.92696,-55.65966,2018-09-04 15:00:00,35,0,35
"23446",10501,"Grand Falls-Windsor","NL",48.92696,-55.65966,2018-09-04 16:00:00,37,0,37
"23447",10501,"Grand Falls-Windsor","NL",48.92696,-55.65966,2018-09-04 17:00:00,34,0,34
"23448",10501,"Grand Falls-Windsor","NL",48.92696,-55.65966,2018-09-04 18:00:00,31,0,31
"23449",10501,"Grand Falls-Windsor","NL",48.92696,-55.65966,2018-09-04 19:00:00,29,0,29
"23450",10501,"Grand Falls-Windsor","NL",48.92696,-55.65966,2018-09-04 20:00:00,28,0,28
"23451",10501,"Grand Falls-Windsor","NL",48.92696,-55.65966,2018-09-04 21:00:00,27,0,27
"23452",10501,"Grand Falls-Windsor","NL",48.92696,-55.65966,2018-09-04 22:00:00,26,0,26
"23453",10501,"Grand Falls-Windsor","NL",48.92696,-55.65966,2018-09-04 23:00:00,23,0,23
"23454",10501,"Grand Falls-Windsor","NL",48.92696,-55.65966,2018-09-05 00:00:00,20,0,20
"23455",10501,"Grand Falls-Windsor","NL",48.92696,-55.65966,2018-09-05 01:00:00,18,1,19
"23456",10501,"Grand Falls-Windsor","NL",48.92696,-55.65966,2018-09-05 02:00:00,16,1,17
"23457",10501,"Grand Falls-Windsor","NL",48.92696,-55.65966,2018-09-05 03:00:00,12,1,13
"23458",10501,"Grand Falls-Windsor","NL",48.92696,-55.65966,2018-09-05 04:00:00,13,0,13
"23459",10501,"Grand Falls-Windsor","NL",48.92696,-55.65966,2018-09-05 05:00:00,11,0,11
"23460",10501,"Grand Falls-Windsor","NL",48.92696,-55.65966,2018-09-05 06:00:00,12,1,13
"23461",10501,"Grand Falls-Windsor","NL",48.92696,-55.65966,2018-09-05 07:00:00,14,0,14
"23462",10501,"Grand Falls-Windsor","NL",48.92696,-55.65966,2018-09-05 08:00:00,17,1,18
"23463",10501,"Grand Falls-Windsor","NL",48.92696,-55.65966,2018-09-05 09:00:00,22,1,23
"23464",10501,"Grand Falls-Windsor","NL",48.92696,-55.65966,2018-09-05 10:00:00,26,0,26
"23465",10501,"Grand Falls-Windsor","NL",48.92696,-55.65966,2018-09-05 11:00:00,25,0,25
"23466",10501,"Grand Falls-Windsor","NL",48.92696,-55.65966,2018-09-05 12:00:00,29,0,29
"23467",10501,"Grand Falls-Windsor","NL",48.92696,-55.65966,2018-09-05 13:00:00,32,1,33
"23468",10501,"Grand Falls-Windsor","NL",48.92696,-55.65966,2018-09-05 14:00:00,31,NA,NA
"23469",10501,"Grand Falls-Windsor","NL",48.92696,-55.65966,2018-09-05 15:00:00,26,NA,NA
"23470",10501,"Grand Falls-Windsor","NL",48.92696,-55.65966,2018-09-05 16:00:00,30,NA,NA
"23471",10501,"Grand Falls-Windsor","NL",48.92696,-55.65966,2018-09-05 17:00:00,32,1,33
"23472",10501,"Grand Falls-Windsor","NL",48.92696,-55.65966,2018-09-05 18:00:00,30,1,31
"23473",10501,"Grand Falls-Windsor","NL",48.92696,-55.65966,2018-09-05 19:00:00,27,1,28
"23474",10501,"Grand Falls-Windsor","NL",48.92696,-55.65966,2018-09-05 20:00:00,23,2,25
"23475",10501,"Grand Falls-Windsor","NL",48.92696,-55.65966,2018-09-05 21:00:00,18,1,19
"23476",10501,"Grand Falls-Windsor","NL",48.92696,-55.65966,2018-09-05 22:00:00,17,1,18
"23477",10501,"Grand Falls-Windsor","NL",48.92696,-55.65966,2018-09-05 23:00:00,17,1,18
"23478",10501,"Grand Falls-Windsor","NL",48.92696,-55.65966,2018-09-06 00:00:00,17,1,18
"23479",10501,"Grand Falls-Windsor","NL",48.92696,-55.65966,2018-09-06 01:00:00,17,0,17
"23480",10501,"Grand Falls-Windsor","NL",48.92696,-55.65966,2018-09-06 02:00:00,16,0,16
"23481",10501,"Grand Falls-Windsor","NL",48.92696,-55.65966,2018-09-06 03:00:00,18,0,18
"23482",10501,"Grand Falls-Windsor","NL",48.92696,-55.65966,2018-09-06 04:00:00,17,0,17
"23483",10501,"Grand Falls-Windsor","NL",48.92696,-55.65966,2018-09-06 05:00:00,16,0,16
"23484",10501,"Grand Falls-Windsor","NL",48.92696,-55.65966,2018-09-06 06:00:00,17,1,18
"23485",10501,"Grand Falls-Windsor","NL",48.92696,-55.65966,2018-09-06 07:00:00,18,1,19
"23486",10501,"Grand Falls-Windsor","NL",48.92696,-55.65966,2018-09-06 08:00:00,15,2,17
"23487",10501,"Grand Falls-Windsor","NL",48.92696,-55.65966,2018-09-06 09:00:00,13,2,15
"23488",10501,"Grand Falls-Windsor","NL",48.92696,-55.65966,2018-09-06 10:00:00,15,1,16
"23489",10501,"Grand Falls-Windsor","NL",48.92696,-55.65966,2018-09-06 11:00:00,18,1,19
"23490",10501,"Grand Falls-Windsor","NL",48.92696,-55.65966,2018-09-06 12:00:00,26,1,27
"23491",10501,"Grand Falls-Windsor","NL",48.92696,-55.65966,2018-09-06 13:00:00,29,1,30
"23492",10501,"Grand Falls-Windsor","NL",48.92696,-55.65966,2018-09-06 14:00:00,28,1,29
"23493",10501,"Grand Falls-Windsor","NL",48.92696,-55.65966,2018-09-06 15:00:00,29,1,30
"23494",10501,"Grand Falls-Windsor","NL",48.92696,-55.65966,2018-09-06 16:00:00,29,1,30
"23495",10501,"Grand Falls-Windsor","NL",48.92696,-55.65966,2018-09-06 17:00:00,29,1,30
"23496",10501,"Grand Falls-Windsor","NL",48.92696,-55.65966,2018-09-06 18:00:00,27,1,28
"23497",10501,"Grand Falls-Windsor","NL",48.92696,-55.65966,2018-09-06 19:00:00,25,1,26
"23498",10501,"Grand Falls-Windsor","NL",48.92696,-55.65966,2018-09-06 20:00:00,23,0,23
"23499",10501,"Grand Falls-Windsor","NL",48.92696,-55.65966,2018-09-06 21:00:00,21,1,22
"23500",10501,"Grand Falls-Windsor","NL",48.92696,-55.65966,2018-09-06 22:00:00,18,0,18
"23501",10501,"Grand Falls-Windsor","NL",48.92696,-55.65966,2018-09-06 23:00:00,16,0,16
"23502",10501,"Grand Falls-Windsor","NL",48.92696,-55.65966,2018-09-07 00:00:00,13,0,13
"23503",10501,"Grand Falls-Windsor","NL",48.92696,-55.65966,2018-09-07 01:00:00,13,1,14
"23504",10501,"Grand Falls-Windsor","NL",48.92696,-55.65966,2018-09-07 02:00:00,15,0,15
"23505",10501,"Grand Falls-Windsor","NL",48.92696,-55.65966,2018-09-07 03:00:00,16,1,17
"23506",10501,"Grand Falls-Windsor","NL",48.92696,-55.65966,2018-09-07 04:00:00,13,1,14
"23507",10501,"Grand Falls-Windsor","NL",48.92696,-55.65966,2018-09-07 05:00:00,12,1,13
"23508",10501,"Grand Falls-Windsor","NL",48.92696,-55.65966,2018-09-07 06:00:00,9,1,10
"23509",10501,"Grand Falls-Windsor","NL",48.92696,-55.65966,2018-09-07 07:00:00,9,1,10
"23510",10501,"Grand Falls-Windsor","NL",48.92696,-55.65966,2018-09-07 08:00:00,13,1,14
"23511",10501,"Grand Falls-Windsor","NL",48.92696,-55.65966,2018-09-07 09:00:00,17,1,18
"23512",10501,"Grand Falls-Windsor","NL",48.92696,-55.65966,2018-09-07 10:00:00,25,1,26
"23513",10501,"Grand Falls-Windsor","NL",48.92696,-55.65966,2018-09-07 11:00:00,30,1,31
"23514",10501,"Grand Falls-Windsor","NL",48.92696,-55.65966,2018-09-07 12:00:00,31,1,32
"23515",10501,"Grand Falls-Windsor","NL",48.92696,-55.65966,2018-09-07 13:00:00,31,1,32
"23516",10501,"Grand Falls-Windsor","NL",48.92696,-55.65966,2018-09-07 14:00:00,29,1,30
"23517",10501,"Grand Falls-Windsor","NL",48.92696,-55.65966,2018-09-07 15:00:00,30,1,31
"23518",10501,"Grand Falls-Windsor","NL",48.92696,-55.65966,2018-09-07 16:00:00,30,0,30
"23519",10501,"Grand Falls-Windsor","NL",48.92696,-55.65966,2018-09-07 17:00:00,30,1,31
"23520",10501,"Grand Falls-Windsor","NL",48.92696,-55.65966,2018-09-07 18:00:00,29,1,30
"23521",10501,"Grand Falls-Windsor","NL",48.92696,-55.65966,2018-09-07 19:00:00,27,1,28
"23522",10501,"Grand Falls-Windsor","NL",48.92696,-55.65966,2018-09-07 20:00:00,25,1,26
"23523",10501,"Grand Falls-Windsor","NL",48.92696,-55.65966,2018-09-07 21:00:00,18,0,18
"23524",10501,"Grand Falls-Windsor","NL",48.92696,-55.65966,2018-09-07 22:00:00,14,0,14
"23525",10501,"Grand Falls-Windsor","NL",48.92696,-55.65966,2018-09-07 23:00:00,15,1,16
"23526",10501,"Grand Falls-Windsor","NL",48.92696,-55.65966,2018-09-08 00:00:00,13,1,14
"23527",10501,"Grand Falls-Windsor","NL",48.92696,-55.65966,2018-09-08 01:00:00,15,1,16
"23528",10501,"Grand Falls-Windsor","NL",48.92696,-55.65966,2018-09-08 02:00:00,17,1,18
"23529",10501,"Grand Falls-Windsor","NL",48.92696,-55.65966,2018-09-08 03:00:00,17,1,18
"23530",10501,"Grand Falls-Windsor","NL",48.92696,-55.65966,2018-09-08 04:00:00,17,0,17
"23531",10501,"Grand Falls-Windsor","NL",48.92696,-55.65966,2018-09-08 05:00:00,15,0,15
"23532",10501,"Grand Falls-Windsor","NL",48.92696,-55.65966,2018-09-08 06:00:00,14,1,15
"23533",10501,"Grand Falls-Windsor","NL",48.92696,-55.65966,2018-09-08 07:00:00,14,0,14
"23534",10501,"Grand Falls-Windsor","NL",48.92696,-55.65966,2018-09-08 08:00:00,14,1,15
"23535",10501,"Grand Falls-Windsor","NL",48.92696,-55.65966,2018-09-08 09:00:00,23,0,23
"23536",10501,"Grand Falls-Windsor","NL",48.92696,-55.65966,2018-09-08 10:00:00,24,0,24
"23537",10501,"Grand Falls-Windsor","NL",48.92696,-55.65966,2018-09-08 11:00:00,28,1,29
"23538",10501,"Grand Falls-Windsor","NL",48.92696,-55.65966,2018-09-08 12:00:00,29,0,29
"23539",10501,"Grand Falls-Windsor","NL",48.92696,-55.65966,2018-09-08 13:00:00,33,1,34
"23540",10501,"Grand Falls-Windsor","NL",48.92696,-55.65966,2018-09-08 14:00:00,33,1,34
"23541",10501,"Grand Falls-Windsor","NL",48.92696,-55.65966,2018-09-08 15:00:00,31,1,32
"23542",10501,"Grand Falls-Windsor","NL",48.92696,-55.65966,2018-09-08 16:00:00,30,1,31
"23543",10501,"Grand Falls-Windsor","NL",48.92696,-55.65966,2018-09-08 17:00:00,28,0,28
"23544",10501,"Grand Falls-Windsor","NL",48.92696,-55.65966,2018-09-08 18:00:00,27,1,28
"23545",10501,"Grand Falls-Windsor","NL",48.92696,-55.65966,2018-09-08 19:00:00,25,1,26
"23546",10501,"Grand Falls-Windsor","NL",48.92696,-55.65966,2018-09-08 20:00:00,22,0,22
"23547",10501,"Grand Falls-Windsor","NL",48.92696,-55.65966,2018-09-08 21:00:00,19,1,20
"23548",10501,"Grand Falls-Windsor","NL",48.92696,-55.65966,2018-09-08 22:00:00,18,0,18
"23549",10501,"Grand Falls-Windsor","NL",48.92696,-55.65966,2018-09-08 23:00:00,16,1,17
"23550",10501,"Grand Falls-Windsor","NL",48.92696,-55.65966,2018-09-09 00:00:00,14,0,14
"23551",10501,"Grand Falls-Windsor","NL",48.92696,-55.65966,2018-09-09 01:00:00,12,0,12
"23552",10501,"Grand Falls-Windsor","NL",48.92696,-55.65966,2018-09-09 02:00:00,11,1,12
"23553",10501,"Grand Falls-Windsor","NL",48.92696,-55.65966,2018-09-09 03:00:00,11,1,12
"23554",10501,"Grand Falls-Windsor","NL",48.92696,-55.65966,2018-09-09 04:00:00,11,1,12
"23555",10501,"Grand Falls-Windsor","NL",48.92696,-55.65966,2018-09-09 05:00:00,12,1,13
"23556",10501,"Grand Falls-Windsor","NL",48.92696,-55.65966,2018-09-09 06:00:00,12,0,12
"23557",10501,"Grand Falls-Windsor","NL",48.92696,-55.65966,2018-09-09 07:00:00,11,0,11
"23558",10501,"Grand Falls-Windsor","NL",48.92696,-55.65966,2018-09-09 08:00:00,12,0,12
"23559",10501,"Grand Falls-Windsor","NL",48.92696,-55.65966,2018-09-09 09:00:00,14,0,14
"23560",10501,"Grand Falls-Windsor","NL",48.92696,-55.65966,2018-09-09 10:00:00,20,0,20
"23561",10501,"Grand Falls-Windsor","NL",48.92696,-55.65966,2018-09-09 11:00:00,23,0,23
"23562",10501,"Grand Falls-Windsor","NL",48.92696,-55.65966,2018-09-09 12:00:00,27,0,27
"23563",10501,"Grand Falls-Windsor","NL",48.92696,-55.65966,2018-09-09 13:00:00,26,0,26
"23564",10501,"Grand Falls-Windsor","NL",48.92696,-55.65966,2018-09-09 14:00:00,27,0,27
"23565",10501,"Grand Falls-Windsor","NL",48.92696,-55.65966,2018-09-09 15:00:00,28,1,29
"23566",10501,"Grand Falls-Windsor","NL",48.92696,-55.65966,2018-09-09 16:00:00,27,1,28
"23567",10501,"Grand Falls-Windsor","NL",48.92696,-55.65966,2018-09-09 17:00:00,26,0,26
"23568",10501,"Grand Falls-Windsor","NL",48.92696,-55.65966,2018-09-09 18:00:00,27,1,28
"23569",10501,"Grand Falls-Windsor","NL",48.92696,-55.65966,2018-09-09 19:00:00,25,1,26
"23570",10501,"Grand Falls-Windsor","NL",48.92696,-55.65966,2018-09-09 20:00:00,20,3,23
"23571",10501,"Grand Falls-Windsor","NL",48.92696,-55.65966,2018-09-09 21:00:00,18,2,20
"23572",10501,"Grand Falls-Windsor","NL",48.92696,-55.65966,2018-09-09 22:00:00,17,2,19
"23573",10501,"Grand Falls-Windsor","NL",48.92696,-55.65966,2018-09-09 23:00:00,12,1,13
"23574",10501,"Grand Falls-Windsor","NL",48.92696,-55.65966,2018-09-10 00:00:00,14,1,15
"23575",10501,"Grand Falls-Windsor","NL",48.92696,-55.65966,2018-09-10 01:00:00,13,0,13
"23576",10501,"Grand Falls-Windsor","NL",48.92696,-55.65966,2018-09-10 02:00:00,12,0,12
"23577",10501,"Grand Falls-Windsor","NL",48.92696,-55.65966,2018-09-10 03:00:00,11,0,11
"23578",10501,"Grand Falls-Windsor","NL",48.92696,-55.65966,2018-09-10 04:00:00,8,0,8
"23579",10501,"Grand Falls-Windsor","NL",48.92696,-55.65966,2018-09-10 05:00:00,8,0,8
"23580",10501,"Grand Falls-Windsor","NL",48.92696,-55.65966,2018-09-10 06:00:00,9,1,10
"23581",10501,"Grand Falls-Windsor","NL",48.92696,-55.65966,2018-09-10 07:00:00,8,1,9
"23582",10501,"Grand Falls-Windsor","NL",48.92696,-55.65966,2018-09-10 08:00:00,9,1,10
"23583",10501,"Grand Falls-Windsor","NL",48.92696,-55.65966,2018-09-10 09:00:00,12,1,13
"23584",10501,"Grand Falls-Windsor","NL",48.92696,-55.65966,2018-09-10 10:00:00,18,0,18
"23585",10501,"Grand Falls-Windsor","NL",48.92696,-55.65966,2018-09-10 11:00:00,23,1,24
"23586",10501,"Grand Falls-Windsor","NL",48.92696,-55.65966,2018-09-10 12:00:00,25,0,25
"23587",10501,"Grand Falls-Windsor","NL",48.92696,-55.65966,2018-09-10 13:00:00,27,0,27
"23588",10501,"Grand Falls-Windsor","NL",48.92696,-55.65966,2018-09-10 14:00:00,28,1,29
"23589",10501,"Grand Falls-Windsor","NL",48.92696,-55.65966,2018-09-10 15:00:00,28,1,29
"23590",10501,"Grand Falls-Windsor","NL",48.92696,-55.65966,2018-09-10 16:00:00,29,0,29
"23591",10501,"Grand Falls-Windsor","NL",48.92696,-55.65966,2018-09-10 17:00:00,30,0,30
"23592",10501,"Grand Falls-Windsor","NL",48.92696,-55.65966,2018-09-10 18:00:00,29,1,30
"23593",10501,"Grand Falls-Windsor","NL",48.92696,-55.65966,2018-09-10 19:00:00,28,0,28
"23594",10501,"Grand Falls-Windsor","NL",48.92696,-55.65966,2018-09-10 20:00:00,27,1,28
"23595",10501,"Grand Falls-Windsor","NL",48.92696,-55.65966,2018-09-10 21:00:00,26,0,26
"23596",10501,"Grand Falls-Windsor","NL",48.92696,-55.65966,2018-09-10 22:00:00,23,0,23
"23597",10501,"Grand Falls-Windsor","NL",48.92696,-55.65966,2018-09-10 23:00:00,19,1,20
"23598",10501,"Grand Falls-Windsor","NL",48.92696,-55.65966,2018-09-11 00:00:00,21,1,22
"23599",10501,"Grand Falls-Windsor","NL",48.92696,-55.65966,2018-09-11 01:00:00,22,0,22
"23600",10501,"Grand Falls-Windsor","NL",48.92696,-55.65966,2018-09-11 02:00:00,20,1,21
"23601",10501,"Grand Falls-Windsor","NL",48.92696,-55.65966,2018-09-11 03:00:00,22,0,22
"23602",10501,"Grand Falls-Windsor","NL",48.92696,-55.65966,2018-09-11 04:00:00,21,0,21
"23603",10501,"Grand Falls-Windsor","NL",48.92696,-55.65966,2018-09-11 05:00:00,18,1,19
"23604",10501,"Grand Falls-Windsor","NL",48.92696,-55.65966,2018-09-11 06:00:00,18,1,19
"23605",10501,"Grand Falls-Windsor","NL",48.92696,-55.65966,2018-09-11 07:00:00,18,1,19
"23606",10501,"Grand Falls-Windsor","NL",48.92696,-55.65966,2018-09-11 08:00:00,21,1,22
"23607",10501,"Grand Falls-Windsor","NL",48.92696,-55.65966,2018-09-11 09:00:00,24,1,25
"23608",10501,"Grand Falls-Windsor","NL",48.92696,-55.65966,2018-09-11 10:00:00,25,0,25
"23609",10501,"Grand Falls-Windsor","NL",48.92696,-55.65966,2018-09-11 11:00:00,26,1,27
"23610",10501,"Grand Falls-Windsor","NL",48.92696,-55.65966,2018-09-11 12:00:00,27,1,28
"23611",10501,"Grand Falls-Windsor","NL",48.92696,-55.65966,2018-09-11 13:00:00,28,1,29
"23612",10501,"Grand Falls-Windsor","NL",48.92696,-55.65966,2018-09-11 14:00:00,30,0,30
"23613",10501,"Grand Falls-Windsor","NL",48.92696,-55.65966,2018-09-11 15:00:00,31,0,31
"23614",10501,"Grand Falls-Windsor","NL",48.92696,-55.65966,2018-09-11 16:00:00,32,1,33
"23615",10501,"Grand Falls-Windsor","NL",48.92696,-55.65966,2018-09-11 17:00:00,33,1,34
"23616",10501,"Grand Falls-Windsor","NL",48.92696,-55.65966,2018-09-11 18:00:00,33,1,34
"23617",10501,"Grand Falls-Windsor","NL",48.92696,-55.65966,2018-09-11 19:00:00,33,1,34
"23618",10501,"Grand Falls-Windsor","NL",48.92696,-55.65966,2018-09-11 20:00:00,33,1,34
"23619",10501,"Grand Falls-Windsor","NL",48.92696,-55.65966,2018-09-11 21:00:00,31,0,31
"23620",10501,"Grand Falls-Windsor","NL",48.92696,-55.65966,2018-09-11 22:00:00,30,1,31
"23621",10501,"Grand Falls-Windsor","NL",48.92696,-55.65966,2018-09-11 23:00:00,29,1,30
"23622",10501,"Grand Falls-Windsor","NL",48.92696,-55.65966,2018-09-12 00:00:00,26,1,27
"23623",10501,"Grand Falls-Windsor","NL",48.92696,-55.65966,2018-09-12 01:00:00,24,0,24
"23624",10501,"Grand Falls-Windsor","NL",48.92696,-55.65966,2018-09-12 02:00:00,21,0,21
"23625",10501,"Grand Falls-Windsor","NL",48.92696,-55.65966,2018-09-12 03:00:00,21,0,21
"23626",10501,"Grand Falls-Windsor","NL",48.92696,-55.65966,2018-09-12 04:00:00,22,0,22
"23627",10501,"Grand Falls-Windsor","NL",48.92696,-55.65966,2018-09-12 05:00:00,24,0,24
"23628",10501,"Grand Falls-Windsor","NL",48.92696,-55.65966,2018-09-12 06:00:00,21,2,23
"23629",10501,"Grand Falls-Windsor","NL",48.92696,-55.65966,2018-09-12 07:00:00,18,2,20
"23630",10501,"Grand Falls-Windsor","NL",48.92696,-55.65966,2018-09-12 08:00:00,17,2,19
"23631",10501,"Grand Falls-Windsor","NL",48.92696,-55.65966,2018-09-12 09:00:00,21,1,22
"23632",10501,"Grand Falls-Windsor","NL",48.92696,-55.65966,2018-09-12 10:00:00,22,1,23
"23633",10501,"Grand Falls-Windsor","NL",48.92696,-55.65966,2018-09-12 11:00:00,21,2,23
"23634",10501,"Grand Falls-Windsor","NL",48.92696,-55.65966,2018-09-12 12:00:00,25,1,26
"23635",10501,"Grand Falls-Windsor","NL",48.92696,-55.65966,2018-09-12 13:00:00,26,0,26
"23636",10501,"Grand Falls-Windsor","NL",48.92696,-55.65966,2018-09-12 14:00:00,30,1,31
"23637",10501,"Grand Falls-Windsor","NL",48.92696,-55.65966,2018-09-12 15:00:00,31,0,31
"23638",10501,"Grand Falls-Windsor","NL",48.92696,-55.65966,2018-09-12 16:00:00,31,1,32
"23639",10501,"Grand Falls-Windsor","NL",48.92696,-55.65966,2018-09-12 17:00:00,30,1,31
"23640",10501,"Grand Falls-Windsor","NL",48.92696,-55.65966,2018-09-12 18:00:00,31,1,32
"23641",10501,"Grand Falls-Windsor","NL",48.92696,-55.65966,2018-09-12 19:00:00,25,1,26
"23642",10501,"Grand Falls-Windsor","NL",48.92696,-55.65966,2018-09-12 20:00:00,22,1,23
"23643",10501,"Grand Falls-Windsor","NL",48.92696,-55.65966,2018-09-12 21:00:00,22,1,23
"23644",10501,"Grand Falls-Windsor","NL",48.92696,-55.65966,2018-09-12 22:00:00,20,1,21
"23645",10501,"Grand Falls-Windsor","NL",48.92696,-55.65966,2018-09-12 23:00:00,14,1,15
"23646",10501,"Grand Falls-Windsor","NL",48.92696,-55.65966,2018-09-13 00:00:00,14,1,15
"23647",10501,"Grand Falls-Windsor","NL",48.92696,-55.65966,2018-09-13 01:00:00,14,0,14
"23648",10501,"Grand Falls-Windsor","NL",48.92696,-55.65966,2018-09-13 02:00:00,14,0,14
"23649",10501,"Grand Falls-Windsor","NL",48.92696,-55.65966,2018-09-13 03:00:00,11,1,12
"23650",10501,"Grand Falls-Windsor","NL",48.92696,-55.65966,2018-09-13 04:00:00,9,0,9
"23651",10501,"Grand Falls-Windsor","NL",48.92696,-55.65966,2018-09-13 05:00:00,10,0,10
"23652",10501,"Grand Falls-Windsor","NL",48.92696,-55.65966,2018-09-13 06:00:00,8,1,9
"23653",10501,"Grand Falls-Windsor","NL",48.92696,-55.65966,2018-09-13 07:00:00,6,0,6
"23654",10501,"Grand Falls-Windsor","NL",48.92696,-55.65966,2018-09-13 08:00:00,10,1,11
"23655",10501,"Grand Falls-Windsor","NL",48.92696,-55.65966,2018-09-13 09:00:00,14,1,15
"23656",10501,"Grand Falls-Windsor","NL",48.92696,-55.65966,2018-09-13 10:00:00,17,0,17
"23657",10501,"Grand Falls-Windsor","NL",48.92696,-55.65966,2018-09-13 11:00:00,19,0,19
"23658",10501,"Grand Falls-Windsor","NL",48.92696,-55.65966,2018-09-13 12:00:00,23,1,24
"23659",10501,"Grand Falls-Windsor","NL",48.92696,-55.65966,2018-09-13 13:00:00,25,1,26
"23660",10501,"Grand Falls-Windsor","NL",48.92696,-55.65966,2018-09-13 14:00:00,30,1,31
"23661",10501,"Grand Falls-Windsor","NL",48.92696,-55.65966,2018-09-13 15:00:00,32,1,33
"23662",10501,"Grand Falls-Windsor","NL",48.92696,-55.65966,2018-09-13 16:00:00,37,1,38
"23663",10501,"Grand Falls-Windsor","NL",48.92696,-55.65966,2018-09-13 17:00:00,33,1,34
"23664",10501,"Grand Falls-Windsor","NL",48.92696,-55.65966,2018-09-13 18:00:00,30,1,31
"23665",10501,"Grand Falls-Windsor","NL",48.92696,-55.65966,2018-09-13 19:00:00,24,2,26
"23666",10501,"Grand Falls-Windsor","NL",48.92696,-55.65966,2018-09-13 20:00:00,20,2,22
"23667",10501,"Grand Falls-Windsor","NL",48.92696,-55.65966,2018-09-13 21:00:00,27,1,28
"23668",10501,"Grand Falls-Windsor","NL",48.92696,-55.65966,2018-09-13 22:00:00,27,1,28
"23669",10501,"Grand Falls-Windsor","NL",48.92696,-55.65966,2018-09-13 23:00:00,26,1,27
"23670",10501,"Grand Falls-Windsor","NL",48.92696,-55.65966,2018-09-14 00:00:00,24,0,24
"23671",10501,"Grand Falls-Windsor","NL",48.92696,-55.65966,2018-09-14 01:00:00,24,0,24
"23672",10501,"Grand Falls-Windsor","NL",48.92696,-55.65966,2018-09-14 02:00:00,25,1,26
"23673",10501,"Grand Falls-Windsor","NL",48.92696,-55.65966,2018-09-14 03:00:00,27,1,28
"23674",10501,"Grand Falls-Windsor","NL",48.92696,-55.65966,2018-09-14 04:00:00,27,0,27
"23675",10501,"Grand Falls-Windsor","NL",48.92696,-55.65966,2018-09-14 05:00:00,27,0,27
"23676",10501,"Grand Falls-Windsor","NL",48.92696,-55.65966,2018-09-14 06:00:00,28,1,29
"23677",10501,"Grand Falls-Windsor","NL",48.92696,-55.65966,2018-09-14 07:00:00,29,1,30
"23678",10501,"Grand Falls-Windsor","NL",48.92696,-55.65966,2018-09-14 08:00:00,30,1,31
"23679",10501,"Grand Falls-Windsor","NL",48.92696,-55.65966,2018-09-14 09:00:00,31,2,33
"23680",10501,"Grand Falls-Windsor","NL",48.92696,-55.65966,2018-09-14 10:00:00,32,1,33
"23681",10501,"Grand Falls-Windsor","NL",48.92696,-55.65966,2018-09-14 11:00:00,32,1,33
"23682",10501,"Grand Falls-Windsor","NL",48.92696,-55.65966,2018-09-14 12:00:00,33,1,34
"23683",10501,"Grand Falls-Windsor","NL",48.92696,-55.65966,2018-09-14 13:00:00,33,1,34
"23684",10501,"Grand Falls-Windsor","NL",48.92696,-55.65966,2018-09-14 14:00:00,34,1,35
"23685",10501,"Grand Falls-Windsor","NL",48.92696,-55.65966,2018-09-14 15:00:00,33,1,34
"23686",10501,"Grand Falls-Windsor","NL",48.92696,-55.65966,2018-09-14 16:00:00,33,1,34
"23687",10501,"Grand Falls-Windsor","NL",48.92696,-55.65966,2018-09-14 17:00:00,33,1,34
"23688",10501,"Grand Falls-Windsor","NL",48.92696,-55.65966,2018-09-14 18:00:00,30,1,31
"23689",10501,"Grand Falls-Windsor","NL",48.92696,-55.65966,2018-09-14 19:00:00,22,2,24
"23690",10501,"Grand Falls-Windsor","NL",48.92696,-55.65966,2018-09-14 20:00:00,15,2,17
"23691",10501,"Grand Falls-Windsor","NL",48.92696,-55.65966,2018-09-14 21:00:00,11,3,14
"23692",10501,"Grand Falls-Windsor","NL",48.92696,-55.65966,2018-09-14 22:00:00,15,2,17
"23693",10501,"Grand Falls-Windsor","NL",48.92696,-55.65966,2018-09-14 23:00:00,15,1,16
"23694",10501,"Grand Falls-Windsor","NL",48.92696,-55.65966,2018-09-15 00:00:00,16,1,17
"23695",10501,"Grand Falls-Windsor","NL",48.92696,-55.65966,2018-09-15 01:00:00,16,0,16
"23696",10501,"Grand Falls-Windsor","NL",48.92696,-55.65966,2018-09-15 02:00:00,17,0,17
"23697",10501,"Grand Falls-Windsor","NL",48.92696,-55.65966,2018-09-15 03:00:00,17,0,17
"23698",10501,"Grand Falls-Windsor","NL",48.92696,-55.65966,2018-09-15 04:00:00,19,0,19
"23699",10501,"Grand Falls-Windsor","NL",48.92696,-55.65966,2018-09-15 05:00:00,18,0,18
"23700",10501,"Grand Falls-Windsor","NL",48.92696,-55.65966,2018-09-15 06:00:00,19,1,20
"23701",10501,"Grand Falls-Windsor","NL",48.92696,-55.65966,2018-09-15 07:00:00,19,0,19
"23702",10501,"Grand Falls-Windsor","NL",48.92696,-55.65966,2018-09-15 08:00:00,21,0,21
"23703",10501,"Grand Falls-Windsor","NL",48.92696,-55.65966,2018-09-15 09:00:00,23,0,23
"23704",10501,"Grand Falls-Windsor","NL",48.92696,-55.65966,2018-09-15 10:00:00,25,0,25
"23705",10501,"Grand Falls-Windsor","NL",48.92696,-55.65966,2018-09-15 11:00:00,26,1,27
"23706",10501,"Grand Falls-Windsor","NL",48.92696,-55.65966,2018-09-15 12:00:00,26,1,27
"23707",10501,"Grand Falls-Windsor","NL",48.92696,-55.65966,2018-09-15 13:00:00,28,0,28
"23708",10501,"Grand Falls-Windsor","NL",48.92696,-55.65966,2018-09-15 14:00:00,30,1,31
"23709",10501,"Grand Falls-Windsor","NL",48.92696,-55.65966,2018-09-15 15:00:00,32,0,32
"23710",10501,"Grand Falls-Windsor","NL",48.92696,-55.65966,2018-09-15 16:00:00,32,1,33
"23711",10501,"Grand Falls-Windsor","NL",48.92696,-55.65966,2018-09-15 17:00:00,33,1,34
"23712",10501,"Grand Falls-Windsor","NL",48.92696,-55.65966,2018-09-15 18:00:00,32,0,32
"23713",10501,"Grand Falls-Windsor","NL",48.92696,-55.65966,2018-09-15 19:00:00,31,1,32
"23714",10501,"Grand Falls-Windsor","NL",48.92696,-55.65966,2018-09-15 20:00:00,29,1,30
"23715",10501,"Grand Falls-Windsor","NL",48.92696,-55.65966,2018-09-15 21:00:00,24,1,25
"23716",10501,"Grand Falls-Windsor","NL",48.92696,-55.65966,2018-09-15 22:00:00,21,1,22
"23717",10501,"Grand Falls-Windsor","NL",48.92696,-55.65966,2018-09-15 23:00:00,20,1,21
"23718",10501,"Grand Falls-Windsor","NL",48.92696,-55.65966,2018-09-16 00:00:00,20,0,20
"23719",10501,"Grand Falls-Windsor","NL",48.92696,-55.65966,2018-09-16 01:00:00,21,1,22
"23720",10501,"Grand Falls-Windsor","NL",48.92696,-55.65966,2018-09-16 02:00:00,22,1,23
"23721",10501,"Grand Falls-Windsor","NL",48.92696,-55.65966,2018-09-16 03:00:00,21,1,22
"23722",10501,"Grand Falls-Windsor","NL",48.92696,-55.65966,2018-09-16 04:00:00,20,1,21
"23723",10501,"Grand Falls-Windsor","NL",48.92696,-55.65966,2018-09-16 05:00:00,19,1,20
"23724",10501,"Grand Falls-Windsor","NL",48.92696,-55.65966,2018-09-16 06:00:00,20,0,20
"23725",10501,"Grand Falls-Windsor","NL",48.92696,-55.65966,2018-09-16 07:00:00,22,0,22
"23726",10501,"Grand Falls-Windsor","NL",48.92696,-55.65966,2018-09-16 08:00:00,23,1,24
"23727",10501,"Grand Falls-Windsor","NL",48.92696,-55.65966,2018-09-16 09:00:00,26,1,27
"23728",10501,"Grand Falls-Windsor","NL",48.92696,-55.65966,2018-09-16 10:00:00,26,1,27
"23729",10501,"Grand Falls-Windsor","NL",48.92696,-55.65966,2018-09-16 11:00:00,26,1,27
"23730",10501,"Grand Falls-Windsor","NL",48.92696,-55.65966,2018-09-16 12:00:00,25,0,25
"23731",10501,"Grand Falls-Windsor","NL",48.92696,-55.65966,2018-09-16 13:00:00,23,1,24
"23732",10501,"Grand Falls-Windsor","NL",48.92696,-55.65966,2018-09-16 14:00:00,23,0,23
"23733",10501,"Grand Falls-Windsor","NL",48.92696,-55.65966,2018-09-16 15:00:00,25,0,25
"23734",10501,"Grand Falls-Windsor","NL",48.92696,-55.65966,2018-09-16 16:00:00,27,0,27
"23735",10501,"Grand Falls-Windsor","NL",48.92696,-55.65966,2018-09-16 17:00:00,26,1,27
"23736",10501,"Grand Falls-Windsor","NL",48.92696,-55.65966,2018-09-16 18:00:00,26,1,27
"23737",10501,"Grand Falls-Windsor","NL",48.92696,-55.65966,2018-09-16 19:00:00,24,1,25
"23738",10501,"Grand Falls-Windsor","NL",48.92696,-55.65966,2018-09-16 20:00:00,24,1,25
"23739",10501,"Grand Falls-Windsor","NL",48.92696,-55.65966,2018-09-16 21:00:00,24,1,25
"23740",10501,"Grand Falls-Windsor","NL",48.92696,-55.65966,2018-09-16 22:00:00,20,1,21
"23741",10501,"Grand Falls-Windsor","NL",48.92696,-55.65966,2018-09-16 23:00:00,16,1,17
"23742",10501,"Grand Falls-Windsor","NL",48.92696,-55.65966,2018-09-17 00:00:00,16,1,17
"23743",10501,"Grand Falls-Windsor","NL",48.92696,-55.65966,2018-09-17 01:00:00,15,0,15
"23744",10501,"Grand Falls-Windsor","NL",48.92696,-55.65966,2018-09-17 02:00:00,13,0,13
"23745",10501,"Grand Falls-Windsor","NL",48.92696,-55.65966,2018-09-17 03:00:00,14,0,14
"23746",10501,"Grand Falls-Windsor","NL",48.92696,-55.65966,2018-09-17 04:00:00,12,1,13
"23747",10501,"Grand Falls-Windsor","NL",48.92696,-55.65966,2018-09-17 05:00:00,12,0,12
"23748",10501,"Grand Falls-Windsor","NL",48.92696,-55.65966,2018-09-17 06:00:00,12,1,13
"23749",10501,"Grand Falls-Windsor","NL",48.92696,-55.65966,2018-09-17 07:00:00,11,1,12
"23750",10501,"Grand Falls-Windsor","NL",48.92696,-55.65966,2018-09-17 08:00:00,14,2,16
"23751",10501,"Grand Falls-Windsor","NL",48.92696,-55.65966,2018-09-17 09:00:00,16,1,17
"23752",10501,"Grand Falls-Windsor","NL",48.92696,-55.65966,2018-09-17 10:00:00,21,0,21
"23753",10501,"Grand Falls-Windsor","NL",48.92696,-55.65966,2018-09-17 11:00:00,22,1,23
"23754",10501,"Grand Falls-Windsor","NL",48.92696,-55.65966,2018-09-17 12:00:00,23,1,24
"23755",10501,"Grand Falls-Windsor","NL",48.92696,-55.65966,2018-09-17 13:00:00,23,1,24
"23756",10501,"Grand Falls-Windsor","NL",48.92696,-55.65966,2018-09-17 14:00:00,22,1,23
"23757",10501,"Grand Falls-Windsor","NL",48.92696,-55.65966,2018-09-17 15:00:00,20,2,22
"23758",10501,"Grand Falls-Windsor","NL",48.92696,-55.65966,2018-09-17 16:00:00,19,4,23
"23759",10501,"Grand Falls-Windsor","NL",48.92696,-55.65966,2018-09-17 17:00:00,23,3,26
"23760",10501,"Grand Falls-Windsor","NL",48.92696,-55.65966,2018-09-17 18:00:00,26,2,28
"23761",10501,"Grand Falls-Windsor","NL",48.92696,-55.65966,2018-09-17 19:00:00,27,1,28
"23762",10501,"Grand Falls-Windsor","NL",48.92696,-55.65966,2018-09-17 20:00:00,27,1,28
"23763",10501,"Grand Falls-Windsor","NL",48.92696,-55.65966,2018-09-17 21:00:00,28,1,29
"23764",10501,"Grand Falls-Windsor","NL",48.92696,-55.65966,2018-09-17 22:00:00,28,1,29
"23765",10501,"Grand Falls-Windsor","NL",48.92696,-55.65966,2018-09-17 23:00:00,27,1,28
"23766",10501,"Grand Falls-Windsor","NL",48.92696,-55.65966,2018-09-18 00:00:00,26,1,27
"23767",10501,"Grand Falls-Windsor","NL",48.92696,-55.65966,2018-09-18 01:00:00,26,0,26
"23768",10501,"Grand Falls-Windsor","NL",48.92696,-55.65966,2018-09-18 02:00:00,24,1,25
"23769",10501,"Grand Falls-Windsor","NL",48.92696,-55.65966,2018-09-18 03:00:00,23,1,24
"23770",10501,"Grand Falls-Windsor","NL",48.92696,-55.65966,2018-09-18 04:00:00,23,1,24
"23771",10501,"Grand Falls-Windsor","NL",48.92696,-55.65966,2018-09-18 05:00:00,22,1,23
"23772",10501,"Grand Falls-Windsor","NL",48.92696,-55.65966,2018-09-18 06:00:00,26,1,27
"23773",10501,"Grand Falls-Windsor","NL",48.92696,-55.65966,2018-09-18 07:00:00,25,2,27
"23774",10501,"Grand Falls-Windsor","NL",48.92696,-55.65966,2018-09-18 08:00:00,25,2,27
"23775",10501,"Grand Falls-Windsor","NL",48.92696,-55.65966,2018-09-18 09:00:00,26,2,28
"23776",10501,"Grand Falls-Windsor","NL",48.92696,-55.65966,2018-09-18 10:00:00,26,1,27
"23777",10501,"Grand Falls-Windsor","NL",48.92696,-55.65966,2018-09-18 11:00:00,30,2,32
"23778",10501,"Grand Falls-Windsor","NL",48.92696,-55.65966,2018-09-18 12:00:00,30,1,31
"23779",10501,"Grand Falls-Windsor","NL",48.92696,-55.65966,2018-09-18 13:00:00,30,1,31
"23780",10501,"Grand Falls-Windsor","NL",48.92696,-55.65966,2018-09-18 14:00:00,29,1,30
"23781",10501,"Grand Falls-Windsor","NL",48.92696,-55.65966,2018-09-18 15:00:00,28,2,30
"23782",10501,"Grand Falls-Windsor","NL",48.92696,-55.65966,2018-09-18 16:00:00,28,1,29
"23783",10501,"Grand Falls-Windsor","NL",48.92696,-55.65966,2018-09-18 17:00:00,27,2,29
"23784",10501,"Grand Falls-Windsor","NL",48.92696,-55.65966,2018-09-18 18:00:00,25,2,27
"23785",10501,"Grand Falls-Windsor","NL",48.92696,-55.65966,2018-09-18 19:00:00,23,2,25
"23786",10501,"Grand Falls-Windsor","NL",48.92696,-55.65966,2018-09-18 20:00:00,23,1,24
"23787",10501,"Grand Falls-Windsor","NL",48.92696,-55.65966,2018-09-18 21:00:00,22,1,23
"23788",10501,"Grand Falls-Windsor","NL",48.92696,-55.65966,2018-09-18 22:00:00,21,1,22
"23789",10501,"Grand Falls-Windsor","NL",48.92696,-55.65966,2018-09-18 23:00:00,19,1,20
"23790",10501,"Grand Falls-Windsor","NL",48.92696,-55.65966,2018-09-19 00:00:00,11,2,13
"23791",10501,"Grand Falls-Windsor","NL",48.92696,-55.65966,2018-09-19 01:00:00,10,3,13
"23792",10501,"Grand Falls-Windsor","NL",48.92696,-55.65966,2018-09-19 02:00:00,11,3,14
"23793",10501,"Grand Falls-Windsor","NL",48.92696,-55.65966,2018-09-19 03:00:00,8,1,9
"23794",10501,"Grand Falls-Windsor","NL",48.92696,-55.65966,2018-09-19 04:00:00,11,1,12
"23795",10501,"Grand Falls-Windsor","NL",48.92696,-55.65966,2018-09-19 05:00:00,7,2,9
"23796",10501,"Grand Falls-Windsor","NL",48.92696,-55.65966,2018-09-19 06:00:00,19,2,21
"23797",10501,"Grand Falls-Windsor","NL",48.92696,-55.65966,2018-09-19 07:00:00,21,2,23
"23798",10501,"Grand Falls-Windsor","NL",48.92696,-55.65966,2018-09-19 08:00:00,24,2,26
"23799",10501,"Grand Falls-Windsor","NL",48.92696,-55.65966,2018-09-19 09:00:00,28,1,29
"23800",10501,"Grand Falls-Windsor","NL",48.92696,-55.65966,2018-09-19 10:00:00,30,1,31
"23801",10501,"Grand Falls-Windsor","NL",48.92696,-55.65966,2018-09-19 11:00:00,31,1,32
"23802",10501,"Grand Falls-Windsor","NL",48.92696,-55.65966,2018-09-19 12:00:00,31,1,32
"23803",10501,"Grand Falls-Windsor","NL",48.92696,-55.65966,2018-09-19 13:00:00,31,1,32
"23804",10501,"Grand Falls-Windsor","NL",48.92696,-55.65966,2018-09-19 14:00:00,31,1,32
"23805",10501,"Grand Falls-Windsor","NL",48.92696,-55.65966,2018-09-19 15:00:00,31,1,32
"23806",10501,"Grand Falls-Windsor","NL",48.92696,-55.65966,2018-09-19 16:00:00,31,1,32
"23807",10501,"Grand Falls-Windsor","NL",48.92696,-55.65966,2018-09-19 17:00:00,31,1,32
"23808",10501,"Grand Falls-Windsor","NL",48.92696,-55.65966,2018-09-19 18:00:00,30,1,31
"23809",10501,"Grand Falls-Windsor","NL",48.92696,-55.65966,2018-09-19 19:00:00,28,1,29
"23810",10501,"Grand Falls-Windsor","NL",48.92696,-55.65966,2018-09-19 20:00:00,29,1,30
"23811",10501,"Grand Falls-Windsor","NL",48.92696,-55.65966,2018-09-19 21:00:00,28,1,29
"23812",10501,"Grand Falls-Windsor","NL",48.92696,-55.65966,2018-09-19 22:00:00,28,1,29
"23813",10501,"Grand Falls-Windsor","NL",48.92696,-55.65966,2018-09-19 23:00:00,27,1,28
"23814",10501,"Grand Falls-Windsor","NL",48.92696,-55.65966,2018-09-20 00:00:00,26,1,27
"23815",10501,"Grand Falls-Windsor","NL",48.92696,-55.65966,2018-09-20 01:00:00,25,1,26
"23816",10501,"Grand Falls-Windsor","NL",48.92696,-55.65966,2018-09-20 02:00:00,26,1,27
"23817",10501,"Grand Falls-Windsor","NL",48.92696,-55.65966,2018-09-20 03:00:00,27,1,28
"23818",10501,"Grand Falls-Windsor","NL",48.92696,-55.65966,2018-09-20 04:00:00,27,1,28
"23819",10501,"Grand Falls-Windsor","NL",48.92696,-55.65966,2018-09-20 05:00:00,23,2,25
"23820",10501,"Grand Falls-Windsor","NL",48.92696,-55.65966,2018-09-20 06:00:00,27,1,28
"23821",10501,"Grand Falls-Windsor","NL",48.92696,-55.65966,2018-09-20 07:00:00,25,3,28
"23822",10501,"Grand Falls-Windsor","NL",48.92696,-55.65966,2018-09-20 08:00:00,25,3,28
"23823",10501,"Grand Falls-Windsor","NL",48.92696,-55.65966,2018-09-20 09:00:00,29,2,31
"23824",10501,"Grand Falls-Windsor","NL",48.92696,-55.65966,2018-09-20 10:00:00,31,2,33
"23825",10501,"Grand Falls-Windsor","NL",48.92696,-55.65966,2018-09-20 11:00:00,32,3,35
"23826",10501,"Grand Falls-Windsor","NL",48.92696,-55.65966,2018-09-20 12:00:00,32,1,33
"23827",10501,"Grand Falls-Windsor","NL",48.92696,-55.65966,2018-09-20 13:00:00,33,1,34
"23828",10501,"Grand Falls-Windsor","NL",48.92696,-55.65966,2018-09-20 14:00:00,33,1,34
"23829",10501,"Grand Falls-Windsor","NL",48.92696,-55.65966,2018-09-20 15:00:00,33,1,34
"23830",10501,"Grand Falls-Windsor","NL",48.92696,-55.65966,2018-09-20 16:00:00,31,1,32
"23831",10501,"Grand Falls-Windsor","NL",48.92696,-55.65966,2018-09-20 17:00:00,31,1,32
"23832",10501,"Grand Falls-Windsor","NL",48.92696,-55.65966,2018-09-20 18:00:00,31,1,32
"23833",10501,"Grand Falls-Windsor","NL",48.92696,-55.65966,2018-09-20 19:00:00,28,2,30
"23834",10501,"Grand Falls-Windsor","NL",48.92696,-55.65966,2018-09-20 20:00:00,27,2,29
"23835",10501,"Grand Falls-Windsor","NL",48.92696,-55.65966,2018-09-20 21:00:00,20,3,23
"23836",10501,"Grand Falls-Windsor","NL",48.92696,-55.65966,2018-09-20 22:00:00,9,1,10
"23837",10501,"Grand Falls-Windsor","NL",48.92696,-55.65966,2018-09-20 23:00:00,8,1,9
"23838",10501,"Grand Falls-Windsor","NL",48.92696,-55.65966,2018-09-21 00:00:00,8,0,8
"23839",10501,"Grand Falls-Windsor","NL",48.92696,-55.65966,2018-09-21 01:00:00,10,0,10
"23840",10501,"Grand Falls-Windsor","NL",48.92696,-55.65966,2018-09-21 02:00:00,10,0,10
"23841",10501,"Grand Falls-Windsor","NL",48.92696,-55.65966,2018-09-21 03:00:00,11,0,11
"23842",10501,"Grand Falls-Windsor","NL",48.92696,-55.65966,2018-09-21 04:00:00,9,0,9
"23843",10501,"Grand Falls-Windsor","NL",48.92696,-55.65966,2018-09-21 05:00:00,7,1,8
"23844",10501,"Grand Falls-Windsor","NL",48.92696,-55.65966,2018-09-21 06:00:00,8,2,10
"23845",10501,"Grand Falls-Windsor","NL",48.92696,-55.65966,2018-09-21 07:00:00,9,1,10
"23846",10501,"Grand Falls-Windsor","NL",48.92696,-55.65966,2018-09-21 08:00:00,10,2,12
"23847",10501,"Grand Falls-Windsor","NL",48.92696,-55.65966,2018-09-21 09:00:00,14,0,14
"23848",10501,"Grand Falls-Windsor","NL",48.92696,-55.65966,2018-09-21 10:00:00,19,1,20
"23849",10501,"Grand Falls-Windsor","NL",48.92696,-55.65966,2018-09-21 11:00:00,25,1,26
"23850",10501,"Grand Falls-Windsor","NL",48.92696,-55.65966,2018-09-21 12:00:00,27,0,27
"23851",10501,"Grand Falls-Windsor","NL",48.92696,-55.65966,2018-09-21 13:00:00,32,1,33
"23852",10501,"Grand Falls-Windsor","NL",48.92696,-55.65966,2018-09-21 14:00:00,33,1,34
"23853",10501,"Grand Falls-Windsor","NL",48.92696,-55.65966,2018-09-21 15:00:00,31,1,32
"23854",10501,"Grand Falls-Windsor","NL",48.92696,-55.65966,2018-09-21 16:00:00,31,1,32
"23855",10501,"Grand Falls-Windsor","NL",48.92696,-55.65966,2018-09-21 17:00:00,31,1,32
"23856",10501,"Grand Falls-Windsor","NL",48.92696,-55.65966,2018-09-21 18:00:00,30,1,31
"23857",10501,"Grand Falls-Windsor","NL",48.92696,-55.65966,2018-09-21 19:00:00,27,1,28
"23858",10501,"Grand Falls-Windsor","NL",48.92696,-55.65966,2018-09-21 20:00:00,21,1,22
"23859",10501,"Grand Falls-Windsor","NL",48.92696,-55.65966,2018-09-21 21:00:00,22,1,23
"23860",10501,"Grand Falls-Windsor","NL",48.92696,-55.65966,2018-09-21 22:00:00,23,1,24
"23861",10501,"Grand Falls-Windsor","NL",48.92696,-55.65966,2018-09-21 23:00:00,25,0,25
"23862",10501,"Grand Falls-Windsor","NL",48.92696,-55.65966,2018-09-22 00:00:00,26,0,26
"23863",10501,"Grand Falls-Windsor","NL",48.92696,-55.65966,2018-09-22 01:00:00,26,0,26
"23864",10501,"Grand Falls-Windsor","NL",48.92696,-55.65966,2018-09-22 02:00:00,26,0,26
"23865",10501,"Grand Falls-Windsor","NL",48.92696,-55.65966,2018-09-22 03:00:00,24,1,25
"23866",10501,"Grand Falls-Windsor","NL",48.92696,-55.65966,2018-09-22 04:00:00,26,0,26
"23867",10501,"Grand Falls-Windsor","NL",48.92696,-55.65966,2018-09-22 05:00:00,27,0,27
"23868",10501,"Grand Falls-Windsor","NL",48.92696,-55.65966,2018-09-22 06:00:00,27,0,27
"23869",10501,"Grand Falls-Windsor","NL",48.92696,-55.65966,2018-09-22 07:00:00,27,1,28
"23870",10501,"Grand Falls-Windsor","NL",48.92696,-55.65966,2018-09-22 08:00:00,27,0,27
"23871",10501,"Grand Falls-Windsor","NL",48.92696,-55.65966,2018-09-22 09:00:00,29,0,29
"23872",10501,"Grand Falls-Windsor","NL",48.92696,-55.65966,2018-09-22 10:00:00,31,0,31
"23873",10501,"Grand Falls-Windsor","NL",48.92696,-55.65966,2018-09-22 11:00:00,33,0,33
"23874",10501,"Grand Falls-Windsor","NL",48.92696,-55.65966,2018-09-22 12:00:00,NA,NA,NA
"23875",10501,"Grand Falls-Windsor","NL",48.92696,-55.65966,2018-09-22 13:00:00,NA,NA,NA
"23876",10501,"Grand Falls-Windsor","NL",48.92696,-55.65966,2018-09-22 14:00:00,NA,NA,NA
"23877",10501,"Grand Falls-Windsor","NL",48.92696,-55.65966,2018-09-22 15:00:00,NA,1,NA
"23878",10501,"Grand Falls-Windsor","NL",48.92696,-55.65966,2018-09-22 16:00:00,28,0,28
"23879",10501,"Grand Falls-Windsor","NL",48.92696,-55.65966,2018-09-22 17:00:00,23,0,23
"23880",10501,"Grand Falls-Windsor","NL",48.92696,-55.65966,2018-09-22 18:00:00,25,0,25
"23881",10501,"Grand Falls-Windsor","NL",48.92696,-55.65966,2018-09-22 19:00:00,26,0,26
"23882",10501,"Grand Falls-Windsor","NL",48.92696,-55.65966,2018-09-22 20:00:00,29,0,29
"23883",10501,"Grand Falls-Windsor","NL",48.92696,-55.65966,2018-09-22 21:00:00,31,0,31
"23884",10501,"Grand Falls-Windsor","NL",48.92696,-55.65966,2018-09-22 22:00:00,32,0,32
"23885",10501,"Grand Falls-Windsor","NL",48.92696,-55.65966,2018-09-22 23:00:00,31,0,31
"23886",10501,"Grand Falls-Windsor","NL",48.92696,-55.65966,2018-09-23 00:00:00,30,0,30
"23887",10501,"Grand Falls-Windsor","NL",48.92696,-55.65966,2018-09-23 01:00:00,27,0,27
"23888",10501,"Grand Falls-Windsor","NL",48.92696,-55.65966,2018-09-23 02:00:00,NA,0,NA
"23889",10501,"Grand Falls-Windsor","NL",48.92696,-55.65966,2018-09-23 03:00:00,NA,0,NA
"23890",10501,"Grand Falls-Windsor","NL",48.92696,-55.65966,2018-09-23 04:00:00,32,0,32
"23891",10501,"Grand Falls-Windsor","NL",48.92696,-55.65966,2018-09-23 05:00:00,29,0,29
"23892",10501,"Grand Falls-Windsor","NL",48.92696,-55.65966,2018-09-23 06:00:00,27,0,27
"23893",10501,"Grand Falls-Windsor","NL",48.92696,-55.65966,2018-09-23 07:00:00,22,1,23
"23894",10501,"Grand Falls-Windsor","NL",48.92696,-55.65966,2018-09-23 08:00:00,26,0,26
"23895",10501,"Grand Falls-Windsor","NL",48.92696,-55.65966,2018-09-23 09:00:00,28,0,28
"23896",10501,"Grand Falls-Windsor","NL",48.92696,-55.65966,2018-09-23 10:00:00,29,0,29
"23897",10501,"Grand Falls-Windsor","NL",48.92696,-55.65966,2018-09-23 11:00:00,30,0,30
"23898",10501,"Grand Falls-Windsor","NL",48.92696,-55.65966,2018-09-23 12:00:00,30,0,30
"23899",10501,"Grand Falls-Windsor","NL",48.92696,-55.65966,2018-09-23 13:00:00,30,0,30
"23900",10501,"Grand Falls-Windsor","NL",48.92696,-55.65966,2018-09-23 14:00:00,30,0,30
"23901",10501,"Grand Falls-Windsor","NL",48.92696,-55.65966,2018-09-23 15:00:00,31,0,31
"23902",10501,"Grand Falls-Windsor","NL",48.92696,-55.65966,2018-09-23 16:00:00,31,0,31
"23903",10501,"Grand Falls-Windsor","NL",48.92696,-55.65966,2018-09-23 17:00:00,31,0,31
"23904",10501,"Grand Falls-Windsor","NL",48.92696,-55.65966,2018-09-23 18:00:00,31,1,32
"23905",10501,"Grand Falls-Windsor","NL",48.92696,-55.65966,2018-09-23 19:00:00,31,0,31
"23906",10501,"Grand Falls-Windsor","NL",48.92696,-55.65966,2018-09-23 20:00:00,28,0,28
"23907",10501,"Grand Falls-Windsor","NL",48.92696,-55.65966,2018-09-23 21:00:00,29,0,29
"23908",10501,"Grand Falls-Windsor","NL",48.92696,-55.65966,2018-09-23 22:00:00,28,0,28
"23909",10501,"Grand Falls-Windsor","NL",48.92696,-55.65966,2018-09-23 23:00:00,27,0,27
"23910",10501,"Grand Falls-Windsor","NL",48.92696,-55.65966,2018-09-24 00:00:00,25,0,25
"23911",10501,"Grand Falls-Windsor","NL",48.92696,-55.65966,2018-09-24 01:00:00,25,0,25
"23912",10501,"Grand Falls-Windsor","NL",48.92696,-55.65966,2018-09-24 02:00:00,25,0,25
"23913",10501,"Grand Falls-Windsor","NL",48.92696,-55.65966,2018-09-24 03:00:00,22,0,22
"23914",10501,"Grand Falls-Windsor","NL",48.92696,-55.65966,2018-09-24 04:00:00,20,0,20
"23915",10501,"Grand Falls-Windsor","NL",48.92696,-55.65966,2018-09-24 05:00:00,15,0,15
"23916",10501,"Grand Falls-Windsor","NL",48.92696,-55.65966,2018-09-24 06:00:00,12,1,13
"23917",10501,"Grand Falls-Windsor","NL",48.92696,-55.65966,2018-09-24 07:00:00,11,2,13
"23918",10501,"Grand Falls-Windsor","NL",48.92696,-55.65966,2018-09-24 08:00:00,15,0,15
"23919",10501,"Grand Falls-Windsor","NL",48.92696,-55.65966,2018-09-24 09:00:00,21,1,22
"23920",10501,"Grand Falls-Windsor","NL",48.92696,-55.65966,2018-09-24 10:00:00,26,0,26
"23921",10501,"Grand Falls-Windsor","NL",48.92696,-55.65966,2018-09-24 11:00:00,28,0,28
"23922",10501,"Grand Falls-Windsor","NL",48.92696,-55.65966,2018-09-24 12:00:00,28,1,29
"23923",10501,"Grand Falls-Windsor","NL",48.92696,-55.65966,2018-09-24 13:00:00,29,1,30
"23924",10501,"Grand Falls-Windsor","NL",48.92696,-55.65966,2018-09-24 14:00:00,29,1,30
"23925",10501,"Grand Falls-Windsor","NL",48.92696,-55.65966,2018-09-24 15:00:00,31,0,31
"23926",10501,"Grand Falls-Windsor","NL",48.92696,-55.65966,2018-09-24 16:00:00,29,2,31
"23927",10501,"Grand Falls-Windsor","NL",48.92696,-55.65966,2018-09-24 17:00:00,26,4,30
"23928",10501,"Grand Falls-Windsor","NL",48.92696,-55.65966,2018-09-24 18:00:00,26,1,27
"23929",10501,"Grand Falls-Windsor","NL",48.92696,-55.65966,2018-09-24 19:00:00,25,0,25
"23930",10501,"Grand Falls-Windsor","NL",48.92696,-55.65966,2018-09-24 20:00:00,24,1,25
"23931",10501,"Grand Falls-Windsor","NL",48.92696,-55.65966,2018-09-24 21:00:00,24,0,24
"23932",10501,"Grand Falls-Windsor","NL",48.92696,-55.65966,2018-09-24 22:00:00,23,0,23
"23933",10501,"Grand Falls-Windsor","NL",48.92696,-55.65966,2018-09-24 23:00:00,22,0,22
"23934",10501,"Grand Falls-Windsor","NL",48.92696,-55.65966,2018-09-25 00:00:00,20,0,20
"23935",10501,"Grand Falls-Windsor","NL",48.92696,-55.65966,2018-09-25 01:00:00,19,0,19
"23936",10501,"Grand Falls-Windsor","NL",48.92696,-55.65966,2018-09-25 02:00:00,18,0,18
"23937",10501,"Grand Falls-Windsor","NL",48.92696,-55.65966,2018-09-25 03:00:00,19,0,19
"23938",10501,"Grand Falls-Windsor","NL",48.92696,-55.65966,2018-09-25 04:00:00,19,0,19
"23939",10501,"Grand Falls-Windsor","NL",48.92696,-55.65966,2018-09-25 05:00:00,22,0,22
"23940",10501,"Grand Falls-Windsor","NL",48.92696,-55.65966,2018-09-25 06:00:00,19,0,19
"23941",10501,"Grand Falls-Windsor","NL",48.92696,-55.65966,2018-09-25 07:00:00,17,0,17
"23942",10501,"Grand Falls-Windsor","NL",48.92696,-55.65966,2018-09-25 08:00:00,19,1,20
"23943",10501,"Grand Falls-Windsor","NL",48.92696,-55.65966,2018-09-25 09:00:00,24,1,25
"23944",10501,"Grand Falls-Windsor","NL",48.92696,-55.65966,2018-09-25 10:00:00,29,1,30
"23945",10501,"Grand Falls-Windsor","NL",48.92696,-55.65966,2018-09-25 11:00:00,31,1,32
"23946",10501,"Grand Falls-Windsor","NL",48.92696,-55.65966,2018-09-25 12:00:00,32,1,33
"23947",10501,"Grand Falls-Windsor","NL",48.92696,-55.65966,2018-09-25 13:00:00,33,1,34
"23948",10501,"Grand Falls-Windsor","NL",48.92696,-55.65966,2018-09-25 14:00:00,34,0,34
"23949",10501,"Grand Falls-Windsor","NL",48.92696,-55.65966,2018-09-25 15:00:00,34,0,34
"23950",10501,"Grand Falls-Windsor","NL",48.92696,-55.65966,2018-09-25 16:00:00,35,1,36
"23951",10501,"Grand Falls-Windsor","NL",48.92696,-55.65966,2018-09-25 17:00:00,35,0,35
"23952",10501,"Grand Falls-Windsor","NL",48.92696,-55.65966,2018-09-25 18:00:00,32,1,33
"23953",10501,"Grand Falls-Windsor","NL",48.92696,-55.65966,2018-09-25 19:00:00,22,2,24
"23954",10501,"Grand Falls-Windsor","NL",48.92696,-55.65966,2018-09-25 20:00:00,14,0,14
"23955",10501,"Grand Falls-Windsor","NL",48.92696,-55.65966,2018-09-25 21:00:00,15,1,16
"23956",10501,"Grand Falls-Windsor","NL",48.92696,-55.65966,2018-09-25 22:00:00,15,1,16
"23957",10501,"Grand Falls-Windsor","NL",48.92696,-55.65966,2018-09-25 23:00:00,15,1,16
"23958",10501,"Grand Falls-Windsor","NL",48.92696,-55.65966,2018-09-26 00:00:00,14,0,14
"23959",10501,"Grand Falls-Windsor","NL",48.92696,-55.65966,2018-09-26 01:00:00,17,1,18
"23960",10501,"Grand Falls-Windsor","NL",48.92696,-55.65966,2018-09-26 02:00:00,19,0,19
"23961",10501,"Grand Falls-Windsor","NL",48.92696,-55.65966,2018-09-26 03:00:00,17,0,17
"23962",10501,"Grand Falls-Windsor","NL",48.92696,-55.65966,2018-09-26 04:00:00,18,0,18
"23963",10501,"Grand Falls-Windsor","NL",48.92696,-55.65966,2018-09-26 05:00:00,22,0,22
"23964",10501,"Grand Falls-Windsor","NL",48.92696,-55.65966,2018-09-26 06:00:00,22,0,22
"23965",10501,"Grand Falls-Windsor","NL",48.92696,-55.65966,2018-09-26 07:00:00,25,0,25
"23966",10501,"Grand Falls-Windsor","NL",48.92696,-55.65966,2018-09-26 08:00:00,27,1,28
"23967",10501,"Grand Falls-Windsor","NL",48.92696,-55.65966,2018-09-26 09:00:00,28,1,29
"23968",10501,"Grand Falls-Windsor","NL",48.92696,-55.65966,2018-09-26 10:00:00,30,1,31
"23969",10501,"Grand Falls-Windsor","NL",48.92696,-55.65966,2018-09-26 11:00:00,31,0,31
"23970",10501,"Grand Falls-Windsor","NL",48.92696,-55.65966,2018-09-26 12:00:00,33,0,33
"23971",10501,"Grand Falls-Windsor","NL",48.92696,-55.65966,2018-09-26 13:00:00,36,1,37
"23972",10501,"Grand Falls-Windsor","NL",48.92696,-55.65966,2018-09-26 14:00:00,37,0,37
"23973",10501,"Grand Falls-Windsor","NL",48.92696,-55.65966,2018-09-26 15:00:00,37,1,38
"23974",10501,"Grand Falls-Windsor","NL",48.92696,-55.65966,2018-09-26 16:00:00,38,0,38
"23975",10501,"Grand Falls-Windsor","NL",48.92696,-55.65966,2018-09-26 17:00:00,37,0,37
"23976",10501,"Grand Falls-Windsor","NL",48.92696,-55.65966,2018-09-26 18:00:00,36,0,36
"23977",10501,"Grand Falls-Windsor","NL",48.92696,-55.65966,2018-09-26 19:00:00,37,0,37
"23978",10501,"Grand Falls-Windsor","NL",48.92696,-55.65966,2018-09-26 20:00:00,36,0,36
"23979",10501,"Grand Falls-Windsor","NL",48.92696,-55.65966,2018-09-26 21:00:00,36,0,36
"23980",10501,"Grand Falls-Windsor","NL",48.92696,-55.65966,2018-09-26 22:00:00,37,0,37
"23981",10501,"Grand Falls-Windsor","NL",48.92696,-55.65966,2018-09-26 23:00:00,37,0,37
"23982",10501,"Grand Falls-Windsor","NL",48.92696,-55.65966,2018-09-27 00:00:00,36,0,36
"23983",10501,"Grand Falls-Windsor","NL",48.92696,-55.65966,2018-09-27 01:00:00,38,0,38
"23984",10501,"Grand Falls-Windsor","NL",48.92696,-55.65966,2018-09-27 02:00:00,37,0,37
"23985",10501,"Grand Falls-Windsor","NL",48.92696,-55.65966,2018-09-27 03:00:00,37,0,37
"23986",10501,"Grand Falls-Windsor","NL",48.92696,-55.65966,2018-09-27 04:00:00,38,0,38
"23987",10501,"Grand Falls-Windsor","NL",48.92696,-55.65966,2018-09-27 05:00:00,39,0,39
"23988",10501,"Grand Falls-Windsor","NL",48.92696,-55.65966,2018-09-27 06:00:00,39,0,39
"23989",10501,"Grand Falls-Windsor","NL",48.92696,-55.65966,2018-09-27 07:00:00,39,0,39
"23990",10501,"Grand Falls-Windsor","NL",48.92696,-55.65966,2018-09-27 08:00:00,39,0,39
"23991",10501,"Grand Falls-Windsor","NL",48.92696,-55.65966,2018-09-27 09:00:00,40,0,40
"23992",10501,"Grand Falls-Windsor","NL",48.92696,-55.65966,2018-09-27 10:00:00,39,0,39
"23993",10501,"Grand Falls-Windsor","NL",48.92696,-55.65966,2018-09-27 11:00:00,35,0,35
"23994",10501,"Grand Falls-Windsor","NL",48.92696,-55.65966,2018-09-27 12:00:00,36,0,36
"23995",10501,"Grand Falls-Windsor","NL",48.92696,-55.65966,2018-09-27 13:00:00,34,0,34
"23996",10501,"Grand Falls-Windsor","NL",48.92696,-55.65966,2018-09-27 14:00:00,32,0,32
"23997",10501,"Grand Falls-Windsor","NL",48.92696,-55.65966,2018-09-27 15:00:00,35,1,36
"23998",10501,"Grand Falls-Windsor","NL",48.92696,-55.65966,2018-09-27 16:00:00,35,1,36
"23999",10501,"Grand Falls-Windsor","NL",48.92696,-55.65966,2018-09-27 17:00:00,32,1,33
"24000",10501,"Grand Falls-Windsor","NL",48.92696,-55.65966,2018-09-27 18:00:00,32,1,33
"24001",10501,"Grand Falls-Windsor","NL",48.92696,-55.65966,2018-09-27 19:00:00,27,1,28
"24002",10501,"Grand Falls-Windsor","NL",48.92696,-55.65966,2018-09-27 20:00:00,25,0,25
"24003",10501,"Grand Falls-Windsor","NL",48.92696,-55.65966,2018-09-27 21:00:00,30,0,30
"24004",10501,"Grand Falls-Windsor","NL",48.92696,-55.65966,2018-09-27 22:00:00,28,1,29
"24005",10501,"Grand Falls-Windsor","NL",48.92696,-55.65966,2018-09-27 23:00:00,25,1,26
"24006",10501,"Grand Falls-Windsor","NL",48.92696,-55.65966,2018-09-28 00:00:00,22,1,23
"24007",10501,"Grand Falls-Windsor","NL",48.92696,-55.65966,2018-09-28 01:00:00,22,1,23
"24008",10501,"Grand Falls-Windsor","NL",48.92696,-55.65966,2018-09-28 02:00:00,17,1,18
"24009",10501,"Grand Falls-Windsor","NL",48.92696,-55.65966,2018-09-28 03:00:00,10,1,11
"24010",10501,"Grand Falls-Windsor","NL",48.92696,-55.65966,2018-09-28 04:00:00,8,0,8
"24011",10501,"Grand Falls-Windsor","NL",48.92696,-55.65966,2018-09-28 05:00:00,5,0,5
"24012",10501,"Grand Falls-Windsor","NL",48.92696,-55.65966,2018-09-28 06:00:00,5,0,5
"24013",10501,"Grand Falls-Windsor","NL",48.92696,-55.65966,2018-09-28 07:00:00,4,1,5
"24014",10501,"Grand Falls-Windsor","NL",48.92696,-55.65966,2018-09-28 08:00:00,4,1,5
"24015",10501,"Grand Falls-Windsor","NL",48.92696,-55.65966,2018-09-28 09:00:00,8,2,10
"24016",10501,"Grand Falls-Windsor","NL",48.92696,-55.65966,2018-09-28 10:00:00,19,1,20
"24017",10501,"Grand Falls-Windsor","NL",48.92696,-55.65966,2018-09-28 11:00:00,24,1,25
"24018",10501,"Grand Falls-Windsor","NL",48.92696,-55.65966,2018-09-28 12:00:00,25,1,26
"24019",10501,"Grand Falls-Windsor","NL",48.92696,-55.65966,2018-09-28 13:00:00,26,1,27
"24020",10501,"Grand Falls-Windsor","NL",48.92696,-55.65966,2018-09-28 14:00:00,27,1,28
"24021",10501,"Grand Falls-Windsor","NL",48.92696,-55.65966,2018-09-28 15:00:00,27,1,28
"24022",10501,"Grand Falls-Windsor","NL",48.92696,-55.65966,2018-09-28 16:00:00,27,1,28
"24023",10501,"Grand Falls-Windsor","NL",48.92696,-55.65966,2018-09-28 17:00:00,28,1,29
"24024",10501,"Grand Falls-Windsor","NL",48.92696,-55.65966,2018-09-28 18:00:00,27,1,28
"24025",10501,"Grand Falls-Windsor","NL",48.92696,-55.65966,2018-09-28 19:00:00,26,1,27
"24026",10501,"Grand Falls-Windsor","NL",48.92696,-55.65966,2018-09-28 20:00:00,24,1,25
"24027",10501,"Grand Falls-Windsor","NL",48.92696,-55.65966,2018-09-28 21:00:00,23,2,25
"24028",10501,"Grand Falls-Windsor","NL",48.92696,-55.65966,2018-09-28 22:00:00,23,1,24
"24029",10501,"Grand Falls-Windsor","NL",48.92696,-55.65966,2018-09-28 23:00:00,21,1,22
"24030",10501,"Grand Falls-Windsor","NL",48.92696,-55.65966,2018-09-29 00:00:00,18,0,18
"24031",10501,"Grand Falls-Windsor","NL",48.92696,-55.65966,2018-09-29 01:00:00,16,1,17
"24032",10501,"Grand Falls-Windsor","NL",48.92696,-55.65966,2018-09-29 02:00:00,15,1,16
"24033",10501,"Grand Falls-Windsor","NL",48.92696,-55.65966,2018-09-29 03:00:00,22,NA,NA
"24034",10501,"Grand Falls-Windsor","NL",48.92696,-55.65966,2018-09-29 04:00:00,NA,NA,NA
"24035",10501,"Grand Falls-Windsor","NL",48.92696,-55.65966,2018-09-29 05:00:00,NA,NA,NA
"24036",10501,"Grand Falls-Windsor","NL",48.92696,-55.65966,2018-09-29 06:00:00,NA,NA,NA
"24037",10501,"Grand Falls-Windsor","NL",48.92696,-55.65966,2018-09-29 07:00:00,NA,NA,NA
"24038",10501,"Grand Falls-Windsor","NL",48.92696,-55.65966,2018-09-29 08:00:00,NA,NA,NA
"24039",10501,"Grand Falls-Windsor","NL",48.92696,-55.65966,2018-09-29 09:00:00,NA,NA,NA
"24040",10501,"Grand Falls-Windsor","NL",48.92696,-55.65966,2018-09-29 10:00:00,NA,NA,NA
"24041",10501,"Grand Falls-Windsor","NL",48.92696,-55.65966,2018-09-29 11:00:00,NA,NA,NA
"24042",10501,"Grand Falls-Windsor","NL",48.92696,-55.65966,2018-09-29 12:00:00,NA,NA,NA
"24043",10501,"Grand Falls-Windsor","NL",48.92696,-55.65966,2018-09-29 13:00:00,NA,NA,NA
"24044",10501,"Grand Falls-Windsor","NL",48.92696,-55.65966,2018-09-29 14:00:00,NA,NA,NA
"24045",10501,"Grand Falls-Windsor","NL",48.92696,-55.65966,2018-09-29 15:00:00,NA,NA,NA
"24046",10501,"Grand Falls-Windsor","NL",48.92696,-55.65966,2018-09-29 16:00:00,NA,NA,NA
"24047",10501,"Grand Falls-Windsor","NL",48.92696,-55.65966,2018-09-29 17:00:00,NA,NA,NA
"24048",10501,"Grand Falls-Windsor","NL",48.92696,-55.65966,2018-09-29 18:00:00,NA,NA,NA
"24049",10501,"Grand Falls-Windsor","NL",48.92696,-55.65966,2018-09-29 19:00:00,NA,NA,NA
"24050",10501,"Grand Falls-Windsor","NL",48.92696,-55.65966,2018-09-29 20:00:00,NA,NA,NA
"24051",10501,"Grand Falls-Windsor","NL",48.92696,-55.65966,2018-09-29 21:00:00,NA,NA,NA
"24052",10501,"Grand Falls-Windsor","NL",48.92696,-55.65966,2018-09-29 22:00:00,NA,NA,NA
"24053",10501,"Grand Falls-Windsor","NL",48.92696,-55.65966,2018-09-29 23:00:00,NA,NA,NA
"24054",10501,"Grand Falls-Windsor","NL",48.92696,-55.65966,2018-09-30 00:00:00,NA,NA,NA
"24055",10501,"Grand Falls-Windsor","NL",48.92696,-55.65966,2018-09-30 01:00:00,NA,NA,NA
"24056",10501,"Grand Falls-Windsor","NL",48.92696,-55.65966,2018-09-30 02:00:00,NA,NA,NA
"24057",10501,"Grand Falls-Windsor","NL",48.92696,-55.65966,2018-09-30 03:00:00,NA,NA,NA
"24058",10501,"Grand Falls-Windsor","NL",48.92696,-55.65966,2018-09-30 04:00:00,NA,NA,NA
"24059",10501,"Grand Falls-Windsor","NL",48.92696,-55.65966,2018-09-30 05:00:00,NA,NA,NA
"24060",10501,"Grand Falls-Windsor","NL",48.92696,-55.65966,2018-09-30 06:00:00,NA,NA,NA
"24061",10501,"Grand Falls-Windsor","NL",48.92696,-55.65966,2018-09-30 07:00:00,NA,NA,NA
"24062",10501,"Grand Falls-Windsor","NL",48.92696,-55.65966,2018-09-30 08:00:00,NA,NA,NA
"24063",10501,"Grand Falls-Windsor","NL",48.92696,-55.65966,2018-09-30 09:00:00,NA,NA,NA
"24064",10501,"Grand Falls-Windsor","NL",48.92696,-55.65966,2018-09-30 10:00:00,NA,NA,NA
"24065",10501,"Grand Falls-Windsor","NL",48.92696,-55.65966,2018-09-30 11:00:00,NA,NA,NA
"24066",10501,"Grand Falls-Windsor","NL",48.92696,-55.65966,2018-09-30 12:00:00,NA,NA,NA
"24067",10501,"Grand Falls-Windsor","NL",48.92696,-55.65966,2018-09-30 13:00:00,NA,NA,NA
"24068",10501,"Grand Falls-Windsor","NL",48.92696,-55.65966,2018-09-30 14:00:00,NA,NA,NA
"24069",10501,"Grand Falls-Windsor","NL",48.92696,-55.65966,2018-09-30 15:00:00,NA,NA,NA
"24070",10501,"Grand Falls-Windsor","NL",48.92696,-55.65966,2018-09-30 16:00:00,NA,NA,NA
"24071",10501,"Grand Falls-Windsor","NL",48.92696,-55.65966,2018-09-30 17:00:00,NA,NA,NA
"24072",10501,"Grand Falls-Windsor","NL",48.92696,-55.65966,2018-09-30 18:00:00,NA,NA,NA
"24073",10501,"Grand Falls-Windsor","NL",48.92696,-55.65966,2018-09-30 19:00:00,NA,NA,NA
"24074",10501,"Grand Falls-Windsor","NL",48.92696,-55.65966,2018-09-30 20:00:00,NA,NA,NA
"24075",10501,"Grand Falls-Windsor","NL",48.92696,-55.65966,2018-09-30 21:00:00,NA,NA,NA
"24076",10501,"Grand Falls-Windsor","NL",48.92696,-55.65966,2018-09-30 22:00:00,NA,NA,NA
"24077",10501,"Grand Falls-Windsor","NL",48.92696,-55.65966,2018-09-30 23:00:00,NA,NA,NA
"24078",10501,"Grand Falls-Windsor","NL",48.92696,-55.65966,2018-10-01 00:00:00,NA,NA,NA
"24079",10501,"Grand Falls-Windsor","NL",48.92696,-55.65966,2018-10-01 01:00:00,NA,NA,NA
"24080",10501,"Grand Falls-Windsor","NL",48.92696,-55.65966,2018-10-01 02:00:00,NA,NA,NA
"24081",10501,"Grand Falls-Windsor","NL",48.92696,-55.65966,2018-10-01 03:00:00,NA,NA,NA
"24082",10501,"Grand Falls-Windsor","NL",48.92696,-55.65966,2018-10-01 04:00:00,NA,NA,NA
"24083",10501,"Grand Falls-Windsor","NL",48.92696,-55.65966,2018-10-01 05:00:00,NA,NA,NA
"24084",10501,"Grand Falls-Windsor","NL",48.92696,-55.65966,2018-10-01 06:00:00,NA,NA,NA
"24085",10501,"Grand Falls-Windsor","NL",48.92696,-55.65966,2018-10-01 07:00:00,NA,NA,NA
"24086",10501,"Grand Falls-Windsor","NL",48.92696,-55.65966,2018-10-01 08:00:00,NA,NA,NA
"24087",10501,"Grand Falls-Windsor","NL",48.92696,-55.65966,2018-10-01 09:00:00,NA,NA,NA
"24088",10501,"Grand Falls-Windsor","NL",48.92696,-55.65966,2018-10-01 10:00:00,NA,NA,NA
"24089",10501,"Grand Falls-Windsor","NL",48.92696,-55.65966,2018-10-01 11:00:00,NA,NA,NA
"24090",10501,"Grand Falls-Windsor","NL",48.92696,-55.65966,2018-10-01 12:00:00,NA,NA,NA
"24091",10501,"Grand Falls-Windsor","NL",48.92696,-55.65966,2018-10-01 13:00:00,NA,NA,NA
"24092",10501,"Grand Falls-Windsor","NL",48.92696,-55.65966,2018-10-01 14:00:00,NA,NA,NA
"24093",10501,"Grand Falls-Windsor","NL",48.92696,-55.65966,2018-10-01 15:00:00,NA,NA,NA
"24094",10501,"Grand Falls-Windsor","NL",48.92696,-55.65966,2018-10-01 16:00:00,NA,NA,NA
"24095",10501,"Grand Falls-Windsor","NL",48.92696,-55.65966,2018-10-01 17:00:00,NA,NA,NA
"24096",10501,"Grand Falls-Windsor","NL",48.92696,-55.65966,2018-10-01 18:00:00,NA,NA,NA
"24097",10501,"Grand Falls-Windsor","NL",48.92696,-55.65966,2018-10-01 19:00:00,NA,NA,NA
"24098",10501,"Grand Falls-Windsor","NL",48.92696,-55.65966,2018-10-01 20:00:00,NA,NA,NA
"24099",10501,"Grand Falls-Windsor","NL",48.92696,-55.65966,2018-10-01 21:00:00,NA,NA,NA
"24100",10501,"Grand Falls-Windsor","NL",48.92696,-55.65966,2018-10-01 22:00:00,NA,NA,NA
"24101",10501,"Grand Falls-Windsor","NL",48.92696,-55.65966,2018-10-01 23:00:00,NA,NA,NA
"24102",10501,"Grand Falls-Windsor","NL",48.92696,-55.65966,2018-10-02 00:00:00,NA,NA,NA
"24103",10501,"Grand Falls-Windsor","NL",48.92696,-55.65966,2018-10-02 01:00:00,NA,NA,NA
"24104",10501,"Grand Falls-Windsor","NL",48.92696,-55.65966,2018-10-02 02:00:00,NA,NA,NA
"24105",10501,"Grand Falls-Windsor","NL",48.92696,-55.65966,2018-10-02 03:00:00,NA,NA,NA
"24106",10501,"Grand Falls-Windsor","NL",48.92696,-55.65966,2018-10-02 04:00:00,NA,NA,NA
"24107",10501,"Grand Falls-Windsor","NL",48.92696,-55.65966,2018-10-02 05:00:00,NA,NA,NA
"24108",10501,"Grand Falls-Windsor","NL",48.92696,-55.65966,2018-10-02 06:00:00,NA,NA,NA
"24109",10501,"Grand Falls-Windsor","NL",48.92696,-55.65966,2018-10-02 07:00:00,NA,NA,NA
"24110",10501,"Grand Falls-Windsor","NL",48.92696,-55.65966,2018-10-02 08:00:00,NA,NA,NA
"24111",10501,"Grand Falls-Windsor","NL",48.92696,-55.65966,2018-10-02 09:00:00,NA,NA,NA
"24112",10501,"Grand Falls-Windsor","NL",48.92696,-55.65966,2018-10-02 10:00:00,NA,NA,NA
"24113",10501,"Grand Falls-Windsor","NL",48.92696,-55.65966,2018-10-02 11:00:00,NA,NA,NA
"24114",10501,"Grand Falls-Windsor","NL",48.92696,-55.65966,2018-10-02 12:00:00,NA,NA,NA
"24115",10501,"Grand Falls-Windsor","NL",48.92696,-55.65966,2018-10-02 13:00:00,NA,NA,NA
"24116",10501,"Grand Falls-Windsor","NL",48.92696,-55.65966,2018-10-02 14:00:00,NA,NA,NA
"24117",10501,"Grand Falls-Windsor","NL",48.92696,-55.65966,2018-10-02 15:00:00,NA,NA,NA
"24118",10501,"Grand Falls-Windsor","NL",48.92696,-55.65966,2018-10-02 16:00:00,NA,NA,NA
"24119",10501,"Grand Falls-Windsor","NL",48.92696,-55.65966,2018-10-02 17:00:00,NA,NA,NA
"24120",10501,"Grand Falls-Windsor","NL",48.92696,-55.65966,2018-10-02 18:00:00,NA,NA,NA
"24121",10501,"Grand Falls-Windsor","NL",48.92696,-55.65966,2018-10-02 19:00:00,NA,NA,NA
"24122",10501,"Grand Falls-Windsor","NL",48.92696,-55.65966,2018-10-02 20:00:00,NA,NA,NA
"24123",10501,"Grand Falls-Windsor","NL",48.92696,-55.65966,2018-10-02 21:00:00,NA,NA,NA
"24124",10501,"Grand Falls-Windsor","NL",48.92696,-55.65966,2018-10-02 22:00:00,NA,NA,NA
"24125",10501,"Grand Falls-Windsor","NL",48.92696,-55.65966,2018-10-02 23:00:00,NA,NA,NA
"24126",10501,"Grand Falls-Windsor","NL",48.92696,-55.65966,2018-10-03 00:00:00,NA,NA,NA
"24127",10501,"Grand Falls-Windsor","NL",48.92696,-55.65966,2018-10-03 01:00:00,NA,NA,NA
"24128",10501,"Grand Falls-Windsor","NL",48.92696,-55.65966,2018-10-03 02:00:00,NA,NA,NA
"24129",10501,"Grand Falls-Windsor","NL",48.92696,-55.65966,2018-10-03 03:00:00,NA,NA,NA
"24130",10501,"Grand Falls-Windsor","NL",48.92696,-55.65966,2018-10-03 04:00:00,NA,NA,NA
"24131",10501,"Grand Falls-Windsor","NL",48.92696,-55.65966,2018-10-03 05:00:00,NA,NA,NA
"24132",10501,"Grand Falls-Windsor","NL",48.92696,-55.65966,2018-10-03 06:00:00,NA,NA,NA
"24133",10501,"Grand Falls-Windsor","NL",48.92696,-55.65966,2018-10-03 07:00:00,NA,NA,NA
"24134",10501,"Grand Falls-Windsor","NL",48.92696,-55.65966,2018-10-03 08:00:00,NA,NA,NA
"24135",10501,"Grand Falls-Windsor","NL",48.92696,-55.65966,2018-10-03 09:00:00,NA,NA,NA
"24136",10501,"Grand Falls-Windsor","NL",48.92696,-55.65966,2018-10-03 10:00:00,NA,NA,NA
"24137",10501,"Grand Falls-Windsor","NL",48.92696,-55.65966,2018-10-03 11:00:00,NA,NA,NA
"24138",10501,"Grand Falls-Windsor","NL",48.92696,-55.65966,2018-10-03 12:00:00,NA,NA,NA
"24139",10501,"Grand Falls-Windsor","NL",48.92696,-55.65966,2018-10-03 13:00:00,NA,NA,NA
"24140",10501,"Grand Falls-Windsor","NL",48.92696,-55.65966,2018-10-03 14:00:00,NA,NA,NA
"24141",10501,"Grand Falls-Windsor","NL",48.92696,-55.65966,2018-10-03 15:00:00,NA,NA,NA
"24142",10501,"Grand Falls-Windsor","NL",48.92696,-55.65966,2018-10-03 16:00:00,NA,NA,NA
"24143",10501,"Grand Falls-Windsor","NL",48.92696,-55.65966,2018-10-03 17:00:00,NA,NA,NA
"24144",10501,"Grand Falls-Windsor","NL",48.92696,-55.65966,2018-10-03 18:00:00,NA,NA,NA
"24145",10501,"Grand Falls-Windsor","NL",48.92696,-55.65966,2018-10-03 19:00:00,NA,NA,NA
"24146",10501,"Grand Falls-Windsor","NL",48.92696,-55.65966,2018-10-03 20:00:00,NA,NA,NA
"24147",10501,"Grand Falls-Windsor","NL",48.92696,-55.65966,2018-10-03 21:00:00,NA,NA,NA
"24148",10501,"Grand Falls-Windsor","NL",48.92696,-55.65966,2018-10-03 22:00:00,NA,NA,NA
"24149",10501,"Grand Falls-Windsor","NL",48.92696,-55.65966,2018-10-03 23:00:00,NA,NA,NA
"24150",10501,"Grand Falls-Windsor","NL",48.92696,-55.65966,2018-10-04 00:00:00,NA,NA,NA
"24151",10501,"Grand Falls-Windsor","NL",48.92696,-55.65966,2018-10-04 01:00:00,NA,NA,NA
"24152",10501,"Grand Falls-Windsor","NL",48.92696,-55.65966,2018-10-04 02:00:00,NA,NA,NA
"24153",10501,"Grand Falls-Windsor","NL",48.92696,-55.65966,2018-10-04 03:00:00,NA,NA,NA
"24154",10501,"Grand Falls-Windsor","NL",48.92696,-55.65966,2018-10-04 04:00:00,NA,NA,NA
"24155",10501,"Grand Falls-Windsor","NL",48.92696,-55.65966,2018-10-04 05:00:00,NA,NA,NA
"24156",10501,"Grand Falls-Windsor","NL",48.92696,-55.65966,2018-10-04 06:00:00,NA,NA,NA
"24157",10501,"Grand Falls-Windsor","NL",48.92696,-55.65966,2018-10-04 07:00:00,NA,NA,NA
"24158",10501,"Grand Falls-Windsor","NL",48.92696,-55.65966,2018-10-04 08:00:00,NA,NA,NA
"24159",10501,"Grand Falls-Windsor","NL",48.92696,-55.65966,2018-10-04 09:00:00,NA,NA,NA
"24160",10501,"Grand Falls-Windsor","NL",48.92696,-55.65966,2018-10-04 10:00:00,NA,NA,NA
"24161",10501,"Grand Falls-Windsor","NL",48.92696,-55.65966,2018-10-04 11:00:00,NA,NA,NA
"24162",10501,"Grand Falls-Windsor","NL",48.92696,-55.65966,2018-10-04 12:00:00,NA,NA,NA
"24163",10501,"Grand Falls-Windsor","NL",48.92696,-55.65966,2018-10-04 13:00:00,NA,NA,NA
"24164",10501,"Grand Falls-Windsor","NL",48.92696,-55.65966,2018-10-04 14:00:00,NA,NA,NA
"24165",10501,"Grand Falls-Windsor","NL",48.92696,-55.65966,2018-10-04 15:00:00,NA,NA,NA
"24166",10501,"Grand Falls-Windsor","NL",48.92696,-55.65966,2018-10-04 16:00:00,NA,NA,NA
"24167",10501,"Grand Falls-Windsor","NL",48.92696,-55.65966,2018-10-04 17:00:00,NA,NA,NA
"24168",10501,"Grand Falls-Windsor","NL",48.92696,-55.65966,2018-10-04 18:00:00,NA,NA,NA
"24169",10501,"Grand Falls-Windsor","NL",48.92696,-55.65966,2018-10-04 19:00:00,NA,NA,NA
"24170",10501,"Grand Falls-Windsor","NL",48.92696,-55.65966,2018-10-04 20:00:00,NA,NA,NA
"24171",10501,"Grand Falls-Windsor","NL",48.92696,-55.65966,2018-10-04 21:00:00,NA,NA,NA
"24172",10501,"Grand Falls-Windsor","NL",48.92696,-55.65966,2018-10-04 22:00:00,NA,NA,NA
"24173",10501,"Grand Falls-Windsor","NL",48.92696,-55.65966,2018-10-04 23:00:00,NA,NA,NA
"24174",10501,"Grand Falls-Windsor","NL",48.92696,-55.65966,2018-10-05 00:00:00,NA,NA,NA
"24175",10501,"Grand Falls-Windsor","NL",48.92696,-55.65966,2018-10-05 01:00:00,NA,NA,NA
"24176",10501,"Grand Falls-Windsor","NL",48.92696,-55.65966,2018-10-05 02:00:00,NA,NA,NA
"24177",10501,"Grand Falls-Windsor","NL",48.92696,-55.65966,2018-10-05 03:00:00,NA,NA,NA
"24178",10501,"Grand Falls-Windsor","NL",48.92696,-55.65966,2018-10-05 04:00:00,NA,NA,NA
"24179",10501,"Grand Falls-Windsor","NL",48.92696,-55.65966,2018-10-05 05:00:00,NA,NA,NA
"24180",10501,"Grand Falls-Windsor","NL",48.92696,-55.65966,2018-10-05 06:00:00,NA,NA,NA
"24181",10501,"Grand Falls-Windsor","NL",48.92696,-55.65966,2018-10-05 07:00:00,NA,NA,NA
"24182",10501,"Grand Falls-Windsor","NL",48.92696,-55.65966,2018-10-05 08:00:00,NA,NA,NA
"24183",10501,"Grand Falls-Windsor","NL",48.92696,-55.65966,2018-10-05 09:00:00,NA,NA,NA
"24184",10501,"Grand Falls-Windsor","NL",48.92696,-55.65966,2018-10-05 10:00:00,NA,NA,NA
"24185",10501,"Grand Falls-Windsor","NL",48.92696,-55.65966,2018-10-05 11:00:00,NA,NA,NA
"24186",10501,"Grand Falls-Windsor","NL",48.92696,-55.65966,2018-10-05 12:00:00,NA,NA,NA
"24187",10501,"Grand Falls-Windsor","NL",48.92696,-55.65966,2018-10-05 13:00:00,NA,NA,NA
"24188",10501,"Grand Falls-Windsor","NL",48.92696,-55.65966,2018-10-05 14:00:00,NA,NA,NA
"24189",10501,"Grand Falls-Windsor","NL",48.92696,-55.65966,2018-10-05 15:00:00,NA,NA,NA
"24190",10501,"Grand Falls-Windsor","NL",48.92696,-55.65966,2018-10-05 16:00:00,NA,NA,NA
"24191",10501,"Grand Falls-Windsor","NL",48.92696,-55.65966,2018-10-05 17:00:00,NA,NA,NA
"24192",10501,"Grand Falls-Windsor","NL",48.92696,-55.65966,2018-10-05 18:00:00,NA,NA,NA
"24193",10501,"Grand Falls-Windsor","NL",48.92696,-55.65966,2018-10-05 19:00:00,NA,NA,NA
"24194",10501,"Grand Falls-Windsor","NL",48.92696,-55.65966,2018-10-05 20:00:00,NA,NA,NA
"24195",10501,"Grand Falls-Windsor","NL",48.92696,-55.65966,2018-10-05 21:00:00,NA,NA,NA
"24196",10501,"Grand Falls-Windsor","NL",48.92696,-55.65966,2018-10-05 22:00:00,NA,NA,NA
"24197",10501,"Grand Falls-Windsor","NL",48.92696,-55.65966,2018-10-05 23:00:00,NA,NA,NA
"24198",10501,"Grand Falls-Windsor","NL",48.92696,-55.65966,2018-10-06 00:00:00,NA,NA,NA
"24199",10501,"Grand Falls-Windsor","NL",48.92696,-55.65966,2018-10-06 01:00:00,NA,NA,NA
"24200",10501,"Grand Falls-Windsor","NL",48.92696,-55.65966,2018-10-06 02:00:00,NA,NA,NA
"24201",10501,"Grand Falls-Windsor","NL",48.92696,-55.65966,2018-10-06 03:00:00,NA,NA,NA
"24202",10501,"Grand Falls-Windsor","NL",48.92696,-55.65966,2018-10-06 04:00:00,NA,NA,NA
"24203",10501,"Grand Falls-Windsor","NL",48.92696,-55.65966,2018-10-06 05:00:00,NA,NA,NA
"24204",10501,"Grand Falls-Windsor","NL",48.92696,-55.65966,2018-10-06 06:00:00,NA,NA,NA
"24205",10501,"Grand Falls-Windsor","NL",48.92696,-55.65966,2018-10-06 07:00:00,NA,NA,NA
"24206",10501,"Grand Falls-Windsor","NL",48.92696,-55.65966,2018-10-06 08:00:00,NA,NA,NA
"24207",10501,"Grand Falls-Windsor","NL",48.92696,-55.65966,2018-10-06 09:00:00,NA,NA,NA
"24208",10501,"Grand Falls-Windsor","NL",48.92696,-55.65966,2018-10-06 10:00:00,NA,NA,NA
"24209",10501,"Grand Falls-Windsor","NL",48.92696,-55.65966,2018-10-06 11:00:00,NA,NA,NA
"24210",10501,"Grand Falls-Windsor","NL",48.92696,-55.65966,2018-10-06 12:00:00,NA,NA,NA
"24211",10501,"Grand Falls-Windsor","NL",48.92696,-55.65966,2018-10-06 13:00:00,NA,NA,NA
"24212",10501,"Grand Falls-Windsor","NL",48.92696,-55.65966,2018-10-06 14:00:00,NA,NA,NA
"24213",10501,"Grand Falls-Windsor","NL",48.92696,-55.65966,2018-10-06 15:00:00,NA,NA,NA
"24214",10501,"Grand Falls-Windsor","NL",48.92696,-55.65966,2018-10-06 16:00:00,NA,NA,NA
"24215",10501,"Grand Falls-Windsor","NL",48.92696,-55.65966,2018-10-06 17:00:00,NA,NA,NA
"24216",10501,"Grand Falls-Windsor","NL",48.92696,-55.65966,2018-10-06 18:00:00,NA,NA,NA
"24217",10501,"Grand Falls-Windsor","NL",48.92696,-55.65966,2018-10-06 19:00:00,NA,NA,NA
"24218",10501,"Grand Falls-Windsor","NL",48.92696,-55.65966,2018-10-06 20:00:00,NA,NA,NA
"24219",10501,"Grand Falls-Windsor","NL",48.92696,-55.65966,2018-10-06 21:00:00,NA,NA,NA
"24220",10501,"Grand Falls-Windsor","NL",48.92696,-55.65966,2018-10-06 22:00:00,NA,NA,NA
"24221",10501,"Grand Falls-Windsor","NL",48.92696,-55.65966,2018-10-06 23:00:00,NA,NA,NA
"24222",10501,"Grand Falls-Windsor","NL",48.92696,-55.65966,2018-10-07 00:00:00,NA,NA,NA
"24223",10501,"Grand Falls-Windsor","NL",48.92696,-55.65966,2018-10-07 01:00:00,NA,NA,NA
"24224",10501,"Grand Falls-Windsor","NL",48.92696,-55.65966,2018-10-07 02:00:00,NA,NA,NA
"24225",10501,"Grand Falls-Windsor","NL",48.92696,-55.65966,2018-10-07 03:00:00,NA,NA,NA
"24226",10501,"Grand Falls-Windsor","NL",48.92696,-55.65966,2018-10-07 04:00:00,NA,NA,NA
"24227",10501,"Grand Falls-Windsor","NL",48.92696,-55.65966,2018-10-07 05:00:00,NA,NA,NA
"24228",10501,"Grand Falls-Windsor","NL",48.92696,-55.65966,2018-10-07 06:00:00,NA,NA,NA
"24229",10501,"Grand Falls-Windsor","NL",48.92696,-55.65966,2018-10-07 07:00:00,NA,NA,NA
"24230",10501,"Grand Falls-Windsor","NL",48.92696,-55.65966,2018-10-07 08:00:00,NA,NA,NA
"24231",10501,"Grand Falls-Windsor","NL",48.92696,-55.65966,2018-10-07 09:00:00,NA,NA,NA
"24232",10501,"Grand Falls-Windsor","NL",48.92696,-55.65966,2018-10-07 10:00:00,NA,NA,NA
"24233",10501,"Grand Falls-Windsor","NL",48.92696,-55.65966,2018-10-07 11:00:00,NA,NA,NA
"24234",10501,"Grand Falls-Windsor","NL",48.92696,-55.65966,2018-10-07 12:00:00,NA,NA,NA
"24235",10501,"Grand Falls-Windsor","NL",48.92696,-55.65966,2018-10-07 13:00:00,NA,NA,NA
"24236",10501,"Grand Falls-Windsor","NL",48.92696,-55.65966,2018-10-07 14:00:00,NA,NA,NA
"24237",10501,"Grand Falls-Windsor","NL",48.92696,-55.65966,2018-10-07 15:00:00,NA,NA,NA
"24238",10501,"Grand Falls-Windsor","NL",48.92696,-55.65966,2018-10-07 16:00:00,NA,NA,NA
"24239",10501,"Grand Falls-Windsor","NL",48.92696,-55.65966,2018-10-07 17:00:00,NA,NA,NA
"24240",10501,"Grand Falls-Windsor","NL",48.92696,-55.65966,2018-10-07 18:00:00,NA,NA,NA
"24241",10501,"Grand Falls-Windsor","NL",48.92696,-55.65966,2018-10-07 19:00:00,NA,NA,NA
"24242",10501,"Grand Falls-Windsor","NL",48.92696,-55.65966,2018-10-07 20:00:00,NA,NA,NA
"24243",10501,"Grand Falls-Windsor","NL",48.92696,-55.65966,2018-10-07 21:00:00,NA,NA,NA
"24244",10501,"Grand Falls-Windsor","NL",48.92696,-55.65966,2018-10-07 22:00:00,NA,NA,NA
"24245",10501,"Grand Falls-Windsor","NL",48.92696,-55.65966,2018-10-07 23:00:00,NA,NA,NA
"24246",10501,"Grand Falls-Windsor","NL",48.92696,-55.65966,2018-10-08 00:00:00,NA,NA,NA
"24247",10501,"Grand Falls-Windsor","NL",48.92696,-55.65966,2018-10-08 01:00:00,NA,NA,NA
"24248",10501,"Grand Falls-Windsor","NL",48.92696,-55.65966,2018-10-08 02:00:00,NA,NA,NA
"24249",10501,"Grand Falls-Windsor","NL",48.92696,-55.65966,2018-10-08 03:00:00,NA,NA,NA
"24250",10501,"Grand Falls-Windsor","NL",48.92696,-55.65966,2018-10-08 04:00:00,NA,NA,NA
"24251",10501,"Grand Falls-Windsor","NL",48.92696,-55.65966,2018-10-08 05:00:00,NA,NA,NA
"24252",10501,"Grand Falls-Windsor","NL",48.92696,-55.65966,2018-10-08 06:00:00,NA,NA,NA
"24253",10501,"Grand Falls-Windsor","NL",48.92696,-55.65966,2018-10-08 07:00:00,NA,NA,NA
"24254",10501,"Grand Falls-Windsor","NL",48.92696,-55.65966,2018-10-08 08:00:00,NA,NA,NA
"24255",10501,"Grand Falls-Windsor","NL",48.92696,-55.65966,2018-10-08 09:00:00,NA,NA,NA
"24256",10501,"Grand Falls-Windsor","NL",48.92696,-55.65966,2018-10-08 10:00:00,NA,NA,NA
"24257",10501,"Grand Falls-Windsor","NL",48.92696,-55.65966,2018-10-08 11:00:00,NA,NA,NA
"24258",10501,"Grand Falls-Windsor","NL",48.92696,-55.65966,2018-10-08 12:00:00,NA,NA,NA
"24259",10501,"Grand Falls-Windsor","NL",48.92696,-55.65966,2018-10-08 13:00:00,NA,NA,NA
"24260",10501,"Grand Falls-Windsor","NL",48.92696,-55.65966,2018-10-08 14:00:00,NA,NA,NA
"24261",10501,"Grand Falls-Windsor","NL",48.92696,-55.65966,2018-10-08 15:00:00,NA,NA,NA
"24262",10501,"Grand Falls-Windsor","NL",48.92696,-55.65966,2018-10-08 16:00:00,NA,NA,NA
"24263",10501,"Grand Falls-Windsor","NL",48.92696,-55.65966,2018-10-08 17:00:00,NA,NA,NA
"24264",10501,"Grand Falls-Windsor","NL",48.92696,-55.65966,2018-10-08 18:00:00,NA,NA,NA
"24265",10501,"Grand Falls-Windsor","NL",48.92696,-55.65966,2018-10-08 19:00:00,NA,NA,NA
"24266",10501,"Grand Falls-Windsor","NL",48.92696,-55.65966,2018-10-08 20:00:00,NA,NA,NA
"24267",10501,"Grand Falls-Windsor","NL",48.92696,-55.65966,2018-10-08 21:00:00,NA,NA,NA
"24268",10501,"Grand Falls-Windsor","NL",48.92696,-55.65966,2018-10-08 22:00:00,NA,NA,NA
"24269",10501,"Grand Falls-Windsor","NL",48.92696,-55.65966,2018-10-08 23:00:00,NA,NA,NA
"24270",10501,"Grand Falls-Windsor","NL",48.92696,-55.65966,2018-10-09 00:00:00,NA,NA,NA
"24271",10501,"Grand Falls-Windsor","NL",48.92696,-55.65966,2018-10-09 01:00:00,NA,NA,NA
"24272",10501,"Grand Falls-Windsor","NL",48.92696,-55.65966,2018-10-09 02:00:00,NA,NA,NA
"24273",10501,"Grand Falls-Windsor","NL",48.92696,-55.65966,2018-10-09 03:00:00,NA,NA,NA
"24274",10501,"Grand Falls-Windsor","NL",48.92696,-55.65966,2018-10-09 04:00:00,NA,NA,NA
"24275",10501,"Grand Falls-Windsor","NL",48.92696,-55.65966,2018-10-09 05:00:00,NA,NA,NA
"24276",10501,"Grand Falls-Windsor","NL",48.92696,-55.65966,2018-10-09 06:00:00,NA,NA,NA
"24277",10501,"Grand Falls-Windsor","NL",48.92696,-55.65966,2018-10-09 07:00:00,NA,NA,NA
"24278",10501,"Grand Falls-Windsor","NL",48.92696,-55.65966,2018-10-09 08:00:00,NA,NA,NA
"24279",10501,"Grand Falls-Windsor","NL",48.92696,-55.65966,2018-10-09 09:00:00,NA,NA,NA
"24280",10501,"Grand Falls-Windsor","NL",48.92696,-55.65966,2018-10-09 10:00:00,NA,NA,NA
"24281",10501,"Grand Falls-Windsor","NL",48.92696,-55.65966,2018-10-09 11:00:00,NA,NA,NA
"24282",10501,"Grand Falls-Windsor","NL",48.92696,-55.65966,2018-10-09 12:00:00,NA,NA,NA
"24283",10501,"Grand Falls-Windsor","NL",48.92696,-55.65966,2018-10-09 13:00:00,NA,NA,NA
"24284",10501,"Grand Falls-Windsor","NL",48.92696,-55.65966,2018-10-09 14:00:00,NA,NA,NA
"24285",10501,"Grand Falls-Windsor","NL",48.92696,-55.65966,2018-10-09 15:00:00,NA,NA,NA
"24286",10501,"Grand Falls-Windsor","NL",48.92696,-55.65966,2018-10-09 16:00:00,NA,NA,NA
"24287",10501,"Grand Falls-Windsor","NL",48.92696,-55.65966,2018-10-09 17:00:00,NA,NA,NA
"24288",10501,"Grand Falls-Windsor","NL",48.92696,-55.65966,2018-10-09 18:00:00,NA,NA,NA
"24289",10501,"Grand Falls-Windsor","NL",48.92696,-55.65966,2018-10-09 19:00:00,NA,NA,NA
"24290",10501,"Grand Falls-Windsor","NL",48.92696,-55.65966,2018-10-09 20:00:00,NA,NA,NA
"24291",10501,"Grand Falls-Windsor","NL",48.92696,-55.65966,2018-10-09 21:00:00,NA,NA,NA
"24292",10501,"Grand Falls-Windsor","NL",48.92696,-55.65966,2018-10-09 22:00:00,NA,NA,NA
"24293",10501,"Grand Falls-Windsor","NL",48.92696,-55.65966,2018-10-09 23:00:00,NA,NA,NA
"24294",10501,"Grand Falls-Windsor","NL",48.92696,-55.65966,2018-10-10 00:00:00,NA,NA,NA
"24295",10501,"Grand Falls-Windsor","NL",48.92696,-55.65966,2018-10-10 01:00:00,NA,NA,NA
"24296",10501,"Grand Falls-Windsor","NL",48.92696,-55.65966,2018-10-10 02:00:00,NA,NA,NA
"24297",10501,"Grand Falls-Windsor","NL",48.92696,-55.65966,2018-10-10 03:00:00,NA,NA,NA
"24298",10501,"Grand Falls-Windsor","NL",48.92696,-55.65966,2018-10-10 04:00:00,NA,NA,NA
"24299",10501,"Grand Falls-Windsor","NL",48.92696,-55.65966,2018-10-10 05:00:00,NA,NA,NA
"24300",10501,"Grand Falls-Windsor","NL",48.92696,-55.65966,2018-10-10 06:00:00,NA,NA,NA
"24301",10501,"Grand Falls-Windsor","NL",48.92696,-55.65966,2018-10-10 07:00:00,NA,NA,NA
"24302",10501,"Grand Falls-Windsor","NL",48.92696,-55.65966,2018-10-10 08:00:00,NA,NA,NA
"24303",10501,"Grand Falls-Windsor","NL",48.92696,-55.65966,2018-10-10 09:00:00,NA,NA,NA
"24304",10501,"Grand Falls-Windsor","NL",48.92696,-55.65966,2018-10-10 10:00:00,NA,NA,NA
"24305",10501,"Grand Falls-Windsor","NL",48.92696,-55.65966,2018-10-10 11:00:00,NA,NA,NA
"24306",10501,"Grand Falls-Windsor","NL",48.92696,-55.65966,2018-10-10 12:00:00,NA,NA,NA
"24307",10501,"Grand Falls-Windsor","NL",48.92696,-55.65966,2018-10-10 13:00:00,NA,NA,NA
"24308",10501,"Grand Falls-Windsor","NL",48.92696,-55.65966,2018-10-10 14:00:00,NA,NA,NA
"24309",10501,"Grand Falls-Windsor","NL",48.92696,-55.65966,2018-10-10 15:00:00,NA,NA,NA
"24310",10501,"Grand Falls-Windsor","NL",48.92696,-55.65966,2018-10-10 16:00:00,NA,NA,NA
"24311",10501,"Grand Falls-Windsor","NL",48.92696,-55.65966,2018-10-10 17:00:00,NA,NA,NA
"24312",10501,"Grand Falls-Windsor","NL",48.92696,-55.65966,2018-10-10 18:00:00,NA,NA,NA
"24313",10501,"Grand Falls-Windsor","NL",48.92696,-55.65966,2018-10-10 19:00:00,NA,NA,NA
"24314",10501,"Grand Falls-Windsor","NL",48.92696,-55.65966,2018-10-10 20:00:00,NA,NA,NA
"24315",10501,"Grand Falls-Windsor","NL",48.92696,-55.65966,2018-10-10 21:00:00,NA,NA,NA
"24316",10501,"Grand Falls-Windsor","NL",48.92696,-55.65966,2018-10-10 22:00:00,NA,NA,NA
"24317",10501,"Grand Falls-Windsor","NL",48.92696,-55.65966,2018-10-10 23:00:00,NA,NA,NA
"24318",10501,"Grand Falls-Windsor","NL",48.92696,-55.65966,2018-10-11 00:00:00,NA,NA,NA
"24319",10501,"Grand Falls-Windsor","NL",48.92696,-55.65966,2018-10-11 01:00:00,NA,NA,NA
"24320",10501,"Grand Falls-Windsor","NL",48.92696,-55.65966,2018-10-11 02:00:00,NA,NA,NA
"24321",10501,"Grand Falls-Windsor","NL",48.92696,-55.65966,2018-10-11 03:00:00,NA,NA,NA
"24322",10501,"Grand Falls-Windsor","NL",48.92696,-55.65966,2018-10-11 04:00:00,NA,NA,NA
"24323",10501,"Grand Falls-Windsor","NL",48.92696,-55.65966,2018-10-11 05:00:00,NA,NA,NA
"24324",10501,"Grand Falls-Windsor","NL",48.92696,-55.65966,2018-10-11 06:00:00,NA,NA,NA
"24325",10501,"Grand Falls-Windsor","NL",48.92696,-55.65966,2018-10-11 07:00:00,NA,NA,NA
"24326",10501,"Grand Falls-Windsor","NL",48.92696,-55.65966,2018-10-11 08:00:00,NA,NA,NA
"24327",10501,"Grand Falls-Windsor","NL",48.92696,-55.65966,2018-10-11 09:00:00,NA,NA,NA
"24328",10501,"Grand Falls-Windsor","NL",48.92696,-55.65966,2018-10-11 10:00:00,NA,NA,NA
"24329",10501,"Grand Falls-Windsor","NL",48.92696,-55.65966,2018-10-11 11:00:00,NA,NA,NA
"24330",10501,"Grand Falls-Windsor","NL",48.92696,-55.65966,2018-10-11 12:00:00,NA,NA,NA
"24331",10501,"Grand Falls-Windsor","NL",48.92696,-55.65966,2018-10-11 13:00:00,NA,NA,NA
"24332",10501,"Grand Falls-Windsor","NL",48.92696,-55.65966,2018-10-11 14:00:00,34,NA,NA
"24333",10501,"Grand Falls-Windsor","NL",48.92696,-55.65966,2018-10-11 15:00:00,35,NA,NA
"24334",10501,"Grand Falls-Windsor","NL",48.92696,-55.65966,2018-10-11 16:00:00,34,NA,NA
"24335",10501,"Grand Falls-Windsor","NL",48.92696,-55.65966,2018-10-11 17:00:00,33,NA,NA
"24336",10501,"Grand Falls-Windsor","NL",48.92696,-55.65966,2018-10-11 18:00:00,31,NA,NA
"24337",10501,"Grand Falls-Windsor","NL",48.92696,-55.65966,2018-10-11 19:00:00,26,NA,NA
"24338",10501,"Grand Falls-Windsor","NL",48.92696,-55.65966,2018-10-11 20:00:00,16,NA,NA
"24339",10501,"Grand Falls-Windsor","NL",48.92696,-55.65966,2018-10-11 21:00:00,15,NA,NA
"24340",10501,"Grand Falls-Windsor","NL",48.92696,-55.65966,2018-10-11 22:00:00,15,NA,NA
"24341",10501,"Grand Falls-Windsor","NL",48.92696,-55.65966,2018-10-11 23:00:00,14,NA,NA
"24342",10501,"Grand Falls-Windsor","NL",48.92696,-55.65966,2018-10-12 00:00:00,14,NA,NA
"24343",10501,"Grand Falls-Windsor","NL",48.92696,-55.65966,2018-10-12 01:00:00,13,NA,NA
"24344",10501,"Grand Falls-Windsor","NL",48.92696,-55.65966,2018-10-12 02:00:00,13,NA,NA
"24345",10501,"Grand Falls-Windsor","NL",48.92696,-55.65966,2018-10-12 03:00:00,13,NA,NA
"24346",10501,"Grand Falls-Windsor","NL",48.92696,-55.65966,2018-10-12 04:00:00,13,NA,NA
"24347",10501,"Grand Falls-Windsor","NL",48.92696,-55.65966,2018-10-12 05:00:00,14,NA,NA
"24348",10501,"Grand Falls-Windsor","NL",48.92696,-55.65966,2018-10-12 06:00:00,15,NA,NA
"24349",10501,"Grand Falls-Windsor","NL",48.92696,-55.65966,2018-10-12 07:00:00,18,NA,NA
"24350",10501,"Grand Falls-Windsor","NL",48.92696,-55.65966,2018-10-12 08:00:00,19,NA,NA
"24351",10501,"Grand Falls-Windsor","NL",48.92696,-55.65966,2018-10-12 09:00:00,22,NA,NA
"24352",10501,"Grand Falls-Windsor","NL",48.92696,-55.65966,2018-10-12 10:00:00,29,NA,NA
"24353",10501,"Grand Falls-Windsor","NL",48.92696,-55.65966,2018-10-12 11:00:00,33,NA,NA
"24354",10501,"Grand Falls-Windsor","NL",48.92696,-55.65966,2018-10-12 12:00:00,33,NA,NA
"24355",10501,"Grand Falls-Windsor","NL",48.92696,-55.65966,2018-10-12 13:00:00,34,NA,NA
"24356",10501,"Grand Falls-Windsor","NL",48.92696,-55.65966,2018-10-12 14:00:00,35,NA,NA
"24357",10501,"Grand Falls-Windsor","NL",48.92696,-55.65966,2018-10-12 15:00:00,35,NA,NA
"24358",10501,"Grand Falls-Windsor","NL",48.92696,-55.65966,2018-10-12 16:00:00,34,NA,NA
"24359",10501,"Grand Falls-Windsor","NL",48.92696,-55.65966,2018-10-12 17:00:00,33,NA,NA
"24360",10501,"Grand Falls-Windsor","NL",48.92696,-55.65966,2018-10-12 18:00:00,33,NA,NA
"24361",10501,"Grand Falls-Windsor","NL",48.92696,-55.65966,2018-10-12 19:00:00,32,NA,NA
"24362",10501,"Grand Falls-Windsor","NL",48.92696,-55.65966,2018-10-12 20:00:00,31,NA,NA
"24363",10501,"Grand Falls-Windsor","NL",48.92696,-55.65966,2018-10-12 21:00:00,28,NA,NA
"24364",10501,"Grand Falls-Windsor","NL",48.92696,-55.65966,2018-10-12 22:00:00,28,NA,NA
"24365",10501,"Grand Falls-Windsor","NL",48.92696,-55.65966,2018-10-12 23:00:00,27,NA,NA
"24366",10501,"Grand Falls-Windsor","NL",48.92696,-55.65966,2018-10-13 00:00:00,27,NA,NA
"24367",10501,"Grand Falls-Windsor","NL",48.92696,-55.65966,2018-10-13 01:00:00,28,NA,NA
"24368",10501,"Grand Falls-Windsor","NL",48.92696,-55.65966,2018-10-13 02:00:00,33,NA,NA
"24369",10501,"Grand Falls-Windsor","NL",48.92696,-55.65966,2018-10-13 03:00:00,36,NA,NA
"24370",10501,"Grand Falls-Windsor","NL",48.92696,-55.65966,2018-10-13 04:00:00,36,NA,NA
"24371",10501,"Grand Falls-Windsor","NL",48.92696,-55.65966,2018-10-13 05:00:00,36,NA,NA
"24372",10501,"Grand Falls-Windsor","NL",48.92696,-55.65966,2018-10-13 06:00:00,35,NA,NA
"24373",10501,"Grand Falls-Windsor","NL",48.92696,-55.65966,2018-10-13 07:00:00,34,NA,NA
"24374",10501,"Grand Falls-Windsor","NL",48.92696,-55.65966,2018-10-13 08:00:00,35,NA,NA
"24375",10501,"Grand Falls-Windsor","NL",48.92696,-55.65966,2018-10-13 09:00:00,36,NA,NA
"24376",10501,"Grand Falls-Windsor","NL",48.92696,-55.65966,2018-10-13 10:00:00,35,NA,NA
"24377",10501,"Grand Falls-Windsor","NL",48.92696,-55.65966,2018-10-13 11:00:00,34,NA,NA
"24378",10501,"Grand Falls-Windsor","NL",48.92696,-55.65966,2018-10-13 12:00:00,35,NA,NA
"24379",10501,"Grand Falls-Windsor","NL",48.92696,-55.65966,2018-10-13 13:00:00,34,NA,NA
"24380",10501,"Grand Falls-Windsor","NL",48.92696,-55.65966,2018-10-13 14:00:00,33,NA,NA
"24381",10501,"Grand Falls-Windsor","NL",48.92696,-55.65966,2018-10-13 15:00:00,32,NA,NA
"24382",10501,"Grand Falls-Windsor","NL",48.92696,-55.65966,2018-10-13 16:00:00,30,NA,NA
"24383",10501,"Grand Falls-Windsor","NL",48.92696,-55.65966,2018-10-13 17:00:00,29,NA,NA
"24384",10501,"Grand Falls-Windsor","NL",48.92696,-55.65966,2018-10-13 18:00:00,25,NA,NA
"24385",10501,"Grand Falls-Windsor","NL",48.92696,-55.65966,2018-10-13 19:00:00,24,NA,NA
"24386",10501,"Grand Falls-Windsor","NL",48.92696,-55.65966,2018-10-13 20:00:00,22,NA,NA
"24387",10501,"Grand Falls-Windsor","NL",48.92696,-55.65966,2018-10-13 21:00:00,22,NA,NA
"24388",10501,"Grand Falls-Windsor","NL",48.92696,-55.65966,2018-10-13 22:00:00,24,NA,NA
"24389",10501,"Grand Falls-Windsor","NL",48.92696,-55.65966,2018-10-13 23:00:00,22,NA,NA
"24390",10501,"Grand Falls-Windsor","NL",48.92696,-55.65966,2018-10-14 00:00:00,19,NA,NA
"24391",10501,"Grand Falls-Windsor","NL",48.92696,-55.65966,2018-10-14 01:00:00,17,NA,NA
"24392",10501,"Grand Falls-Windsor","NL",48.92696,-55.65966,2018-10-14 02:00:00,17,NA,NA
"24393",10501,"Grand Falls-Windsor","NL",48.92696,-55.65966,2018-10-14 03:00:00,16,NA,NA
"24394",10501,"Grand Falls-Windsor","NL",48.92696,-55.65966,2018-10-14 04:00:00,16,NA,NA
"24395",10501,"Grand Falls-Windsor","NL",48.92696,-55.65966,2018-10-14 05:00:00,17,NA,NA
"24396",10501,"Grand Falls-Windsor","NL",48.92696,-55.65966,2018-10-14 06:00:00,18,NA,NA
"24397",10501,"Grand Falls-Windsor","NL",48.92696,-55.65966,2018-10-14 07:00:00,21,NA,NA
"24398",10501,"Grand Falls-Windsor","NL",48.92696,-55.65966,2018-10-14 08:00:00,21,NA,NA
"24399",10501,"Grand Falls-Windsor","NL",48.92696,-55.65966,2018-10-14 09:00:00,24,NA,NA
"24400",10501,"Grand Falls-Windsor","NL",48.92696,-55.65966,2018-10-14 10:00:00,26,NA,NA
"24401",10501,"Grand Falls-Windsor","NL",48.92696,-55.65966,2018-10-14 11:00:00,27,NA,NA
"24402",10501,"Grand Falls-Windsor","NL",48.92696,-55.65966,2018-10-14 12:00:00,30,NA,NA
"24403",10501,"Grand Falls-Windsor","NL",48.92696,-55.65966,2018-10-14 13:00:00,29,NA,NA
"24404",10501,"Grand Falls-Windsor","NL",48.92696,-55.65966,2018-10-14 14:00:00,27,NA,NA
"24405",10501,"Grand Falls-Windsor","NL",48.92696,-55.65966,2018-10-14 15:00:00,27,NA,NA
"24406",10501,"Grand Falls-Windsor","NL",48.92696,-55.65966,2018-10-14 16:00:00,26,NA,NA
"24407",10501,"Grand Falls-Windsor","NL",48.92696,-55.65966,2018-10-14 17:00:00,23,NA,NA
"24408",10501,"Grand Falls-Windsor","NL",48.92696,-55.65966,2018-10-14 18:00:00,21,NA,NA
"24409",10501,"Grand Falls-Windsor","NL",48.92696,-55.65966,2018-10-14 19:00:00,22,NA,NA
"24410",10501,"Grand Falls-Windsor","NL",48.92696,-55.65966,2018-10-14 20:00:00,24,NA,NA
"24411",10501,"Grand Falls-Windsor","NL",48.92696,-55.65966,2018-10-14 21:00:00,25,NA,NA
"24412",10501,"Grand Falls-Windsor","NL",48.92696,-55.65966,2018-10-14 22:00:00,25,NA,NA
"24413",10501,"Grand Falls-Windsor","NL",48.92696,-55.65966,2018-10-14 23:00:00,25,NA,NA
"24414",10501,"Grand Falls-Windsor","NL",48.92696,-55.65966,2018-10-15 00:00:00,25,NA,NA
"24415",10501,"Grand Falls-Windsor","NL",48.92696,-55.65966,2018-10-15 01:00:00,24,NA,NA
"24416",10501,"Grand Falls-Windsor","NL",48.92696,-55.65966,2018-10-15 02:00:00,21,NA,NA
"24417",10501,"Grand Falls-Windsor","NL",48.92696,-55.65966,2018-10-15 03:00:00,20,NA,NA
"24418",10501,"Grand Falls-Windsor","NL",48.92696,-55.65966,2018-10-15 04:00:00,19,NA,NA
"24419",10501,"Grand Falls-Windsor","NL",48.92696,-55.65966,2018-10-15 05:00:00,18,NA,NA
"24420",10501,"Grand Falls-Windsor","NL",48.92696,-55.65966,2018-10-15 06:00:00,18,NA,NA
"24421",10501,"Grand Falls-Windsor","NL",48.92696,-55.65966,2018-10-15 07:00:00,17,NA,NA
"24422",10501,"Grand Falls-Windsor","NL",48.92696,-55.65966,2018-10-15 08:00:00,19,NA,NA
"24423",10501,"Grand Falls-Windsor","NL",48.92696,-55.65966,2018-10-15 09:00:00,18,NA,NA
"24424",10501,"Grand Falls-Windsor","NL",48.92696,-55.65966,2018-10-15 10:00:00,22,NA,NA
"24425",10501,"Grand Falls-Windsor","NL",48.92696,-55.65966,2018-10-15 11:00:00,22,NA,NA
"24426",10501,"Grand Falls-Windsor","NL",48.92696,-55.65966,2018-10-15 12:00:00,23,NA,NA
"24427",10501,"Grand Falls-Windsor","NL",48.92696,-55.65966,2018-10-15 13:00:00,22,NA,NA
"24428",10501,"Grand Falls-Windsor","NL",48.92696,-55.65966,2018-10-15 14:00:00,22,NA,NA
"24429",10501,"Grand Falls-Windsor","NL",48.92696,-55.65966,2018-10-15 15:00:00,24,NA,NA
"24430",10501,"Grand Falls-Windsor","NL",48.92696,-55.65966,2018-10-15 16:00:00,25,NA,NA
"24431",10501,"Grand Falls-Windsor","NL",48.92696,-55.65966,2018-10-15 17:00:00,25,NA,NA
"24432",10501,"Grand Falls-Windsor","NL",48.92696,-55.65966,2018-10-15 18:00:00,23,NA,NA
"24433",10501,"Grand Falls-Windsor","NL",48.92696,-55.65966,2018-10-15 19:00:00,19,NA,NA
"24434",10501,"Grand Falls-Windsor","NL",48.92696,-55.65966,2018-10-15 20:00:00,15,NA,NA
"24435",10501,"Grand Falls-Windsor","NL",48.92696,-55.65966,2018-10-15 21:00:00,18,NA,NA
"24436",10501,"Grand Falls-Windsor","NL",48.92696,-55.65966,2018-10-15 22:00:00,21,NA,NA
"24437",10501,"Grand Falls-Windsor","NL",48.92696,-55.65966,2018-10-15 23:00:00,23,NA,NA
"24438",10501,"Grand Falls-Windsor","NL",48.92696,-55.65966,2018-10-16 00:00:00,25,NA,NA
"24439",10501,"Grand Falls-Windsor","NL",48.92696,-55.65966,2018-10-16 01:00:00,26,NA,NA
"24440",10501,"Grand Falls-Windsor","NL",48.92696,-55.65966,2018-10-16 02:00:00,25,NA,NA
"24441",10501,"Grand Falls-Windsor","NL",48.92696,-55.65966,2018-10-16 03:00:00,25,NA,NA
"24442",10501,"Grand Falls-Windsor","NL",48.92696,-55.65966,2018-10-16 04:00:00,27,NA,NA
"24443",10501,"Grand Falls-Windsor","NL",48.92696,-55.65966,2018-10-16 05:00:00,28,NA,NA
"24444",10501,"Grand Falls-Windsor","NL",48.92696,-55.65966,2018-10-16 06:00:00,31,NA,NA
"24445",10501,"Grand Falls-Windsor","NL",48.92696,-55.65966,2018-10-16 07:00:00,32,NA,NA
"24446",10501,"Grand Falls-Windsor","NL",48.92696,-55.65966,2018-10-16 08:00:00,33,NA,NA
"24447",10501,"Grand Falls-Windsor","NL",48.92696,-55.65966,2018-10-16 09:00:00,34,NA,NA
"24448",10501,"Grand Falls-Windsor","NL",48.92696,-55.65966,2018-10-16 10:00:00,36,NA,NA
"24449",10501,"Grand Falls-Windsor","NL",48.92696,-55.65966,2018-10-16 11:00:00,38,NA,NA
"24450",10501,"Grand Falls-Windsor","NL",48.92696,-55.65966,2018-10-16 12:00:00,38,NA,NA
"24451",10501,"Grand Falls-Windsor","NL",48.92696,-55.65966,2018-10-16 13:00:00,40,NA,NA
"24452",10501,"Grand Falls-Windsor","NL",48.92696,-55.65966,2018-10-16 14:00:00,39,NA,NA
"24453",10501,"Grand Falls-Windsor","NL",48.92696,-55.65966,2018-10-16 15:00:00,38,NA,NA
"24454",10501,"Grand Falls-Windsor","NL",48.92696,-55.65966,2018-10-16 16:00:00,36,NA,NA
"24455",10501,"Grand Falls-Windsor","NL",48.92696,-55.65966,2018-10-16 17:00:00,31,NA,NA
"24456",10501,"Grand Falls-Windsor","NL",48.92696,-55.65966,2018-10-16 18:00:00,23,NA,NA
"24457",10501,"Grand Falls-Windsor","NL",48.92696,-55.65966,2018-10-16 19:00:00,25,NA,NA
"24458",10501,"Grand Falls-Windsor","NL",48.92696,-55.65966,2018-10-16 20:00:00,30,NA,NA
"24459",10501,"Grand Falls-Windsor","NL",48.92696,-55.65966,2018-10-16 21:00:00,28,NA,NA
"24460",10501,"Grand Falls-Windsor","NL",48.92696,-55.65966,2018-10-16 22:00:00,28,NA,NA
"24461",10501,"Grand Falls-Windsor","NL",48.92696,-55.65966,2018-10-16 23:00:00,27,NA,NA
"24462",10501,"Grand Falls-Windsor","NL",48.92696,-55.65966,2018-10-17 00:00:00,26,NA,NA
"24463",10501,"Grand Falls-Windsor","NL",48.92696,-55.65966,2018-10-17 01:00:00,26,NA,NA
"24464",10501,"Grand Falls-Windsor","NL",48.92696,-55.65966,2018-10-17 02:00:00,26,NA,NA
"24465",10501,"Grand Falls-Windsor","NL",48.92696,-55.65966,2018-10-17 03:00:00,25,NA,NA
"24466",10501,"Grand Falls-Windsor","NL",48.92696,-55.65966,2018-10-17 04:00:00,25,NA,NA
"24467",10501,"Grand Falls-Windsor","NL",48.92696,-55.65966,2018-10-17 05:00:00,25,NA,NA
"24468",10501,"Grand Falls-Windsor","NL",48.92696,-55.65966,2018-10-17 06:00:00,26,NA,NA
"24469",10501,"Grand Falls-Windsor","NL",48.92696,-55.65966,2018-10-17 07:00:00,26,NA,NA
"24470",10501,"Grand Falls-Windsor","NL",48.92696,-55.65966,2018-10-17 08:00:00,26,NA,NA
"24471",10501,"Grand Falls-Windsor","NL",48.92696,-55.65966,2018-10-17 09:00:00,26,NA,NA
"24472",10501,"Grand Falls-Windsor","NL",48.92696,-55.65966,2018-10-17 10:00:00,27,NA,NA
"24473",10501,"Grand Falls-Windsor","NL",48.92696,-55.65966,2018-10-17 11:00:00,27,NA,NA
"24474",10501,"Grand Falls-Windsor","NL",48.92696,-55.65966,2018-10-17 12:00:00,28,NA,NA
"24475",10501,"Grand Falls-Windsor","NL",48.92696,-55.65966,2018-10-17 13:00:00,30,NA,NA
"24476",10501,"Grand Falls-Windsor","NL",48.92696,-55.65966,2018-10-17 14:00:00,30,NA,NA
"24477",10501,"Grand Falls-Windsor","NL",48.92696,-55.65966,2018-10-17 15:00:00,30,NA,NA
"24478",10501,"Grand Falls-Windsor","NL",48.92696,-55.65966,2018-10-17 16:00:00,31,NA,NA
"24479",10501,"Grand Falls-Windsor","NL",48.92696,-55.65966,2018-10-17 17:00:00,30,NA,NA
"24480",10501,"Grand Falls-Windsor","NL",48.92696,-55.65966,2018-10-17 18:00:00,29,NA,NA
"24481",10501,"Grand Falls-Windsor","NL",48.92696,-55.65966,2018-10-17 19:00:00,30,NA,NA
"24482",10501,"Grand Falls-Windsor","NL",48.92696,-55.65966,2018-10-17 20:00:00,29,NA,NA
"24483",10501,"Grand Falls-Windsor","NL",48.92696,-55.65966,2018-10-17 21:00:00,29,NA,NA
"24484",10501,"Grand Falls-Windsor","NL",48.92696,-55.65966,2018-10-17 22:00:00,28,NA,NA
"24485",10501,"Grand Falls-Windsor","NL",48.92696,-55.65966,2018-10-17 23:00:00,26,NA,NA
"24486",10501,"Grand Falls-Windsor","NL",48.92696,-55.65966,2018-10-18 00:00:00,26,NA,NA
"24487",10501,"Grand Falls-Windsor","NL",48.92696,-55.65966,2018-10-18 01:00:00,24,NA,NA
"24488",10501,"Grand Falls-Windsor","NL",48.92696,-55.65966,2018-10-18 02:00:00,23,NA,NA
"24489",10501,"Grand Falls-Windsor","NL",48.92696,-55.65966,2018-10-18 03:00:00,22,NA,NA
"24490",10501,"Grand Falls-Windsor","NL",48.92696,-55.65966,2018-10-18 04:00:00,23,NA,NA
"24491",10501,"Grand Falls-Windsor","NL",48.92696,-55.65966,2018-10-18 05:00:00,20,NA,NA
"24492",10501,"Grand Falls-Windsor","NL",48.92696,-55.65966,2018-10-18 06:00:00,15,NA,NA
"24493",10501,"Grand Falls-Windsor","NL",48.92696,-55.65966,2018-10-18 07:00:00,14,NA,NA
"24494",10501,"Grand Falls-Windsor","NL",48.92696,-55.65966,2018-10-18 08:00:00,18,NA,NA
"24495",10501,"Grand Falls-Windsor","NL",48.92696,-55.65966,2018-10-18 09:00:00,21,NA,NA
"24496",10501,"Grand Falls-Windsor","NL",48.92696,-55.65966,2018-10-18 10:00:00,25,NA,NA
"24497",10501,"Grand Falls-Windsor","NL",48.92696,-55.65966,2018-10-18 11:00:00,32,NA,NA
"24498",10501,"Grand Falls-Windsor","NL",48.92696,-55.65966,2018-10-18 12:00:00,32,NA,NA
"24499",10501,"Grand Falls-Windsor","NL",48.92696,-55.65966,2018-10-18 13:00:00,34,NA,NA
"24500",10501,"Grand Falls-Windsor","NL",48.92696,-55.65966,2018-10-18 14:00:00,35,NA,NA
"24501",10501,"Grand Falls-Windsor","NL",48.92696,-55.65966,2018-10-18 15:00:00,34,NA,NA
"24502",10501,"Grand Falls-Windsor","NL",48.92696,-55.65966,2018-10-18 16:00:00,35,NA,NA
"24503",10501,"Grand Falls-Windsor","NL",48.92696,-55.65966,2018-10-18 17:00:00,36,NA,NA
"24504",10501,"Grand Falls-Windsor","NL",48.92696,-55.65966,2018-10-18 18:00:00,35,NA,NA
"24505",10501,"Grand Falls-Windsor","NL",48.92696,-55.65966,2018-10-18 19:00:00,34,NA,NA
"24506",10501,"Grand Falls-Windsor","NL",48.92696,-55.65966,2018-10-18 20:00:00,33,NA,NA
"24507",10501,"Grand Falls-Windsor","NL",48.92696,-55.65966,2018-10-18 21:00:00,33,NA,NA
"24508",10501,"Grand Falls-Windsor","NL",48.92696,-55.65966,2018-10-18 22:00:00,32,NA,NA
"24509",10501,"Grand Falls-Windsor","NL",48.92696,-55.65966,2018-10-18 23:00:00,28,NA,NA
"24510",10501,"Grand Falls-Windsor","NL",48.92696,-55.65966,2018-10-19 00:00:00,27,NA,NA
"24511",10501,"Grand Falls-Windsor","NL",48.92696,-55.65966,2018-10-19 01:00:00,27,NA,NA
"24512",10501,"Grand Falls-Windsor","NL",48.92696,-55.65966,2018-10-19 02:00:00,27,NA,NA
"24513",10501,"Grand Falls-Windsor","NL",48.92696,-55.65966,2018-10-19 03:00:00,27,NA,NA
"24514",10501,"Grand Falls-Windsor","NL",48.92696,-55.65966,2018-10-19 04:00:00,28,NA,NA
"24515",10501,"Grand Falls-Windsor","NL",48.92696,-55.65966,2018-10-19 05:00:00,29,NA,NA
"24516",10501,"Grand Falls-Windsor","NL",48.92696,-55.65966,2018-10-19 06:00:00,32,NA,NA
"24517",10501,"Grand Falls-Windsor","NL",48.92696,-55.65966,2018-10-19 07:00:00,30,NA,NA
"24518",10501,"Grand Falls-Windsor","NL",48.92696,-55.65966,2018-10-19 08:00:00,32,NA,NA
"24519",10501,"Grand Falls-Windsor","NL",48.92696,-55.65966,2018-10-19 09:00:00,35,NA,NA
"24520",10501,"Grand Falls-Windsor","NL",48.92696,-55.65966,2018-10-19 10:00:00,38,NA,NA
"24521",10501,"Grand Falls-Windsor","NL",48.92696,-55.65966,2018-10-19 11:00:00,39,NA,NA
"24522",10501,"Grand Falls-Windsor","NL",48.92696,-55.65966,2018-10-19 12:00:00,38,NA,NA
"24523",10501,"Grand Falls-Windsor","NL",48.92696,-55.65966,2018-10-19 13:00:00,37,NA,NA
"24524",10501,"Grand Falls-Windsor","NL",48.92696,-55.65966,2018-10-19 14:00:00,37,NA,NA
"24525",10501,"Grand Falls-Windsor","NL",48.92696,-55.65966,2018-10-19 15:00:00,38,NA,NA
"24526",10501,"Grand Falls-Windsor","NL",48.92696,-55.65966,2018-10-19 16:00:00,38,NA,NA
"24527",10501,"Grand Falls-Windsor","NL",48.92696,-55.65966,2018-10-19 17:00:00,35,NA,NA
"24528",10501,"Grand Falls-Windsor","NL",48.92696,-55.65966,2018-10-19 18:00:00,32,NA,NA
"24529",10501,"Grand Falls-Windsor","NL",48.92696,-55.65966,2018-10-19 19:00:00,16,NA,NA
"24530",10501,"Grand Falls-Windsor","NL",48.92696,-55.65966,2018-10-19 20:00:00,7,NA,NA
"24531",10501,"Grand Falls-Windsor","NL",48.92696,-55.65966,2018-10-19 21:00:00,7,NA,NA
"24532",10501,"Grand Falls-Windsor","NL",48.92696,-55.65966,2018-10-19 22:00:00,10,NA,NA
"24533",10501,"Grand Falls-Windsor","NL",48.92696,-55.65966,2018-10-19 23:00:00,14,NA,NA
"24534",10501,"Grand Falls-Windsor","NL",48.92696,-55.65966,2018-10-20 00:00:00,20,NA,NA
"24535",10501,"Grand Falls-Windsor","NL",48.92696,-55.65966,2018-10-20 01:00:00,16,NA,NA
"24536",10501,"Grand Falls-Windsor","NL",48.92696,-55.65966,2018-10-20 02:00:00,18,NA,NA
"24537",10501,"Grand Falls-Windsor","NL",48.92696,-55.65966,2018-10-20 03:00:00,22,NA,NA
"24538",10501,"Grand Falls-Windsor","NL",48.92696,-55.65966,2018-10-20 04:00:00,22,NA,NA
"24539",10501,"Grand Falls-Windsor","NL",48.92696,-55.65966,2018-10-20 05:00:00,25,NA,NA
"24540",10501,"Grand Falls-Windsor","NL",48.92696,-55.65966,2018-10-20 06:00:00,27,NA,NA
"24541",10501,"Grand Falls-Windsor","NL",48.92696,-55.65966,2018-10-20 07:00:00,28,NA,NA
"24542",10501,"Grand Falls-Windsor","NL",48.92696,-55.65966,2018-10-20 08:00:00,28,NA,NA
"24543",10501,"Grand Falls-Windsor","NL",48.92696,-55.65966,2018-10-20 09:00:00,29,NA,NA
"24544",10501,"Grand Falls-Windsor","NL",48.92696,-55.65966,2018-10-20 10:00:00,28,NA,NA
"24545",10501,"Grand Falls-Windsor","NL",48.92696,-55.65966,2018-10-20 11:00:00,28,NA,NA
"24546",10501,"Grand Falls-Windsor","NL",48.92696,-55.65966,2018-10-20 12:00:00,28,NA,NA
"24547",10501,"Grand Falls-Windsor","NL",48.92696,-55.65966,2018-10-20 13:00:00,34,NA,NA
"24548",10501,"Grand Falls-Windsor","NL",48.92696,-55.65966,2018-10-20 14:00:00,36,NA,NA
"24549",10501,"Grand Falls-Windsor","NL",48.92696,-55.65966,2018-10-20 15:00:00,37,NA,NA
"24550",10501,"Grand Falls-Windsor","NL",48.92696,-55.65966,2018-10-20 16:00:00,36,NA,NA
"24551",10501,"Grand Falls-Windsor","NL",48.92696,-55.65966,2018-10-20 17:00:00,35,NA,NA
"24552",10501,"Grand Falls-Windsor","NL",48.92696,-55.65966,2018-10-20 18:00:00,35,NA,NA
"24553",10501,"Grand Falls-Windsor","NL",48.92696,-55.65966,2018-10-20 19:00:00,34,NA,NA
"24554",10501,"Grand Falls-Windsor","NL",48.92696,-55.65966,2018-10-20 20:00:00,36,NA,NA
"24555",10501,"Grand Falls-Windsor","NL",48.92696,-55.65966,2018-10-20 21:00:00,37,NA,NA
"24556",10501,"Grand Falls-Windsor","NL",48.92696,-55.65966,2018-10-20 22:00:00,38,NA,NA
"24557",10501,"Grand Falls-Windsor","NL",48.92696,-55.65966,2018-10-20 23:00:00,42,NA,NA
"24558",10501,"Grand Falls-Windsor","NL",48.92696,-55.65966,2018-10-21 00:00:00,42,NA,NA
"24559",10501,"Grand Falls-Windsor","NL",48.92696,-55.65966,2018-10-21 01:00:00,41,NA,NA
"24560",10501,"Grand Falls-Windsor","NL",48.92696,-55.65966,2018-10-21 02:00:00,42,NA,NA
"24561",10501,"Grand Falls-Windsor","NL",48.92696,-55.65966,2018-10-21 03:00:00,41,NA,NA
"24562",10501,"Grand Falls-Windsor","NL",48.92696,-55.65966,2018-10-21 04:00:00,41,NA,NA
"24563",10501,"Grand Falls-Windsor","NL",48.92696,-55.65966,2018-10-21 05:00:00,42,NA,NA
"24564",10501,"Grand Falls-Windsor","NL",48.92696,-55.65966,2018-10-21 06:00:00,43,NA,NA
"24565",10501,"Grand Falls-Windsor","NL",48.92696,-55.65966,2018-10-21 07:00:00,42,NA,NA
"24566",10501,"Grand Falls-Windsor","NL",48.92696,-55.65966,2018-10-21 08:00:00,41,NA,NA
"24567",10501,"Grand Falls-Windsor","NL",48.92696,-55.65966,2018-10-21 09:00:00,41,NA,NA
"24568",10501,"Grand Falls-Windsor","NL",48.92696,-55.65966,2018-10-21 10:00:00,41,NA,NA
"24569",10501,"Grand Falls-Windsor","NL",48.92696,-55.65966,2018-10-21 11:00:00,41,NA,NA
"24570",10501,"Grand Falls-Windsor","NL",48.92696,-55.65966,2018-10-21 12:00:00,41,NA,NA
"24571",10501,"Grand Falls-Windsor","NL",48.92696,-55.65966,2018-10-21 13:00:00,40,NA,NA
"24572",10501,"Grand Falls-Windsor","NL",48.92696,-55.65966,2018-10-21 14:00:00,38,NA,NA
"24573",10501,"Grand Falls-Windsor","NL",48.92696,-55.65966,2018-10-21 15:00:00,37,NA,NA
"24574",10501,"Grand Falls-Windsor","NL",48.92696,-55.65966,2018-10-21 16:00:00,32,NA,NA
"24575",10501,"Grand Falls-Windsor","NL",48.92696,-55.65966,2018-10-21 17:00:00,36,NA,NA
"24576",10501,"Grand Falls-Windsor","NL",48.92696,-55.65966,2018-10-21 18:00:00,37,NA,NA
"24577",10501,"Grand Falls-Windsor","NL",48.92696,-55.65966,2018-10-21 19:00:00,38,NA,NA
"24578",10501,"Grand Falls-Windsor","NL",48.92696,-55.65966,2018-10-21 20:00:00,39,NA,NA
"24579",10501,"Grand Falls-Windsor","NL",48.92696,-55.65966,2018-10-21 21:00:00,38,NA,NA
"24580",10501,"Grand Falls-Windsor","NL",48.92696,-55.65966,2018-10-21 22:00:00,37,NA,NA
"24581",10501,"Grand Falls-Windsor","NL",48.92696,-55.65966,2018-10-21 23:00:00,36,NA,NA
"24582",10501,"Grand Falls-Windsor","NL",48.92696,-55.65966,2018-10-22 00:00:00,32,NA,NA
"24583",10501,"Grand Falls-Windsor","NL",48.92696,-55.65966,2018-10-22 01:00:00,30,NA,NA
"24584",10501,"Grand Falls-Windsor","NL",48.92696,-55.65966,2018-10-22 02:00:00,34,NA,NA
"24585",10501,"Grand Falls-Windsor","NL",48.92696,-55.65966,2018-10-22 03:00:00,32,NA,NA
"24586",10501,"Grand Falls-Windsor","NL",48.92696,-55.65966,2018-10-22 04:00:00,32,NA,NA
"24587",10501,"Grand Falls-Windsor","NL",48.92696,-55.65966,2018-10-22 05:00:00,33,NA,NA
"24588",10501,"Grand Falls-Windsor","NL",48.92696,-55.65966,2018-10-22 06:00:00,25,NA,NA
"24589",10501,"Grand Falls-Windsor","NL",48.92696,-55.65966,2018-10-22 07:00:00,24,NA,NA
"24590",10501,"Grand Falls-Windsor","NL",48.92696,-55.65966,2018-10-22 08:00:00,25,NA,NA
"24591",10501,"Grand Falls-Windsor","NL",48.92696,-55.65966,2018-10-22 09:00:00,24,NA,NA
"24592",10501,"Grand Falls-Windsor","NL",48.92696,-55.65966,2018-10-22 10:00:00,23,NA,NA
"24593",10501,"Grand Falls-Windsor","NL",48.92696,-55.65966,2018-10-22 11:00:00,24,NA,NA
"24594",10501,"Grand Falls-Windsor","NL",48.92696,-55.65966,2018-10-22 12:00:00,27,NA,NA
"24595",10501,"Grand Falls-Windsor","NL",48.92696,-55.65966,2018-10-22 13:00:00,28,NA,NA
"24596",10501,"Grand Falls-Windsor","NL",48.92696,-55.65966,2018-10-22 14:00:00,29,NA,NA
"24597",10501,"Grand Falls-Windsor","NL",48.92696,-55.65966,2018-10-22 15:00:00,29,NA,NA
"24598",10501,"Grand Falls-Windsor","NL",48.92696,-55.65966,2018-10-22 16:00:00,28,NA,NA
"24599",10501,"Grand Falls-Windsor","NL",48.92696,-55.65966,2018-10-22 17:00:00,25,NA,NA
"24600",10501,"Grand Falls-Windsor","NL",48.92696,-55.65966,2018-10-22 18:00:00,23,NA,NA
"24601",10501,"Grand Falls-Windsor","NL",48.92696,-55.65966,2018-10-22 19:00:00,23,NA,NA
"24602",10501,"Grand Falls-Windsor","NL",48.92696,-55.65966,2018-10-22 20:00:00,23,NA,NA
"24603",10501,"Grand Falls-Windsor","NL",48.92696,-55.65966,2018-10-22 21:00:00,25,NA,NA
"24604",10501,"Grand Falls-Windsor","NL",48.92696,-55.65966,2018-10-22 22:00:00,28,NA,NA
"24605",10501,"Grand Falls-Windsor","NL",48.92696,-55.65966,2018-10-22 23:00:00,26,NA,NA
"24606",10501,"Grand Falls-Windsor","NL",48.92696,-55.65966,2018-10-23 00:00:00,27,NA,NA
"24607",10501,"Grand Falls-Windsor","NL",48.92696,-55.65966,2018-10-23 01:00:00,28,NA,NA
"24608",10501,"Grand Falls-Windsor","NL",48.92696,-55.65966,2018-10-23 02:00:00,30,NA,NA
"24609",10501,"Grand Falls-Windsor","NL",48.92696,-55.65966,2018-10-23 03:00:00,28,NA,NA
"24610",10501,"Grand Falls-Windsor","NL",48.92696,-55.65966,2018-10-23 04:00:00,29,NA,NA
"24611",10501,"Grand Falls-Windsor","NL",48.92696,-55.65966,2018-10-23 05:00:00,27,NA,NA
"24612",10501,"Grand Falls-Windsor","NL",48.92696,-55.65966,2018-10-23 06:00:00,26,NA,NA
"24613",10501,"Grand Falls-Windsor","NL",48.92696,-55.65966,2018-10-23 07:00:00,26,NA,NA
"24614",10501,"Grand Falls-Windsor","NL",48.92696,-55.65966,2018-10-23 08:00:00,26,NA,NA
"24615",10501,"Grand Falls-Windsor","NL",48.92696,-55.65966,2018-10-23 09:00:00,28,NA,NA
"24616",10501,"Grand Falls-Windsor","NL",48.92696,-55.65966,2018-10-23 10:00:00,30,NA,NA
"24617",10501,"Grand Falls-Windsor","NL",48.92696,-55.65966,2018-10-23 11:00:00,31,NA,NA
"24618",10501,"Grand Falls-Windsor","NL",48.92696,-55.65966,2018-10-23 12:00:00,31,NA,NA
"24619",10501,"Grand Falls-Windsor","NL",48.92696,-55.65966,2018-10-23 13:00:00,31,NA,NA
"24620",10501,"Grand Falls-Windsor","NL",48.92696,-55.65966,2018-10-23 14:00:00,32,NA,NA
"24621",10501,"Grand Falls-Windsor","NL",48.92696,-55.65966,2018-10-23 15:00:00,31,NA,NA
"24622",10501,"Grand Falls-Windsor","NL",48.92696,-55.65966,2018-10-23 16:00:00,31,NA,NA
"24623",10501,"Grand Falls-Windsor","NL",48.92696,-55.65966,2018-10-23 17:00:00,30,NA,NA
"24624",10501,"Grand Falls-Windsor","NL",48.92696,-55.65966,2018-10-23 18:00:00,28,NA,NA
"24625",10501,"Grand Falls-Windsor","NL",48.92696,-55.65966,2018-10-23 19:00:00,26,NA,NA
"24626",10501,"Grand Falls-Windsor","NL",48.92696,-55.65966,2018-10-23 20:00:00,25,NA,NA
"24627",10501,"Grand Falls-Windsor","NL",48.92696,-55.65966,2018-10-23 21:00:00,23,NA,NA
"24628",10501,"Grand Falls-Windsor","NL",48.92696,-55.65966,2018-10-23 22:00:00,20,NA,NA
"24629",10501,"Grand Falls-Windsor","NL",48.92696,-55.65966,2018-10-23 23:00:00,17,NA,NA
"24630",10501,"Grand Falls-Windsor","NL",48.92696,-55.65966,2018-10-24 00:00:00,17,NA,NA
"24631",10501,"Grand Falls-Windsor","NL",48.92696,-55.65966,2018-10-24 01:00:00,13,NA,NA
"24632",10501,"Grand Falls-Windsor","NL",48.92696,-55.65966,2018-10-24 02:00:00,11,NA,NA
"24633",10501,"Grand Falls-Windsor","NL",48.92696,-55.65966,2018-10-24 03:00:00,12,NA,NA
"24634",10501,"Grand Falls-Windsor","NL",48.92696,-55.65966,2018-10-24 04:00:00,12,NA,NA
"24635",10501,"Grand Falls-Windsor","NL",48.92696,-55.65966,2018-10-24 05:00:00,8,NA,NA
"24636",10501,"Grand Falls-Windsor","NL",48.92696,-55.65966,2018-10-24 06:00:00,7,NA,NA
"24637",10501,"Grand Falls-Windsor","NL",48.92696,-55.65966,2018-10-24 07:00:00,6,NA,NA
"24638",10501,"Grand Falls-Windsor","NL",48.92696,-55.65966,2018-10-24 08:00:00,4,NA,NA
"24639",10501,"Grand Falls-Windsor","NL",48.92696,-55.65966,2018-10-24 09:00:00,5,NA,NA
"24640",10501,"Grand Falls-Windsor","NL",48.92696,-55.65966,2018-10-24 10:00:00,7,NA,NA
"24641",10501,"Grand Falls-Windsor","NL",48.92696,-55.65966,2018-10-24 11:00:00,11,NA,NA
"24642",10501,"Grand Falls-Windsor","NL",48.92696,-55.65966,2018-10-24 12:00:00,14,NA,NA
"24643",10501,"Grand Falls-Windsor","NL",48.92696,-55.65966,2018-10-24 13:00:00,17,NA,NA
"24644",10501,"Grand Falls-Windsor","NL",48.92696,-55.65966,2018-10-24 14:00:00,21,NA,NA
"24645",10501,"Grand Falls-Windsor","NL",48.92696,-55.65966,2018-10-24 15:00:00,29,NA,NA
"24646",10501,"Grand Falls-Windsor","NL",48.92696,-55.65966,2018-10-24 16:00:00,29,NA,NA
"24647",10501,"Grand Falls-Windsor","NL",48.92696,-55.65966,2018-10-24 17:00:00,28,NA,NA
"24648",10501,"Grand Falls-Windsor","NL",48.92696,-55.65966,2018-10-24 18:00:00,27,NA,NA
"24649",10501,"Grand Falls-Windsor","NL",48.92696,-55.65966,2018-10-24 19:00:00,30,NA,NA
"24650",10501,"Grand Falls-Windsor","NL",48.92696,-55.65966,2018-10-24 20:00:00,32,NA,NA
"24651",10501,"Grand Falls-Windsor","NL",48.92696,-55.65966,2018-10-24 21:00:00,34,NA,NA
"24652",10501,"Grand Falls-Windsor","NL",48.92696,-55.65966,2018-10-24 22:00:00,34,NA,NA
"24653",10501,"Grand Falls-Windsor","NL",48.92696,-55.65966,2018-10-24 23:00:00,35,NA,NA
"24654",10501,"Grand Falls-Windsor","NL",48.92696,-55.65966,2018-10-25 00:00:00,35,NA,NA
"24655",10501,"Grand Falls-Windsor","NL",48.92696,-55.65966,2018-10-25 01:00:00,34,NA,NA
"24656",10501,"Grand Falls-Windsor","NL",48.92696,-55.65966,2018-10-25 02:00:00,34,NA,NA
"24657",10501,"Grand Falls-Windsor","NL",48.92696,-55.65966,2018-10-25 03:00:00,36,NA,NA
"24658",10501,"Grand Falls-Windsor","NL",48.92696,-55.65966,2018-10-25 04:00:00,39,NA,NA
"24659",10501,"Grand Falls-Windsor","NL",48.92696,-55.65966,2018-10-25 05:00:00,39,NA,NA
"24660",10501,"Grand Falls-Windsor","NL",48.92696,-55.65966,2018-10-25 06:00:00,38,NA,NA
"24661",10501,"Grand Falls-Windsor","NL",48.92696,-55.65966,2018-10-25 07:00:00,38,NA,NA
"24662",10501,"Grand Falls-Windsor","NL",48.92696,-55.65966,2018-10-25 08:00:00,37,NA,NA
"24663",10501,"Grand Falls-Windsor","NL",48.92696,-55.65966,2018-10-25 09:00:00,35,NA,NA
"24664",10501,"Grand Falls-Windsor","NL",48.92696,-55.65966,2018-10-25 10:00:00,33,NA,NA
"24665",10501,"Grand Falls-Windsor","NL",48.92696,-55.65966,2018-10-25 11:00:00,32,NA,NA
"24666",10501,"Grand Falls-Windsor","NL",48.92696,-55.65966,2018-10-25 12:00:00,31,NA,NA
"24667",10501,"Grand Falls-Windsor","NL",48.92696,-55.65966,2018-10-25 13:00:00,30,NA,NA
"24668",10501,"Grand Falls-Windsor","NL",48.92696,-55.65966,2018-10-25 14:00:00,29,NA,NA
"24669",10501,"Grand Falls-Windsor","NL",48.92696,-55.65966,2018-10-25 15:00:00,26,1,27
"24670",10501,"Grand Falls-Windsor","NL",48.92696,-55.65966,2018-10-25 16:00:00,27,1,28
"24671",10501,"Grand Falls-Windsor","NL",48.92696,-55.65966,2018-10-25 17:00:00,28,1,29
"24672",10501,"Grand Falls-Windsor","NL",48.92696,-55.65966,2018-10-25 18:00:00,35,1,36
"24673",10501,"Grand Falls-Windsor","NL",48.92696,-55.65966,2018-10-25 19:00:00,34,1,35
"24674",10501,"Grand Falls-Windsor","NL",48.92696,-55.65966,2018-10-25 20:00:00,31,1,32
"24675",10501,"Grand Falls-Windsor","NL",48.92696,-55.65966,2018-10-25 21:00:00,28,1,29
"24676",10501,"Grand Falls-Windsor","NL",48.92696,-55.65966,2018-10-25 22:00:00,27,1,28
"24677",10501,"Grand Falls-Windsor","NL",48.92696,-55.65966,2018-10-25 23:00:00,28,1,29
"24678",10501,"Grand Falls-Windsor","NL",48.92696,-55.65966,2018-10-26 00:00:00,28,1,29
"24679",10501,"Grand Falls-Windsor","NL",48.92696,-55.65966,2018-10-26 01:00:00,25,1,26
"24680",10501,"Grand Falls-Windsor","NL",48.92696,-55.65966,2018-10-26 02:00:00,23,0,23
"24681",10501,"Grand Falls-Windsor","NL",48.92696,-55.65966,2018-10-26 03:00:00,31,1,32
"24682",10501,"Grand Falls-Windsor","NL",48.92696,-55.65966,2018-10-26 04:00:00,30,1,31
"24683",10501,"Grand Falls-Windsor","NL",48.92696,-55.65966,2018-10-26 05:00:00,27,0,27
"24684",10501,"Grand Falls-Windsor","NL",48.92696,-55.65966,2018-10-26 06:00:00,23,1,24
"24685",10501,"Grand Falls-Windsor","NL",48.92696,-55.65966,2018-10-26 07:00:00,22,1,23
"24686",10501,"Grand Falls-Windsor","NL",48.92696,-55.65966,2018-10-26 08:00:00,22,1,23
"24687",10501,"Grand Falls-Windsor","NL",48.92696,-55.65966,2018-10-26 09:00:00,26,0,26
"24688",10501,"Grand Falls-Windsor","NL",48.92696,-55.65966,2018-10-26 10:00:00,29,0,29
"24689",10501,"Grand Falls-Windsor","NL",48.92696,-55.65966,2018-10-26 11:00:00,31,1,32
"24690",10501,"Grand Falls-Windsor","NL",48.92696,-55.65966,2018-10-26 12:00:00,32,1,33
"24691",10501,"Grand Falls-Windsor","NL",48.92696,-55.65966,2018-10-26 13:00:00,33,0,33
"24692",10501,"Grand Falls-Windsor","NL",48.92696,-55.65966,2018-10-26 14:00:00,35,1,36
"24693",10501,"Grand Falls-Windsor","NL",48.92696,-55.65966,2018-10-26 15:00:00,35,1,36
"24694",10501,"Grand Falls-Windsor","NL",48.92696,-55.65966,2018-10-26 16:00:00,34,1,35
"24695",10501,"Grand Falls-Windsor","NL",48.92696,-55.65966,2018-10-26 17:00:00,34,1,35
"24696",10501,"Grand Falls-Windsor","NL",48.92696,-55.65966,2018-10-26 18:00:00,34,1,35
"24697",10501,"Grand Falls-Windsor","NL",48.92696,-55.65966,2018-10-26 19:00:00,33,1,34
"24698",10501,"Grand Falls-Windsor","NL",48.92696,-55.65966,2018-10-26 20:00:00,33,0,33
"24699",10501,"Grand Falls-Windsor","NL",48.92696,-55.65966,2018-10-26 21:00:00,33,1,34
"24700",10501,"Grand Falls-Windsor","NL",48.92696,-55.65966,2018-10-26 22:00:00,33,1,34
"24701",10501,"Grand Falls-Windsor","NL",48.92696,-55.65966,2018-10-26 23:00:00,33,1,34
"24702",10501,"Grand Falls-Windsor","NL",48.92696,-55.65966,2018-10-27 00:00:00,32,1,33
"24703",10501,"Grand Falls-Windsor","NL",48.92696,-55.65966,2018-10-27 01:00:00,32,1,33
"24704",10501,"Grand Falls-Windsor","NL",48.92696,-55.65966,2018-10-27 02:00:00,31,0,31
"24705",10501,"Grand Falls-Windsor","NL",48.92696,-55.65966,2018-10-27 03:00:00,33,1,34
"24706",10501,"Grand Falls-Windsor","NL",48.92696,-55.65966,2018-10-27 04:00:00,33,1,34
"24707",10501,"Grand Falls-Windsor","NL",48.92696,-55.65966,2018-10-27 05:00:00,34,1,35
"24708",10501,"Grand Falls-Windsor","NL",48.92696,-55.65966,2018-10-27 06:00:00,34,1,35
"24709",10501,"Grand Falls-Windsor","NL",48.92696,-55.65966,2018-10-27 07:00:00,34,1,35
"24710",10501,"Grand Falls-Windsor","NL",48.92696,-55.65966,2018-10-27 08:00:00,33,1,34
"24711",10501,"Grand Falls-Windsor","NL",48.92696,-55.65966,2018-10-27 09:00:00,33,1,34
"24712",10501,"Grand Falls-Windsor","NL",48.92696,-55.65966,2018-10-27 10:00:00,35,1,36
"24713",10501,"Grand Falls-Windsor","NL",48.92696,-55.65966,2018-10-27 11:00:00,36,1,37
"24714",10501,"Grand Falls-Windsor","NL",48.92696,-55.65966,2018-10-27 12:00:00,37,1,38
"24715",10501,"Grand Falls-Windsor","NL",48.92696,-55.65966,2018-10-27 13:00:00,37,1,38
"24716",10501,"Grand Falls-Windsor","NL",48.92696,-55.65966,2018-10-27 14:00:00,38,1,39
"24717",10501,"Grand Falls-Windsor","NL",48.92696,-55.65966,2018-10-27 15:00:00,38,1,39
"24718",10501,"Grand Falls-Windsor","NL",48.92696,-55.65966,2018-10-27 16:00:00,38,1,39
"24719",10501,"Grand Falls-Windsor","NL",48.92696,-55.65966,2018-10-27 17:00:00,39,1,40
"24720",10501,"Grand Falls-Windsor","NL",48.92696,-55.65966,2018-10-27 18:00:00,39,1,40
"24721",10501,"Grand Falls-Windsor","NL",48.92696,-55.65966,2018-10-27 19:00:00,38,1,39
"24722",10501,"Grand Falls-Windsor","NL",48.92696,-55.65966,2018-10-27 20:00:00,36,1,37
"24723",10501,"Grand Falls-Windsor","NL",48.92696,-55.65966,2018-10-27 21:00:00,32,1,33
"24724",10501,"Grand Falls-Windsor","NL",48.92696,-55.65966,2018-10-27 22:00:00,31,1,32
"24725",10501,"Grand Falls-Windsor","NL",48.92696,-55.65966,2018-10-27 23:00:00,26,1,27
"24726",10501,"Grand Falls-Windsor","NL",48.92696,-55.65966,2018-10-28 00:00:00,25,2,27
"24727",10501,"Grand Falls-Windsor","NL",48.92696,-55.65966,2018-10-28 01:00:00,22,3,25
"24728",10501,"Grand Falls-Windsor","NL",48.92696,-55.65966,2018-10-28 02:00:00,21,1,22
"24729",10501,"Grand Falls-Windsor","NL",48.92696,-55.65966,2018-10-28 03:00:00,19,1,20
"24730",10501,"Grand Falls-Windsor","NL",48.92696,-55.65966,2018-10-28 04:00:00,15,1,16
"24731",10501,"Grand Falls-Windsor","NL",48.92696,-55.65966,2018-10-28 05:00:00,19,1,20
"24732",10501,"Grand Falls-Windsor","NL",48.92696,-55.65966,2018-10-28 06:00:00,21,1,22
"24733",10501,"Grand Falls-Windsor","NL",48.92696,-55.65966,2018-10-28 07:00:00,22,0,22
"24734",10501,"Grand Falls-Windsor","NL",48.92696,-55.65966,2018-10-28 08:00:00,25,2,27
"24735",10501,"Grand Falls-Windsor","NL",48.92696,-55.65966,2018-10-28 09:00:00,27,2,29
"24736",10501,"Grand Falls-Windsor","NL",48.92696,-55.65966,2018-10-28 10:00:00,25,1,26
"24737",10501,"Grand Falls-Windsor","NL",48.92696,-55.65966,2018-10-28 11:00:00,30,1,31
"24738",10501,"Grand Falls-Windsor","NL",48.92696,-55.65966,2018-10-28 12:00:00,32,1,33
"24739",10501,"Grand Falls-Windsor","NL",48.92696,-55.65966,2018-10-28 13:00:00,29,2,31
"24740",10501,"Grand Falls-Windsor","NL",48.92696,-55.65966,2018-10-28 14:00:00,29,3,32
"24741",10501,"Grand Falls-Windsor","NL",48.92696,-55.65966,2018-10-28 15:00:00,28,3,31
"24742",10501,"Grand Falls-Windsor","NL",48.92696,-55.65966,2018-10-28 16:00:00,28,2,30
"24743",10501,"Grand Falls-Windsor","NL",48.92696,-55.65966,2018-10-28 17:00:00,27,2,29
"24744",10501,"Grand Falls-Windsor","NL",48.92696,-55.65966,2018-10-28 18:00:00,29,2,31
"24745",10501,"Grand Falls-Windsor","NL",48.92696,-55.65966,2018-10-28 19:00:00,29,2,31
"24746",10501,"Grand Falls-Windsor","NL",48.92696,-55.65966,2018-10-28 20:00:00,31,2,33
"24747",10501,"Grand Falls-Windsor","NL",48.92696,-55.65966,2018-10-28 21:00:00,31,1,32
"24748",10501,"Grand Falls-Windsor","NL",48.92696,-55.65966,2018-10-28 22:00:00,29,1,30
"24749",10501,"Grand Falls-Windsor","NL",48.92696,-55.65966,2018-10-28 23:00:00,28,1,29
"24750",10501,"Grand Falls-Windsor","NL",48.92696,-55.65966,2018-10-29 00:00:00,28,1,29
"24751",10501,"Grand Falls-Windsor","NL",48.92696,-55.65966,2018-10-29 01:00:00,27,1,28
"24752",10501,"Grand Falls-Windsor","NL",48.92696,-55.65966,2018-10-29 02:00:00,33,1,34
"24753",10501,"Grand Falls-Windsor","NL",48.92696,-55.65966,2018-10-29 03:00:00,35,0,35
"24754",10501,"Grand Falls-Windsor","NL",48.92696,-55.65966,2018-10-29 04:00:00,35,0,35
"24755",10501,"Grand Falls-Windsor","NL",48.92696,-55.65966,2018-10-29 05:00:00,34,1,35
"24756",10501,"Grand Falls-Windsor","NL",48.92696,-55.65966,2018-10-29 06:00:00,35,1,36
"24757",10501,"Grand Falls-Windsor","NL",48.92696,-55.65966,2018-10-29 07:00:00,34,1,35
"24758",10501,"Grand Falls-Windsor","NL",48.92696,-55.65966,2018-10-29 08:00:00,34,1,35
"24759",10501,"Grand Falls-Windsor","NL",48.92696,-55.65966,2018-10-29 09:00:00,31,1,32
"24760",10501,"Grand Falls-Windsor","NL",48.92696,-55.65966,2018-10-29 10:00:00,32,1,33
"24761",10501,"Grand Falls-Windsor","NL",48.92696,-55.65966,2018-10-29 11:00:00,35,0,35
"24762",10501,"Grand Falls-Windsor","NL",48.92696,-55.65966,2018-10-29 12:00:00,33,2,35
"24763",10501,"Grand Falls-Windsor","NL",48.92696,-55.65966,2018-10-29 13:00:00,34,1,35
"24764",10501,"Grand Falls-Windsor","NL",48.92696,-55.65966,2018-10-29 14:00:00,33,1,34
"24765",10501,"Grand Falls-Windsor","NL",48.92696,-55.65966,2018-10-29 15:00:00,31,1,32
"24766",10501,"Grand Falls-Windsor","NL",48.92696,-55.65966,2018-10-29 16:00:00,29,2,31
"24767",10501,"Grand Falls-Windsor","NL",48.92696,-55.65966,2018-10-29 17:00:00,24,3,27
"24768",10501,"Grand Falls-Windsor","NL",48.92696,-55.65966,2018-10-29 18:00:00,17,5,22
"24769",10501,"Grand Falls-Windsor","NL",48.92696,-55.65966,2018-10-29 19:00:00,17,1,18
"24770",10501,"Grand Falls-Windsor","NL",48.92696,-55.65966,2018-10-29 20:00:00,8,5,13
"24771",10501,"Grand Falls-Windsor","NL",48.92696,-55.65966,2018-10-29 21:00:00,5,5,10
"24772",10501,"Grand Falls-Windsor","NL",48.92696,-55.65966,2018-10-29 22:00:00,6,6,12
"24773",10501,"Grand Falls-Windsor","NL",48.92696,-55.65966,2018-10-29 23:00:00,5,4,9
"24774",10501,"Grand Falls-Windsor","NL",48.92696,-55.65966,2018-10-30 00:00:00,4,3,7
"24775",10501,"Grand Falls-Windsor","NL",48.92696,-55.65966,2018-10-30 01:00:00,4,2,6
"24776",10501,"Grand Falls-Windsor","NL",48.92696,-55.65966,2018-10-30 02:00:00,9,1,10
"24777",10501,"Grand Falls-Windsor","NL",48.92696,-55.65966,2018-10-30 03:00:00,12,1,13
"24778",10501,"Grand Falls-Windsor","NL",48.92696,-55.65966,2018-10-30 04:00:00,11,1,12
"24779",10501,"Grand Falls-Windsor","NL",48.92696,-55.65966,2018-10-30 05:00:00,11,1,12
"24780",10501,"Grand Falls-Windsor","NL",48.92696,-55.65966,2018-10-30 06:00:00,11,1,12
"24781",10501,"Grand Falls-Windsor","NL",48.92696,-55.65966,2018-10-30 07:00:00,11,1,12
"24782",10501,"Grand Falls-Windsor","NL",48.92696,-55.65966,2018-10-30 08:00:00,7,2,9
"24783",10501,"Grand Falls-Windsor","NL",48.92696,-55.65966,2018-10-30 09:00:00,5,5,10
"24784",10501,"Grand Falls-Windsor","NL",48.92696,-55.65966,2018-10-30 10:00:00,7,2,9
"24785",10501,"Grand Falls-Windsor","NL",48.92696,-55.65966,2018-10-30 11:00:00,12,1,13
"24786",10501,"Grand Falls-Windsor","NL",48.92696,-55.65966,2018-10-30 12:00:00,14,3,17
"24787",10501,"Grand Falls-Windsor","NL",48.92696,-55.65966,2018-10-30 13:00:00,17,2,19
"24788",10501,"Grand Falls-Windsor","NL",48.92696,-55.65966,2018-10-30 14:00:00,18,3,21
"24789",10501,"Grand Falls-Windsor","NL",48.92696,-55.65966,2018-10-30 15:00:00,17,4,21
"24790",10501,"Grand Falls-Windsor","NL",48.92696,-55.65966,2018-10-30 16:00:00,18,4,22
"24791",10501,"Grand Falls-Windsor","NL",48.92696,-55.65966,2018-10-30 17:00:00,19,4,23
"24792",10501,"Grand Falls-Windsor","NL",48.92696,-55.65966,2018-10-30 18:00:00,20,6,26
"24793",10501,"Grand Falls-Windsor","NL",48.92696,-55.65966,2018-10-30 19:00:00,20,3,23
"24794",10501,"Grand Falls-Windsor","NL",48.92696,-55.65966,2018-10-30 20:00:00,24,1,25
"24795",10501,"Grand Falls-Windsor","NL",48.92696,-55.65966,2018-10-30 21:00:00,25,2,27
"24796",10501,"Grand Falls-Windsor","NL",48.92696,-55.65966,2018-10-30 22:00:00,24,2,26
"24797",10501,"Grand Falls-Windsor","NL",48.92696,-55.65966,2018-10-30 23:00:00,26,1,27
"24798",10501,"Grand Falls-Windsor","NL",48.92696,-55.65966,2018-10-31 00:00:00,25,1,26
"24799",10501,"Grand Falls-Windsor","NL",48.92696,-55.65966,2018-10-31 01:00:00,27,1,28
"24800",10501,"Grand Falls-Windsor","NL",48.92696,-55.65966,2018-10-31 02:00:00,29,1,30
"24801",10501,"Grand Falls-Windsor","NL",48.92696,-55.65966,2018-10-31 03:00:00,28,1,29
"24802",10501,"Grand Falls-Windsor","NL",48.92696,-55.65966,2018-10-31 04:00:00,26,1,27
"24803",10501,"Grand Falls-Windsor","NL",48.92696,-55.65966,2018-10-31 05:00:00,28,1,29
"24804",10501,"Grand Falls-Windsor","NL",48.92696,-55.65966,2018-10-31 06:00:00,28,2,30
"24805",10501,"Grand Falls-Windsor","NL",48.92696,-55.65966,2018-10-31 07:00:00,29,2,31
"24806",10501,"Grand Falls-Windsor","NL",48.92696,-55.65966,2018-10-31 08:00:00,30,2,32
"24807",10501,"Grand Falls-Windsor","NL",48.92696,-55.65966,2018-10-31 09:00:00,30,2,32
"24808",10501,"Grand Falls-Windsor","NL",48.92696,-55.65966,2018-10-31 10:00:00,31,3,34
"24809",10501,"Grand Falls-Windsor","NL",48.92696,-55.65966,2018-10-31 11:00:00,32,2,34
"24810",10501,"Grand Falls-Windsor","NL",48.92696,-55.65966,2018-10-31 12:00:00,33,2,35
"24811",10501,"Grand Falls-Windsor","NL",48.92696,-55.65966,2018-10-31 13:00:00,35,2,37
"24812",10501,"Grand Falls-Windsor","NL",48.92696,-55.65966,2018-10-31 14:00:00,33,3,36
"24813",10501,"Grand Falls-Windsor","NL",48.92696,-55.65966,2018-10-31 15:00:00,33,3,36
"24814",10501,"Grand Falls-Windsor","NL",48.92696,-55.65966,2018-10-31 16:00:00,35,2,37
"24815",10501,"Grand Falls-Windsor","NL",48.92696,-55.65966,2018-10-31 17:00:00,37,3,40
"24816",10501,"Grand Falls-Windsor","NL",48.92696,-55.65966,2018-10-31 18:00:00,39,2,41
"24817",10501,"Grand Falls-Windsor","NL",48.92696,-55.65966,2018-10-31 19:00:00,39,2,41
"24818",10501,"Grand Falls-Windsor","NL",48.92696,-55.65966,2018-10-31 20:00:00,39,1,40
"24819",10501,"Grand Falls-Windsor","NL",48.92696,-55.65966,2018-10-31 21:00:00,40,1,41
"24820",10501,"Grand Falls-Windsor","NL",48.92696,-55.65966,2018-10-31 22:00:00,41,1,42
"24821",10501,"Grand Falls-Windsor","NL",48.92696,-55.65966,2018-10-31 23:00:00,40,1,41
"24822",10501,"Grand Falls-Windsor","NL",48.92696,-55.65966,2018-11-01 00:00:00,42,1,43
"24823",10501,"Grand Falls-Windsor","NL",48.92696,-55.65966,2018-11-01 01:00:00,42,1,43
"24824",10501,"Grand Falls-Windsor","NL",48.92696,-55.65966,2018-11-01 02:00:00,43,1,44
"24825",10501,"Grand Falls-Windsor","NL",48.92696,-55.65966,2018-11-01 03:00:00,42,0,42
"24826",10501,"Grand Falls-Windsor","NL",48.92696,-55.65966,2018-11-01 04:00:00,41,1,42
"24827",10501,"Grand Falls-Windsor","NL",48.92696,-55.65966,2018-11-01 05:00:00,39,1,40
"24828",10501,"Grand Falls-Windsor","NL",48.92696,-55.65966,2018-11-01 06:00:00,37,2,39
"24829",10501,"Grand Falls-Windsor","NL",48.92696,-55.65966,2018-11-01 07:00:00,34,5,39
"24830",10501,"Grand Falls-Windsor","NL",48.92696,-55.65966,2018-11-01 08:00:00,31,8,39
"24831",10501,"Grand Falls-Windsor","NL",48.92696,-55.65966,2018-11-01 09:00:00,34,7,41
"24832",10501,"Grand Falls-Windsor","NL",48.92696,-55.65966,2018-11-01 10:00:00,41,4,45
"24833",10501,"Grand Falls-Windsor","NL",48.92696,-55.65966,2018-11-01 11:00:00,43,2,45
"24834",10501,"Grand Falls-Windsor","NL",48.92696,-55.65966,2018-11-01 12:00:00,43,1,44
"24835",10501,"Grand Falls-Windsor","NL",48.92696,-55.65966,2018-11-01 13:00:00,42,1,43
"24836",10501,"Grand Falls-Windsor","NL",48.92696,-55.65966,2018-11-01 14:00:00,42,1,43
"24837",10501,"Grand Falls-Windsor","NL",48.92696,-55.65966,2018-11-01 15:00:00,40,1,41
"24838",10501,"Grand Falls-Windsor","NL",48.92696,-55.65966,2018-11-01 16:00:00,36,1,37
"24839",10501,"Grand Falls-Windsor","NL",48.92696,-55.65966,2018-11-01 17:00:00,33,1,34
"24840",10501,"Grand Falls-Windsor","NL",48.92696,-55.65966,2018-11-01 18:00:00,30,1,31
"24841",10501,"Grand Falls-Windsor","NL",48.92696,-55.65966,2018-11-01 19:00:00,28,1,29
"24842",10501,"Grand Falls-Windsor","NL",48.92696,-55.65966,2018-11-01 20:00:00,27,1,28
"24843",10501,"Grand Falls-Windsor","NL",48.92696,-55.65966,2018-11-01 21:00:00,26,1,27
"24844",10501,"Grand Falls-Windsor","NL",48.92696,-55.65966,2018-11-01 22:00:00,25,0,25
"24845",10501,"Grand Falls-Windsor","NL",48.92696,-55.65966,2018-11-01 23:00:00,25,0,25
"24846",10501,"Grand Falls-Windsor","NL",48.92696,-55.65966,2018-11-02 00:00:00,25,1,26
"24847",10501,"Grand Falls-Windsor","NL",48.92696,-55.65966,2018-11-02 01:00:00,21,1,22
"24848",10501,"Grand Falls-Windsor","NL",48.92696,-55.65966,2018-11-02 02:00:00,17,1,18
"24849",10501,"Grand Falls-Windsor","NL",48.92696,-55.65966,2018-11-02 03:00:00,23,1,24
"24850",10501,"Grand Falls-Windsor","NL",48.92696,-55.65966,2018-11-02 04:00:00,26,1,27
"24851",10501,"Grand Falls-Windsor","NL",48.92696,-55.65966,2018-11-02 05:00:00,24,1,25
"24852",10501,"Grand Falls-Windsor","NL",48.92696,-55.65966,2018-11-02 06:00:00,22,1,23
"24853",10501,"Grand Falls-Windsor","NL",48.92696,-55.65966,2018-11-02 07:00:00,21,1,22
"24854",10501,"Grand Falls-Windsor","NL",48.92696,-55.65966,2018-11-02 08:00:00,18,3,21
"24855",10501,"Grand Falls-Windsor","NL",48.92696,-55.65966,2018-11-02 09:00:00,18,1,19
"24856",10501,"Grand Falls-Windsor","NL",48.92696,-55.65966,2018-11-02 10:00:00,20,1,21
"24857",10501,"Grand Falls-Windsor","NL",48.92696,-55.65966,2018-11-02 11:00:00,23,1,24
"24858",10501,"Grand Falls-Windsor","NL",48.92696,-55.65966,2018-11-02 12:00:00,24,1,25
"24859",10501,"Grand Falls-Windsor","NL",48.92696,-55.65966,2018-11-02 13:00:00,25,1,26
"24860",10501,"Grand Falls-Windsor","NL",48.92696,-55.65966,2018-11-02 14:00:00,26,1,27
"24861",10501,"Grand Falls-Windsor","NL",48.92696,-55.65966,2018-11-02 15:00:00,26,1,27
"24862",10501,"Grand Falls-Windsor","NL",48.92696,-55.65966,2018-11-02 16:00:00,25,1,26
"24863",10501,"Grand Falls-Windsor","NL",48.92696,-55.65966,2018-11-02 17:00:00,23,2,25
"24864",10501,"Grand Falls-Windsor","NL",48.92696,-55.65966,2018-11-02 18:00:00,18,3,21
"24865",10501,"Grand Falls-Windsor","NL",48.92696,-55.65966,2018-11-02 19:00:00,18,1,19
"24866",10501,"Grand Falls-Windsor","NL",48.92696,-55.65966,2018-11-02 20:00:00,18,1,19
"24867",10501,"Grand Falls-Windsor","NL",48.92696,-55.65966,2018-11-02 21:00:00,24,1,25
"24868",10501,"Grand Falls-Windsor","NL",48.92696,-55.65966,2018-11-02 22:00:00,21,1,22
"24869",10501,"Grand Falls-Windsor","NL",48.92696,-55.65966,2018-11-02 23:00:00,20,1,21
"24870",10501,"Grand Falls-Windsor","NL",48.92696,-55.65966,2018-11-03 00:00:00,17,2,19
"24871",10501,"Grand Falls-Windsor","NL",48.92696,-55.65966,2018-11-03 01:00:00,14,1,15
"24872",10501,"Grand Falls-Windsor","NL",48.92696,-55.65966,2018-11-03 02:00:00,12,1,13
"24873",10501,"Grand Falls-Windsor","NL",48.92696,-55.65966,2018-11-03 03:00:00,12,2,14
"24874",10501,"Grand Falls-Windsor","NL",48.92696,-55.65966,2018-11-03 04:00:00,11,1,12
"24875",10501,"Grand Falls-Windsor","NL",48.92696,-55.65966,2018-11-03 05:00:00,10,2,12
"24876",10501,"Grand Falls-Windsor","NL",48.92696,-55.65966,2018-11-03 06:00:00,11,2,13
"24877",10501,"Grand Falls-Windsor","NL",48.92696,-55.65966,2018-11-03 07:00:00,9,1,10
"24878",10501,"Grand Falls-Windsor","NL",48.92696,-55.65966,2018-11-03 08:00:00,8,2,10
"24879",10501,"Grand Falls-Windsor","NL",48.92696,-55.65966,2018-11-03 09:00:00,11,2,13
"24880",10501,"Grand Falls-Windsor","NL",48.92696,-55.65966,2018-11-03 10:00:00,15,1,16
"24881",10501,"Grand Falls-Windsor","NL",48.92696,-55.65966,2018-11-03 11:00:00,16,2,18
"24882",10501,"Grand Falls-Windsor","NL",48.92696,-55.65966,2018-11-03 12:00:00,18,1,19
"24883",10501,"Grand Falls-Windsor","NL",48.92696,-55.65966,2018-11-03 13:00:00,19,1,20
"24884",10501,"Grand Falls-Windsor","NL",48.92696,-55.65966,2018-11-03 14:00:00,20,1,21
"24885",10501,"Grand Falls-Windsor","NL",48.92696,-55.65966,2018-11-03 15:00:00,19,1,20
"24886",10501,"Grand Falls-Windsor","NL",48.92696,-55.65966,2018-11-03 16:00:00,19,2,21
"24887",10501,"Grand Falls-Windsor","NL",48.92696,-55.65966,2018-11-03 17:00:00,19,3,22
"24888",10501,"Grand Falls-Windsor","NL",48.92696,-55.65966,2018-11-03 18:00:00,20,2,22
"24889",10501,"Grand Falls-Windsor","NL",48.92696,-55.65966,2018-11-03 19:00:00,19,3,22
"24890",10501,"Grand Falls-Windsor","NL",48.92696,-55.65966,2018-11-03 20:00:00,18,2,20
"24891",10501,"Grand Falls-Windsor","NL",48.92696,-55.65966,2018-11-03 21:00:00,17,2,19
"24892",10501,"Grand Falls-Windsor","NL",48.92696,-55.65966,2018-11-03 22:00:00,15,1,16
"24893",10501,"Grand Falls-Windsor","NL",48.92696,-55.65966,2018-11-03 23:00:00,29,1,30
"24894",10501,"Grand Falls-Windsor","NL",48.92696,-55.65966,2018-11-04 00:00:00,37,1,38
"24895",10501,"Grand Falls-Windsor","NL",48.92696,-55.65966,2018-11-04 01:00:00,39,1,40
"24896",10501,"Grand Falls-Windsor","NL",48.92696,-55.65966,2018-11-04 02:00:00,39,1,40
"24897",10501,"Grand Falls-Windsor","NL",48.92696,-55.65966,2018-11-04 03:00:00,49,0,49
"24898",10501,"Grand Falls-Windsor","NL",48.92696,-55.65966,2018-11-04 04:00:00,45,0,45
"24899",10501,"Grand Falls-Windsor","NL",48.92696,-55.65966,2018-11-04 05:00:00,42,1,43
"24900",10501,"Grand Falls-Windsor","NL",48.92696,-55.65966,2018-11-04 06:00:00,38,1,39
"24901",10501,"Grand Falls-Windsor","NL",48.92696,-55.65966,2018-11-04 07:00:00,32,1,33
"24902",10501,"Grand Falls-Windsor","NL",48.92696,-55.65966,2018-11-04 08:00:00,19,1,20
"24903",10501,"Grand Falls-Windsor","NL",48.92696,-55.65966,2018-11-04 09:00:00,16,1,17
"24904",10501,"Grand Falls-Windsor","NL",48.92696,-55.65966,2018-11-04 10:00:00,16,1,17
"24905",10501,"Grand Falls-Windsor","NL",48.92696,-55.65966,2018-11-04 11:00:00,16,1,17
"24906",10501,"Grand Falls-Windsor","NL",48.92696,-55.65966,2018-11-04 12:00:00,18,1,19
"24907",10501,"Grand Falls-Windsor","NL",48.92696,-55.65966,2018-11-04 13:00:00,21,1,22
"24908",10501,"Grand Falls-Windsor","NL",48.92696,-55.65966,2018-11-04 14:00:00,23,0,23
"24909",10501,"Grand Falls-Windsor","NL",48.92696,-55.65966,2018-11-04 15:00:00,24,1,25
"24910",10501,"Grand Falls-Windsor","NL",48.92696,-55.65966,2018-11-04 16:00:00,27,1,28
"24911",10501,"Grand Falls-Windsor","NL",48.92696,-55.65966,2018-11-04 17:00:00,28,1,29
"24912",10501,"Grand Falls-Windsor","NL",48.92696,-55.65966,2018-11-04 18:00:00,30,1,31
"24913",10501,"Grand Falls-Windsor","NL",48.92696,-55.65966,2018-11-04 19:00:00,30,0,30
"24914",10501,"Grand Falls-Windsor","NL",48.92696,-55.65966,2018-11-04 20:00:00,29,1,30
"24915",10501,"Grand Falls-Windsor","NL",48.92696,-55.65966,2018-11-04 21:00:00,28,0,28
"24916",10501,"Grand Falls-Windsor","NL",48.92696,-55.65966,2018-11-04 22:00:00,28,1,29
"24917",10501,"Grand Falls-Windsor","NL",48.92696,-55.65966,2018-11-04 23:00:00,30,1,31
"24918",10501,"Grand Falls-Windsor","NL",48.92696,-55.65966,2018-11-05 00:00:00,30,1,31
"24919",10501,"Grand Falls-Windsor","NL",48.92696,-55.65966,2018-11-05 01:00:00,31,1,32
"24920",10501,"Grand Falls-Windsor","NL",48.92696,-55.65966,2018-11-05 02:00:00,31,1,32
"24921",10501,"Grand Falls-Windsor","NL",48.92696,-55.65966,2018-11-05 03:00:00,31,1,32
"24922",10501,"Grand Falls-Windsor","NL",48.92696,-55.65966,2018-11-05 04:00:00,35,1,36
"24923",10501,"Grand Falls-Windsor","NL",48.92696,-55.65966,2018-11-05 05:00:00,36,1,37
"24924",10501,"Grand Falls-Windsor","NL",48.92696,-55.65966,2018-11-05 06:00:00,34,0,34
"24925",10501,"Grand Falls-Windsor","NL",48.92696,-55.65966,2018-11-05 07:00:00,36,0,36
"24926",10501,"Grand Falls-Windsor","NL",48.92696,-55.65966,2018-11-05 08:00:00,33,2,35
"24927",10501,"Grand Falls-Windsor","NL",48.92696,-55.65966,2018-11-05 09:00:00,35,1,36
"24928",10501,"Grand Falls-Windsor","NL",48.92696,-55.65966,2018-11-05 10:00:00,34,8,42
"24929",10501,"Grand Falls-Windsor","NL",48.92696,-55.65966,2018-11-05 11:00:00,37,1,38
"24930",10501,"Grand Falls-Windsor","NL",48.92696,-55.65966,2018-11-05 12:00:00,37,1,38
"24931",10501,"Grand Falls-Windsor","NL",48.92696,-55.65966,2018-11-05 13:00:00,37,1,38
"24932",10501,"Grand Falls-Windsor","NL",48.92696,-55.65966,2018-11-05 14:00:00,37,1,38
"24933",10501,"Grand Falls-Windsor","NL",48.92696,-55.65966,2018-11-05 15:00:00,36,1,37
"24934",10501,"Grand Falls-Windsor","NL",48.92696,-55.65966,2018-11-05 16:00:00,36,1,37
"24935",10501,"Grand Falls-Windsor","NL",48.92696,-55.65966,2018-11-05 17:00:00,36,1,37
"24936",10501,"Grand Falls-Windsor","NL",48.92696,-55.65966,2018-11-05 18:00:00,35,1,36
"24937",10501,"Grand Falls-Windsor","NL",48.92696,-55.65966,2018-11-05 19:00:00,34,1,35
"24938",10501,"Grand Falls-Windsor","NL",48.92696,-55.65966,2018-11-05 20:00:00,32,1,33
"24939",10501,"Grand Falls-Windsor","NL",48.92696,-55.65966,2018-11-05 21:00:00,28,1,29
"24940",10501,"Grand Falls-Windsor","NL",48.92696,-55.65966,2018-11-05 22:00:00,25,1,26
"24941",10501,"Grand Falls-Windsor","NL",48.92696,-55.65966,2018-11-05 23:00:00,25,1,26
"24942",10501,"Grand Falls-Windsor","NL",48.92696,-55.65966,2018-11-06 00:00:00,24,1,25
"24943",10501,"Grand Falls-Windsor","NL",48.92696,-55.65966,2018-11-06 01:00:00,21,1,22
"24944",10501,"Grand Falls-Windsor","NL",48.92696,-55.65966,2018-11-06 02:00:00,20,0,20
"24945",10501,"Grand Falls-Windsor","NL",48.92696,-55.65966,2018-11-06 03:00:00,25,0,25
"24946",10501,"Grand Falls-Windsor","NL",48.92696,-55.65966,2018-11-06 04:00:00,24,1,25
"24947",10501,"Grand Falls-Windsor","NL",48.92696,-55.65966,2018-11-06 05:00:00,22,1,23
"24948",10501,"Grand Falls-Windsor","NL",48.92696,-55.65966,2018-11-06 06:00:00,21,0,21
"24949",10501,"Grand Falls-Windsor","NL",48.92696,-55.65966,2018-11-06 07:00:00,19,1,20
"24950",10501,"Grand Falls-Windsor","NL",48.92696,-55.65966,2018-11-06 08:00:00,20,1,21
"24951",10501,"Grand Falls-Windsor","NL",48.92696,-55.65966,2018-11-06 09:00:00,20,1,21
"24952",10501,"Grand Falls-Windsor","NL",48.92696,-55.65966,2018-11-06 10:00:00,23,1,24
"24953",10501,"Grand Falls-Windsor","NL",48.92696,-55.65966,2018-11-06 11:00:00,27,1,28
"24954",10501,"Grand Falls-Windsor","NL",48.92696,-55.65966,2018-11-06 12:00:00,27,1,28
"24955",10501,"Grand Falls-Windsor","NL",48.92696,-55.65966,2018-11-06 13:00:00,NA,1,NA
"24956",10501,"Grand Falls-Windsor","NL",48.92696,-55.65966,2018-11-06 14:00:00,NA,1,NA
"24957",10501,"Grand Falls-Windsor","NL",48.92696,-55.65966,2018-11-06 15:00:00,NA,NA,NA
"24958",10501,"Grand Falls-Windsor","NL",48.92696,-55.65966,2018-11-06 16:00:00,19,NA,NA
"24959",10501,"Grand Falls-Windsor","NL",48.92696,-55.65966,2018-11-06 17:00:00,18,NA,NA
"24960",10501,"Grand Falls-Windsor","NL",48.92696,-55.65966,2018-11-06 18:00:00,15,6,21
"24961",10501,"Grand Falls-Windsor","NL",48.92696,-55.65966,2018-11-06 19:00:00,13,2,15
"24962",10501,"Grand Falls-Windsor","NL",48.92696,-55.65966,2018-11-06 20:00:00,11,2,13
"24963",10501,"Grand Falls-Windsor","NL",48.92696,-55.65966,2018-11-06 21:00:00,12,2,14
"24964",10501,"Grand Falls-Windsor","NL",48.92696,-55.65966,2018-11-06 22:00:00,14,1,15
"24965",10501,"Grand Falls-Windsor","NL",48.92696,-55.65966,2018-11-06 23:00:00,19,3,22
"24966",10501,"Grand Falls-Windsor","NL",48.92696,-55.65966,2018-11-07 00:00:00,21,1,22
"24967",10501,"Grand Falls-Windsor","NL",48.92696,-55.65966,2018-11-07 01:00:00,22,1,23
"24968",10501,"Grand Falls-Windsor","NL",48.92696,-55.65966,2018-11-07 02:00:00,23,1,24
"24969",10501,"Grand Falls-Windsor","NL",48.92696,-55.65966,2018-11-07 03:00:00,27,0,27
"24970",10501,"Grand Falls-Windsor","NL",48.92696,-55.65966,2018-11-07 04:00:00,30,0,30
"24971",10501,"Grand Falls-Windsor","NL",48.92696,-55.65966,2018-11-07 05:00:00,31,0,31
"24972",10501,"Grand Falls-Windsor","NL",48.92696,-55.65966,2018-11-07 06:00:00,32,0,32
"24973",10501,"Grand Falls-Windsor","NL",48.92696,-55.65966,2018-11-07 07:00:00,32,1,33
"24974",10501,"Grand Falls-Windsor","NL",48.92696,-55.65966,2018-11-07 08:00:00,33,1,34
"24975",10501,"Grand Falls-Windsor","NL",48.92696,-55.65966,2018-11-07 09:00:00,32,1,33
"24976",10501,"Grand Falls-Windsor","NL",48.92696,-55.65966,2018-11-07 10:00:00,30,1,31
"24977",10501,"Grand Falls-Windsor","NL",48.92696,-55.65966,2018-11-07 11:00:00,30,1,31
"24978",10501,"Grand Falls-Windsor","NL",48.92696,-55.65966,2018-11-07 12:00:00,31,1,32
"24979",10501,"Grand Falls-Windsor","NL",48.92696,-55.65966,2018-11-07 13:00:00,33,1,34
"24980",10501,"Grand Falls-Windsor","NL",48.92696,-55.65966,2018-11-07 14:00:00,32,1,33
"24981",10501,"Grand Falls-Windsor","NL",48.92696,-55.65966,2018-11-07 15:00:00,32,1,33
"24982",10501,"Grand Falls-Windsor","NL",48.92696,-55.65966,2018-11-07 16:00:00,33,1,34
"24983",10501,"Grand Falls-Windsor","NL",48.92696,-55.65966,2018-11-07 17:00:00,30,1,31
"24984",10501,"Grand Falls-Windsor","NL",48.92696,-55.65966,2018-11-07 18:00:00,29,1,30
"24985",10501,"Grand Falls-Windsor","NL",48.92696,-55.65966,2018-11-07 19:00:00,26,1,27
"24986",10501,"Grand Falls-Windsor","NL",48.92696,-55.65966,2018-11-07 20:00:00,24,1,25
"24987",10501,"Grand Falls-Windsor","NL",48.92696,-55.65966,2018-11-07 21:00:00,23,1,24
"24988",10501,"Grand Falls-Windsor","NL",48.92696,-55.65966,2018-11-07 22:00:00,23,1,24
"24989",10501,"Grand Falls-Windsor","NL",48.92696,-55.65966,2018-11-07 23:00:00,25,1,26
"24990",10501,"Grand Falls-Windsor","NL",48.92696,-55.65966,2018-11-08 00:00:00,24,1,25
"24991",10501,"Grand Falls-Windsor","NL",48.92696,-55.65966,2018-11-08 01:00:00,24,1,25
"24992",10501,"Grand Falls-Windsor","NL",48.92696,-55.65966,2018-11-08 02:00:00,25,1,26
"24993",10501,"Grand Falls-Windsor","NL",48.92696,-55.65966,2018-11-08 03:00:00,24,1,25
"24994",10501,"Grand Falls-Windsor","NL",48.92696,-55.65966,2018-11-08 04:00:00,24,1,25
"24995",10501,"Grand Falls-Windsor","NL",48.92696,-55.65966,2018-11-08 05:00:00,24,1,25
"24996",10501,"Grand Falls-Windsor","NL",48.92696,-55.65966,2018-11-08 06:00:00,24,1,25
"24997",10501,"Grand Falls-Windsor","NL",48.92696,-55.65966,2018-11-08 07:00:00,24,1,25
"24998",10501,"Grand Falls-Windsor","NL",48.92696,-55.65966,2018-11-08 08:00:00,23,5,28
"24999",10501,"Grand Falls-Windsor","NL",48.92696,-55.65966,2018-11-08 09:00:00,23,1,24
"25000",10501,"Grand Falls-Windsor","NL",48.92696,-55.65966,2018-11-08 10:00:00,22,1,23
"25001",10501,"Grand Falls-Windsor","NL",48.92696,-55.65966,2018-11-08 11:00:00,21,1,22
"25002",10501,"Grand Falls-Windsor","NL",48.92696,-55.65966,2018-11-08 12:00:00,19,1,20
"25003",10501,"Grand Falls-Windsor","NL",48.92696,-55.65966,2018-11-08 13:00:00,18,1,19
"25004",10501,"Grand Falls-Windsor","NL",48.92696,-55.65966,2018-11-08 14:00:00,18,1,19
"25005",10501,"Grand Falls-Windsor","NL",48.92696,-55.65966,2018-11-08 15:00:00,17,1,18
"25006",10501,"Grand Falls-Windsor","NL",48.92696,-55.65966,2018-11-08 16:00:00,18,1,19
"25007",10501,"Grand Falls-Windsor","NL",48.92696,-55.65966,2018-11-08 17:00:00,17,1,18
"25008",10501,"Grand Falls-Windsor","NL",48.92696,-55.65966,2018-11-08 18:00:00,17,1,18
"25009",10501,"Grand Falls-Windsor","NL",48.92696,-55.65966,2018-11-08 19:00:00,16,1,17
"25010",10501,"Grand Falls-Windsor","NL",48.92696,-55.65966,2018-11-08 20:00:00,16,1,17
"25011",10501,"Grand Falls-Windsor","NL",48.92696,-55.65966,2018-11-08 21:00:00,16,1,17
"25012",10501,"Grand Falls-Windsor","NL",48.92696,-55.65966,2018-11-08 22:00:00,17,1,18
"25013",10501,"Grand Falls-Windsor","NL",48.92696,-55.65966,2018-11-08 23:00:00,17,1,18
"25014",10501,"Grand Falls-Windsor","NL",48.92696,-55.65966,2018-11-09 00:00:00,17,1,18
"25015",10501,"Grand Falls-Windsor","NL",48.92696,-55.65966,2018-11-09 01:00:00,17,1,18
"25016",10501,"Grand Falls-Windsor","NL",48.92696,-55.65966,2018-11-09 02:00:00,17,1,18
"25017",10501,"Grand Falls-Windsor","NL",48.92696,-55.65966,2018-11-09 03:00:00,18,0,18
"25018",10501,"Grand Falls-Windsor","NL",48.92696,-55.65966,2018-11-09 04:00:00,15,1,16
"25019",10501,"Grand Falls-Windsor","NL",48.92696,-55.65966,2018-11-09 05:00:00,14,1,15
"25020",10501,"Grand Falls-Windsor","NL",48.92696,-55.65966,2018-11-09 06:00:00,13,1,14
"25021",10501,"Grand Falls-Windsor","NL",48.92696,-55.65966,2018-11-09 07:00:00,15,1,16
"25022",10501,"Grand Falls-Windsor","NL",48.92696,-55.65966,2018-11-09 08:00:00,15,2,17
"25023",10501,"Grand Falls-Windsor","NL",48.92696,-55.65966,2018-11-09 09:00:00,17,1,18
"25024",10501,"Grand Falls-Windsor","NL",48.92696,-55.65966,2018-11-09 10:00:00,20,1,21
"25025",10501,"Grand Falls-Windsor","NL",48.92696,-55.65966,2018-11-09 11:00:00,25,1,26
"25026",10501,"Grand Falls-Windsor","NL",48.92696,-55.65966,2018-11-09 12:00:00,26,1,27
"25027",10501,"Grand Falls-Windsor","NL",48.92696,-55.65966,2018-11-09 13:00:00,26,1,27
"25028",10501,"Grand Falls-Windsor","NL",48.92696,-55.65966,2018-11-09 14:00:00,27,1,28
"25029",10501,"Grand Falls-Windsor","NL",48.92696,-55.65966,2018-11-09 15:00:00,26,1,27
"25030",10501,"Grand Falls-Windsor","NL",48.92696,-55.65966,2018-11-09 16:00:00,27,1,28
"25031",10501,"Grand Falls-Windsor","NL",48.92696,-55.65966,2018-11-09 17:00:00,27,2,29
"25032",10501,"Grand Falls-Windsor","NL",48.92696,-55.65966,2018-11-09 18:00:00,26,4,30
"25033",10501,"Grand Falls-Windsor","NL",48.92696,-55.65966,2018-11-09 19:00:00,30,1,31
"25034",10501,"Grand Falls-Windsor","NL",48.92696,-55.65966,2018-11-09 20:00:00,34,1,35
"25035",10501,"Grand Falls-Windsor","NL",48.92696,-55.65966,2018-11-09 21:00:00,33,1,34
"25036",10501,"Grand Falls-Windsor","NL",48.92696,-55.65966,2018-11-09 22:00:00,29,1,30
"25037",10501,"Grand Falls-Windsor","NL",48.92696,-55.65966,2018-11-09 23:00:00,25,2,27
"25038",10501,"Grand Falls-Windsor","NL",48.92696,-55.65966,2018-11-10 00:00:00,25,1,26
"25039",10501,"Grand Falls-Windsor","NL",48.92696,-55.65966,2018-11-10 01:00:00,27,1,28
"25040",10501,"Grand Falls-Windsor","NL",48.92696,-55.65966,2018-11-10 02:00:00,26,0,26
"25041",10501,"Grand Falls-Windsor","NL",48.92696,-55.65966,2018-11-10 03:00:00,27,1,28
"25042",10501,"Grand Falls-Windsor","NL",48.92696,-55.65966,2018-11-10 04:00:00,27,0,27
"25043",10501,"Grand Falls-Windsor","NL",48.92696,-55.65966,2018-11-10 05:00:00,34,1,35
"25044",10501,"Grand Falls-Windsor","NL",48.92696,-55.65966,2018-11-10 06:00:00,35,1,36
"25045",10501,"Grand Falls-Windsor","NL",48.92696,-55.65966,2018-11-10 07:00:00,31,3,34
"25046",10501,"Grand Falls-Windsor","NL",48.92696,-55.65966,2018-11-10 08:00:00,24,4,28
"25047",10501,"Grand Falls-Windsor","NL",48.92696,-55.65966,2018-11-10 09:00:00,24,1,25
"25048",10501,"Grand Falls-Windsor","NL",48.92696,-55.65966,2018-11-10 10:00:00,25,1,26
"25049",10501,"Grand Falls-Windsor","NL",48.92696,-55.65966,2018-11-10 11:00:00,28,1,29
"25050",10501,"Grand Falls-Windsor","NL",48.92696,-55.65966,2018-11-10 12:00:00,29,1,30
"25051",10501,"Grand Falls-Windsor","NL",48.92696,-55.65966,2018-11-10 13:00:00,32,1,33
"25052",10501,"Grand Falls-Windsor","NL",48.92696,-55.65966,2018-11-10 14:00:00,31,1,32
"25053",10501,"Grand Falls-Windsor","NL",48.92696,-55.65966,2018-11-10 15:00:00,30,1,31
"25054",10501,"Grand Falls-Windsor","NL",48.92696,-55.65966,2018-11-10 16:00:00,29,1,30
"25055",10501,"Grand Falls-Windsor","NL",48.92696,-55.65966,2018-11-10 17:00:00,27,1,28
"25056",10501,"Grand Falls-Windsor","NL",48.92696,-55.65966,2018-11-10 18:00:00,27,1,28
"25057",10501,"Grand Falls-Windsor","NL",48.92696,-55.65966,2018-11-10 19:00:00,27,1,28
"25058",10501,"Grand Falls-Windsor","NL",48.92696,-55.65966,2018-11-10 20:00:00,26,1,27
"25059",10501,"Grand Falls-Windsor","NL",48.92696,-55.65966,2018-11-10 21:00:00,25,1,26
"25060",10501,"Grand Falls-Windsor","NL",48.92696,-55.65966,2018-11-10 22:00:00,27,1,28
"25061",10501,"Grand Falls-Windsor","NL",48.92696,-55.65966,2018-11-10 23:00:00,29,1,30
"25062",10501,"Grand Falls-Windsor","NL",48.92696,-55.65966,2018-11-11 00:00:00,29,2,31
"25063",10501,"Grand Falls-Windsor","NL",48.92696,-55.65966,2018-11-11 01:00:00,29,2,31
"25064",10501,"Grand Falls-Windsor","NL",48.92696,-55.65966,2018-11-11 02:00:00,30,1,31
"25065",10501,"Grand Falls-Windsor","NL",48.92696,-55.65966,2018-11-11 03:00:00,33,1,34
"25066",10501,"Grand Falls-Windsor","NL",48.92696,-55.65966,2018-11-11 04:00:00,32,1,33
"25067",10501,"Grand Falls-Windsor","NL",48.92696,-55.65966,2018-11-11 05:00:00,29,1,30
"25068",10501,"Grand Falls-Windsor","NL",48.92696,-55.65966,2018-11-11 06:00:00,27,1,28
"25069",10501,"Grand Falls-Windsor","NL",48.92696,-55.65966,2018-11-11 07:00:00,30,1,31
"25070",10501,"Grand Falls-Windsor","NL",48.92696,-55.65966,2018-11-11 08:00:00,33,1,34
"25071",10501,"Grand Falls-Windsor","NL",48.92696,-55.65966,2018-11-11 09:00:00,31,1,32
"25072",10501,"Grand Falls-Windsor","NL",48.92696,-55.65966,2018-11-11 10:00:00,27,1,28
"25073",10501,"Grand Falls-Windsor","NL",48.92696,-55.65966,2018-11-11 11:00:00,23,1,24
"25074",10501,"Grand Falls-Windsor","NL",48.92696,-55.65966,2018-11-11 12:00:00,23,1,24
"25075",10501,"Grand Falls-Windsor","NL",48.92696,-55.65966,2018-11-11 13:00:00,23,1,24
"25076",10501,"Grand Falls-Windsor","NL",48.92696,-55.65966,2018-11-11 14:00:00,24,1,25
"25077",10501,"Grand Falls-Windsor","NL",48.92696,-55.65966,2018-11-11 15:00:00,25,1,26
"25078",10501,"Grand Falls-Windsor","NL",48.92696,-55.65966,2018-11-11 16:00:00,27,1,28
"25079",10501,"Grand Falls-Windsor","NL",48.92696,-55.65966,2018-11-11 17:00:00,28,1,29
"25080",10501,"Grand Falls-Windsor","NL",48.92696,-55.65966,2018-11-11 18:00:00,29,1,30
"25081",10501,"Grand Falls-Windsor","NL",48.92696,-55.65966,2018-11-11 19:00:00,29,1,30
"25082",10501,"Grand Falls-Windsor","NL",48.92696,-55.65966,2018-11-11 20:00:00,30,1,31
"25083",10501,"Grand Falls-Windsor","NL",48.92696,-55.65966,2018-11-11 21:00:00,31,1,32
"25084",10501,"Grand Falls-Windsor","NL",48.92696,-55.65966,2018-11-11 22:00:00,32,1,33
"25085",10501,"Grand Falls-Windsor","NL",48.92696,-55.65966,2018-11-11 23:00:00,32,1,33
"25086",10501,"Grand Falls-Windsor","NL",48.92696,-55.65966,2018-11-12 00:00:00,33,1,34
"25087",10501,"Grand Falls-Windsor","NL",48.92696,-55.65966,2018-11-12 01:00:00,33,1,34
"25088",10501,"Grand Falls-Windsor","NL",48.92696,-55.65966,2018-11-12 02:00:00,34,1,35
"25089",10501,"Grand Falls-Windsor","NL",48.92696,-55.65966,2018-11-12 03:00:00,34,0,34
"25090",10501,"Grand Falls-Windsor","NL",48.92696,-55.65966,2018-11-12 04:00:00,34,1,35
"25091",10501,"Grand Falls-Windsor","NL",48.92696,-55.65966,2018-11-12 05:00:00,34,1,35
"25092",10501,"Grand Falls-Windsor","NL",48.92696,-55.65966,2018-11-12 06:00:00,34,1,35
"25093",10501,"Grand Falls-Windsor","NL",48.92696,-55.65966,2018-11-12 07:00:00,34,1,35
"25094",10501,"Grand Falls-Windsor","NL",48.92696,-55.65966,2018-11-12 08:00:00,34,1,35
"25095",10501,"Grand Falls-Windsor","NL",48.92696,-55.65966,2018-11-12 09:00:00,36,1,37
"25096",10501,"Grand Falls-Windsor","NL",48.92696,-55.65966,2018-11-12 10:00:00,37,1,38
"25097",10501,"Grand Falls-Windsor","NL",48.92696,-55.65966,2018-11-12 11:00:00,38,1,39
"25098",10501,"Grand Falls-Windsor","NL",48.92696,-55.65966,2018-11-12 12:00:00,39,1,40
"25099",10501,"Grand Falls-Windsor","NL",48.92696,-55.65966,2018-11-12 13:00:00,40,1,41
"25100",10501,"Grand Falls-Windsor","NL",48.92696,-55.65966,2018-11-12 14:00:00,41,1,42
"25101",10501,"Grand Falls-Windsor","NL",48.92696,-55.65966,2018-11-12 15:00:00,39,1,40
"25102",10501,"Grand Falls-Windsor","NL",48.92696,-55.65966,2018-11-12 16:00:00,38,1,39
"25103",10501,"Grand Falls-Windsor","NL",48.92696,-55.65966,2018-11-12 17:00:00,37,1,38
"25104",10501,"Grand Falls-Windsor","NL",48.92696,-55.65966,2018-11-12 18:00:00,37,0,37
"25105",10501,"Grand Falls-Windsor","NL",48.92696,-55.65966,2018-11-12 19:00:00,37,1,38
"25106",10501,"Grand Falls-Windsor","NL",48.92696,-55.65966,2018-11-12 20:00:00,36,3,39
"25107",10501,"Grand Falls-Windsor","NL",48.92696,-55.65966,2018-11-12 21:00:00,36,1,37
"25108",10501,"Grand Falls-Windsor","NL",48.92696,-55.65966,2018-11-12 22:00:00,36,1,37
"25109",10501,"Grand Falls-Windsor","NL",48.92696,-55.65966,2018-11-12 23:00:00,35,1,36
"25110",10501,"Grand Falls-Windsor","NL",48.92696,-55.65966,2018-11-13 00:00:00,35,1,36
"25111",10501,"Grand Falls-Windsor","NL",48.92696,-55.65966,2018-11-13 01:00:00,35,1,36
"25112",10501,"Grand Falls-Windsor","NL",48.92696,-55.65966,2018-11-13 02:00:00,34,1,35
"25113",10501,"Grand Falls-Windsor","NL",48.92696,-55.65966,2018-11-13 03:00:00,34,0,34
"25114",10501,"Grand Falls-Windsor","NL",48.92696,-55.65966,2018-11-13 04:00:00,34,0,34
"25115",10501,"Grand Falls-Windsor","NL",48.92696,-55.65966,2018-11-13 05:00:00,34,1,35
"25116",10501,"Grand Falls-Windsor","NL",48.92696,-55.65966,2018-11-13 06:00:00,34,0,34
"25117",10501,"Grand Falls-Windsor","NL",48.92696,-55.65966,2018-11-13 07:00:00,34,1,35
"25118",10501,"Grand Falls-Windsor","NL",48.92696,-55.65966,2018-11-13 08:00:00,33,1,34
"25119",10501,"Grand Falls-Windsor","NL",48.92696,-55.65966,2018-11-13 09:00:00,33,2,35
"25120",10501,"Grand Falls-Windsor","NL",48.92696,-55.65966,2018-11-13 10:00:00,34,1,35
"25121",10501,"Grand Falls-Windsor","NL",48.92696,-55.65966,2018-11-13 11:00:00,35,1,36
"25122",10501,"Grand Falls-Windsor","NL",48.92696,-55.65966,2018-11-13 12:00:00,35,1,36
"25123",10501,"Grand Falls-Windsor","NL",48.92696,-55.65966,2018-11-13 13:00:00,35,1,36
"25124",10501,"Grand Falls-Windsor","NL",48.92696,-55.65966,2018-11-13 14:00:00,36,1,37
"25125",10501,"Grand Falls-Windsor","NL",48.92696,-55.65966,2018-11-13 15:00:00,35,1,36
"25126",10501,"Grand Falls-Windsor","NL",48.92696,-55.65966,2018-11-13 16:00:00,36,1,37
"25127",10501,"Grand Falls-Windsor","NL",48.92696,-55.65966,2018-11-13 17:00:00,35,1,36
"25128",10501,"Grand Falls-Windsor","NL",48.92696,-55.65966,2018-11-13 18:00:00,34,1,35
"25129",10501,"Grand Falls-Windsor","NL",48.92696,-55.65966,2018-11-13 19:00:00,34,1,35
"25130",10501,"Grand Falls-Windsor","NL",48.92696,-55.65966,2018-11-13 20:00:00,35,1,36
"25131",10501,"Grand Falls-Windsor","NL",48.92696,-55.65966,2018-11-13 21:00:00,34,1,35
"25132",10501,"Grand Falls-Windsor","NL",48.92696,-55.65966,2018-11-13 22:00:00,32,1,33
"25133",10501,"Grand Falls-Windsor","NL",48.92696,-55.65966,2018-11-13 23:00:00,32,1,33
"25134",10501,"Grand Falls-Windsor","NL",48.92696,-55.65966,2018-11-14 00:00:00,32,1,33
"25135",10501,"Grand Falls-Windsor","NL",48.92696,-55.65966,2018-11-14 01:00:00,31,1,32
"25136",10501,"Grand Falls-Windsor","NL",48.92696,-55.65966,2018-11-14 02:00:00,29,0,29
"25137",10501,"Grand Falls-Windsor","NL",48.92696,-55.65966,2018-11-14 03:00:00,30,1,31
"25138",10501,"Grand Falls-Windsor","NL",48.92696,-55.65966,2018-11-14 04:00:00,31,1,32
"25139",10501,"Grand Falls-Windsor","NL",48.92696,-55.65966,2018-11-14 05:00:00,32,1,33
"25140",10501,"Grand Falls-Windsor","NL",48.92696,-55.65966,2018-11-14 06:00:00,33,1,34
"25141",10501,"Grand Falls-Windsor","NL",48.92696,-55.65966,2018-11-14 07:00:00,31,5,36
"25142",10501,"Grand Falls-Windsor","NL",48.92696,-55.65966,2018-11-14 08:00:00,34,1,35
"25143",10501,"Grand Falls-Windsor","NL",48.92696,-55.65966,2018-11-14 09:00:00,36,1,37
"25144",10501,"Grand Falls-Windsor","NL",48.92696,-55.65966,2018-11-14 10:00:00,36,2,38
"25145",10501,"Grand Falls-Windsor","NL",48.92696,-55.65966,2018-11-14 11:00:00,37,1,38
"25146",10501,"Grand Falls-Windsor","NL",48.92696,-55.65966,2018-11-14 12:00:00,35,1,36
"25147",10501,"Grand Falls-Windsor","NL",48.92696,-55.65966,2018-11-14 13:00:00,32,1,33
"25148",10501,"Grand Falls-Windsor","NL",48.92696,-55.65966,2018-11-14 14:00:00,28,1,29
"25149",10501,"Grand Falls-Windsor","NL",48.92696,-55.65966,2018-11-14 15:00:00,30,1,31
"25150",10501,"Grand Falls-Windsor","NL",48.92696,-55.65966,2018-11-14 16:00:00,NA,NA,NA
"25151",10501,"Grand Falls-Windsor","NL",48.92696,-55.65966,2018-11-14 17:00:00,NA,NA,NA
"25152",10501,"Grand Falls-Windsor","NL",48.92696,-55.65966,2018-11-14 18:00:00,NA,NA,NA
"25153",10501,"Grand Falls-Windsor","NL",48.92696,-55.65966,2018-11-14 19:00:00,NA,NA,NA
"25154",10501,"Grand Falls-Windsor","NL",48.92696,-55.65966,2018-11-14 20:00:00,NA,NA,NA
"25155",10501,"Grand Falls-Windsor","NL",48.92696,-55.65966,2018-11-14 21:00:00,NA,NA,NA
"25156",10501,"Grand Falls-Windsor","NL",48.92696,-55.65966,2018-11-14 22:00:00,NA,NA,NA
"25157",10501,"Grand Falls-Windsor","NL",48.92696,-55.65966,2018-11-14 23:00:00,NA,NA,NA
"25158",10501,"Grand Falls-Windsor","NL",48.92696,-55.65966,2018-11-15 00:00:00,NA,NA,NA
"25159",10501,"Grand Falls-Windsor","NL",48.92696,-55.65966,2018-11-15 01:00:00,NA,NA,NA
"25160",10501,"Grand Falls-Windsor","NL",48.92696,-55.65966,2018-11-15 02:00:00,NA,NA,NA
"25161",10501,"Grand Falls-Windsor","NL",48.92696,-55.65966,2018-11-15 03:00:00,NA,NA,NA
"25162",10501,"Grand Falls-Windsor","NL",48.92696,-55.65966,2018-11-15 04:00:00,NA,NA,NA
"25163",10501,"Grand Falls-Windsor","NL",48.92696,-55.65966,2018-11-15 05:00:00,NA,NA,NA
"25164",10501,"Grand Falls-Windsor","NL",48.92696,-55.65966,2018-11-15 06:00:00,NA,NA,NA
"25165",10501,"Grand Falls-Windsor","NL",48.92696,-55.65966,2018-11-15 07:00:00,NA,NA,NA
"25166",10501,"Grand Falls-Windsor","NL",48.92696,-55.65966,2018-11-15 08:00:00,NA,NA,NA
"25167",10501,"Grand Falls-Windsor","NL",48.92696,-55.65966,2018-11-15 09:00:00,NA,NA,NA
"25168",10501,"Grand Falls-Windsor","NL",48.92696,-55.65966,2018-11-15 10:00:00,NA,NA,NA
"25169",10501,"Grand Falls-Windsor","NL",48.92696,-55.65966,2018-11-15 11:00:00,NA,NA,NA
"25170",10501,"Grand Falls-Windsor","NL",48.92696,-55.65966,2018-11-15 12:00:00,37,0,37
"25171",10501,"Grand Falls-Windsor","NL",48.92696,-55.65966,2018-11-15 13:00:00,38,1,39
"25172",10501,"Grand Falls-Windsor","NL",48.92696,-55.65966,2018-11-15 14:00:00,38,1,39
"25173",10501,"Grand Falls-Windsor","NL",48.92696,-55.65966,2018-11-15 15:00:00,38,1,39
"25174",10501,"Grand Falls-Windsor","NL",48.92696,-55.65966,2018-11-15 16:00:00,37,1,38
"25175",10501,"Grand Falls-Windsor","NL",48.92696,-55.65966,2018-11-15 17:00:00,38,1,39
"25176",10501,"Grand Falls-Windsor","NL",48.92696,-55.65966,2018-11-15 18:00:00,37,1,38
"25177",10501,"Grand Falls-Windsor","NL",48.92696,-55.65966,2018-11-15 19:00:00,38,1,39
"25178",10501,"Grand Falls-Windsor","NL",48.92696,-55.65966,2018-11-15 20:00:00,39,1,40
"25179",10501,"Grand Falls-Windsor","NL",48.92696,-55.65966,2018-11-15 21:00:00,40,1,41
"25180",10501,"Grand Falls-Windsor","NL",48.92696,-55.65966,2018-11-15 22:00:00,39,1,40
"25181",10501,"Grand Falls-Windsor","NL",48.92696,-55.65966,2018-11-15 23:00:00,39,1,40
"25182",10501,"Grand Falls-Windsor","NL",48.92696,-55.65966,2018-11-16 00:00:00,39,1,40
"25183",10501,"Grand Falls-Windsor","NL",48.92696,-55.65966,2018-11-16 01:00:00,38,1,39
"25184",10501,"Grand Falls-Windsor","NL",48.92696,-55.65966,2018-11-16 02:00:00,38,1,39
"25185",10501,"Grand Falls-Windsor","NL",48.92696,-55.65966,2018-11-16 03:00:00,39,1,40
"25186",10501,"Grand Falls-Windsor","NL",48.92696,-55.65966,2018-11-16 04:00:00,39,1,40
"25187",10501,"Grand Falls-Windsor","NL",48.92696,-55.65966,2018-11-16 05:00:00,38,1,39
"25188",10501,"Grand Falls-Windsor","NL",48.92696,-55.65966,2018-11-16 06:00:00,38,1,39
"25189",10501,"Grand Falls-Windsor","NL",48.92696,-55.65966,2018-11-16 07:00:00,37,1,38
"25190",10501,"Grand Falls-Windsor","NL",48.92696,-55.65966,2018-11-16 08:00:00,35,1,36
"25191",10501,"Grand Falls-Windsor","NL",48.92696,-55.65966,2018-11-16 09:00:00,34,1,35
"25192",10501,"Grand Falls-Windsor","NL",48.92696,-55.65966,2018-11-16 10:00:00,36,1,37
"25193",10501,"Grand Falls-Windsor","NL",48.92696,-55.65966,2018-11-16 11:00:00,36,1,37
"25194",10501,"Grand Falls-Windsor","NL",48.92696,-55.65966,2018-11-16 12:00:00,37,1,38
"25195",10501,"Grand Falls-Windsor","NL",48.92696,-55.65966,2018-11-16 13:00:00,38,1,39
"25196",10501,"Grand Falls-Windsor","NL",48.92696,-55.65966,2018-11-16 14:00:00,38,1,39
"25197",10501,"Grand Falls-Windsor","NL",48.92696,-55.65966,2018-11-16 15:00:00,38,1,39
"25198",10501,"Grand Falls-Windsor","NL",48.92696,-55.65966,2018-11-16 16:00:00,37,2,39
"25199",10501,"Grand Falls-Windsor","NL",48.92696,-55.65966,2018-11-16 17:00:00,36,2,38
"25200",10501,"Grand Falls-Windsor","NL",48.92696,-55.65966,2018-11-16 18:00:00,33,3,36
"25201",10501,"Grand Falls-Windsor","NL",48.92696,-55.65966,2018-11-16 19:00:00,33,2,35
"25202",10501,"Grand Falls-Windsor","NL",48.92696,-55.65966,2018-11-16 20:00:00,33,2,35
"25203",10501,"Grand Falls-Windsor","NL",48.92696,-55.65966,2018-11-16 21:00:00,33,2,35
"25204",10501,"Grand Falls-Windsor","NL",48.92696,-55.65966,2018-11-16 22:00:00,33,3,36
"25205",10501,"Grand Falls-Windsor","NL",48.92696,-55.65966,2018-11-16 23:00:00,34,1,35
"25206",10501,"Grand Falls-Windsor","NL",48.92696,-55.65966,2018-11-17 00:00:00,35,1,36
"25207",10501,"Grand Falls-Windsor","NL",48.92696,-55.65966,2018-11-17 01:00:00,35,1,36
"25208",10501,"Grand Falls-Windsor","NL",48.92696,-55.65966,2018-11-17 02:00:00,35,2,37
"25209",10501,"Grand Falls-Windsor","NL",48.92696,-55.65966,2018-11-17 03:00:00,35,1,36
"25210",10501,"Grand Falls-Windsor","NL",48.92696,-55.65966,2018-11-17 04:00:00,36,1,37
"25211",10501,"Grand Falls-Windsor","NL",48.92696,-55.65966,2018-11-17 05:00:00,37,1,38
"25212",10501,"Grand Falls-Windsor","NL",48.92696,-55.65966,2018-11-17 06:00:00,37,1,38
"25213",10501,"Grand Falls-Windsor","NL",48.92696,-55.65966,2018-11-17 07:00:00,39,2,41
"25214",10501,"Grand Falls-Windsor","NL",48.92696,-55.65966,2018-11-17 08:00:00,38,3,41
"25215",10501,"Grand Falls-Windsor","NL",48.92696,-55.65966,2018-11-17 09:00:00,39,2,41
"25216",10501,"Grand Falls-Windsor","NL",48.92696,-55.65966,2018-11-17 10:00:00,40,2,42
"25217",10501,"Grand Falls-Windsor","NL",48.92696,-55.65966,2018-11-17 11:00:00,40,1,41
"25218",10501,"Grand Falls-Windsor","NL",48.92696,-55.65966,2018-11-17 12:00:00,40,1,41
"25219",10501,"Grand Falls-Windsor","NL",48.92696,-55.65966,2018-11-17 13:00:00,42,1,43
"25220",10501,"Grand Falls-Windsor","NL",48.92696,-55.65966,2018-11-17 14:00:00,42,2,44
"25221",10501,"Grand Falls-Windsor","NL",48.92696,-55.65966,2018-11-17 15:00:00,41,1,42
"25222",10501,"Grand Falls-Windsor","NL",48.92696,-55.65966,2018-11-17 16:00:00,38,1,39
"25223",10501,"Grand Falls-Windsor","NL",48.92696,-55.65966,2018-11-17 17:00:00,36,1,37
"25224",10501,"Grand Falls-Windsor","NL",48.92696,-55.65966,2018-11-17 18:00:00,36,1,37
"25225",10501,"Grand Falls-Windsor","NL",48.92696,-55.65966,2018-11-17 19:00:00,36,1,37
"25226",10501,"Grand Falls-Windsor","NL",48.92696,-55.65966,2018-11-17 20:00:00,36,1,37
"25227",10501,"Grand Falls-Windsor","NL",48.92696,-55.65966,2018-11-17 21:00:00,35,1,36
"25228",10501,"Grand Falls-Windsor","NL",48.92696,-55.65966,2018-11-17 22:00:00,34,1,35
"25229",10501,"Grand Falls-Windsor","NL",48.92696,-55.65966,2018-11-17 23:00:00,32,1,33
"25230",10501,"Grand Falls-Windsor","NL",48.92696,-55.65966,2018-11-18 00:00:00,32,1,33
"25231",10501,"Grand Falls-Windsor","NL",48.92696,-55.65966,2018-11-18 01:00:00,31,0,31
"25232",10501,"Grand Falls-Windsor","NL",48.92696,-55.65966,2018-11-18 02:00:00,28,1,29
"25233",10501,"Grand Falls-Windsor","NL",48.92696,-55.65966,2018-11-18 03:00:00,30,1,31
"25234",10501,"Grand Falls-Windsor","NL",48.92696,-55.65966,2018-11-18 04:00:00,30,1,31
"25235",10501,"Grand Falls-Windsor","NL",48.92696,-55.65966,2018-11-18 05:00:00,33,2,35
"25236",10501,"Grand Falls-Windsor","NL",48.92696,-55.65966,2018-11-18 06:00:00,31,3,34
"25237",10501,"Grand Falls-Windsor","NL",48.92696,-55.65966,2018-11-18 07:00:00,29,3,32
"25238",10501,"Grand Falls-Windsor","NL",48.92696,-55.65966,2018-11-18 08:00:00,29,3,32
"25239",10501,"Grand Falls-Windsor","NL",48.92696,-55.65966,2018-11-18 09:00:00,26,5,31
"25240",10501,"Grand Falls-Windsor","NL",48.92696,-55.65966,2018-11-18 10:00:00,32,2,34
"25241",10501,"Grand Falls-Windsor","NL",48.92696,-55.65966,2018-11-18 11:00:00,34,1,35
"25242",10501,"Grand Falls-Windsor","NL",48.92696,-55.65966,2018-11-18 12:00:00,31,1,32
"25243",10501,"Grand Falls-Windsor","NL",48.92696,-55.65966,2018-11-18 13:00:00,29,5,34
"25244",10501,"Grand Falls-Windsor","NL",48.92696,-55.65966,2018-11-18 14:00:00,32,1,33
"25245",10501,"Grand Falls-Windsor","NL",48.92696,-55.65966,2018-11-18 15:00:00,32,1,33
"25246",10501,"Grand Falls-Windsor","NL",48.92696,-55.65966,2018-11-18 16:00:00,32,0,32
"25247",10501,"Grand Falls-Windsor","NL",48.92696,-55.65966,2018-11-18 17:00:00,32,1,33
"25248",10501,"Grand Falls-Windsor","NL",48.92696,-55.65966,2018-11-18 18:00:00,32,1,33
"25249",10501,"Grand Falls-Windsor","NL",48.92696,-55.65966,2018-11-18 19:00:00,32,1,33
"25250",10501,"Grand Falls-Windsor","NL",48.92696,-55.65966,2018-11-18 20:00:00,33,1,34
"25251",10501,"Grand Falls-Windsor","NL",48.92696,-55.65966,2018-11-18 21:00:00,35,1,36
"25252",10501,"Grand Falls-Windsor","NL",48.92696,-55.65966,2018-11-18 22:00:00,35,1,36
"25253",10501,"Grand Falls-Windsor","NL",48.92696,-55.65966,2018-11-18 23:00:00,36,1,37
"25254",10501,"Grand Falls-Windsor","NL",48.92696,-55.65966,2018-11-19 00:00:00,36,1,37
"25255",10501,"Grand Falls-Windsor","NL",48.92696,-55.65966,2018-11-19 01:00:00,31,1,32
"25256",10501,"Grand Falls-Windsor","NL",48.92696,-55.65966,2018-11-19 02:00:00,29,1,30
"25257",10501,"Grand Falls-Windsor","NL",48.92696,-55.65966,2018-11-19 03:00:00,29,1,30
"25258",10501,"Grand Falls-Windsor","NL",48.92696,-55.65966,2018-11-19 04:00:00,29,2,31
"25259",10501,"Grand Falls-Windsor","NL",48.92696,-55.65966,2018-11-19 05:00:00,27,2,29
"25260",10501,"Grand Falls-Windsor","NL",48.92696,-55.65966,2018-11-19 06:00:00,26,2,28
"25261",10501,"Grand Falls-Windsor","NL",48.92696,-55.65966,2018-11-19 07:00:00,26,4,30
"25262",10501,"Grand Falls-Windsor","NL",48.92696,-55.65966,2018-11-19 08:00:00,26,5,31
"25263",10501,"Grand Falls-Windsor","NL",48.92696,-55.65966,2018-11-19 09:00:00,25,5,30
"25264",10501,"Grand Falls-Windsor","NL",48.92696,-55.65966,2018-11-19 10:00:00,35,1,36
"25265",10501,"Grand Falls-Windsor","NL",48.92696,-55.65966,2018-11-19 11:00:00,37,1,38
"25266",10501,"Grand Falls-Windsor","NL",48.92696,-55.65966,2018-11-19 12:00:00,38,1,39
"25267",10501,"Grand Falls-Windsor","NL",48.92696,-55.65966,2018-11-19 13:00:00,39,1,40
"25268",10501,"Grand Falls-Windsor","NL",48.92696,-55.65966,2018-11-19 14:00:00,38,1,39
"25269",10501,"Grand Falls-Windsor","NL",48.92696,-55.65966,2018-11-19 15:00:00,38,1,39
"25270",10501,"Grand Falls-Windsor","NL",48.92696,-55.65966,2018-11-19 16:00:00,36,1,37
"25271",10501,"Grand Falls-Windsor","NL",48.92696,-55.65966,2018-11-19 17:00:00,37,1,38
"25272",10501,"Grand Falls-Windsor","NL",48.92696,-55.65966,2018-11-19 18:00:00,37,1,38
"25273",10501,"Grand Falls-Windsor","NL",48.92696,-55.65966,2018-11-19 19:00:00,38,1,39
"25274",10501,"Grand Falls-Windsor","NL",48.92696,-55.65966,2018-11-19 20:00:00,37,1,38
"25275",10501,"Grand Falls-Windsor","NL",48.92696,-55.65966,2018-11-19 21:00:00,36,1,37
"25276",10501,"Grand Falls-Windsor","NL",48.92696,-55.65966,2018-11-19 22:00:00,33,2,35
"25277",10501,"Grand Falls-Windsor","NL",48.92696,-55.65966,2018-11-19 23:00:00,31,2,33
"25278",10501,"Grand Falls-Windsor","NL",48.92696,-55.65966,2018-11-20 00:00:00,31,1,32
"25279",10501,"Grand Falls-Windsor","NL",48.92696,-55.65966,2018-11-20 01:00:00,32,1,33
"25280",10501,"Grand Falls-Windsor","NL",48.92696,-55.65966,2018-11-20 02:00:00,31,1,32
"25281",10501,"Grand Falls-Windsor","NL",48.92696,-55.65966,2018-11-20 03:00:00,31,1,32
"25282",10501,"Grand Falls-Windsor","NL",48.92696,-55.65966,2018-11-20 04:00:00,30,1,31
"25283",10501,"Grand Falls-Windsor","NL",48.92696,-55.65966,2018-11-20 05:00:00,29,2,31
"25284",10501,"Grand Falls-Windsor","NL",48.92696,-55.65966,2018-11-20 06:00:00,27,2,29
"25285",10501,"Grand Falls-Windsor","NL",48.92696,-55.65966,2018-11-20 07:00:00,23,3,26
"25286",10501,"Grand Falls-Windsor","NL",48.92696,-55.65966,2018-11-20 08:00:00,20,4,24
"25287",10501,"Grand Falls-Windsor","NL",48.92696,-55.65966,2018-11-20 09:00:00,20,5,25
"25288",10501,"Grand Falls-Windsor","NL",48.92696,-55.65966,2018-11-20 10:00:00,15,5,20
"25289",10501,"Grand Falls-Windsor","NL",48.92696,-55.65966,2018-11-20 11:00:00,18,3,21
"25290",10501,"Grand Falls-Windsor","NL",48.92696,-55.65966,2018-11-20 12:00:00,26,3,29
"25291",10501,"Grand Falls-Windsor","NL",48.92696,-55.65966,2018-11-20 13:00:00,28,18,46
"25292",10501,"Grand Falls-Windsor","NL",48.92696,-55.65966,2018-11-20 14:00:00,28,4,32
"25293",10501,"Grand Falls-Windsor","NL",48.92696,-55.65966,2018-11-20 15:00:00,25,6,31
"25294",10501,"Grand Falls-Windsor","NL",48.92696,-55.65966,2018-11-20 16:00:00,27,4,31
"25295",10501,"Grand Falls-Windsor","NL",48.92696,-55.65966,2018-11-20 17:00:00,27,4,31
"25296",10501,"Grand Falls-Windsor","NL",48.92696,-55.65966,2018-11-20 18:00:00,29,4,33
"25297",10501,"Grand Falls-Windsor","NL",48.92696,-55.65966,2018-11-20 19:00:00,30,3,33
"25298",10501,"Grand Falls-Windsor","NL",48.92696,-55.65966,2018-11-20 20:00:00,33,2,35
"25299",10501,"Grand Falls-Windsor","NL",48.92696,-55.65966,2018-11-20 21:00:00,33,2,35
"25300",10501,"Grand Falls-Windsor","NL",48.92696,-55.65966,2018-11-20 22:00:00,33,2,35
"25301",10501,"Grand Falls-Windsor","NL",48.92696,-55.65966,2018-11-20 23:00:00,33,2,35
"25302",10501,"Grand Falls-Windsor","NL",48.92696,-55.65966,2018-11-21 00:00:00,33,1,34
"25303",10501,"Grand Falls-Windsor","NL",48.92696,-55.65966,2018-11-21 01:00:00,32,1,33
"25304",10501,"Grand Falls-Windsor","NL",48.92696,-55.65966,2018-11-21 02:00:00,32,2,34
"25305",10501,"Grand Falls-Windsor","NL",48.92696,-55.65966,2018-11-21 03:00:00,33,2,35
"25306",10501,"Grand Falls-Windsor","NL",48.92696,-55.65966,2018-11-21 04:00:00,35,1,36
"25307",10501,"Grand Falls-Windsor","NL",48.92696,-55.65966,2018-11-21 05:00:00,34,2,36
"25308",10501,"Grand Falls-Windsor","NL",48.92696,-55.65966,2018-11-21 06:00:00,35,1,36
"25309",10501,"Grand Falls-Windsor","NL",48.92696,-55.65966,2018-11-21 07:00:00,34,2,36
"25310",10501,"Grand Falls-Windsor","NL",48.92696,-55.65966,2018-11-21 08:00:00,33,4,37
"25311",10501,"Grand Falls-Windsor","NL",48.92696,-55.65966,2018-11-21 09:00:00,33,3,36
"25312",10501,"Grand Falls-Windsor","NL",48.92696,-55.65966,2018-11-21 10:00:00,30,7,37
"25313",10501,"Grand Falls-Windsor","NL",48.92696,-55.65966,2018-11-21 11:00:00,30,6,36
"25314",10501,"Grand Falls-Windsor","NL",48.92696,-55.65966,2018-11-21 12:00:00,32,2,34
"25315",10501,"Grand Falls-Windsor","NL",48.92696,-55.65966,2018-11-21 13:00:00,32,2,34
"25316",10501,"Grand Falls-Windsor","NL",48.92696,-55.65966,2018-11-21 14:00:00,33,2,35
"25317",10501,"Grand Falls-Windsor","NL",48.92696,-55.65966,2018-11-21 15:00:00,30,2,32
"25318",10501,"Grand Falls-Windsor","NL",48.92696,-55.65966,2018-11-21 16:00:00,31,1,32
"25319",10501,"Grand Falls-Windsor","NL",48.92696,-55.65966,2018-11-21 17:00:00,34,1,35
"25320",10501,"Grand Falls-Windsor","NL",48.92696,-55.65966,2018-11-21 18:00:00,34,1,35
"25321",10501,"Grand Falls-Windsor","NL",48.92696,-55.65966,2018-11-21 19:00:00,35,1,36
"25322",10501,"Grand Falls-Windsor","NL",48.92696,-55.65966,2018-11-21 20:00:00,35,0,35
"25323",10501,"Grand Falls-Windsor","NL",48.92696,-55.65966,2018-11-21 21:00:00,36,1,37
"25324",10501,"Grand Falls-Windsor","NL",48.92696,-55.65966,2018-11-21 22:00:00,35,1,36
"25325",10501,"Grand Falls-Windsor","NL",48.92696,-55.65966,2018-11-21 23:00:00,35,1,36
"25326",10501,"Grand Falls-Windsor","NL",48.92696,-55.65966,2018-11-22 00:00:00,34,1,35
"25327",10501,"Grand Falls-Windsor","NL",48.92696,-55.65966,2018-11-22 01:00:00,34,1,35
"25328",10501,"Grand Falls-Windsor","NL",48.92696,-55.65966,2018-11-22 02:00:00,35,1,36
"25329",10501,"Grand Falls-Windsor","NL",48.92696,-55.65966,2018-11-22 03:00:00,34,0,34
"25330",10501,"Grand Falls-Windsor","NL",48.92696,-55.65966,2018-11-22 04:00:00,34,1,35
"25331",10501,"Grand Falls-Windsor","NL",48.92696,-55.65966,2018-11-22 05:00:00,33,0,33
"25332",10501,"Grand Falls-Windsor","NL",48.92696,-55.65966,2018-11-22 06:00:00,30,1,31
"25333",10501,"Grand Falls-Windsor","NL",48.92696,-55.65966,2018-11-22 07:00:00,30,1,31
"25334",10501,"Grand Falls-Windsor","NL",48.92696,-55.65966,2018-11-22 08:00:00,29,2,31
"25335",10501,"Grand Falls-Windsor","NL",48.92696,-55.65966,2018-11-22 09:00:00,30,2,32
"25336",10501,"Grand Falls-Windsor","NL",48.92696,-55.65966,2018-11-22 10:00:00,31,1,32
"25337",10501,"Grand Falls-Windsor","NL",48.92696,-55.65966,2018-11-22 11:00:00,31,1,32
"25338",10501,"Grand Falls-Windsor","NL",48.92696,-55.65966,2018-11-22 12:00:00,32,1,33
"25339",10501,"Grand Falls-Windsor","NL",48.92696,-55.65966,2018-11-22 13:00:00,34,1,35
"25340",10501,"Grand Falls-Windsor","NL",48.92696,-55.65966,2018-11-22 14:00:00,38,1,39
"25341",10501,"Grand Falls-Windsor","NL",48.92696,-55.65966,2018-11-22 15:00:00,37,1,38
"25342",10501,"Grand Falls-Windsor","NL",48.92696,-55.65966,2018-11-22 16:00:00,36,1,37
"25343",10501,"Grand Falls-Windsor","NL",48.92696,-55.65966,2018-11-22 17:00:00,35,1,36
"25344",10501,"Grand Falls-Windsor","NL",48.92696,-55.65966,2018-11-22 18:00:00,34,1,35
"25345",10501,"Grand Falls-Windsor","NL",48.92696,-55.65966,2018-11-22 19:00:00,33,1,34
"25346",10501,"Grand Falls-Windsor","NL",48.92696,-55.65966,2018-11-22 20:00:00,34,1,35
"25347",10501,"Grand Falls-Windsor","NL",48.92696,-55.65966,2018-11-22 21:00:00,35,1,36
"25348",10501,"Grand Falls-Windsor","NL",48.92696,-55.65966,2018-11-22 22:00:00,35,1,36
"25349",10501,"Grand Falls-Windsor","NL",48.92696,-55.65966,2018-11-22 23:00:00,35,1,36
"25350",10501,"Grand Falls-Windsor","NL",48.92696,-55.65966,2018-11-23 00:00:00,33,1,34
"25351",10501,"Grand Falls-Windsor","NL",48.92696,-55.65966,2018-11-23 01:00:00,32,1,33
"25352",10501,"Grand Falls-Windsor","NL",48.92696,-55.65966,2018-11-23 02:00:00,28,2,30
"25353",10501,"Grand Falls-Windsor","NL",48.92696,-55.65966,2018-11-23 03:00:00,29,1,30
"25354",10501,"Grand Falls-Windsor","NL",48.92696,-55.65966,2018-11-23 04:00:00,27,1,28
"25355",10501,"Grand Falls-Windsor","NL",48.92696,-55.65966,2018-11-23 05:00:00,32,1,33
"25356",10501,"Grand Falls-Windsor","NL",48.92696,-55.65966,2018-11-23 06:00:00,32,0,32
"25357",10501,"Grand Falls-Windsor","NL",48.92696,-55.65966,2018-11-23 07:00:00,33,1,34
"25358",10501,"Grand Falls-Windsor","NL",48.92696,-55.65966,2018-11-23 08:00:00,34,1,35
"25359",10501,"Grand Falls-Windsor","NL",48.92696,-55.65966,2018-11-23 09:00:00,35,1,36
"25360",10501,"Grand Falls-Windsor","NL",48.92696,-55.65966,2018-11-23 10:00:00,36,1,37
"25361",10501,"Grand Falls-Windsor","NL",48.92696,-55.65966,2018-11-23 11:00:00,35,2,37
"25362",10501,"Grand Falls-Windsor","NL",48.92696,-55.65966,2018-11-23 12:00:00,36,1,37
"25363",10501,"Grand Falls-Windsor","NL",48.92696,-55.65966,2018-11-23 13:00:00,36,1,37
"25364",10501,"Grand Falls-Windsor","NL",48.92696,-55.65966,2018-11-23 14:00:00,36,1,37
"25365",10501,"Grand Falls-Windsor","NL",48.92696,-55.65966,2018-11-23 15:00:00,36,1,37
"25366",10501,"Grand Falls-Windsor","NL",48.92696,-55.65966,2018-11-23 16:00:00,37,1,38
"25367",10501,"Grand Falls-Windsor","NL",48.92696,-55.65966,2018-11-23 17:00:00,36,1,37
"25368",10501,"Grand Falls-Windsor","NL",48.92696,-55.65966,2018-11-23 18:00:00,36,1,37
"25369",10501,"Grand Falls-Windsor","NL",48.92696,-55.65966,2018-11-23 19:00:00,36,1,37
"25370",10501,"Grand Falls-Windsor","NL",48.92696,-55.65966,2018-11-23 20:00:00,35,1,36
"25371",10501,"Grand Falls-Windsor","NL",48.92696,-55.65966,2018-11-23 21:00:00,35,1,36
"25372",10501,"Grand Falls-Windsor","NL",48.92696,-55.65966,2018-11-23 22:00:00,35,1,36
"25373",10501,"Grand Falls-Windsor","NL",48.92696,-55.65966,2018-11-23 23:00:00,35,1,36
"25374",10501,"Grand Falls-Windsor","NL",48.92696,-55.65966,2018-11-24 00:00:00,35,0,35
"25375",10501,"Grand Falls-Windsor","NL",48.92696,-55.65966,2018-11-24 01:00:00,36,1,37
"25376",10501,"Grand Falls-Windsor","NL",48.92696,-55.65966,2018-11-24 02:00:00,36,1,37
"25377",10501,"Grand Falls-Windsor","NL",48.92696,-55.65966,2018-11-24 03:00:00,38,1,39
"25378",10501,"Grand Falls-Windsor","NL",48.92696,-55.65966,2018-11-24 04:00:00,40,1,41
"25379",10501,"Grand Falls-Windsor","NL",48.92696,-55.65966,2018-11-24 05:00:00,40,1,41
"25380",10501,"Grand Falls-Windsor","NL",48.92696,-55.65966,2018-11-24 06:00:00,40,1,41
"25381",10501,"Grand Falls-Windsor","NL",48.92696,-55.65966,2018-11-24 07:00:00,40,1,41
"25382",10501,"Grand Falls-Windsor","NL",48.92696,-55.65966,2018-11-24 08:00:00,39,1,40
"25383",10501,"Grand Falls-Windsor","NL",48.92696,-55.65966,2018-11-24 09:00:00,38,1,39
"25384",10501,"Grand Falls-Windsor","NL",48.92696,-55.65966,2018-11-24 10:00:00,38,1,39
"25385",10501,"Grand Falls-Windsor","NL",48.92696,-55.65966,2018-11-24 11:00:00,34,4,38
"25386",10501,"Grand Falls-Windsor","NL",48.92696,-55.65966,2018-11-24 12:00:00,37,1,38
"25387",10501,"Grand Falls-Windsor","NL",48.92696,-55.65966,2018-11-24 13:00:00,36,1,37
"25388",10501,"Grand Falls-Windsor","NL",48.92696,-55.65966,2018-11-24 14:00:00,36,1,37
"25389",10501,"Grand Falls-Windsor","NL",48.92696,-55.65966,2018-11-24 15:00:00,36,1,37
"25390",10501,"Grand Falls-Windsor","NL",48.92696,-55.65966,2018-11-24 16:00:00,36,1,37
"25391",10501,"Grand Falls-Windsor","NL",48.92696,-55.65966,2018-11-24 17:00:00,36,1,37
"25392",10501,"Grand Falls-Windsor","NL",48.92696,-55.65966,2018-11-24 18:00:00,36,1,37
"25393",10501,"Grand Falls-Windsor","NL",48.92696,-55.65966,2018-11-24 19:00:00,36,1,37
"25394",10501,"Grand Falls-Windsor","NL",48.92696,-55.65966,2018-11-24 20:00:00,36,1,37
"25395",10501,"Grand Falls-Windsor","NL",48.92696,-55.65966,2018-11-24 21:00:00,36,1,37
"25396",10501,"Grand Falls-Windsor","NL",48.92696,-55.65966,2018-11-24 22:00:00,35,1,36
"25397",10501,"Grand Falls-Windsor","NL",48.92696,-55.65966,2018-11-24 23:00:00,35,1,36
"25398",10501,"Grand Falls-Windsor","NL",48.92696,-55.65966,2018-11-25 00:00:00,35,1,36
"25399",10501,"Grand Falls-Windsor","NL",48.92696,-55.65966,2018-11-25 01:00:00,35,0,35
"25400",10501,"Grand Falls-Windsor","NL",48.92696,-55.65966,2018-11-25 02:00:00,35,1,36
"25401",10501,"Grand Falls-Windsor","NL",48.92696,-55.65966,2018-11-25 03:00:00,34,0,34
"25402",10501,"Grand Falls-Windsor","NL",48.92696,-55.65966,2018-11-25 04:00:00,34,0,34
"25403",10501,"Grand Falls-Windsor","NL",48.92696,-55.65966,2018-11-25 05:00:00,34,1,35
"25404",10501,"Grand Falls-Windsor","NL",48.92696,-55.65966,2018-11-25 06:00:00,34,1,35
"25405",10501,"Grand Falls-Windsor","NL",48.92696,-55.65966,2018-11-25 07:00:00,34,0,34
"25406",10501,"Grand Falls-Windsor","NL",48.92696,-55.65966,2018-11-25 08:00:00,34,1,35
"25407",10501,"Grand Falls-Windsor","NL",48.92696,-55.65966,2018-11-25 09:00:00,34,1,35
"25408",10501,"Grand Falls-Windsor","NL",48.92696,-55.65966,2018-11-25 10:00:00,35,0,35
"25409",10501,"Grand Falls-Windsor","NL",48.92696,-55.65966,2018-11-25 11:00:00,35,1,36
"25410",10501,"Grand Falls-Windsor","NL",48.92696,-55.65966,2018-11-25 12:00:00,36,1,37
"25411",10501,"Grand Falls-Windsor","NL",48.92696,-55.65966,2018-11-25 13:00:00,37,1,38
"25412",10501,"Grand Falls-Windsor","NL",48.92696,-55.65966,2018-11-25 14:00:00,36,3,39
"25413",10501,"Grand Falls-Windsor","NL",48.92696,-55.65966,2018-11-25 15:00:00,36,1,37
"25414",10501,"Grand Falls-Windsor","NL",48.92696,-55.65966,2018-11-25 16:00:00,36,1,37
"25415",10501,"Grand Falls-Windsor","NL",48.92696,-55.65966,2018-11-25 17:00:00,36,1,37
"25416",10501,"Grand Falls-Windsor","NL",48.92696,-55.65966,2018-11-25 18:00:00,36,1,37
"25417",10501,"Grand Falls-Windsor","NL",48.92696,-55.65966,2018-11-25 19:00:00,36,1,37
"25418",10501,"Grand Falls-Windsor","NL",48.92696,-55.65966,2018-11-25 20:00:00,38,1,39
"25419",10501,"Grand Falls-Windsor","NL",48.92696,-55.65966,2018-11-25 21:00:00,38,1,39
"25420",10501,"Grand Falls-Windsor","NL",48.92696,-55.65966,2018-11-25 22:00:00,37,1,38
"25421",10501,"Grand Falls-Windsor","NL",48.92696,-55.65966,2018-11-25 23:00:00,36,1,37
"25422",10501,"Grand Falls-Windsor","NL",48.92696,-55.65966,2018-11-26 00:00:00,35,1,36
"25423",10501,"Grand Falls-Windsor","NL",48.92696,-55.65966,2018-11-26 01:00:00,34,1,35
"25424",10501,"Grand Falls-Windsor","NL",48.92696,-55.65966,2018-11-26 02:00:00,33,1,34
"25425",10501,"Grand Falls-Windsor","NL",48.92696,-55.65966,2018-11-26 03:00:00,35,1,36
"25426",10501,"Grand Falls-Windsor","NL",48.92696,-55.65966,2018-11-26 04:00:00,36,1,37
"25427",10501,"Grand Falls-Windsor","NL",48.92696,-55.65966,2018-11-26 05:00:00,36,1,37
"25428",10501,"Grand Falls-Windsor","NL",48.92696,-55.65966,2018-11-26 06:00:00,37,1,38
"25429",10501,"Grand Falls-Windsor","NL",48.92696,-55.65966,2018-11-26 07:00:00,36,2,38
"25430",10501,"Grand Falls-Windsor","NL",48.92696,-55.65966,2018-11-26 08:00:00,36,3,39
"25431",10501,"Grand Falls-Windsor","NL",48.92696,-55.65966,2018-11-26 09:00:00,35,3,38
"25432",10501,"Grand Falls-Windsor","NL",48.92696,-55.65966,2018-11-26 10:00:00,37,3,40
"25433",10501,"Grand Falls-Windsor","NL",48.92696,-55.65966,2018-11-26 11:00:00,38,2,40
"25434",10501,"Grand Falls-Windsor","NL",48.92696,-55.65966,2018-11-26 12:00:00,37,3,40
"25435",10501,"Grand Falls-Windsor","NL",48.92696,-55.65966,2018-11-26 13:00:00,37,3,40
"25436",10501,"Grand Falls-Windsor","NL",48.92696,-55.65966,2018-11-26 14:00:00,36,3,39
"25437",10501,"Grand Falls-Windsor","NL",48.92696,-55.65966,2018-11-26 15:00:00,37,2,39
"25438",10501,"Grand Falls-Windsor","NL",48.92696,-55.65966,2018-11-26 16:00:00,35,3,38
"25439",10501,"Grand Falls-Windsor","NL",48.92696,-55.65966,2018-11-26 17:00:00,34,3,37
"25440",10501,"Grand Falls-Windsor","NL",48.92696,-55.65966,2018-11-26 18:00:00,33,2,35
"25441",10501,"Grand Falls-Windsor","NL",48.92696,-55.65966,2018-11-26 19:00:00,34,2,36
"25442",10501,"Grand Falls-Windsor","NL",48.92696,-55.65966,2018-11-26 20:00:00,34,2,36
"25443",10501,"Grand Falls-Windsor","NL",48.92696,-55.65966,2018-11-26 21:00:00,34,2,36
"25444",10501,"Grand Falls-Windsor","NL",48.92696,-55.65966,2018-11-26 22:00:00,33,2,35
"25445",10501,"Grand Falls-Windsor","NL",48.92696,-55.65966,2018-11-26 23:00:00,33,2,35
"25446",10501,"Grand Falls-Windsor","NL",48.92696,-55.65966,2018-11-27 00:00:00,34,1,35
"25447",10501,"Grand Falls-Windsor","NL",48.92696,-55.65966,2018-11-27 01:00:00,34,2,36
"25448",10501,"Grand Falls-Windsor","NL",48.92696,-55.65966,2018-11-27 02:00:00,35,1,36
"25449",10501,"Grand Falls-Windsor","NL",48.92696,-55.65966,2018-11-27 03:00:00,35,1,36
"25450",10501,"Grand Falls-Windsor","NL",48.92696,-55.65966,2018-11-27 04:00:00,35,1,36
"25451",10501,"Grand Falls-Windsor","NL",48.92696,-55.65966,2018-11-27 05:00:00,35,1,36
"25452",10501,"Grand Falls-Windsor","NL",48.92696,-55.65966,2018-11-27 06:00:00,34,1,35
"25453",10501,"Grand Falls-Windsor","NL",48.92696,-55.65966,2018-11-27 07:00:00,33,2,35
"25454",10501,"Grand Falls-Windsor","NL",48.92696,-55.65966,2018-11-27 08:00:00,33,3,36
"25455",10501,"Grand Falls-Windsor","NL",48.92696,-55.65966,2018-11-27 09:00:00,31,6,37
"25456",10501,"Grand Falls-Windsor","NL",48.92696,-55.65966,2018-11-27 10:00:00,34,2,36
"25457",10501,"Grand Falls-Windsor","NL",48.92696,-55.65966,2018-11-27 11:00:00,35,2,37
"25458",10501,"Grand Falls-Windsor","NL",48.92696,-55.65966,2018-11-27 12:00:00,35,2,37
"25459",10501,"Grand Falls-Windsor","NL",48.92696,-55.65966,2018-11-27 13:00:00,34,2,36
"25460",10501,"Grand Falls-Windsor","NL",48.92696,-55.65966,2018-11-27 14:00:00,34,2,36
"25461",10501,"Grand Falls-Windsor","NL",48.92696,-55.65966,2018-11-27 15:00:00,33,3,36
"25462",10501,"Grand Falls-Windsor","NL",48.92696,-55.65966,2018-11-27 16:00:00,31,4,35
"25463",10501,"Grand Falls-Windsor","NL",48.92696,-55.65966,2018-11-27 17:00:00,32,3,35
"25464",10501,"Grand Falls-Windsor","NL",48.92696,-55.65966,2018-11-27 18:00:00,30,3,33
"25465",10501,"Grand Falls-Windsor","NL",48.92696,-55.65966,2018-11-27 19:00:00,29,4,33
"25466",10501,"Grand Falls-Windsor","NL",48.92696,-55.65966,2018-11-27 20:00:00,31,2,33
"25467",10501,"Grand Falls-Windsor","NL",48.92696,-55.65966,2018-11-27 21:00:00,31,2,33
"25468",10501,"Grand Falls-Windsor","NL",48.92696,-55.65966,2018-11-27 22:00:00,30,3,33
"25469",10501,"Grand Falls-Windsor","NL",48.92696,-55.65966,2018-11-27 23:00:00,31,2,33
"25470",10501,"Grand Falls-Windsor","NL",48.92696,-55.65966,2018-11-28 00:00:00,29,2,31
"25471",10501,"Grand Falls-Windsor","NL",48.92696,-55.65966,2018-11-28 01:00:00,31,1,32
"25472",10501,"Grand Falls-Windsor","NL",48.92696,-55.65966,2018-11-28 02:00:00,31,2,33
"25473",10501,"Grand Falls-Windsor","NL",48.92696,-55.65966,2018-11-28 03:00:00,30,2,32
"25474",10501,"Grand Falls-Windsor","NL",48.92696,-55.65966,2018-11-28 04:00:00,30,2,32
"25475",10501,"Grand Falls-Windsor","NL",48.92696,-55.65966,2018-11-28 05:00:00,30,2,32
"25476",10501,"Grand Falls-Windsor","NL",48.92696,-55.65966,2018-11-28 06:00:00,29,2,31
"25477",10501,"Grand Falls-Windsor","NL",48.92696,-55.65966,2018-11-28 07:00:00,29,3,32
"25478",10501,"Grand Falls-Windsor","NL",48.92696,-55.65966,2018-11-28 08:00:00,30,2,32
"25479",10501,"Grand Falls-Windsor","NL",48.92696,-55.65966,2018-11-28 09:00:00,30,2,32
"25480",10501,"Grand Falls-Windsor","NL",48.92696,-55.65966,2018-11-28 10:00:00,30,2,32
"25481",10501,"Grand Falls-Windsor","NL",48.92696,-55.65966,2018-11-28 11:00:00,31,2,33
"25482",10501,"Grand Falls-Windsor","NL",48.92696,-55.65966,2018-11-28 12:00:00,32,3,35
"25483",10501,"Grand Falls-Windsor","NL",48.92696,-55.65966,2018-11-28 13:00:00,33,2,35
"25484",10501,"Grand Falls-Windsor","NL",48.92696,-55.65966,2018-11-28 14:00:00,32,3,35
"25485",10501,"Grand Falls-Windsor","NL",48.92696,-55.65966,2018-11-28 15:00:00,32,3,35
"25486",10501,"Grand Falls-Windsor","NL",48.92696,-55.65966,2018-11-28 16:00:00,33,2,35
"25487",10501,"Grand Falls-Windsor","NL",48.92696,-55.65966,2018-11-28 17:00:00,35,2,37
"25488",10501,"Grand Falls-Windsor","NL",48.92696,-55.65966,2018-11-28 18:00:00,36,2,38
"25489",10501,"Grand Falls-Windsor","NL",48.92696,-55.65966,2018-11-28 19:00:00,35,2,37
"25490",10501,"Grand Falls-Windsor","NL",48.92696,-55.65966,2018-11-28 20:00:00,36,2,38
"25491",10501,"Grand Falls-Windsor","NL",48.92696,-55.65966,2018-11-28 21:00:00,36,2,38
"25492",10501,"Grand Falls-Windsor","NL",48.92696,-55.65966,2018-11-28 22:00:00,36,2,38
"25493",10501,"Grand Falls-Windsor","NL",48.92696,-55.65966,2018-11-28 23:00:00,37,1,38
"25494",10501,"Grand Falls-Windsor","NL",48.92696,-55.65966,2018-11-29 00:00:00,38,1,39
"25495",10501,"Grand Falls-Windsor","NL",48.92696,-55.65966,2018-11-29 01:00:00,39,1,40
"25496",10501,"Grand Falls-Windsor","NL",48.92696,-55.65966,2018-11-29 02:00:00,40,1,41
"25497",10501,"Grand Falls-Windsor","NL",48.92696,-55.65966,2018-11-29 03:00:00,39,1,40
"25498",10501,"Grand Falls-Windsor","NL",48.92696,-55.65966,2018-11-29 04:00:00,40,1,41
"25499",10501,"Grand Falls-Windsor","NL",48.92696,-55.65966,2018-11-29 05:00:00,39,1,40
"25500",10501,"Grand Falls-Windsor","NL",48.92696,-55.65966,2018-11-29 06:00:00,40,1,41
"25501",10501,"Grand Falls-Windsor","NL",48.92696,-55.65966,2018-11-29 07:00:00,40,1,41
"25502",10501,"Grand Falls-Windsor","NL",48.92696,-55.65966,2018-11-29 08:00:00,40,2,42
"25503",10501,"Grand Falls-Windsor","NL",48.92696,-55.65966,2018-11-29 09:00:00,40,2,42
"25504",10501,"Grand Falls-Windsor","NL",48.92696,-55.65966,2018-11-29 10:00:00,39,2,41
"25505",10501,"Grand Falls-Windsor","NL",48.92696,-55.65966,2018-11-29 11:00:00,39,2,41
"25506",10501,"Grand Falls-Windsor","NL",48.92696,-55.65966,2018-11-29 12:00:00,39,2,41
"25507",10501,"Grand Falls-Windsor","NL",48.92696,-55.65966,2018-11-29 13:00:00,36,14,50
"25508",10501,"Grand Falls-Windsor","NL",48.92696,-55.65966,2018-11-29 14:00:00,40,3,43
"25509",10501,"Grand Falls-Windsor","NL",48.92696,-55.65966,2018-11-29 15:00:00,40,2,42
"25510",10501,"Grand Falls-Windsor","NL",48.92696,-55.65966,2018-11-29 16:00:00,40,1,41
"25511",10501,"Grand Falls-Windsor","NL",48.92696,-55.65966,2018-11-29 17:00:00,39,5,44
"25512",10501,"Grand Falls-Windsor","NL",48.92696,-55.65966,2018-11-29 18:00:00,41,2,43
"25513",10501,"Grand Falls-Windsor","NL",48.92696,-55.65966,2018-11-29 19:00:00,41,1,42
"25514",10501,"Grand Falls-Windsor","NL",48.92696,-55.65966,2018-11-29 20:00:00,41,1,42
"25515",10501,"Grand Falls-Windsor","NL",48.92696,-55.65966,2018-11-29 21:00:00,41,2,43
"25516",10501,"Grand Falls-Windsor","NL",48.92696,-55.65966,2018-11-29 22:00:00,41,2,43
"25517",10501,"Grand Falls-Windsor","NL",48.92696,-55.65966,2018-11-29 23:00:00,42,1,43
"25518",10501,"Grand Falls-Windsor","NL",48.92696,-55.65966,2018-11-30 00:00:00,41,1,42
"25519",10501,"Grand Falls-Windsor","NL",48.92696,-55.65966,2018-11-30 01:00:00,41,2,43
"25520",10501,"Grand Falls-Windsor","NL",48.92696,-55.65966,2018-11-30 02:00:00,41,1,42
"25521",10501,"Grand Falls-Windsor","NL",48.92696,-55.65966,2018-11-30 03:00:00,40,1,41
"25522",10501,"Grand Falls-Windsor","NL",48.92696,-55.65966,2018-11-30 04:00:00,40,1,41
"25523",10501,"Grand Falls-Windsor","NL",48.92696,-55.65966,2018-11-30 05:00:00,40,1,41
"25524",10501,"Grand Falls-Windsor","NL",48.92696,-55.65966,2018-11-30 06:00:00,39,2,41
"25525",10501,"Grand Falls-Windsor","NL",48.92696,-55.65966,2018-11-30 07:00:00,39,2,41
"25526",10501,"Grand Falls-Windsor","NL",48.92696,-55.65966,2018-11-30 08:00:00,39,2,41
"25527",10501,"Grand Falls-Windsor","NL",48.92696,-55.65966,2018-11-30 09:00:00,39,2,41
"25528",10501,"Grand Falls-Windsor","NL",48.92696,-55.65966,2018-11-30 10:00:00,39,2,41
"25529",10501,"Grand Falls-Windsor","NL",48.92696,-55.65966,2018-11-30 11:00:00,37,6,43
"25530",10501,"Grand Falls-Windsor","NL",48.92696,-55.65966,2018-11-30 12:00:00,38,3,41
"25531",10501,"Grand Falls-Windsor","NL",48.92696,-55.65966,2018-11-30 13:00:00,39,1,40
"25532",10501,"Grand Falls-Windsor","NL",48.92696,-55.65966,2018-11-30 14:00:00,40,1,41
"25533",10501,"Grand Falls-Windsor","NL",48.92696,-55.65966,2018-11-30 15:00:00,41,2,43
"25534",10501,"Grand Falls-Windsor","NL",48.92696,-55.65966,2018-11-30 16:00:00,41,1,42
"25535",10501,"Grand Falls-Windsor","NL",48.92696,-55.65966,2018-11-30 17:00:00,41,1,42
"25536",10501,"Grand Falls-Windsor","NL",48.92696,-55.65966,2018-11-30 18:00:00,40,1,41
"25537",10501,"Grand Falls-Windsor","NL",48.92696,-55.65966,2018-11-30 19:00:00,40,1,41
"25538",10501,"Grand Falls-Windsor","NL",48.92696,-55.65966,2018-11-30 20:00:00,40,1,41
"25539",10501,"Grand Falls-Windsor","NL",48.92696,-55.65966,2018-11-30 21:00:00,40,1,41
"25540",10501,"Grand Falls-Windsor","NL",48.92696,-55.65966,2018-11-30 22:00:00,41,1,42
"25541",10501,"Grand Falls-Windsor","NL",48.92696,-55.65966,2018-11-30 23:00:00,41,1,42
"25542",10501,"Grand Falls-Windsor","NL",48.92696,-55.65966,2018-12-01 00:00:00,41,2,43
"25543",10501,"Grand Falls-Windsor","NL",48.92696,-55.65966,2018-12-01 01:00:00,40,3,43
"25544",10501,"Grand Falls-Windsor","NL",48.92696,-55.65966,2018-12-01 02:00:00,41,1,42
"25545",10501,"Grand Falls-Windsor","NL",48.92696,-55.65966,2018-12-01 03:00:00,42,1,43
"25546",10501,"Grand Falls-Windsor","NL",48.92696,-55.65966,2018-12-01 04:00:00,41,1,42
"25547",10501,"Grand Falls-Windsor","NL",48.92696,-55.65966,2018-12-01 05:00:00,41,1,42
"25548",10501,"Grand Falls-Windsor","NL",48.92696,-55.65966,2018-12-01 06:00:00,41,1,42
"25549",10501,"Grand Falls-Windsor","NL",48.92696,-55.65966,2018-12-01 07:00:00,41,1,42
"25550",10501,"Grand Falls-Windsor","NL",48.92696,-55.65966,2018-12-01 08:00:00,40,1,41
"25551",10501,"Grand Falls-Windsor","NL",48.92696,-55.65966,2018-12-01 09:00:00,40,1,41
"25552",10501,"Grand Falls-Windsor","NL",48.92696,-55.65966,2018-12-01 10:00:00,39,2,41
"25553",10501,"Grand Falls-Windsor","NL",48.92696,-55.65966,2018-12-01 11:00:00,39,2,41
"25554",10501,"Grand Falls-Windsor","NL",48.92696,-55.65966,2018-12-01 12:00:00,38,3,41
"25555",10501,"Grand Falls-Windsor","NL",48.92696,-55.65966,2018-12-01 13:00:00,40,2,42
"25556",10501,"Grand Falls-Windsor","NL",48.92696,-55.65966,2018-12-01 14:00:00,41,2,43
"25557",10501,"Grand Falls-Windsor","NL",48.92696,-55.65966,2018-12-01 15:00:00,40,2,42
"25558",10501,"Grand Falls-Windsor","NL",48.92696,-55.65966,2018-12-01 16:00:00,39,2,41
"25559",10501,"Grand Falls-Windsor","NL",48.92696,-55.65966,2018-12-01 17:00:00,39,3,42
"25560",10501,"Grand Falls-Windsor","NL",48.92696,-55.65966,2018-12-01 18:00:00,40,2,42
"25561",10501,"Grand Falls-Windsor","NL",48.92696,-55.65966,2018-12-01 19:00:00,37,3,40
"25562",10501,"Grand Falls-Windsor","NL",48.92696,-55.65966,2018-12-01 20:00:00,38,2,40
"25563",10501,"Grand Falls-Windsor","NL",48.92696,-55.65966,2018-12-01 21:00:00,38,2,40
"25564",10501,"Grand Falls-Windsor","NL",48.92696,-55.65966,2018-12-01 22:00:00,37,3,40
"25565",10501,"Grand Falls-Windsor","NL",48.92696,-55.65966,2018-12-01 23:00:00,35,1,36
"25566",10501,"Grand Falls-Windsor","NL",48.92696,-55.65966,2018-12-02 00:00:00,37,1,38
"25567",10501,"Grand Falls-Windsor","NL",48.92696,-55.65966,2018-12-02 01:00:00,33,1,34
"25568",10501,"Grand Falls-Windsor","NL",48.92696,-55.65966,2018-12-02 02:00:00,33,1,34
"25569",10501,"Grand Falls-Windsor","NL",48.92696,-55.65966,2018-12-02 03:00:00,36,1,37
"25570",10501,"Grand Falls-Windsor","NL",48.92696,-55.65966,2018-12-02 04:00:00,31,16,47
"25571",10501,"Grand Falls-Windsor","NL",48.92696,-55.65966,2018-12-02 05:00:00,35,19,54
"25572",10501,"Grand Falls-Windsor","NL",48.92696,-55.65966,2018-12-02 06:00:00,32,2,34
"25573",10501,"Grand Falls-Windsor","NL",48.92696,-55.65966,2018-12-02 07:00:00,36,1,37
"25574",10501,"Grand Falls-Windsor","NL",48.92696,-55.65966,2018-12-02 08:00:00,35,1,36
"25575",10501,"Grand Falls-Windsor","NL",48.92696,-55.65966,2018-12-02 09:00:00,33,1,34
"25576",10501,"Grand Falls-Windsor","NL",48.92696,-55.65966,2018-12-02 10:00:00,33,1,34
"25577",10501,"Grand Falls-Windsor","NL",48.92696,-55.65966,2018-12-02 11:00:00,34,1,35
"25578",10501,"Grand Falls-Windsor","NL",48.92696,-55.65966,2018-12-02 12:00:00,33,1,34
"25579",10501,"Grand Falls-Windsor","NL",48.92696,-55.65966,2018-12-02 13:00:00,35,1,36
"25580",10501,"Grand Falls-Windsor","NL",48.92696,-55.65966,2018-12-02 14:00:00,36,1,37
"25581",10501,"Grand Falls-Windsor","NL",48.92696,-55.65966,2018-12-02 15:00:00,37,1,38
"25582",10501,"Grand Falls-Windsor","NL",48.92696,-55.65966,2018-12-02 16:00:00,37,1,38
"25583",10501,"Grand Falls-Windsor","NL",48.92696,-55.65966,2018-12-02 17:00:00,37,1,38
"25584",10501,"Grand Falls-Windsor","NL",48.92696,-55.65966,2018-12-02 18:00:00,37,1,38
"25585",10501,"Grand Falls-Windsor","NL",48.92696,-55.65966,2018-12-02 19:00:00,35,1,36
"25586",10501,"Grand Falls-Windsor","NL",48.92696,-55.65966,2018-12-02 20:00:00,35,1,36
"25587",10501,"Grand Falls-Windsor","NL",48.92696,-55.65966,2018-12-02 21:00:00,37,1,38
"25588",10501,"Grand Falls-Windsor","NL",48.92696,-55.65966,2018-12-02 22:00:00,40,0,40
"25589",10501,"Grand Falls-Windsor","NL",48.92696,-55.65966,2018-12-02 23:00:00,40,1,41
"25590",10501,"Grand Falls-Windsor","NL",48.92696,-55.65966,2018-12-03 00:00:00,40,1,41
"25591",10501,"Grand Falls-Windsor","NL",48.92696,-55.65966,2018-12-03 01:00:00,40,1,41
"25592",10501,"Grand Falls-Windsor","NL",48.92696,-55.65966,2018-12-03 02:00:00,39,1,40
"25593",10501,"Grand Falls-Windsor","NL",48.92696,-55.65966,2018-12-03 03:00:00,37,0,37
"25594",10501,"Grand Falls-Windsor","NL",48.92696,-55.65966,2018-12-03 04:00:00,37,1,38
"25595",10501,"Grand Falls-Windsor","NL",48.92696,-55.65966,2018-12-03 05:00:00,37,0,37
"25596",10501,"Grand Falls-Windsor","NL",48.92696,-55.65966,2018-12-03 06:00:00,38,1,39
"25597",10501,"Grand Falls-Windsor","NL",48.92696,-55.65966,2018-12-03 07:00:00,38,1,39
"25598",10501,"Grand Falls-Windsor","NL",48.92696,-55.65966,2018-12-03 08:00:00,38,1,39
"25599",10501,"Grand Falls-Windsor","NL",48.92696,-55.65966,2018-12-03 09:00:00,39,1,40
"25600",10501,"Grand Falls-Windsor","NL",48.92696,-55.65966,2018-12-03 10:00:00,40,1,41
"25601",10501,"Grand Falls-Windsor","NL",48.92696,-55.65966,2018-12-03 11:00:00,41,1,42
"25602",10501,"Grand Falls-Windsor","NL",48.92696,-55.65966,2018-12-03 12:00:00,40,1,41
"25603",10501,"Grand Falls-Windsor","NL",48.92696,-55.65966,2018-12-03 13:00:00,41,1,42
"25604",10501,"Grand Falls-Windsor","NL",48.92696,-55.65966,2018-12-03 14:00:00,40,1,41
"25605",10501,"Grand Falls-Windsor","NL",48.92696,-55.65966,2018-12-03 15:00:00,41,1,42
"25606",10501,"Grand Falls-Windsor","NL",48.92696,-55.65966,2018-12-03 16:00:00,40,1,41
"25607",10501,"Grand Falls-Windsor","NL",48.92696,-55.65966,2018-12-03 17:00:00,39,1,40
"25608",10501,"Grand Falls-Windsor","NL",48.92696,-55.65966,2018-12-03 18:00:00,37,1,38
"25609",10501,"Grand Falls-Windsor","NL",48.92696,-55.65966,2018-12-03 19:00:00,36,1,37
"25610",10501,"Grand Falls-Windsor","NL",48.92696,-55.65966,2018-12-03 20:00:00,33,2,35
"25611",10501,"Grand Falls-Windsor","NL",48.92696,-55.65966,2018-12-03 21:00:00,32,2,34
"25612",10501,"Grand Falls-Windsor","NL",48.92696,-55.65966,2018-12-03 22:00:00,33,1,34
"25613",10501,"Grand Falls-Windsor","NL",48.92696,-55.65966,2018-12-03 23:00:00,32,1,33
"25614",10501,"Grand Falls-Windsor","NL",48.92696,-55.65966,2018-12-04 00:00:00,31,1,32
"25615",10501,"Grand Falls-Windsor","NL",48.92696,-55.65966,2018-12-04 01:00:00,30,1,31
"25616",10501,"Grand Falls-Windsor","NL",48.92696,-55.65966,2018-12-04 02:00:00,28,1,29
"25617",10501,"Grand Falls-Windsor","NL",48.92696,-55.65966,2018-12-04 03:00:00,30,1,31
"25618",10501,"Grand Falls-Windsor","NL",48.92696,-55.65966,2018-12-04 04:00:00,30,0,30
"25619",10501,"Grand Falls-Windsor","NL",48.92696,-55.65966,2018-12-04 05:00:00,31,1,32
"25620",10501,"Grand Falls-Windsor","NL",48.92696,-55.65966,2018-12-04 06:00:00,28,3,31
"25621",10501,"Grand Falls-Windsor","NL",48.92696,-55.65966,2018-12-04 07:00:00,28,1,29
"25622",10501,"Grand Falls-Windsor","NL",48.92696,-55.65966,2018-12-04 08:00:00,26,1,27
"25623",10501,"Grand Falls-Windsor","NL",48.92696,-55.65966,2018-12-04 09:00:00,22,1,23
"25624",10501,"Grand Falls-Windsor","NL",48.92696,-55.65966,2018-12-04 10:00:00,22,4,26
"25625",10501,"Grand Falls-Windsor","NL",48.92696,-55.65966,2018-12-04 11:00:00,29,1,30
"25626",10501,"Grand Falls-Windsor","NL",48.92696,-55.65966,2018-12-04 12:00:00,33,1,34
"25627",10501,"Grand Falls-Windsor","NL",48.92696,-55.65966,2018-12-04 13:00:00,35,1,36
"25628",10501,"Grand Falls-Windsor","NL",48.92696,-55.65966,2018-12-04 14:00:00,35,1,36
"25629",10501,"Grand Falls-Windsor","NL",48.92696,-55.65966,2018-12-04 15:00:00,35,1,36
"25630",10501,"Grand Falls-Windsor","NL",48.92696,-55.65966,2018-12-04 16:00:00,34,1,35
"25631",10501,"Grand Falls-Windsor","NL",48.92696,-55.65966,2018-12-04 17:00:00,34,1,35
"25632",10501,"Grand Falls-Windsor","NL",48.92696,-55.65966,2018-12-04 18:00:00,34,1,35
"25633",10501,"Grand Falls-Windsor","NL",48.92696,-55.65966,2018-12-04 19:00:00,35,1,36
"25634",10501,"Grand Falls-Windsor","NL",48.92696,-55.65966,2018-12-04 20:00:00,35,1,36
"25635",10501,"Grand Falls-Windsor","NL",48.92696,-55.65966,2018-12-04 21:00:00,35,1,36
"25636",10501,"Grand Falls-Windsor","NL",48.92696,-55.65966,2018-12-04 22:00:00,34,1,35
"25637",10501,"Grand Falls-Windsor","NL",48.92696,-55.65966,2018-12-04 23:00:00,34,1,35
"25638",10501,"Grand Falls-Windsor","NL",48.92696,-55.65966,2018-12-05 00:00:00,34,1,35
"25639",10501,"Grand Falls-Windsor","NL",48.92696,-55.65966,2018-12-05 01:00:00,34,1,35
"25640",10501,"Grand Falls-Windsor","NL",48.92696,-55.65966,2018-12-05 02:00:00,34,1,35
"25641",10501,"Grand Falls-Windsor","NL",48.92696,-55.65966,2018-12-05 03:00:00,35,0,35
"25642",10501,"Grand Falls-Windsor","NL",48.92696,-55.65966,2018-12-05 04:00:00,35,1,36
"25643",10501,"Grand Falls-Windsor","NL",48.92696,-55.65966,2018-12-05 05:00:00,35,1,36
"25644",10501,"Grand Falls-Windsor","NL",48.92696,-55.65966,2018-12-05 06:00:00,38,1,39
"25645",10501,"Grand Falls-Windsor","NL",48.92696,-55.65966,2018-12-05 07:00:00,38,1,39
"25646",10501,"Grand Falls-Windsor","NL",48.92696,-55.65966,2018-12-05 08:00:00,38,2,40
"25647",10501,"Grand Falls-Windsor","NL",48.92696,-55.65966,2018-12-05 09:00:00,37,2,39
"25648",10501,"Grand Falls-Windsor","NL",48.92696,-55.65966,2018-12-05 10:00:00,38,1,39
"25649",10501,"Grand Falls-Windsor","NL",48.92696,-55.65966,2018-12-05 11:00:00,39,1,40
"25650",10501,"Grand Falls-Windsor","NL",48.92696,-55.65966,2018-12-05 12:00:00,39,1,40
"25651",10501,"Grand Falls-Windsor","NL",48.92696,-55.65966,2018-12-05 13:00:00,40,1,41
"25652",10501,"Grand Falls-Windsor","NL",48.92696,-55.65966,2018-12-05 14:00:00,40,1,41
"25653",10501,"Grand Falls-Windsor","NL",48.92696,-55.65966,2018-12-05 15:00:00,40,1,41
"25654",10501,"Grand Falls-Windsor","NL",48.92696,-55.65966,2018-12-05 16:00:00,41,1,42
"25655",10501,"Grand Falls-Windsor","NL",48.92696,-55.65966,2018-12-05 17:00:00,42,1,43
"25656",10501,"Grand Falls-Windsor","NL",48.92696,-55.65966,2018-12-05 18:00:00,43,1,44
"25657",10501,"Grand Falls-Windsor","NL",48.92696,-55.65966,2018-12-05 19:00:00,42,1,43
"25658",10501,"Grand Falls-Windsor","NL",48.92696,-55.65966,2018-12-05 20:00:00,42,1,43
"25659",10501,"Grand Falls-Windsor","NL",48.92696,-55.65966,2018-12-05 21:00:00,41,1,42
"25660",10501,"Grand Falls-Windsor","NL",48.92696,-55.65966,2018-12-05 22:00:00,41,1,42
"25661",10501,"Grand Falls-Windsor","NL",48.92696,-55.65966,2018-12-05 23:00:00,41,1,42
"25662",10501,"Grand Falls-Windsor","NL",48.92696,-55.65966,2018-12-06 00:00:00,40,1,41
"25663",10501,"Grand Falls-Windsor","NL",48.92696,-55.65966,2018-12-06 01:00:00,40,1,41
"25664",10501,"Grand Falls-Windsor","NL",48.92696,-55.65966,2018-12-06 02:00:00,40,1,41
"25665",10501,"Grand Falls-Windsor","NL",48.92696,-55.65966,2018-12-06 03:00:00,40,1,41
"25666",10501,"Grand Falls-Windsor","NL",48.92696,-55.65966,2018-12-06 04:00:00,38,1,39
"25667",10501,"Grand Falls-Windsor","NL",48.92696,-55.65966,2018-12-06 05:00:00,35,2,37
"25668",10501,"Grand Falls-Windsor","NL",48.92696,-55.65966,2018-12-06 06:00:00,32,3,35
"25669",10501,"Grand Falls-Windsor","NL",48.92696,-55.65966,2018-12-06 07:00:00,34,1,35
"25670",10501,"Grand Falls-Windsor","NL",48.92696,-55.65966,2018-12-06 08:00:00,34,2,36
"25671",10501,"Grand Falls-Windsor","NL",48.92696,-55.65966,2018-12-06 09:00:00,32,2,34
"25672",10501,"Grand Falls-Windsor","NL",48.92696,-55.65966,2018-12-06 10:00:00,30,4,34
"25673",10501,"Grand Falls-Windsor","NL",48.92696,-55.65966,2018-12-06 11:00:00,33,1,34
"25674",10501,"Grand Falls-Windsor","NL",48.92696,-55.65966,2018-12-06 12:00:00,33,2,35
"25675",10501,"Grand Falls-Windsor","NL",48.92696,-55.65966,2018-12-06 13:00:00,33,3,36
"25676",10501,"Grand Falls-Windsor","NL",48.92696,-55.65966,2018-12-06 14:00:00,33,5,38
"25677",10501,"Grand Falls-Windsor","NL",48.92696,-55.65966,2018-12-06 15:00:00,34,4,38
"25678",10501,"Grand Falls-Windsor","NL",48.92696,-55.65966,2018-12-06 16:00:00,33,4,37
"25679",10501,"Grand Falls-Windsor","NL",48.92696,-55.65966,2018-12-06 17:00:00,32,5,37
"25680",10501,"Grand Falls-Windsor","NL",48.92696,-55.65966,2018-12-06 18:00:00,32,5,37
"25681",10501,"Grand Falls-Windsor","NL",48.92696,-55.65966,2018-12-06 19:00:00,33,4,37
"25682",10501,"Grand Falls-Windsor","NL",48.92696,-55.65966,2018-12-06 20:00:00,32,4,36
"25683",10501,"Grand Falls-Windsor","NL",48.92696,-55.65966,2018-12-06 21:00:00,34,2,36
"25684",10501,"Grand Falls-Windsor","NL",48.92696,-55.65966,2018-12-06 22:00:00,35,2,37
"25685",10501,"Grand Falls-Windsor","NL",48.92696,-55.65966,2018-12-06 23:00:00,35,2,37
"25686",10501,"Grand Falls-Windsor","NL",48.92696,-55.65966,2018-12-07 00:00:00,34,1,35
"25687",10501,"Grand Falls-Windsor","NL",48.92696,-55.65966,2018-12-07 01:00:00,34,1,35
"25688",10501,"Grand Falls-Windsor","NL",48.92696,-55.65966,2018-12-07 02:00:00,36,1,37
"25689",10501,"Grand Falls-Windsor","NL",48.92696,-55.65966,2018-12-07 03:00:00,36,0,36
"25690",10501,"Grand Falls-Windsor","NL",48.92696,-55.65966,2018-12-07 04:00:00,35,1,36
"25691",10501,"Grand Falls-Windsor","NL",48.92696,-55.65966,2018-12-07 05:00:00,34,0,34
"25692",10501,"Grand Falls-Windsor","NL",48.92696,-55.65966,2018-12-07 06:00:00,34,1,35
"25693",10501,"Grand Falls-Windsor","NL",48.92696,-55.65966,2018-12-07 07:00:00,34,1,35
"25694",10501,"Grand Falls-Windsor","NL",48.92696,-55.65966,2018-12-07 08:00:00,34,0,34
"25695",10501,"Grand Falls-Windsor","NL",48.92696,-55.65966,2018-12-07 09:00:00,33,1,34
"25696",10501,"Grand Falls-Windsor","NL",48.92696,-55.65966,2018-12-07 10:00:00,34,1,35
"25697",10501,"Grand Falls-Windsor","NL",48.92696,-55.65966,2018-12-07 11:00:00,36,1,37
"25698",10501,"Grand Falls-Windsor","NL",48.92696,-55.65966,2018-12-07 12:00:00,36,1,37
"25699",10501,"Grand Falls-Windsor","NL",48.92696,-55.65966,2018-12-07 13:00:00,37,2,39
"25700",10501,"Grand Falls-Windsor","NL",48.92696,-55.65966,2018-12-07 14:00:00,36,1,37
"25701",10501,"Grand Falls-Windsor","NL",48.92696,-55.65966,2018-12-07 15:00:00,38,1,39
"25702",10501,"Grand Falls-Windsor","NL",48.92696,-55.65966,2018-12-07 16:00:00,40,1,41
"25703",10501,"Grand Falls-Windsor","NL",48.92696,-55.65966,2018-12-07 17:00:00,38,1,39
"25704",10501,"Grand Falls-Windsor","NL",48.92696,-55.65966,2018-12-07 18:00:00,33,2,35
"25705",10501,"Grand Falls-Windsor","NL",48.92696,-55.65966,2018-12-07 19:00:00,25,7,32
"25706",10501,"Grand Falls-Windsor","NL",48.92696,-55.65966,2018-12-07 20:00:00,28,4,32
"25707",10501,"Grand Falls-Windsor","NL",48.92696,-55.65966,2018-12-07 21:00:00,30,3,33
"25708",10501,"Grand Falls-Windsor","NL",48.92696,-55.65966,2018-12-07 22:00:00,27,6,33
"25709",10501,"Grand Falls-Windsor","NL",48.92696,-55.65966,2018-12-07 23:00:00,27,6,33
"25710",10501,"Grand Falls-Windsor","NL",48.92696,-55.65966,2018-12-08 00:00:00,29,2,31
"25711",10501,"Grand Falls-Windsor","NL",48.92696,-55.65966,2018-12-08 01:00:00,27,5,32
"25712",10501,"Grand Falls-Windsor","NL",48.92696,-55.65966,2018-12-08 02:00:00,32,2,34
"25713",10501,"Grand Falls-Windsor","NL",48.92696,-55.65966,2018-12-08 03:00:00,32,1,33
"25714",10501,"Grand Falls-Windsor","NL",48.92696,-55.65966,2018-12-08 04:00:00,31,1,32
"25715",10501,"Grand Falls-Windsor","NL",48.92696,-55.65966,2018-12-08 05:00:00,30,1,31
"25716",10501,"Grand Falls-Windsor","NL",48.92696,-55.65966,2018-12-08 06:00:00,29,1,30
"25717",10501,"Grand Falls-Windsor","NL",48.92696,-55.65966,2018-12-08 07:00:00,29,1,30
"25718",10501,"Grand Falls-Windsor","NL",48.92696,-55.65966,2018-12-08 08:00:00,25,1,26
"25719",10501,"Grand Falls-Windsor","NL",48.92696,-55.65966,2018-12-08 09:00:00,27,2,29
"25720",10501,"Grand Falls-Windsor","NL",48.92696,-55.65966,2018-12-08 10:00:00,27,1,28
"25721",10501,"Grand Falls-Windsor","NL",48.92696,-55.65966,2018-12-08 11:00:00,26,1,27
"25722",10501,"Grand Falls-Windsor","NL",48.92696,-55.65966,2018-12-08 12:00:00,27,2,29
"25723",10501,"Grand Falls-Windsor","NL",48.92696,-55.65966,2018-12-08 13:00:00,28,1,29
"25724",10501,"Grand Falls-Windsor","NL",48.92696,-55.65966,2018-12-08 14:00:00,28,1,29
"25725",10501,"Grand Falls-Windsor","NL",48.92696,-55.65966,2018-12-08 15:00:00,30,2,32
"25726",10501,"Grand Falls-Windsor","NL",48.92696,-55.65966,2018-12-08 16:00:00,29,3,32
"25727",10501,"Grand Falls-Windsor","NL",48.92696,-55.65966,2018-12-08 17:00:00,31,2,33
"25728",10501,"Grand Falls-Windsor","NL",48.92696,-55.65966,2018-12-08 18:00:00,31,2,33
"25729",10501,"Grand Falls-Windsor","NL",48.92696,-55.65966,2018-12-08 19:00:00,25,5,30
"25730",10501,"Grand Falls-Windsor","NL",48.92696,-55.65966,2018-12-08 20:00:00,22,5,27
"25731",10501,"Grand Falls-Windsor","NL",48.92696,-55.65966,2018-12-08 21:00:00,24,3,27
"25732",10501,"Grand Falls-Windsor","NL",48.92696,-55.65966,2018-12-08 22:00:00,28,3,31
"25733",10501,"Grand Falls-Windsor","NL",48.92696,-55.65966,2018-12-08 23:00:00,28,3,31
"25734",10501,"Grand Falls-Windsor","NL",48.92696,-55.65966,2018-12-09 00:00:00,24,3,27
"25735",10501,"Grand Falls-Windsor","NL",48.92696,-55.65966,2018-12-09 01:00:00,24,1,25
"25736",10501,"Grand Falls-Windsor","NL",48.92696,-55.65966,2018-12-09 02:00:00,27,2,29
"25737",10501,"Grand Falls-Windsor","NL",48.92696,-55.65966,2018-12-09 03:00:00,27,1,28
"25738",10501,"Grand Falls-Windsor","NL",48.92696,-55.65966,2018-12-09 04:00:00,28,1,29
"25739",10501,"Grand Falls-Windsor","NL",48.92696,-55.65966,2018-12-09 05:00:00,23,5,28
"25740",10501,"Grand Falls-Windsor","NL",48.92696,-55.65966,2018-12-09 06:00:00,24,2,26
"25741",10501,"Grand Falls-Windsor","NL",48.92696,-55.65966,2018-12-09 07:00:00,26,1,27
"25742",10501,"Grand Falls-Windsor","NL",48.92696,-55.65966,2018-12-09 08:00:00,26,2,28
"25743",10501,"Grand Falls-Windsor","NL",48.92696,-55.65966,2018-12-09 09:00:00,27,2,29
"25744",10501,"Grand Falls-Windsor","NL",48.92696,-55.65966,2018-12-09 10:00:00,28,1,29
"25745",10501,"Grand Falls-Windsor","NL",48.92696,-55.65966,2018-12-09 11:00:00,34,1,35
"25746",10501,"Grand Falls-Windsor","NL",48.92696,-55.65966,2018-12-09 12:00:00,35,1,36
"25747",10501,"Grand Falls-Windsor","NL",48.92696,-55.65966,2018-12-09 13:00:00,36,1,37
"25748",10501,"Grand Falls-Windsor","NL",48.92696,-55.65966,2018-12-09 14:00:00,37,1,38
"25749",10501,"Grand Falls-Windsor","NL",48.92696,-55.65966,2018-12-09 15:00:00,37,1,38
"25750",10501,"Grand Falls-Windsor","NL",48.92696,-55.65966,2018-12-09 16:00:00,38,1,39
"25751",10501,"Grand Falls-Windsor","NL",48.92696,-55.65966,2018-12-09 17:00:00,40,1,41
"25752",10501,"Grand Falls-Windsor","NL",48.92696,-55.65966,2018-12-09 18:00:00,40,1,41
"25753",10501,"Grand Falls-Windsor","NL",48.92696,-55.65966,2018-12-09 19:00:00,40,1,41
"25754",10501,"Grand Falls-Windsor","NL",48.92696,-55.65966,2018-12-09 20:00:00,40,1,41
"25755",10501,"Grand Falls-Windsor","NL",48.92696,-55.65966,2018-12-09 21:00:00,40,1,41
"25756",10501,"Grand Falls-Windsor","NL",48.92696,-55.65966,2018-12-09 22:00:00,40,1,41
"25757",10501,"Grand Falls-Windsor","NL",48.92696,-55.65966,2018-12-09 23:00:00,40,1,41
"25758",10501,"Grand Falls-Windsor","NL",48.92696,-55.65966,2018-12-10 00:00:00,41,1,42
"25759",10501,"Grand Falls-Windsor","NL",48.92696,-55.65966,2018-12-10 01:00:00,41,1,42
"25760",10501,"Grand Falls-Windsor","NL",48.92696,-55.65966,2018-12-10 02:00:00,41,1,42
"25761",10501,"Grand Falls-Windsor","NL",48.92696,-55.65966,2018-12-10 03:00:00,41,0,41
"25762",10501,"Grand Falls-Windsor","NL",48.92696,-55.65966,2018-12-10 04:00:00,41,0,41
"25763",10501,"Grand Falls-Windsor","NL",48.92696,-55.65966,2018-12-10 05:00:00,41,0,41
"25764",10501,"Grand Falls-Windsor","NL",48.92696,-55.65966,2018-12-10 06:00:00,41,1,42
"25765",10501,"Grand Falls-Windsor","NL",48.92696,-55.65966,2018-12-10 07:00:00,41,0,41
"25766",10501,"Grand Falls-Windsor","NL",48.92696,-55.65966,2018-12-10 08:00:00,40,2,42
"25767",10501,"Grand Falls-Windsor","NL",48.92696,-55.65966,2018-12-10 09:00:00,39,2,41
"25768",10501,"Grand Falls-Windsor","NL",48.92696,-55.65966,2018-12-10 10:00:00,38,1,39
"25769",10501,"Grand Falls-Windsor","NL",48.92696,-55.65966,2018-12-10 11:00:00,38,1,39
"25770",10501,"Grand Falls-Windsor","NL",48.92696,-55.65966,2018-12-10 12:00:00,37,1,38
"25771",10501,"Grand Falls-Windsor","NL",48.92696,-55.65966,2018-12-10 13:00:00,38,1,39
"25772",10501,"Grand Falls-Windsor","NL",48.92696,-55.65966,2018-12-10 14:00:00,37,1,38
"25773",10501,"Grand Falls-Windsor","NL",48.92696,-55.65966,2018-12-10 15:00:00,38,1,39
"25774",10501,"Grand Falls-Windsor","NL",48.92696,-55.65966,2018-12-10 16:00:00,38,1,39
"25775",10501,"Grand Falls-Windsor","NL",48.92696,-55.65966,2018-12-10 17:00:00,38,1,39
"25776",10501,"Grand Falls-Windsor","NL",48.92696,-55.65966,2018-12-10 18:00:00,39,1,40
"25777",10501,"Grand Falls-Windsor","NL",48.92696,-55.65966,2018-12-10 19:00:00,37,1,38
"25778",10501,"Grand Falls-Windsor","NL",48.92696,-55.65966,2018-12-10 20:00:00,33,3,36
"25779",10501,"Grand Falls-Windsor","NL",48.92696,-55.65966,2018-12-10 21:00:00,32,2,34
"25780",10501,"Grand Falls-Windsor","NL",48.92696,-55.65966,2018-12-10 22:00:00,31,1,32
"25781",10501,"Grand Falls-Windsor","NL",48.92696,-55.65966,2018-12-10 23:00:00,28,3,31
"25782",10501,"Grand Falls-Windsor","NL",48.92696,-55.65966,2018-12-11 00:00:00,27,4,31
"25783",10501,"Grand Falls-Windsor","NL",48.92696,-55.65966,2018-12-11 01:00:00,30,2,32
"25784",10501,"Grand Falls-Windsor","NL",48.92696,-55.65966,2018-12-11 02:00:00,31,1,32
"25785",10501,"Grand Falls-Windsor","NL",48.92696,-55.65966,2018-12-11 03:00:00,30,1,31
"25786",10501,"Grand Falls-Windsor","NL",48.92696,-55.65966,2018-12-11 04:00:00,30,1,31
"25787",10501,"Grand Falls-Windsor","NL",48.92696,-55.65966,2018-12-11 05:00:00,31,1,32
"25788",10501,"Grand Falls-Windsor","NL",48.92696,-55.65966,2018-12-11 06:00:00,33,1,34
"25789",10501,"Grand Falls-Windsor","NL",48.92696,-55.65966,2018-12-11 07:00:00,35,1,36
"25790",10501,"Grand Falls-Windsor","NL",48.92696,-55.65966,2018-12-11 08:00:00,38,1,39
"25791",10501,"Grand Falls-Windsor","NL",48.92696,-55.65966,2018-12-11 09:00:00,40,2,42
"25792",10501,"Grand Falls-Windsor","NL",48.92696,-55.65966,2018-12-11 10:00:00,30,NA,NA
"25793",10501,"Grand Falls-Windsor","NL",48.92696,-55.65966,2018-12-11 11:00:00,35,1,36
"25794",10501,"Grand Falls-Windsor","NL",48.92696,-55.65966,2018-12-11 12:00:00,38,2,40
"25795",10501,"Grand Falls-Windsor","NL",48.92696,-55.65966,2018-12-11 13:00:00,39,2,41
"25796",10501,"Grand Falls-Windsor","NL",48.92696,-55.65966,2018-12-11 14:00:00,39,2,41
"25797",10501,"Grand Falls-Windsor","NL",48.92696,-55.65966,2018-12-11 15:00:00,40,1,41
"25798",10501,"Grand Falls-Windsor","NL",48.92696,-55.65966,2018-12-11 16:00:00,39,2,41
"25799",10501,"Grand Falls-Windsor","NL",48.92696,-55.65966,2018-12-11 17:00:00,39,2,41
"25800",10501,"Grand Falls-Windsor","NL",48.92696,-55.65966,2018-12-11 18:00:00,37,3,40
"25801",10501,"Grand Falls-Windsor","NL",48.92696,-55.65966,2018-12-11 19:00:00,30,6,36
"25802",10501,"Grand Falls-Windsor","NL",48.92696,-55.65966,2018-12-11 20:00:00,34,1,35
"25803",10501,"Grand Falls-Windsor","NL",48.92696,-55.65966,2018-12-11 21:00:00,30,2,32
"25804",10501,"Grand Falls-Windsor","NL",48.92696,-55.65966,2018-12-11 22:00:00,31,2,33
"25805",10501,"Grand Falls-Windsor","NL",48.92696,-55.65966,2018-12-11 23:00:00,34,2,36
"25806",10501,"Grand Falls-Windsor","NL",48.92696,-55.65966,2018-12-12 00:00:00,34,1,35
"25807",10501,"Grand Falls-Windsor","NL",48.92696,-55.65966,2018-12-12 01:00:00,33,1,34
"25808",10501,"Grand Falls-Windsor","NL",48.92696,-55.65966,2018-12-12 02:00:00,32,2,34
"25809",10501,"Grand Falls-Windsor","NL",48.92696,-55.65966,2018-12-12 03:00:00,33,1,34
"25810",10501,"Grand Falls-Windsor","NL",48.92696,-55.65966,2018-12-12 04:00:00,33,1,34
"25811",10501,"Grand Falls-Windsor","NL",48.92696,-55.65966,2018-12-12 05:00:00,32,1,33
"25812",10501,"Grand Falls-Windsor","NL",48.92696,-55.65966,2018-12-12 06:00:00,31,1,32
"25813",10501,"Grand Falls-Windsor","NL",48.92696,-55.65966,2018-12-12 07:00:00,28,4,32
"25814",10501,"Grand Falls-Windsor","NL",48.92696,-55.65966,2018-12-12 08:00:00,24,4,28
"25815",10501,"Grand Falls-Windsor","NL",48.92696,-55.65966,2018-12-12 09:00:00,20,9,29
"25816",10501,"Grand Falls-Windsor","NL",48.92696,-55.65966,2018-12-12 10:00:00,17,13,30
"25817",10501,"Grand Falls-Windsor","NL",48.92696,-55.65966,2018-12-12 11:00:00,22,5,27
"25818",10501,"Grand Falls-Windsor","NL",48.92696,-55.65966,2018-12-12 12:00:00,26,4,30
"25819",10501,"Grand Falls-Windsor","NL",48.92696,-55.65966,2018-12-12 13:00:00,27,4,31
"25820",10501,"Grand Falls-Windsor","NL",48.92696,-55.65966,2018-12-12 14:00:00,26,6,32
"25821",10501,"Grand Falls-Windsor","NL",48.92696,-55.65966,2018-12-12 15:00:00,29,5,34
"25822",10501,"Grand Falls-Windsor","NL",48.92696,-55.65966,2018-12-12 16:00:00,31,5,36
"25823",10501,"Grand Falls-Windsor","NL",48.92696,-55.65966,2018-12-12 17:00:00,33,4,37
"25824",10501,"Grand Falls-Windsor","NL",48.92696,-55.65966,2018-12-12 18:00:00,35,3,38
"25825",10501,"Grand Falls-Windsor","NL",48.92696,-55.65966,2018-12-12 19:00:00,36,3,39
"25826",10501,"Grand Falls-Windsor","NL",48.92696,-55.65966,2018-12-12 20:00:00,35,3,38
"25827",10501,"Grand Falls-Windsor","NL",48.92696,-55.65966,2018-12-12 21:00:00,36,4,40
"25828",10501,"Grand Falls-Windsor","NL",48.92696,-55.65966,2018-12-12 22:00:00,36,4,40
"25829",10501,"Grand Falls-Windsor","NL",48.92696,-55.65966,2018-12-12 23:00:00,37,3,40
"25830",10501,"Grand Falls-Windsor","NL",48.92696,-55.65966,2018-12-13 00:00:00,38,2,40
"25831",10501,"Grand Falls-Windsor","NL",48.92696,-55.65966,2018-12-13 01:00:00,40,1,41
"25832",10501,"Grand Falls-Windsor","NL",48.92696,-55.65966,2018-12-13 02:00:00,41,1,42
"25833",10501,"Grand Falls-Windsor","NL",48.92696,-55.65966,2018-12-13 03:00:00,42,0,42
"25834",10501,"Grand Falls-Windsor","NL",48.92696,-55.65966,2018-12-13 04:00:00,41,1,42
"25835",10501,"Grand Falls-Windsor","NL",48.92696,-55.65966,2018-12-13 05:00:00,37,5,42
"25836",10501,"Grand Falls-Windsor","NL",48.92696,-55.65966,2018-12-13 06:00:00,38,2,40
"25837",10501,"Grand Falls-Windsor","NL",48.92696,-55.65966,2018-12-13 07:00:00,38,2,40
"25838",10501,"Grand Falls-Windsor","NL",48.92696,-55.65966,2018-12-13 08:00:00,39,2,41
"25839",10501,"Grand Falls-Windsor","NL",48.92696,-55.65966,2018-12-13 09:00:00,38,2,40
"25840",10501,"Grand Falls-Windsor","NL",48.92696,-55.65966,2018-12-13 10:00:00,39,2,41
"25841",10501,"Grand Falls-Windsor","NL",48.92696,-55.65966,2018-12-13 11:00:00,39,1,40
"25842",10501,"Grand Falls-Windsor","NL",48.92696,-55.65966,2018-12-13 12:00:00,39,1,40
"25843",10501,"Grand Falls-Windsor","NL",48.92696,-55.65966,2018-12-13 13:00:00,39,1,40
"25844",10501,"Grand Falls-Windsor","NL",48.92696,-55.65966,2018-12-13 14:00:00,40,1,41
"25845",10501,"Grand Falls-Windsor","NL",48.92696,-55.65966,2018-12-13 15:00:00,40,1,41
"25846",10501,"Grand Falls-Windsor","NL",48.92696,-55.65966,2018-12-13 16:00:00,40,1,41
"25847",10501,"Grand Falls-Windsor","NL",48.92696,-55.65966,2018-12-13 17:00:00,38,2,40
"25848",10501,"Grand Falls-Windsor","NL",48.92696,-55.65966,2018-12-13 18:00:00,39,1,40
"25849",10501,"Grand Falls-Windsor","NL",48.92696,-55.65966,2018-12-13 19:00:00,41,1,42
"25850",10501,"Grand Falls-Windsor","NL",48.92696,-55.65966,2018-12-13 20:00:00,41,1,42
"25851",10501,"Grand Falls-Windsor","NL",48.92696,-55.65966,2018-12-13 21:00:00,40,3,43
"25852",10501,"Grand Falls-Windsor","NL",48.92696,-55.65966,2018-12-13 22:00:00,41,1,42
"25853",10501,"Grand Falls-Windsor","NL",48.92696,-55.65966,2018-12-13 23:00:00,41,1,42
"25854",10501,"Grand Falls-Windsor","NL",48.92696,-55.65966,2018-12-14 00:00:00,41,1,42
"25855",10501,"Grand Falls-Windsor","NL",48.92696,-55.65966,2018-12-14 01:00:00,41,1,42
"25856",10501,"Grand Falls-Windsor","NL",48.92696,-55.65966,2018-12-14 02:00:00,42,0,42
"25857",10501,"Grand Falls-Windsor","NL",48.92696,-55.65966,2018-12-14 03:00:00,42,3,45
"25858",10501,"Grand Falls-Windsor","NL",48.92696,-55.65966,2018-12-14 04:00:00,43,1,44
"25859",10501,"Grand Falls-Windsor","NL",48.92696,-55.65966,2018-12-14 05:00:00,43,1,44
"25860",10501,"Grand Falls-Windsor","NL",48.92696,-55.65966,2018-12-14 06:00:00,43,1,44
"25861",10501,"Grand Falls-Windsor","NL",48.92696,-55.65966,2018-12-14 07:00:00,43,1,44
"25862",10501,"Grand Falls-Windsor","NL",48.92696,-55.65966,2018-12-14 08:00:00,41,1,42
"25863",10501,"Grand Falls-Windsor","NL",48.92696,-55.65966,2018-12-14 09:00:00,39,3,42
"25864",10501,"Grand Falls-Windsor","NL",48.92696,-55.65966,2018-12-14 10:00:00,41,1,42
"25865",10501,"Grand Falls-Windsor","NL",48.92696,-55.65966,2018-12-14 11:00:00,41,1,42
"25866",10501,"Grand Falls-Windsor","NL",48.92696,-55.65966,2018-12-14 12:00:00,42,1,43
"25867",10501,"Grand Falls-Windsor","NL",48.92696,-55.65966,2018-12-14 13:00:00,43,1,44
"25868",10501,"Grand Falls-Windsor","NL",48.92696,-55.65966,2018-12-14 14:00:00,43,1,44
"25869",10501,"Grand Falls-Windsor","NL",48.92696,-55.65966,2018-12-14 15:00:00,42,1,43
"25870",10501,"Grand Falls-Windsor","NL",48.92696,-55.65966,2018-12-14 16:00:00,41,1,42
"25871",10501,"Grand Falls-Windsor","NL",48.92696,-55.65966,2018-12-14 17:00:00,42,1,43
"25872",10501,"Grand Falls-Windsor","NL",48.92696,-55.65966,2018-12-14 18:00:00,42,1,43
"25873",10501,"Grand Falls-Windsor","NL",48.92696,-55.65966,2018-12-14 19:00:00,42,1,43
"25874",10501,"Grand Falls-Windsor","NL",48.92696,-55.65966,2018-12-14 20:00:00,43,1,44
"25875",10501,"Grand Falls-Windsor","NL",48.92696,-55.65966,2018-12-14 21:00:00,43,1,44
"25876",10501,"Grand Falls-Windsor","NL",48.92696,-55.65966,2018-12-14 22:00:00,42,1,43
"25877",10501,"Grand Falls-Windsor","NL",48.92696,-55.65966,2018-12-14 23:00:00,41,1,42
"25878",10501,"Grand Falls-Windsor","NL",48.92696,-55.65966,2018-12-15 00:00:00,42,1,43
"25879",10501,"Grand Falls-Windsor","NL",48.92696,-55.65966,2018-12-15 01:00:00,40,1,41
"25880",10501,"Grand Falls-Windsor","NL",48.92696,-55.65966,2018-12-15 02:00:00,40,1,41
"25881",10501,"Grand Falls-Windsor","NL",48.92696,-55.65966,2018-12-15 03:00:00,39,1,40
"25882",10501,"Grand Falls-Windsor","NL",48.92696,-55.65966,2018-12-15 04:00:00,39,1,40
"25883",10501,"Grand Falls-Windsor","NL",48.92696,-55.65966,2018-12-15 05:00:00,38,1,39
"25884",10501,"Grand Falls-Windsor","NL",48.92696,-55.65966,2018-12-15 06:00:00,38,1,39
"25885",10501,"Grand Falls-Windsor","NL",48.92696,-55.65966,2018-12-15 07:00:00,38,1,39
"25886",10501,"Grand Falls-Windsor","NL",48.92696,-55.65966,2018-12-15 08:00:00,37,1,38
"25887",10501,"Grand Falls-Windsor","NL",48.92696,-55.65966,2018-12-15 09:00:00,37,1,38
"25888",10501,"Grand Falls-Windsor","NL",48.92696,-55.65966,2018-12-15 10:00:00,37,1,38
"25889",10501,"Grand Falls-Windsor","NL",48.92696,-55.65966,2018-12-15 11:00:00,36,1,37
"25890",10501,"Grand Falls-Windsor","NL",48.92696,-55.65966,2018-12-15 12:00:00,37,1,38
"25891",10501,"Grand Falls-Windsor","NL",48.92696,-55.65966,2018-12-15 13:00:00,37,1,38
"25892",10501,"Grand Falls-Windsor","NL",48.92696,-55.65966,2018-12-15 14:00:00,37,1,38
"25893",10501,"Grand Falls-Windsor","NL",48.92696,-55.65966,2018-12-15 15:00:00,35,2,37
"25894",10501,"Grand Falls-Windsor","NL",48.92696,-55.65966,2018-12-15 16:00:00,36,1,37
"25895",10501,"Grand Falls-Windsor","NL",48.92696,-55.65966,2018-12-15 17:00:00,34,1,35
"25896",10501,"Grand Falls-Windsor","NL",48.92696,-55.65966,2018-12-15 18:00:00,30,1,31
"25897",10501,"Grand Falls-Windsor","NL",48.92696,-55.65966,2018-12-15 19:00:00,30,1,31
"25898",10501,"Grand Falls-Windsor","NL",48.92696,-55.65966,2018-12-15 20:00:00,29,1,30
"25899",10501,"Grand Falls-Windsor","NL",48.92696,-55.65966,2018-12-15 21:00:00,29,1,30
"25900",10501,"Grand Falls-Windsor","NL",48.92696,-55.65966,2018-12-15 22:00:00,30,1,31
"25901",10501,"Grand Falls-Windsor","NL",48.92696,-55.65966,2018-12-15 23:00:00,30,1,31
"25902",10501,"Grand Falls-Windsor","NL",48.92696,-55.65966,2018-12-16 00:00:00,29,1,30
"25903",10501,"Grand Falls-Windsor","NL",48.92696,-55.65966,2018-12-16 01:00:00,29,1,30
"25904",10501,"Grand Falls-Windsor","NL",48.92696,-55.65966,2018-12-16 02:00:00,29,1,30
"25905",10501,"Grand Falls-Windsor","NL",48.92696,-55.65966,2018-12-16 03:00:00,29,0,29
"25906",10501,"Grand Falls-Windsor","NL",48.92696,-55.65966,2018-12-16 04:00:00,29,1,30
"25907",10501,"Grand Falls-Windsor","NL",48.92696,-55.65966,2018-12-16 05:00:00,29,1,30
"25908",10501,"Grand Falls-Windsor","NL",48.92696,-55.65966,2018-12-16 06:00:00,29,0,29
"25909",10501,"Grand Falls-Windsor","NL",48.92696,-55.65966,2018-12-16 07:00:00,30,1,31
"25910",10501,"Grand Falls-Windsor","NL",48.92696,-55.65966,2018-12-16 08:00:00,31,1,32
"25911",10501,"Grand Falls-Windsor","NL",48.92696,-55.65966,2018-12-16 09:00:00,32,1,33
"25912",10501,"Grand Falls-Windsor","NL",48.92696,-55.65966,2018-12-16 10:00:00,33,1,34
"25913",10501,"Grand Falls-Windsor","NL",48.92696,-55.65966,2018-12-16 11:00:00,33,1,34
"25914",10501,"Grand Falls-Windsor","NL",48.92696,-55.65966,2018-12-16 12:00:00,33,1,34
"25915",10501,"Grand Falls-Windsor","NL",48.92696,-55.65966,2018-12-16 13:00:00,33,1,34
"25916",10501,"Grand Falls-Windsor","NL",48.92696,-55.65966,2018-12-16 14:00:00,33,1,34
"25917",10501,"Grand Falls-Windsor","NL",48.92696,-55.65966,2018-12-16 15:00:00,33,1,34
"25918",10501,"Grand Falls-Windsor","NL",48.92696,-55.65966,2018-12-16 16:00:00,33,1,34
"25919",10501,"Grand Falls-Windsor","NL",48.92696,-55.65966,2018-12-16 17:00:00,32,2,34
"25920",10501,"Grand Falls-Windsor","NL",48.92696,-55.65966,2018-12-16 18:00:00,31,2,33
"25921",10501,"Grand Falls-Windsor","NL",48.92696,-55.65966,2018-12-16 19:00:00,32,2,34
"25922",10501,"Grand Falls-Windsor","NL",48.92696,-55.65966,2018-12-16 20:00:00,35,1,36
"25923",10501,"Grand Falls-Windsor","NL",48.92696,-55.65966,2018-12-16 21:00:00,37,1,38
"25924",10501,"Grand Falls-Windsor","NL",48.92696,-55.65966,2018-12-16 22:00:00,36,1,37
"25925",10501,"Grand Falls-Windsor","NL",48.92696,-55.65966,2018-12-16 23:00:00,36,1,37
"25926",10501,"Grand Falls-Windsor","NL",48.92696,-55.65966,2018-12-17 00:00:00,33,2,35
"25927",10501,"Grand Falls-Windsor","NL",48.92696,-55.65966,2018-12-17 01:00:00,29,4,33
"25928",10501,"Grand Falls-Windsor","NL",48.92696,-55.65966,2018-12-17 02:00:00,28,2,30
"25929",10501,"Grand Falls-Windsor","NL",48.92696,-55.65966,2018-12-17 03:00:00,27,2,29
"25930",10501,"Grand Falls-Windsor","NL",48.92696,-55.65966,2018-12-17 04:00:00,24,1,25
"25931",10501,"Grand Falls-Windsor","NL",48.92696,-55.65966,2018-12-17 05:00:00,25,2,27
"25932",10501,"Grand Falls-Windsor","NL",48.92696,-55.65966,2018-12-17 06:00:00,28,1,29
"25933",10501,"Grand Falls-Windsor","NL",48.92696,-55.65966,2018-12-17 07:00:00,24,4,28
"25934",10501,"Grand Falls-Windsor","NL",48.92696,-55.65966,2018-12-17 08:00:00,23,3,26
"25935",10501,"Grand Falls-Windsor","NL",48.92696,-55.65966,2018-12-17 09:00:00,21,5,26
"25936",10501,"Grand Falls-Windsor","NL",48.92696,-55.65966,2018-12-17 10:00:00,24,2,26
"25937",10501,"Grand Falls-Windsor","NL",48.92696,-55.65966,2018-12-17 11:00:00,27,1,28
"25938",10501,"Grand Falls-Windsor","NL",48.92696,-55.65966,2018-12-17 12:00:00,32,2,34
"25939",10501,"Grand Falls-Windsor","NL",48.92696,-55.65966,2018-12-17 13:00:00,38,1,39
"25940",10501,"Grand Falls-Windsor","NL",48.92696,-55.65966,2018-12-17 14:00:00,38,1,39
"25941",10501,"Grand Falls-Windsor","NL",48.92696,-55.65966,2018-12-17 15:00:00,37,2,39
"25942",10501,"Grand Falls-Windsor","NL",48.92696,-55.65966,2018-12-17 16:00:00,36,1,37
"25943",10501,"Grand Falls-Windsor","NL",48.92696,-55.65966,2018-12-17 17:00:00,35,1,36
"25944",10501,"Grand Falls-Windsor","NL",48.92696,-55.65966,2018-12-17 18:00:00,32,2,34
"25945",10501,"Grand Falls-Windsor","NL",48.92696,-55.65966,2018-12-17 19:00:00,30,4,34
"25946",10501,"Grand Falls-Windsor","NL",48.92696,-55.65966,2018-12-17 20:00:00,29,3,32
"25947",10501,"Grand Falls-Windsor","NL",48.92696,-55.65966,2018-12-17 21:00:00,28,4,32
"25948",10501,"Grand Falls-Windsor","NL",48.92696,-55.65966,2018-12-17 22:00:00,30,2,32
"25949",10501,"Grand Falls-Windsor","NL",48.92696,-55.65966,2018-12-17 23:00:00,29,3,32
"25950",10501,"Grand Falls-Windsor","NL",48.92696,-55.65966,2018-12-18 00:00:00,29,3,32
"25951",10501,"Grand Falls-Windsor","NL",48.92696,-55.65966,2018-12-18 01:00:00,31,2,33
"25952",10501,"Grand Falls-Windsor","NL",48.92696,-55.65966,2018-12-18 02:00:00,32,2,34
"25953",10501,"Grand Falls-Windsor","NL",48.92696,-55.65966,2018-12-18 03:00:00,33,2,35
"25954",10501,"Grand Falls-Windsor","NL",48.92696,-55.65966,2018-12-18 04:00:00,34,2,36
"25955",10501,"Grand Falls-Windsor","NL",48.92696,-55.65966,2018-12-18 05:00:00,35,2,37
"25956",10501,"Grand Falls-Windsor","NL",48.92696,-55.65966,2018-12-18 06:00:00,34,3,37
"25957",10501,"Grand Falls-Windsor","NL",48.92696,-55.65966,2018-12-18 07:00:00,34,3,37
"25958",10501,"Grand Falls-Windsor","NL",48.92696,-55.65966,2018-12-18 08:00:00,34,3,37
"25959",10501,"Grand Falls-Windsor","NL",48.92696,-55.65966,2018-12-18 09:00:00,34,4,38
"25960",10501,"Grand Falls-Windsor","NL",48.92696,-55.65966,2018-12-18 10:00:00,33,5,38
"25961",10501,"Grand Falls-Windsor","NL",48.92696,-55.65966,2018-12-18 11:00:00,31,7,38
"25962",10501,"Grand Falls-Windsor","NL",48.92696,-55.65966,2018-12-18 12:00:00,31,7,38
"25963",10501,"Grand Falls-Windsor","NL",48.92696,-55.65966,2018-12-18 13:00:00,34,2,36
"25964",10501,"Grand Falls-Windsor","NL",48.92696,-55.65966,2018-12-18 14:00:00,36,1,37
"25965",10501,"Grand Falls-Windsor","NL",48.92696,-55.65966,2018-12-18 15:00:00,34,1,35
"25966",10501,"Grand Falls-Windsor","NL",48.92696,-55.65966,2018-12-18 16:00:00,33,1,34
"25967",10501,"Grand Falls-Windsor","NL",48.92696,-55.65966,2018-12-18 17:00:00,32,1,33
"25968",10501,"Grand Falls-Windsor","NL",48.92696,-55.65966,2018-12-18 18:00:00,33,1,34
"25969",10501,"Grand Falls-Windsor","NL",48.92696,-55.65966,2018-12-18 19:00:00,34,1,35
"25970",10501,"Grand Falls-Windsor","NL",48.92696,-55.65966,2018-12-18 20:00:00,34,1,35
"25971",10501,"Grand Falls-Windsor","NL",48.92696,-55.65966,2018-12-18 21:00:00,35,0,35
"25972",10501,"Grand Falls-Windsor","NL",48.92696,-55.65966,2018-12-18 22:00:00,35,1,36
"25973",10501,"Grand Falls-Windsor","NL",48.92696,-55.65966,2018-12-18 23:00:00,34,1,35
"25974",10501,"Grand Falls-Windsor","NL",48.92696,-55.65966,2018-12-19 00:00:00,33,1,34
"25975",10501,"Grand Falls-Windsor","NL",48.92696,-55.65966,2018-12-19 01:00:00,33,1,34
"25976",10501,"Grand Falls-Windsor","NL",48.92696,-55.65966,2018-12-19 02:00:00,32,1,33
"25977",10501,"Grand Falls-Windsor","NL",48.92696,-55.65966,2018-12-19 03:00:00,31,1,32
"25978",10501,"Grand Falls-Windsor","NL",48.92696,-55.65966,2018-12-19 04:00:00,29,3,32
"25979",10501,"Grand Falls-Windsor","NL",48.92696,-55.65966,2018-12-19 05:00:00,27,2,29
"25980",10501,"Grand Falls-Windsor","NL",48.92696,-55.65966,2018-12-19 06:00:00,27,3,30
"25981",10501,"Grand Falls-Windsor","NL",48.92696,-55.65966,2018-12-19 07:00:00,27,1,28
"25982",10501,"Grand Falls-Windsor","NL",48.92696,-55.65966,2018-12-19 08:00:00,26,1,27
"25983",10501,"Grand Falls-Windsor","NL",48.92696,-55.65966,2018-12-19 09:00:00,27,1,28
"25984",10501,"Grand Falls-Windsor","NL",48.92696,-55.65966,2018-12-19 10:00:00,30,1,31
"25985",10501,"Grand Falls-Windsor","NL",48.92696,-55.65966,2018-12-19 11:00:00,30,1,31
"25986",10501,"Grand Falls-Windsor","NL",48.92696,-55.65966,2018-12-19 12:00:00,31,1,32
"25987",10501,"Grand Falls-Windsor","NL",48.92696,-55.65966,2018-12-19 13:00:00,32,1,33
"25988",10501,"Grand Falls-Windsor","NL",48.92696,-55.65966,2018-12-19 14:00:00,31,1,32
"25989",10501,"Grand Falls-Windsor","NL",48.92696,-55.65966,2018-12-19 15:00:00,31,1,32
"25990",10501,"Grand Falls-Windsor","NL",48.92696,-55.65966,2018-12-19 16:00:00,32,1,33
"25991",10501,"Grand Falls-Windsor","NL",48.92696,-55.65966,2018-12-19 17:00:00,33,0,33
"25992",10501,"Grand Falls-Windsor","NL",48.92696,-55.65966,2018-12-19 18:00:00,33,1,34
"25993",10501,"Grand Falls-Windsor","NL",48.92696,-55.65966,2018-12-19 19:00:00,34,1,35
"25994",10501,"Grand Falls-Windsor","NL",48.92696,-55.65966,2018-12-19 20:00:00,34,1,35
"25995",10501,"Grand Falls-Windsor","NL",48.92696,-55.65966,2018-12-19 21:00:00,34,1,35
"25996",10501,"Grand Falls-Windsor","NL",48.92696,-55.65966,2018-12-19 22:00:00,34,1,35
"25997",10501,"Grand Falls-Windsor","NL",48.92696,-55.65966,2018-12-19 23:00:00,34,0,34
"25998",10501,"Grand Falls-Windsor","NL",48.92696,-55.65966,2018-12-20 00:00:00,35,0,35
"25999",10501,"Grand Falls-Windsor","NL",48.92696,-55.65966,2018-12-20 01:00:00,34,1,35
"26000",10501,"Grand Falls-Windsor","NL",48.92696,-55.65966,2018-12-20 02:00:00,34,1,35
"26001",10501,"Grand Falls-Windsor","NL",48.92696,-55.65966,2018-12-20 03:00:00,34,1,35
"26002",10501,"Grand Falls-Windsor","NL",48.92696,-55.65966,2018-12-20 04:00:00,34,0,34
"26003",10501,"Grand Falls-Windsor","NL",48.92696,-55.65966,2018-12-20 05:00:00,34,0,34
"26004",10501,"Grand Falls-Windsor","NL",48.92696,-55.65966,2018-12-20 06:00:00,34,1,35
"26005",10501,"Grand Falls-Windsor","NL",48.92696,-55.65966,2018-12-20 07:00:00,34,0,34
"26006",10501,"Grand Falls-Windsor","NL",48.92696,-55.65966,2018-12-20 08:00:00,36,1,37
"26007",10501,"Grand Falls-Windsor","NL",48.92696,-55.65966,2018-12-20 09:00:00,38,1,39
"26008",10501,"Grand Falls-Windsor","NL",48.92696,-55.65966,2018-12-20 10:00:00,37,2,39
"26009",10501,"Grand Falls-Windsor","NL",48.92696,-55.65966,2018-12-20 11:00:00,37,3,40
"26010",10501,"Grand Falls-Windsor","NL",48.92696,-55.65966,2018-12-20 12:00:00,39,2,41
"26011",10501,"Grand Falls-Windsor","NL",48.92696,-55.65966,2018-12-20 13:00:00,39,1,40
"26012",10501,"Grand Falls-Windsor","NL",48.92696,-55.65966,2018-12-20 14:00:00,40,1,41
"26013",10501,"Grand Falls-Windsor","NL",48.92696,-55.65966,2018-12-20 15:00:00,40,1,41
"26014",10501,"Grand Falls-Windsor","NL",48.92696,-55.65966,2018-12-20 16:00:00,41,1,42
"26015",10501,"Grand Falls-Windsor","NL",48.92696,-55.65966,2018-12-20 17:00:00,42,0,42
"26016",10501,"Grand Falls-Windsor","NL",48.92696,-55.65966,2018-12-20 18:00:00,42,1,43
"26017",10501,"Grand Falls-Windsor","NL",48.92696,-55.65966,2018-12-20 19:00:00,42,1,43
"26018",10501,"Grand Falls-Windsor","NL",48.92696,-55.65966,2018-12-20 20:00:00,42,0,42
"26019",10501,"Grand Falls-Windsor","NL",48.92696,-55.65966,2018-12-20 21:00:00,41,1,42
"26020",10501,"Grand Falls-Windsor","NL",48.92696,-55.65966,2018-12-20 22:00:00,41,1,42
"26021",10501,"Grand Falls-Windsor","NL",48.92696,-55.65966,2018-12-20 23:00:00,41,1,42
"26022",10501,"Grand Falls-Windsor","NL",48.92696,-55.65966,2018-12-21 00:00:00,40,1,41
"26023",10501,"Grand Falls-Windsor","NL",48.92696,-55.65966,2018-12-21 01:00:00,39,1,40
"26024",10501,"Grand Falls-Windsor","NL",48.92696,-55.65966,2018-12-21 02:00:00,38,1,39
"26025",10501,"Grand Falls-Windsor","NL",48.92696,-55.65966,2018-12-21 03:00:00,39,1,40
"26026",10501,"Grand Falls-Windsor","NL",48.92696,-55.65966,2018-12-21 04:00:00,39,1,40
"26027",10501,"Grand Falls-Windsor","NL",48.92696,-55.65966,2018-12-21 05:00:00,39,1,40
"26028",10501,"Grand Falls-Windsor","NL",48.92696,-55.65966,2018-12-21 06:00:00,38,1,39
"26029",10501,"Grand Falls-Windsor","NL",48.92696,-55.65966,2018-12-21 07:00:00,39,1,40
"26030",10501,"Grand Falls-Windsor","NL",48.92696,-55.65966,2018-12-21 08:00:00,38,1,39
"26031",10501,"Grand Falls-Windsor","NL",48.92696,-55.65966,2018-12-21 09:00:00,38,1,39
"26032",10501,"Grand Falls-Windsor","NL",48.92696,-55.65966,2018-12-21 10:00:00,36,6,42
"26033",10501,"Grand Falls-Windsor","NL",48.92696,-55.65966,2018-12-21 11:00:00,35,4,39
"26034",10501,"Grand Falls-Windsor","NL",48.92696,-55.65966,2018-12-21 12:00:00,38,1,39
"26035",10501,"Grand Falls-Windsor","NL",48.92696,-55.65966,2018-12-21 13:00:00,39,1,40
"26036",10501,"Grand Falls-Windsor","NL",48.92696,-55.65966,2018-12-21 14:00:00,39,1,40
"26037",10501,"Grand Falls-Windsor","NL",48.92696,-55.65966,2018-12-21 15:00:00,38,1,39
"26038",10501,"Grand Falls-Windsor","NL",48.92696,-55.65966,2018-12-21 16:00:00,33,5,38
"26039",10501,"Grand Falls-Windsor","NL",48.92696,-55.65966,2018-12-21 17:00:00,22,12,34
"26040",10501,"Grand Falls-Windsor","NL",48.92696,-55.65966,2018-12-21 18:00:00,17,13,30
"26041",10501,"Grand Falls-Windsor","NL",48.92696,-55.65966,2018-12-21 19:00:00,20,6,26
"26042",10501,"Grand Falls-Windsor","NL",48.92696,-55.65966,2018-12-21 20:00:00,13,12,25
"26043",10501,"Grand Falls-Windsor","NL",48.92696,-55.65966,2018-12-21 21:00:00,12,10,22
"26044",10501,"Grand Falls-Windsor","NL",48.92696,-55.65966,2018-12-21 22:00:00,22,4,26
"26045",10501,"Grand Falls-Windsor","NL",48.92696,-55.65966,2018-12-21 23:00:00,22,2,24
"26046",10501,"Grand Falls-Windsor","NL",48.92696,-55.65966,2018-12-22 00:00:00,24,1,25
"26047",10501,"Grand Falls-Windsor","NL",48.92696,-55.65966,2018-12-22 01:00:00,23,2,25
"26048",10501,"Grand Falls-Windsor","NL",48.92696,-55.65966,2018-12-22 02:00:00,25,2,27
"26049",10501,"Grand Falls-Windsor","NL",48.92696,-55.65966,2018-12-22 03:00:00,26,1,27
"26050",10501,"Grand Falls-Windsor","NL",48.92696,-55.65966,2018-12-22 04:00:00,29,1,30
"26051",10501,"Grand Falls-Windsor","NL",48.92696,-55.65966,2018-12-22 05:00:00,28,1,29
"26052",10501,"Grand Falls-Windsor","NL",48.92696,-55.65966,2018-12-22 06:00:00,30,1,31
"26053",10501,"Grand Falls-Windsor","NL",48.92696,-55.65966,2018-12-22 07:00:00,30,0,30
"26054",10501,"Grand Falls-Windsor","NL",48.92696,-55.65966,2018-12-22 08:00:00,32,0,32
"26055",10501,"Grand Falls-Windsor","NL",48.92696,-55.65966,2018-12-22 09:00:00,34,0,34
"26056",10501,"Grand Falls-Windsor","NL",48.92696,-55.65966,2018-12-22 10:00:00,34,1,35
"26057",10501,"Grand Falls-Windsor","NL",48.92696,-55.65966,2018-12-22 11:00:00,34,0,34
"26058",10501,"Grand Falls-Windsor","NL",48.92696,-55.65966,2018-12-22 12:00:00,35,1,36
"26059",10501,"Grand Falls-Windsor","NL",48.92696,-55.65966,2018-12-22 13:00:00,37,1,38
"26060",10501,"Grand Falls-Windsor","NL",48.92696,-55.65966,2018-12-22 14:00:00,38,1,39
"26061",10501,"Grand Falls-Windsor","NL",48.92696,-55.65966,2018-12-22 15:00:00,38,1,39
"26062",10501,"Grand Falls-Windsor","NL",48.92696,-55.65966,2018-12-22 16:00:00,37,0,37
"26063",10501,"Grand Falls-Windsor","NL",48.92696,-55.65966,2018-12-22 17:00:00,37,1,38
"26064",10501,"Grand Falls-Windsor","NL",48.92696,-55.65966,2018-12-22 18:00:00,39,1,40
"26065",10501,"Grand Falls-Windsor","NL",48.92696,-55.65966,2018-12-22 19:00:00,40,0,40
"26066",10501,"Grand Falls-Windsor","NL",48.92696,-55.65966,2018-12-22 20:00:00,40,1,41
"26067",10501,"Grand Falls-Windsor","NL",48.92696,-55.65966,2018-12-22 21:00:00,40,1,41
"26068",10501,"Grand Falls-Windsor","NL",48.92696,-55.65966,2018-12-22 22:00:00,40,1,41
"26069",10501,"Grand Falls-Windsor","NL",48.92696,-55.65966,2018-12-22 23:00:00,39,1,40
"26070",10501,"Grand Falls-Windsor","NL",48.92696,-55.65966,2018-12-23 00:00:00,40,0,40
"26071",10501,"Grand Falls-Windsor","NL",48.92696,-55.65966,2018-12-23 01:00:00,40,1,41
"26072",10501,"Grand Falls-Windsor","NL",48.92696,-55.65966,2018-12-23 02:00:00,40,1,41
"26073",10501,"Grand Falls-Windsor","NL",48.92696,-55.65966,2018-12-23 03:00:00,40,1,41
"26074",10501,"Grand Falls-Windsor","NL",48.92696,-55.65966,2018-12-23 04:00:00,39,1,40
"26075",10501,"Grand Falls-Windsor","NL",48.92696,-55.65966,2018-12-23 05:00:00,38,1,39
"26076",10501,"Grand Falls-Windsor","NL",48.92696,-55.65966,2018-12-23 06:00:00,39,1,40
"26077",10501,"Grand Falls-Windsor","NL",48.92696,-55.65966,2018-12-23 07:00:00,42,0,42
"26078",10501,"Grand Falls-Windsor","NL",48.92696,-55.65966,2018-12-23 08:00:00,42,0,42
"26079",10501,"Grand Falls-Windsor","NL",48.92696,-55.65966,2018-12-23 09:00:00,40,1,41
"26080",10501,"Grand Falls-Windsor","NL",48.92696,-55.65966,2018-12-23 10:00:00,38,1,39
"26081",10501,"Grand Falls-Windsor","NL",48.92696,-55.65966,2018-12-23 11:00:00,38,1,39
"26082",10501,"Grand Falls-Windsor","NL",48.92696,-55.65966,2018-12-23 12:00:00,38,1,39
"26083",10501,"Grand Falls-Windsor","NL",48.92696,-55.65966,2018-12-23 13:00:00,37,1,38
"26084",10501,"Grand Falls-Windsor","NL",48.92696,-55.65966,2018-12-23 14:00:00,34,1,35
"26085",10501,"Grand Falls-Windsor","NL",48.92696,-55.65966,2018-12-23 15:00:00,31,1,32
"26086",10501,"Grand Falls-Windsor","NL",48.92696,-55.65966,2018-12-23 16:00:00,25,1,26
"26087",10501,"Grand Falls-Windsor","NL",48.92696,-55.65966,2018-12-23 17:00:00,24,1,25
"26088",10501,"Grand Falls-Windsor","NL",48.92696,-55.65966,2018-12-23 18:00:00,32,1,33
"26089",10501,"Grand Falls-Windsor","NL",48.92696,-55.65966,2018-12-23 19:00:00,35,1,36
"26090",10501,"Grand Falls-Windsor","NL",48.92696,-55.65966,2018-12-23 20:00:00,36,0,36
"26091",10501,"Grand Falls-Windsor","NL",48.92696,-55.65966,2018-12-23 21:00:00,36,1,37
"26092",10501,"Grand Falls-Windsor","NL",48.92696,-55.65966,2018-12-23 22:00:00,38,1,39
"26093",10501,"Grand Falls-Windsor","NL",48.92696,-55.65966,2018-12-23 23:00:00,38,1,39
"26094",10501,"Grand Falls-Windsor","NL",48.92696,-55.65966,2018-12-24 00:00:00,38,1,39
"26095",10501,"Grand Falls-Windsor","NL",48.92696,-55.65966,2018-12-24 01:00:00,38,1,39
"26096",10501,"Grand Falls-Windsor","NL",48.92696,-55.65966,2018-12-24 02:00:00,39,0,39
"26097",10501,"Grand Falls-Windsor","NL",48.92696,-55.65966,2018-12-24 03:00:00,39,1,40
"26098",10501,"Grand Falls-Windsor","NL",48.92696,-55.65966,2018-12-24 04:00:00,39,1,40
"26099",10501,"Grand Falls-Windsor","NL",48.92696,-55.65966,2018-12-24 05:00:00,39,1,40
"26100",10501,"Grand Falls-Windsor","NL",48.92696,-55.65966,2018-12-24 06:00:00,40,1,41
"26101",10501,"Grand Falls-Windsor","NL",48.92696,-55.65966,2018-12-24 07:00:00,41,1,42
"26102",10501,"Grand Falls-Windsor","NL",48.92696,-55.65966,2018-12-24 08:00:00,41,1,42
"26103",10501,"Grand Falls-Windsor","NL",48.92696,-55.65966,2018-12-24 09:00:00,41,2,43
"26104",10501,"Grand Falls-Windsor","NL",48.92696,-55.65966,2018-12-24 10:00:00,43,1,44
"26105",10501,"Grand Falls-Windsor","NL",48.92696,-55.65966,2018-12-24 11:00:00,42,1,43
"26106",10501,"Grand Falls-Windsor","NL",48.92696,-55.65966,2018-12-24 12:00:00,43,1,44
"26107",10501,"Grand Falls-Windsor","NL",48.92696,-55.65966,2018-12-24 13:00:00,43,1,44
"26108",10501,"Grand Falls-Windsor","NL",48.92696,-55.65966,2018-12-24 14:00:00,43,1,44
"26109",10501,"Grand Falls-Windsor","NL",48.92696,-55.65966,2018-12-24 15:00:00,43,1,44
"26110",10501,"Grand Falls-Windsor","NL",48.92696,-55.65966,2018-12-24 16:00:00,43,1,44
"26111",10501,"Grand Falls-Windsor","NL",48.92696,-55.65966,2018-12-24 17:00:00,43,1,44
"26112",10501,"Grand Falls-Windsor","NL",48.92696,-55.65966,2018-12-24 18:00:00,43,1,44
"26113",10501,"Grand Falls-Windsor","NL",48.92696,-55.65966,2018-12-24 19:00:00,43,1,44
"26114",10501,"Grand Falls-Windsor","NL",48.92696,-55.65966,2018-12-24 20:00:00,41,0,41
"26115",10501,"Grand Falls-Windsor","NL",48.92696,-55.65966,2018-12-24 21:00:00,41,1,42
"26116",10501,"Grand Falls-Windsor","NL",48.92696,-55.65966,2018-12-24 22:00:00,42,0,42
"26117",10501,"Grand Falls-Windsor","NL",48.92696,-55.65966,2018-12-24 23:00:00,42,1,43
"26118",10501,"Grand Falls-Windsor","NL",48.92696,-55.65966,2018-12-25 00:00:00,43,1,44
"26119",10501,"Grand Falls-Windsor","NL",48.92696,-55.65966,2018-12-25 01:00:00,43,1,44
"26120",10501,"Grand Falls-Windsor","NL",48.92696,-55.65966,2018-12-25 02:00:00,43,1,44
"26121",10501,"Grand Falls-Windsor","NL",48.92696,-55.65966,2018-12-25 03:00:00,43,0,43
"26122",10501,"Grand Falls-Windsor","NL",48.92696,-55.65966,2018-12-25 04:00:00,43,0,43
"26123",10501,"Grand Falls-Windsor","NL",48.92696,-55.65966,2018-12-25 05:00:00,43,0,43
"26124",10501,"Grand Falls-Windsor","NL",48.92696,-55.65966,2018-12-25 06:00:00,43,1,44
"26125",10501,"Grand Falls-Windsor","NL",48.92696,-55.65966,2018-12-25 07:00:00,43,0,43
"26126",10501,"Grand Falls-Windsor","NL",48.92696,-55.65966,2018-12-25 08:00:00,42,1,43
"26127",10501,"Grand Falls-Windsor","NL",48.92696,-55.65966,2018-12-25 09:00:00,42,1,43
"26128",10501,"Grand Falls-Windsor","NL",48.92696,-55.65966,2018-12-25 10:00:00,41,1,42
"26129",10501,"Grand Falls-Windsor","NL",48.92696,-55.65966,2018-12-25 11:00:00,41,1,42
"26130",10501,"Grand Falls-Windsor","NL",48.92696,-55.65966,2018-12-25 12:00:00,42,1,43
"26131",10501,"Grand Falls-Windsor","NL",48.92696,-55.65966,2018-12-25 13:00:00,42,1,43
"26132",10501,"Grand Falls-Windsor","NL",48.92696,-55.65966,2018-12-25 14:00:00,43,0,43
"26133",10501,"Grand Falls-Windsor","NL",48.92696,-55.65966,2018-12-25 15:00:00,43,0,43
"26134",10501,"Grand Falls-Windsor","NL",48.92696,-55.65966,2018-12-25 16:00:00,42,1,43
"26135",10501,"Grand Falls-Windsor","NL",48.92696,-55.65966,2018-12-25 17:00:00,42,1,43
"26136",10501,"Grand Falls-Windsor","NL",48.92696,-55.65966,2018-12-25 18:00:00,42,0,42
"26137",10501,"Grand Falls-Windsor","NL",48.92696,-55.65966,2018-12-25 19:00:00,42,1,43
"26138",10501,"Grand Falls-Windsor","NL",48.92696,-55.65966,2018-12-25 20:00:00,41,0,41
"26139",10501,"Grand Falls-Windsor","NL",48.92696,-55.65966,2018-12-25 21:00:00,41,0,41
"26140",10501,"Grand Falls-Windsor","NL",48.92696,-55.65966,2018-12-25 22:00:00,41,0,41
"26141",10501,"Grand Falls-Windsor","NL",48.92696,-55.65966,2018-12-25 23:00:00,42,1,43
"26142",10501,"Grand Falls-Windsor","NL",48.92696,-55.65966,2018-12-26 00:00:00,43,1,44
"26143",10501,"Grand Falls-Windsor","NL",48.92696,-55.65966,2018-12-26 01:00:00,43,1,44
"26144",10501,"Grand Falls-Windsor","NL",48.92696,-55.65966,2018-12-26 02:00:00,43,1,44
"26145",10501,"Grand Falls-Windsor","NL",48.92696,-55.65966,2018-12-26 03:00:00,45,1,46
"26146",10501,"Grand Falls-Windsor","NL",48.92696,-55.65966,2018-12-26 04:00:00,45,1,46
"26147",10501,"Grand Falls-Windsor","NL",48.92696,-55.65966,2018-12-26 05:00:00,45,1,46
"26148",10501,"Grand Falls-Windsor","NL",48.92696,-55.65966,2018-12-26 06:00:00,45,1,46
"26149",10501,"Grand Falls-Windsor","NL",48.92696,-55.65966,2018-12-26 07:00:00,45,1,46
"26150",10501,"Grand Falls-Windsor","NL",48.92696,-55.65966,2018-12-26 08:00:00,45,0,45
"26151",10501,"Grand Falls-Windsor","NL",48.92696,-55.65966,2018-12-26 09:00:00,41,7,48
"26152",10501,"Grand Falls-Windsor","NL",48.92696,-55.65966,2018-12-26 10:00:00,44,1,45
"26153",10501,"Grand Falls-Windsor","NL",48.92696,-55.65966,2018-12-26 11:00:00,44,1,45
"26154",10501,"Grand Falls-Windsor","NL",48.92696,-55.65966,2018-12-26 12:00:00,44,0,44
"26155",10501,"Grand Falls-Windsor","NL",48.92696,-55.65966,2018-12-26 13:00:00,44,1,45
"26156",10501,"Grand Falls-Windsor","NL",48.92696,-55.65966,2018-12-26 14:00:00,44,1,45
"26157",10501,"Grand Falls-Windsor","NL",48.92696,-55.65966,2018-12-26 15:00:00,44,1,45
"26158",10501,"Grand Falls-Windsor","NL",48.92696,-55.65966,2018-12-26 16:00:00,44,1,45
"26159",10501,"Grand Falls-Windsor","NL",48.92696,-55.65966,2018-12-26 17:00:00,44,1,45
"26160",10501,"Grand Falls-Windsor","NL",48.92696,-55.65966,2018-12-26 18:00:00,44,1,45
"26161",10501,"Grand Falls-Windsor","NL",48.92696,-55.65966,2018-12-26 19:00:00,44,1,45
"26162",10501,"Grand Falls-Windsor","NL",48.92696,-55.65966,2018-12-26 20:00:00,44,1,45
"26163",10501,"Grand Falls-Windsor","NL",48.92696,-55.65966,2018-12-26 21:00:00,45,1,46
"26164",10501,"Grand Falls-Windsor","NL",48.92696,-55.65966,2018-12-26 22:00:00,44,0,44
"26165",10501,"Grand Falls-Windsor","NL",48.92696,-55.65966,2018-12-26 23:00:00,42,1,43
"26166",10501,"Grand Falls-Windsor","NL",48.92696,-55.65966,2018-12-27 00:00:00,39,1,40
"26167",10501,"Grand Falls-Windsor","NL",48.92696,-55.65966,2018-12-27 01:00:00,37,1,38
"26168",10501,"Grand Falls-Windsor","NL",48.92696,-55.65966,2018-12-27 02:00:00,36,1,37
"26169",10501,"Grand Falls-Windsor","NL",48.92696,-55.65966,2018-12-27 03:00:00,34,1,35
"26170",10501,"Grand Falls-Windsor","NL",48.92696,-55.65966,2018-12-27 04:00:00,36,1,37
"26171",10501,"Grand Falls-Windsor","NL",48.92696,-55.65966,2018-12-27 05:00:00,37,1,38
"26172",10501,"Grand Falls-Windsor","NL",48.92696,-55.65966,2018-12-27 06:00:00,40,1,41
"26173",10501,"Grand Falls-Windsor","NL",48.92696,-55.65966,2018-12-27 07:00:00,40,1,41
"26174",10501,"Grand Falls-Windsor","NL",48.92696,-55.65966,2018-12-27 08:00:00,40,1,41
"26175",10501,"Grand Falls-Windsor","NL",48.92696,-55.65966,2018-12-27 09:00:00,41,1,42
"26176",10501,"Grand Falls-Windsor","NL",48.92696,-55.65966,2018-12-27 10:00:00,40,2,42
"26177",10501,"Grand Falls-Windsor","NL",48.92696,-55.65966,2018-12-27 11:00:00,41,1,42
"26178",10501,"Grand Falls-Windsor","NL",48.92696,-55.65966,2018-12-27 12:00:00,43,1,44
"26179",10501,"Grand Falls-Windsor","NL",48.92696,-55.65966,2018-12-27 13:00:00,43,1,44
"26180",10501,"Grand Falls-Windsor","NL",48.92696,-55.65966,2018-12-27 14:00:00,43,1,44
"26181",10501,"Grand Falls-Windsor","NL",48.92696,-55.65966,2018-12-27 15:00:00,43,1,44
"26182",10501,"Grand Falls-Windsor","NL",48.92696,-55.65966,2018-12-27 16:00:00,43,1,44
"26183",10501,"Grand Falls-Windsor","NL",48.92696,-55.65966,2018-12-27 17:00:00,42,1,43
"26184",10501,"Grand Falls-Windsor","NL",48.92696,-55.65966,2018-12-27 18:00:00,41,1,42
"26185",10501,"Grand Falls-Windsor","NL",48.92696,-55.65966,2018-12-27 19:00:00,41,1,42
"26186",10501,"Grand Falls-Windsor","NL",48.92696,-55.65966,2018-12-27 20:00:00,40,1,41
"26187",10501,"Grand Falls-Windsor","NL",48.92696,-55.65966,2018-12-27 21:00:00,39,1,40
"26188",10501,"Grand Falls-Windsor","NL",48.92696,-55.65966,2018-12-27 22:00:00,38,1,39
"26189",10501,"Grand Falls-Windsor","NL",48.92696,-55.65966,2018-12-27 23:00:00,34,1,35
"26190",10501,"Grand Falls-Windsor","NL",48.92696,-55.65966,2018-12-28 00:00:00,31,1,32
"26191",10501,"Grand Falls-Windsor","NL",48.92696,-55.65966,2018-12-28 01:00:00,31,1,32
"26192",10501,"Grand Falls-Windsor","NL",48.92696,-55.65966,2018-12-28 02:00:00,31,1,32
"26193",10501,"Grand Falls-Windsor","NL",48.92696,-55.65966,2018-12-28 03:00:00,34,0,34
"26194",10501,"Grand Falls-Windsor","NL",48.92696,-55.65966,2018-12-28 04:00:00,35,0,35
"26195",10501,"Grand Falls-Windsor","NL",48.92696,-55.65966,2018-12-28 05:00:00,35,1,36
"26196",10501,"Grand Falls-Windsor","NL",48.92696,-55.65966,2018-12-28 06:00:00,34,1,35
"26197",10501,"Grand Falls-Windsor","NL",48.92696,-55.65966,2018-12-28 07:00:00,32,1,33
"26198",10501,"Grand Falls-Windsor","NL",48.92696,-55.65966,2018-12-28 08:00:00,29,0,29
"26199",10501,"Grand Falls-Windsor","NL",48.92696,-55.65966,2018-12-28 09:00:00,31,1,32
"26200",10501,"Grand Falls-Windsor","NL",48.92696,-55.65966,2018-12-28 10:00:00,31,3,34
"26201",10501,"Grand Falls-Windsor","NL",48.92696,-55.65966,2018-12-28 11:00:00,37,1,38
"26202",10501,"Grand Falls-Windsor","NL",48.92696,-55.65966,2018-12-28 12:00:00,33,12,45
"26203",10501,"Grand Falls-Windsor","NL",48.92696,-55.65966,2018-12-28 13:00:00,39,1,40
"26204",10501,"Grand Falls-Windsor","NL",48.92696,-55.65966,2018-12-28 14:00:00,39,1,40
"26205",10501,"Grand Falls-Windsor","NL",48.92696,-55.65966,2018-12-28 15:00:00,40,1,41
"26206",10501,"Grand Falls-Windsor","NL",48.92696,-55.65966,2018-12-28 16:00:00,40,1,41
"26207",10501,"Grand Falls-Windsor","NL",48.92696,-55.65966,2018-12-28 17:00:00,40,1,41
"26208",10501,"Grand Falls-Windsor","NL",48.92696,-55.65966,2018-12-28 18:00:00,39,1,40
"26209",10501,"Grand Falls-Windsor","NL",48.92696,-55.65966,2018-12-28 19:00:00,37,1,38
"26210",10501,"Grand Falls-Windsor","NL",48.92696,-55.65966,2018-12-28 20:00:00,36,1,37
"26211",10501,"Grand Falls-Windsor","NL",48.92696,-55.65966,2018-12-28 21:00:00,36,1,37
"26212",10501,"Grand Falls-Windsor","NL",48.92696,-55.65966,2018-12-28 22:00:00,34,1,35
"26213",10501,"Grand Falls-Windsor","NL",48.92696,-55.65966,2018-12-28 23:00:00,31,2,33
"26214",10501,"Grand Falls-Windsor","NL",48.92696,-55.65966,2018-12-29 00:00:00,33,1,34
"26215",10501,"Grand Falls-Windsor","NL",48.92696,-55.65966,2018-12-29 01:00:00,32,1,33
"26216",10501,"Grand Falls-Windsor","NL",48.92696,-55.65966,2018-12-29 02:00:00,31,1,32
"26217",10501,"Grand Falls-Windsor","NL",48.92696,-55.65966,2018-12-29 03:00:00,32,1,33
"26218",10501,"Grand Falls-Windsor","NL",48.92696,-55.65966,2018-12-29 04:00:00,34,1,35
"26219",10501,"Grand Falls-Windsor","NL",48.92696,-55.65966,2018-12-29 05:00:00,35,1,36
"26220",10501,"Grand Falls-Windsor","NL",48.92696,-55.65966,2018-12-29 06:00:00,35,0,35
"26221",10501,"Grand Falls-Windsor","NL",48.92696,-55.65966,2018-12-29 07:00:00,36,1,37
"26222",10501,"Grand Falls-Windsor","NL",48.92696,-55.65966,2018-12-29 08:00:00,36,1,37
"26223",10501,"Grand Falls-Windsor","NL",48.92696,-55.65966,2018-12-29 09:00:00,37,1,38
"26224",10501,"Grand Falls-Windsor","NL",48.92696,-55.65966,2018-12-29 10:00:00,36,0,36
"26225",10501,"Grand Falls-Windsor","NL",48.92696,-55.65966,2018-12-29 11:00:00,36,1,37
"26226",10501,"Grand Falls-Windsor","NL",48.92696,-55.65966,2018-12-29 12:00:00,38,1,39
"26227",10501,"Grand Falls-Windsor","NL",48.92696,-55.65966,2018-12-29 13:00:00,39,1,40
"26228",10501,"Grand Falls-Windsor","NL",48.92696,-55.65966,2018-12-29 14:00:00,38,1,39
"26229",10501,"Grand Falls-Windsor","NL",48.92696,-55.65966,2018-12-29 15:00:00,39,1,40
"26230",10501,"Grand Falls-Windsor","NL",48.92696,-55.65966,2018-12-29 16:00:00,38,1,39
"26231",10501,"Grand Falls-Windsor","NL",48.92696,-55.65966,2018-12-29 17:00:00,38,2,40
"26232",10501,"Grand Falls-Windsor","NL",48.92696,-55.65966,2018-12-29 18:00:00,38,1,39
"26233",10501,"Grand Falls-Windsor","NL",48.92696,-55.65966,2018-12-29 19:00:00,35,4,39
"26234",10501,"Grand Falls-Windsor","NL",48.92696,-55.65966,2018-12-29 20:00:00,35,3,38
"26235",10501,"Grand Falls-Windsor","NL",48.92696,-55.65966,2018-12-29 21:00:00,34,3,37
"26236",10501,"Grand Falls-Windsor","NL",48.92696,-55.65966,2018-12-29 22:00:00,33,3,36
"26237",10501,"Grand Falls-Windsor","NL",48.92696,-55.65966,2018-12-29 23:00:00,34,3,37
"26238",10501,"Grand Falls-Windsor","NL",48.92696,-55.65966,2018-12-30 00:00:00,34,2,36
"26239",10501,"Grand Falls-Windsor","NL",48.92696,-55.65966,2018-12-30 01:00:00,32,3,35
"26240",10501,"Grand Falls-Windsor","NL",48.92696,-55.65966,2018-12-30 02:00:00,33,2,35
"26241",10501,"Grand Falls-Windsor","NL",48.92696,-55.65966,2018-12-30 03:00:00,32,3,35
"26242",10501,"Grand Falls-Windsor","NL",48.92696,-55.65966,2018-12-30 04:00:00,33,2,35
"26243",10501,"Grand Falls-Windsor","NL",48.92696,-55.65966,2018-12-30 05:00:00,33,2,35
"26244",10501,"Grand Falls-Windsor","NL",48.92696,-55.65966,2018-12-30 06:00:00,30,5,35
"26245",10501,"Grand Falls-Windsor","NL",48.92696,-55.65966,2018-12-30 07:00:00,34,1,35
"26246",10501,"Grand Falls-Windsor","NL",48.92696,-55.65966,2018-12-30 08:00:00,34,1,35
"26247",10501,"Grand Falls-Windsor","NL",48.92696,-55.65966,2018-12-30 09:00:00,35,1,36
"26248",10501,"Grand Falls-Windsor","NL",48.92696,-55.65966,2018-12-30 10:00:00,34,1,35
"26249",10501,"Grand Falls-Windsor","NL",48.92696,-55.65966,2018-12-30 11:00:00,34,1,35
"26250",10501,"Grand Falls-Windsor","NL",48.92696,-55.65966,2018-12-30 12:00:00,35,1,36
"26251",10501,"Grand Falls-Windsor","NL",48.92696,-55.65966,2018-12-30 13:00:00,35,1,36
"26252",10501,"Grand Falls-Windsor","NL",48.92696,-55.65966,2018-12-30 14:00:00,35,1,36
"26253",10501,"Grand Falls-Windsor","NL",48.92696,-55.65966,2018-12-30 15:00:00,35,1,36
"26254",10501,"Grand Falls-Windsor","NL",48.92696,-55.65966,2018-12-30 16:00:00,39,1,40
"26255",10501,"Grand Falls-Windsor","NL",48.92696,-55.65966,2018-12-30 17:00:00,38,1,39
"26256",10501,"Grand Falls-Windsor","NL",48.92696,-55.65966,2018-12-30 18:00:00,38,1,39
"26257",10501,"Grand Falls-Windsor","NL",48.92696,-55.65966,2018-12-30 19:00:00,38,1,39
"26258",10501,"Grand Falls-Windsor","NL",48.92696,-55.65966,2018-12-30 20:00:00,37,1,38
"26259",10501,"Grand Falls-Windsor","NL",48.92696,-55.65966,2018-12-30 21:00:00,38,1,39
"26260",10501,"Grand Falls-Windsor","NL",48.92696,-55.65966,2018-12-30 22:00:00,37,1,38
"26261",10501,"Grand Falls-Windsor","NL",48.92696,-55.65966,2018-12-30 23:00:00,37,1,38
"26262",10501,"Grand Falls-Windsor","NL",48.92696,-55.65966,2018-12-31 00:00:00,39,1,40
"26263",10501,"Grand Falls-Windsor","NL",48.92696,-55.65966,2018-12-31 01:00:00,38,1,39
"26264",10501,"Grand Falls-Windsor","NL",48.92696,-55.65966,2018-12-31 02:00:00,38,1,39
"26265",10501,"Grand Falls-Windsor","NL",48.92696,-55.65966,2018-12-31 03:00:00,38,0,38
"26266",10501,"Grand Falls-Windsor","NL",48.92696,-55.65966,2018-12-31 04:00:00,37,2,39
"26267",10501,"Grand Falls-Windsor","NL",48.92696,-55.65966,2018-12-31 05:00:00,36,3,39
"26268",10501,"Grand Falls-Windsor","NL",48.92696,-55.65966,2018-12-31 06:00:00,38,1,39
"26269",10501,"Grand Falls-Windsor","NL",48.92696,-55.65966,2018-12-31 07:00:00,38,1,39
"26270",10501,"Grand Falls-Windsor","NL",48.92696,-55.65966,2018-12-31 08:00:00,38,1,39
"26271",10501,"Grand Falls-Windsor","NL",48.92696,-55.65966,2018-12-31 09:00:00,37,1,38
"26272",10501,"Grand Falls-Windsor","NL",48.92696,-55.65966,2018-12-31 10:00:00,37,2,39
"26273",10501,"Grand Falls-Windsor","NL",48.92696,-55.65966,2018-12-31 11:00:00,38,1,39
"26274",10501,"Grand Falls-Windsor","NL",48.92696,-55.65966,2018-12-31 12:00:00,39,1,40
"26275",10501,"Grand Falls-Windsor","NL",48.92696,-55.65966,2018-12-31 13:00:00,39,1,40
"26276",10501,"Grand Falls-Windsor","NL",48.92696,-55.65966,2018-12-31 14:00:00,41,1,42
"26277",10501,"Grand Falls-Windsor","NL",48.92696,-55.65966,2018-12-31 15:00:00,41,1,42
"26278",10501,"Grand Falls-Windsor","NL",48.92696,-55.65966,2018-12-31 16:00:00,41,1,42
"26279",10501,"Grand Falls-Windsor","NL",48.92696,-55.65966,2018-12-31 17:00:00,41,1,42
"26280",10501,"Grand Falls-Windsor","NL",48.92696,-55.65966,2018-12-31 18:00:00,40,1,41
"26281",10501,"Grand Falls-Windsor","NL",48.92696,-55.65966,2018-12-31 19:00:00,40,1,41
"26282",10501,"Grand Falls-Windsor","NL",48.92696,-55.65966,2018-12-31 20:00:00,40,1,41
"26283",10501,"Grand Falls-Windsor","NL",48.92696,-55.65966,2018-12-31 21:00:00,38,1,39
"26284",10501,"Grand Falls-Windsor","NL",48.92696,-55.65966,2018-12-31 22:00:00,35,2,37
"26285",10501,"Grand Falls-Windsor","NL",48.92696,-55.65966,2018-12-31 23:00:00,32,2,34
"26286",10501,"Grand Falls-Windsor","NL",48.92696,-55.65966,2019-01-01 00:00:00,26,8,34
"26287",10602,"Corner Brook","NL",48.95224,-57.92207,2018-01-01 01:00:00,34,1,35
"26288",10602,"Corner Brook","NL",48.95224,-57.92207,2018-01-01 02:00:00,34,1,35
"26289",10602,"Corner Brook","NL",48.95224,-57.92207,2018-01-01 03:00:00,32,2,34
"26290",10602,"Corner Brook","NL",48.95224,-57.92207,2018-01-01 04:00:00,32,1,33
"26291",10602,"Corner Brook","NL",48.95224,-57.92207,2018-01-01 05:00:00,32,1,33
"26292",10602,"Corner Brook","NL",48.95224,-57.92207,2018-01-01 06:00:00,32,1,33
"26293",10602,"Corner Brook","NL",48.95224,-57.92207,2018-01-01 07:00:00,28,3,31
"26294",10602,"Corner Brook","NL",48.95224,-57.92207,2018-01-01 08:00:00,28,4,32
"26295",10602,"Corner Brook","NL",48.95224,-57.92207,2018-01-01 09:00:00,29,3,32
"26296",10602,"Corner Brook","NL",48.95224,-57.92207,2018-01-01 10:00:00,32,2,34
"26297",10602,"Corner Brook","NL",48.95224,-57.92207,2018-01-01 11:00:00,33,1,34
"26298",10602,"Corner Brook","NL",48.95224,-57.92207,2018-01-01 12:00:00,32,2,34
"26299",10602,"Corner Brook","NL",48.95224,-57.92207,2018-01-01 13:00:00,33,2,35
"26300",10602,"Corner Brook","NL",48.95224,-57.92207,2018-01-01 14:00:00,30,7,37
"26301",10602,"Corner Brook","NL",48.95224,-57.92207,2018-01-01 15:00:00,37,1,38
"26302",10602,"Corner Brook","NL",48.95224,-57.92207,2018-01-01 16:00:00,37,1,38
"26303",10602,"Corner Brook","NL",48.95224,-57.92207,2018-01-01 17:00:00,34,4,38
"26304",10602,"Corner Brook","NL",48.95224,-57.92207,2018-01-01 18:00:00,34,4,38
"26305",10602,"Corner Brook","NL",48.95224,-57.92207,2018-01-01 19:00:00,34,3,37
"26306",10602,"Corner Brook","NL",48.95224,-57.92207,2018-01-01 20:00:00,30,5,35
"26307",10602,"Corner Brook","NL",48.95224,-57.92207,2018-01-01 21:00:00,30,5,35
"26308",10602,"Corner Brook","NL",48.95224,-57.92207,2018-01-01 22:00:00,30,4,34
"26309",10602,"Corner Brook","NL",48.95224,-57.92207,2018-01-01 23:00:00,32,4,36
"26310",10602,"Corner Brook","NL",48.95224,-57.92207,2018-01-02 00:00:00,34,3,37
"26311",10602,"Corner Brook","NL",48.95224,-57.92207,2018-01-02 01:00:00,30,3,33
"26312",10602,"Corner Brook","NL",48.95224,-57.92207,2018-01-02 02:00:00,31,3,34
"26313",10602,"Corner Brook","NL",48.95224,-57.92207,2018-01-02 03:00:00,31,5,36
"26314",10602,"Corner Brook","NL",48.95224,-57.92207,2018-01-02 04:00:00,30,4,34
"26315",10602,"Corner Brook","NL",48.95224,-57.92207,2018-01-02 05:00:00,31,5,36
"26316",10602,"Corner Brook","NL",48.95224,-57.92207,2018-01-02 06:00:00,35,1,36
"26317",10602,"Corner Brook","NL",48.95224,-57.92207,2018-01-02 07:00:00,26,7,33
"26318",10602,"Corner Brook","NL",48.95224,-57.92207,2018-01-02 08:00:00,19,15,34
"26319",10602,"Corner Brook","NL",48.95224,-57.92207,2018-01-02 09:00:00,19,14,33
"26320",10602,"Corner Brook","NL",48.95224,-57.92207,2018-01-02 10:00:00,18,15,33
"26321",10602,"Corner Brook","NL",48.95224,-57.92207,2018-01-02 11:00:00,23,11,34
"26322",10602,"Corner Brook","NL",48.95224,-57.92207,2018-01-02 12:00:00,27,8,35
"26323",10602,"Corner Brook","NL",48.95224,-57.92207,2018-01-02 13:00:00,31,4,35
"26324",10602,"Corner Brook","NL",48.95224,-57.92207,2018-01-02 14:00:00,32,4,36
"26325",10602,"Corner Brook","NL",48.95224,-57.92207,2018-01-02 15:00:00,33,3,36
"26326",10602,"Corner Brook","NL",48.95224,-57.92207,2018-01-02 16:00:00,32,3,35
"26327",10602,"Corner Brook","NL",48.95224,-57.92207,2018-01-02 17:00:00,32,3,35
"26328",10602,"Corner Brook","NL",48.95224,-57.92207,2018-01-02 18:00:00,34,2,36
"26329",10602,"Corner Brook","NL",48.95224,-57.92207,2018-01-02 19:00:00,33,2,35
"26330",10602,"Corner Brook","NL",48.95224,-57.92207,2018-01-02 20:00:00,31,2,33
"26331",10602,"Corner Brook","NL",48.95224,-57.92207,2018-01-02 21:00:00,32,2,34
"26332",10602,"Corner Brook","NL",48.95224,-57.92207,2018-01-02 22:00:00,31,2,33
"26333",10602,"Corner Brook","NL",48.95224,-57.92207,2018-01-02 23:00:00,32,2,34
"26334",10602,"Corner Brook","NL",48.95224,-57.92207,2018-01-03 00:00:00,33,1,34
"26335",10602,"Corner Brook","NL",48.95224,-57.92207,2018-01-03 01:00:00,32,1,33
"26336",10602,"Corner Brook","NL",48.95224,-57.92207,2018-01-03 02:00:00,31,3,34
"26337",10602,"Corner Brook","NL",48.95224,-57.92207,2018-01-03 03:00:00,30,3,33
"26338",10602,"Corner Brook","NL",48.95224,-57.92207,2018-01-03 04:00:00,29,4,33
"26339",10602,"Corner Brook","NL",48.95224,-57.92207,2018-01-03 05:00:00,32,3,35
"26340",10602,"Corner Brook","NL",48.95224,-57.92207,2018-01-03 06:00:00,35,0,35
"26341",10602,"Corner Brook","NL",48.95224,-57.92207,2018-01-03 07:00:00,36,0,36
"26342",10602,"Corner Brook","NL",48.95224,-57.92207,2018-01-03 08:00:00,36,0,36
"26343",10602,"Corner Brook","NL",48.95224,-57.92207,2018-01-03 09:00:00,35,0,35
"26344",10602,"Corner Brook","NL",48.95224,-57.92207,2018-01-03 10:00:00,35,1,36
"26345",10602,"Corner Brook","NL",48.95224,-57.92207,2018-01-03 11:00:00,35,1,36
"26346",10602,"Corner Brook","NL",48.95224,-57.92207,2018-01-03 12:00:00,35,1,36
"26347",10602,"Corner Brook","NL",48.95224,-57.92207,2018-01-03 13:00:00,34,3,37
"26348",10602,"Corner Brook","NL",48.95224,-57.92207,2018-01-03 14:00:00,36,2,38
"26349",10602,"Corner Brook","NL",48.95224,-57.92207,2018-01-03 15:00:00,35,3,38
"26350",10602,"Corner Brook","NL",48.95224,-57.92207,2018-01-03 16:00:00,34,3,37
"26351",10602,"Corner Brook","NL",48.95224,-57.92207,2018-01-03 17:00:00,36,2,38
"26352",10602,"Corner Brook","NL",48.95224,-57.92207,2018-01-03 18:00:00,36,1,37
"26353",10602,"Corner Brook","NL",48.95224,-57.92207,2018-01-03 19:00:00,36,1,37
"26354",10602,"Corner Brook","NL",48.95224,-57.92207,2018-01-03 20:00:00,36,3,39
"26355",10602,"Corner Brook","NL",48.95224,-57.92207,2018-01-03 21:00:00,35,1,36
"26356",10602,"Corner Brook","NL",48.95224,-57.92207,2018-01-03 22:00:00,34,2,36
"26357",10602,"Corner Brook","NL",48.95224,-57.92207,2018-01-03 23:00:00,35,1,36
"26358",10602,"Corner Brook","NL",48.95224,-57.92207,2018-01-04 00:00:00,35,1,36
"26359",10602,"Corner Brook","NL",48.95224,-57.92207,2018-01-04 01:00:00,35,1,36
"26360",10602,"Corner Brook","NL",48.95224,-57.92207,2018-01-04 02:00:00,34,2,36
"26361",10602,"Corner Brook","NL",48.95224,-57.92207,2018-01-04 03:00:00,37,0,37
"26362",10602,"Corner Brook","NL",48.95224,-57.92207,2018-01-04 04:00:00,36,1,37
"26363",10602,"Corner Brook","NL",48.95224,-57.92207,2018-01-04 05:00:00,36,2,38
"26364",10602,"Corner Brook","NL",48.95224,-57.92207,2018-01-04 06:00:00,35,2,37
"26365",10602,"Corner Brook","NL",48.95224,-57.92207,2018-01-04 07:00:00,35,3,38
"26366",10602,"Corner Brook","NL",48.95224,-57.92207,2018-01-04 08:00:00,32,4,36
"26367",10602,"Corner Brook","NL",48.95224,-57.92207,2018-01-04 09:00:00,26,9,35
"26368",10602,"Corner Brook","NL",48.95224,-57.92207,2018-01-04 10:00:00,13,28,41
"26369",10602,"Corner Brook","NL",48.95224,-57.92207,2018-01-04 11:00:00,19,20,39
"26370",10602,"Corner Brook","NL",48.95224,-57.92207,2018-01-04 12:00:00,31,6,37
"26371",10602,"Corner Brook","NL",48.95224,-57.92207,2018-01-04 13:00:00,29,7,36
"26372",10602,"Corner Brook","NL",48.95224,-57.92207,2018-01-04 14:00:00,34,4,38
"26373",10602,"Corner Brook","NL",48.95224,-57.92207,2018-01-04 15:00:00,35,3,38
"26374",10602,"Corner Brook","NL",48.95224,-57.92207,2018-01-04 16:00:00,36,2,38
"26375",10602,"Corner Brook","NL",48.95224,-57.92207,2018-01-04 17:00:00,35,3,38
"26376",10602,"Corner Brook","NL",48.95224,-57.92207,2018-01-04 18:00:00,36,2,38
"26377",10602,"Corner Brook","NL",48.95224,-57.92207,2018-01-04 19:00:00,38,1,39
"26378",10602,"Corner Brook","NL",48.95224,-57.92207,2018-01-04 20:00:00,38,0,38
"26379",10602,"Corner Brook","NL",48.95224,-57.92207,2018-01-04 21:00:00,38,0,38
"26380",10602,"Corner Brook","NL",48.95224,-57.92207,2018-01-04 22:00:00,37,0,37
"26381",10602,"Corner Brook","NL",48.95224,-57.92207,2018-01-04 23:00:00,38,0,38
"26382",10602,"Corner Brook","NL",48.95224,-57.92207,2018-01-05 00:00:00,38,0,38
"26383",10602,"Corner Brook","NL",48.95224,-57.92207,2018-01-05 01:00:00,39,0,39
"26384",10602,"Corner Brook","NL",48.95224,-57.92207,2018-01-05 02:00:00,39,0,39
"26385",10602,"Corner Brook","NL",48.95224,-57.92207,2018-01-05 03:00:00,39,0,39
"26386",10602,"Corner Brook","NL",48.95224,-57.92207,2018-01-05 04:00:00,38,1,39
"26387",10602,"Corner Brook","NL",48.95224,-57.92207,2018-01-05 05:00:00,39,0,39
"26388",10602,"Corner Brook","NL",48.95224,-57.92207,2018-01-05 06:00:00,38,1,39
"26389",10602,"Corner Brook","NL",48.95224,-57.92207,2018-01-05 07:00:00,37,1,38
"26390",10602,"Corner Brook","NL",48.95224,-57.92207,2018-01-05 08:00:00,36,2,38
"26391",10602,"Corner Brook","NL",48.95224,-57.92207,2018-01-05 09:00:00,37,1,38
"26392",10602,"Corner Brook","NL",48.95224,-57.92207,2018-01-05 10:00:00,37,2,39
"26393",10602,"Corner Brook","NL",48.95224,-57.92207,2018-01-05 11:00:00,38,1,39
"26394",10602,"Corner Brook","NL",48.95224,-57.92207,2018-01-05 12:00:00,36,0,36
"26395",10602,"Corner Brook","NL",48.95224,-57.92207,2018-01-05 13:00:00,35,0,35
"26396",10602,"Corner Brook","NL",48.95224,-57.92207,2018-01-05 14:00:00,35,1,36
"26397",10602,"Corner Brook","NL",48.95224,-57.92207,2018-01-05 15:00:00,NA,9,NA
"26398",10602,"Corner Brook","NL",48.95224,-57.92207,2018-01-05 16:00:00,NA,5,NA
"26399",10602,"Corner Brook","NL",48.95224,-57.92207,2018-01-05 17:00:00,39,0,39
"26400",10602,"Corner Brook","NL",48.95224,-57.92207,2018-01-05 18:00:00,39,0,39
"26401",10602,"Corner Brook","NL",48.95224,-57.92207,2018-01-05 19:00:00,40,0,40
"26402",10602,"Corner Brook","NL",48.95224,-57.92207,2018-01-05 20:00:00,40,0,40
"26403",10602,"Corner Brook","NL",48.95224,-57.92207,2018-01-05 21:00:00,40,0,40
"26404",10602,"Corner Brook","NL",48.95224,-57.92207,2018-01-05 22:00:00,39,0,39
"26405",10602,"Corner Brook","NL",48.95224,-57.92207,2018-01-05 23:00:00,37,1,38
"26406",10602,"Corner Brook","NL",48.95224,-57.92207,2018-01-06 00:00:00,36,0,36
"26407",10602,"Corner Brook","NL",48.95224,-57.92207,2018-01-06 01:00:00,36,0,36
"26408",10602,"Corner Brook","NL",48.95224,-57.92207,2018-01-06 02:00:00,35,0,35
"26409",10602,"Corner Brook","NL",48.95224,-57.92207,2018-01-06 03:00:00,34,0,34
"26410",10602,"Corner Brook","NL",48.95224,-57.92207,2018-01-06 04:00:00,35,0,35
"26411",10602,"Corner Brook","NL",48.95224,-57.92207,2018-01-06 05:00:00,34,0,34
"26412",10602,"Corner Brook","NL",48.95224,-57.92207,2018-01-06 06:00:00,33,1,34
"26413",10602,"Corner Brook","NL",48.95224,-57.92207,2018-01-06 07:00:00,33,1,34
"26414",10602,"Corner Brook","NL",48.95224,-57.92207,2018-01-06 08:00:00,33,1,34
"26415",10602,"Corner Brook","NL",48.95224,-57.92207,2018-01-06 09:00:00,35,0,35
"26416",10602,"Corner Brook","NL",48.95224,-57.92207,2018-01-06 10:00:00,34,0,34
"26417",10602,"Corner Brook","NL",48.95224,-57.92207,2018-01-06 11:00:00,35,0,35
"26418",10602,"Corner Brook","NL",48.95224,-57.92207,2018-01-06 12:00:00,35,0,35
"26419",10602,"Corner Brook","NL",48.95224,-57.92207,2018-01-06 13:00:00,35,0,35
"26420",10602,"Corner Brook","NL",48.95224,-57.92207,2018-01-06 14:00:00,35,0,35
"26421",10602,"Corner Brook","NL",48.95224,-57.92207,2018-01-06 15:00:00,34,0,34
"26422",10602,"Corner Brook","NL",48.95224,-57.92207,2018-01-06 16:00:00,34,0,34
"26423",10602,"Corner Brook","NL",48.95224,-57.92207,2018-01-06 17:00:00,34,1,35
"26424",10602,"Corner Brook","NL",48.95224,-57.92207,2018-01-06 18:00:00,34,0,34
"26425",10602,"Corner Brook","NL",48.95224,-57.92207,2018-01-06 19:00:00,34,0,34
"26426",10602,"Corner Brook","NL",48.95224,-57.92207,2018-01-06 20:00:00,34,0,34
"26427",10602,"Corner Brook","NL",48.95224,-57.92207,2018-01-06 21:00:00,34,0,34
"26428",10602,"Corner Brook","NL",48.95224,-57.92207,2018-01-06 22:00:00,35,0,35
"26429",10602,"Corner Brook","NL",48.95224,-57.92207,2018-01-06 23:00:00,35,0,35
"26430",10602,"Corner Brook","NL",48.95224,-57.92207,2018-01-07 00:00:00,35,0,35
"26431",10602,"Corner Brook","NL",48.95224,-57.92207,2018-01-07 01:00:00,36,1,37
"26432",10602,"Corner Brook","NL",48.95224,-57.92207,2018-01-07 02:00:00,36,1,37
"26433",10602,"Corner Brook","NL",48.95224,-57.92207,2018-01-07 03:00:00,37,0,37
"26434",10602,"Corner Brook","NL",48.95224,-57.92207,2018-01-07 04:00:00,38,1,39
"26435",10602,"Corner Brook","NL",48.95224,-57.92207,2018-01-07 05:00:00,38,1,39
"26436",10602,"Corner Brook","NL",48.95224,-57.92207,2018-01-07 06:00:00,37,1,38
"26437",10602,"Corner Brook","NL",48.95224,-57.92207,2018-01-07 07:00:00,37,2,39
"26438",10602,"Corner Brook","NL",48.95224,-57.92207,2018-01-07 08:00:00,38,1,39
"26439",10602,"Corner Brook","NL",48.95224,-57.92207,2018-01-07 09:00:00,38,1,39
"26440",10602,"Corner Brook","NL",48.95224,-57.92207,2018-01-07 10:00:00,38,1,39
"26441",10602,"Corner Brook","NL",48.95224,-57.92207,2018-01-07 11:00:00,38,1,39
"26442",10602,"Corner Brook","NL",48.95224,-57.92207,2018-01-07 12:00:00,37,2,39
"26443",10602,"Corner Brook","NL",48.95224,-57.92207,2018-01-07 13:00:00,38,1,39
"26444",10602,"Corner Brook","NL",48.95224,-57.92207,2018-01-07 14:00:00,36,3,39
"26445",10602,"Corner Brook","NL",48.95224,-57.92207,2018-01-07 15:00:00,37,1,38
"26446",10602,"Corner Brook","NL",48.95224,-57.92207,2018-01-07 16:00:00,37,1,38
"26447",10602,"Corner Brook","NL",48.95224,-57.92207,2018-01-07 17:00:00,37,1,38
"26448",10602,"Corner Brook","NL",48.95224,-57.92207,2018-01-07 18:00:00,37,1,38
"26449",10602,"Corner Brook","NL",48.95224,-57.92207,2018-01-07 19:00:00,36,2,38
"26450",10602,"Corner Brook","NL",48.95224,-57.92207,2018-01-07 20:00:00,37,2,39
"26451",10602,"Corner Brook","NL",48.95224,-57.92207,2018-01-07 21:00:00,38,2,40
"26452",10602,"Corner Brook","NL",48.95224,-57.92207,2018-01-07 22:00:00,38,1,39
"26453",10602,"Corner Brook","NL",48.95224,-57.92207,2018-01-07 23:00:00,39,1,40
"26454",10602,"Corner Brook","NL",48.95224,-57.92207,2018-01-08 00:00:00,38,3,41
"26455",10602,"Corner Brook","NL",48.95224,-57.92207,2018-01-08 01:00:00,39,2,41
"26456",10602,"Corner Brook","NL",48.95224,-57.92207,2018-01-08 02:00:00,39,2,41
"26457",10602,"Corner Brook","NL",48.95224,-57.92207,2018-01-08 03:00:00,41,1,42
"26458",10602,"Corner Brook","NL",48.95224,-57.92207,2018-01-08 04:00:00,41,1,42
"26459",10602,"Corner Brook","NL",48.95224,-57.92207,2018-01-08 05:00:00,41,1,42
"26460",10602,"Corner Brook","NL",48.95224,-57.92207,2018-01-08 06:00:00,42,1,43
"26461",10602,"Corner Brook","NL",48.95224,-57.92207,2018-01-08 07:00:00,42,1,43
"26462",10602,"Corner Brook","NL",48.95224,-57.92207,2018-01-08 08:00:00,41,2,43
"26463",10602,"Corner Brook","NL",48.95224,-57.92207,2018-01-08 09:00:00,41,2,43
"26464",10602,"Corner Brook","NL",48.95224,-57.92207,2018-01-08 10:00:00,42,1,43
"26465",10602,"Corner Brook","NL",48.95224,-57.92207,2018-01-08 11:00:00,41,2,43
"26466",10602,"Corner Brook","NL",48.95224,-57.92207,2018-01-08 12:00:00,41,2,43
"26467",10602,"Corner Brook","NL",48.95224,-57.92207,2018-01-08 13:00:00,42,1,43
"26468",10602,"Corner Brook","NL",48.95224,-57.92207,2018-01-08 14:00:00,42,1,43
"26469",10602,"Corner Brook","NL",48.95224,-57.92207,2018-01-08 15:00:00,41,2,43
"26470",10602,"Corner Brook","NL",48.95224,-57.92207,2018-01-08 16:00:00,42,1,43
"26471",10602,"Corner Brook","NL",48.95224,-57.92207,2018-01-08 17:00:00,40,3,43
"26472",10602,"Corner Brook","NL",48.95224,-57.92207,2018-01-08 18:00:00,40,3,43
"26473",10602,"Corner Brook","NL",48.95224,-57.92207,2018-01-08 19:00:00,40,2,42
"26474",10602,"Corner Brook","NL",48.95224,-57.92207,2018-01-08 20:00:00,41,2,43
"26475",10602,"Corner Brook","NL",48.95224,-57.92207,2018-01-08 21:00:00,40,2,42
"26476",10602,"Corner Brook","NL",48.95224,-57.92207,2018-01-08 22:00:00,41,2,43
"26477",10602,"Corner Brook","NL",48.95224,-57.92207,2018-01-08 23:00:00,41,1,42
"26478",10602,"Corner Brook","NL",48.95224,-57.92207,2018-01-09 00:00:00,40,1,41
"26479",10602,"Corner Brook","NL",48.95224,-57.92207,2018-01-09 01:00:00,40,1,41
"26480",10602,"Corner Brook","NL",48.95224,-57.92207,2018-01-09 02:00:00,40,1,41
"26481",10602,"Corner Brook","NL",48.95224,-57.92207,2018-01-09 03:00:00,40,2,42
"26482",10602,"Corner Brook","NL",48.95224,-57.92207,2018-01-09 04:00:00,37,3,40
"26483",10602,"Corner Brook","NL",48.95224,-57.92207,2018-01-09 05:00:00,39,2,41
"26484",10602,"Corner Brook","NL",48.95224,-57.92207,2018-01-09 06:00:00,38,2,40
"26485",10602,"Corner Brook","NL",48.95224,-57.92207,2018-01-09 07:00:00,38,2,40
"26486",10602,"Corner Brook","NL",48.95224,-57.92207,2018-01-09 08:00:00,37,2,39
"26487",10602,"Corner Brook","NL",48.95224,-57.92207,2018-01-09 09:00:00,30,9,39
"26488",10602,"Corner Brook","NL",48.95224,-57.92207,2018-01-09 10:00:00,27,9,36
"26489",10602,"Corner Brook","NL",48.95224,-57.92207,2018-01-09 11:00:00,33,6,39
"26490",10602,"Corner Brook","NL",48.95224,-57.92207,2018-01-09 12:00:00,30,7,37
"26491",10602,"Corner Brook","NL",48.95224,-57.92207,2018-01-09 13:00:00,29,8,37
"26492",10602,"Corner Brook","NL",48.95224,-57.92207,2018-01-09 14:00:00,34,4,38
"26493",10602,"Corner Brook","NL",48.95224,-57.92207,2018-01-09 15:00:00,33,15,48
"26494",10602,"Corner Brook","NL",48.95224,-57.92207,2018-01-09 16:00:00,33,11,44
"26495",10602,"Corner Brook","NL",48.95224,-57.92207,2018-01-09 17:00:00,30,5,35
"26496",10602,"Corner Brook","NL",48.95224,-57.92207,2018-01-09 18:00:00,30,6,36
"26497",10602,"Corner Brook","NL",48.95224,-57.92207,2018-01-09 19:00:00,27,7,34
"26498",10602,"Corner Brook","NL",48.95224,-57.92207,2018-01-09 20:00:00,29,5,34
"26499",10602,"Corner Brook","NL",48.95224,-57.92207,2018-01-09 21:00:00,33,4,37
"26500",10602,"Corner Brook","NL",48.95224,-57.92207,2018-01-09 22:00:00,35,2,37
"26501",10602,"Corner Brook","NL",48.95224,-57.92207,2018-01-09 23:00:00,35,3,38
"26502",10602,"Corner Brook","NL",48.95224,-57.92207,2018-01-10 00:00:00,35,3,38
"26503",10602,"Corner Brook","NL",48.95224,-57.92207,2018-01-10 01:00:00,40,1,41
"26504",10602,"Corner Brook","NL",48.95224,-57.92207,2018-01-10 02:00:00,39,1,40
"26505",10602,"Corner Brook","NL",48.95224,-57.92207,2018-01-10 03:00:00,37,2,39
"26506",10602,"Corner Brook","NL",48.95224,-57.92207,2018-01-10 04:00:00,36,2,38
"26507",10602,"Corner Brook","NL",48.95224,-57.92207,2018-01-10 05:00:00,39,1,40
"26508",10602,"Corner Brook","NL",48.95224,-57.92207,2018-01-10 06:00:00,37,2,39
"26509",10602,"Corner Brook","NL",48.95224,-57.92207,2018-01-10 07:00:00,36,2,38
"26510",10602,"Corner Brook","NL",48.95224,-57.92207,2018-01-10 08:00:00,36,2,38
"26511",10602,"Corner Brook","NL",48.95224,-57.92207,2018-01-10 09:00:00,36,2,38
"26512",10602,"Corner Brook","NL",48.95224,-57.92207,2018-01-10 10:00:00,36,2,38
"26513",10602,"Corner Brook","NL",48.95224,-57.92207,2018-01-10 11:00:00,35,4,39
"26514",10602,"Corner Brook","NL",48.95224,-57.92207,2018-01-10 12:00:00,36,3,39
"26515",10602,"Corner Brook","NL",48.95224,-57.92207,2018-01-10 13:00:00,37,1,38
"26516",10602,"Corner Brook","NL",48.95224,-57.92207,2018-01-10 14:00:00,36,1,37
"26517",10602,"Corner Brook","NL",48.95224,-57.92207,2018-01-10 15:00:00,36,2,38
"26518",10602,"Corner Brook","NL",48.95224,-57.92207,2018-01-10 16:00:00,35,2,37
"26519",10602,"Corner Brook","NL",48.95224,-57.92207,2018-01-10 17:00:00,35,1,36
"26520",10602,"Corner Brook","NL",48.95224,-57.92207,2018-01-10 18:00:00,35,1,36
"26521",10602,"Corner Brook","NL",48.95224,-57.92207,2018-01-10 19:00:00,36,1,37
"26522",10602,"Corner Brook","NL",48.95224,-57.92207,2018-01-10 20:00:00,35,2,37
"26523",10602,"Corner Brook","NL",48.95224,-57.92207,2018-01-10 21:00:00,35,2,37
"26524",10602,"Corner Brook","NL",48.95224,-57.92207,2018-01-10 22:00:00,35,1,36
"26525",10602,"Corner Brook","NL",48.95224,-57.92207,2018-01-10 23:00:00,35,2,37
"26526",10602,"Corner Brook","NL",48.95224,-57.92207,2018-01-11 00:00:00,36,1,37
"26527",10602,"Corner Brook","NL",48.95224,-57.92207,2018-01-11 01:00:00,36,1,37
"26528",10602,"Corner Brook","NL",48.95224,-57.92207,2018-01-11 02:00:00,36,2,38
"26529",10602,"Corner Brook","NL",48.95224,-57.92207,2018-01-11 03:00:00,36,1,37
"26530",10602,"Corner Brook","NL",48.95224,-57.92207,2018-01-11 04:00:00,37,1,38
"26531",10602,"Corner Brook","NL",48.95224,-57.92207,2018-01-11 05:00:00,38,1,39
"26532",10602,"Corner Brook","NL",48.95224,-57.92207,2018-01-11 06:00:00,37,1,38
"26533",10602,"Corner Brook","NL",48.95224,-57.92207,2018-01-11 07:00:00,38,1,39
"26534",10602,"Corner Brook","NL",48.95224,-57.92207,2018-01-11 08:00:00,39,1,40
"26535",10602,"Corner Brook","NL",48.95224,-57.92207,2018-01-11 09:00:00,37,2,39
"26536",10602,"Corner Brook","NL",48.95224,-57.92207,2018-01-11 10:00:00,38,1,39
"26537",10602,"Corner Brook","NL",48.95224,-57.92207,2018-01-11 11:00:00,37,NA,NA
"26538",10602,"Corner Brook","NL",48.95224,-57.92207,2018-01-11 12:00:00,36,NA,NA
"26539",10602,"Corner Brook","NL",48.95224,-57.92207,2018-01-11 13:00:00,38,NA,NA
"26540",10602,"Corner Brook","NL",48.95224,-57.92207,2018-01-11 14:00:00,35,NA,NA
"26541",10602,"Corner Brook","NL",48.95224,-57.92207,2018-01-11 15:00:00,34,2,36
"26542",10602,"Corner Brook","NL",48.95224,-57.92207,2018-01-11 16:00:00,33,4,37
"26543",10602,"Corner Brook","NL",48.95224,-57.92207,2018-01-11 17:00:00,32,4,36
"26544",10602,"Corner Brook","NL",48.95224,-57.92207,2018-01-11 18:00:00,30,5,35
"26545",10602,"Corner Brook","NL",48.95224,-57.92207,2018-01-11 19:00:00,30,4,34
"26546",10602,"Corner Brook","NL",48.95224,-57.92207,2018-01-11 20:00:00,30,3,33
"26547",10602,"Corner Brook","NL",48.95224,-57.92207,2018-01-11 21:00:00,30,3,33
"26548",10602,"Corner Brook","NL",48.95224,-57.92207,2018-01-11 22:00:00,29,3,32
"26549",10602,"Corner Brook","NL",48.95224,-57.92207,2018-01-11 23:00:00,25,6,31
"26550",10602,"Corner Brook","NL",48.95224,-57.92207,2018-01-12 00:00:00,27,3,30
"26551",10602,"Corner Brook","NL",48.95224,-57.92207,2018-01-12 01:00:00,23,8,31
"26552",10602,"Corner Brook","NL",48.95224,-57.92207,2018-01-12 02:00:00,30,4,34
"26553",10602,"Corner Brook","NL",48.95224,-57.92207,2018-01-12 03:00:00,33,1,34
"26554",10602,"Corner Brook","NL",48.95224,-57.92207,2018-01-12 04:00:00,33,2,35
"26555",10602,"Corner Brook","NL",48.95224,-57.92207,2018-01-12 05:00:00,32,2,34
"26556",10602,"Corner Brook","NL",48.95224,-57.92207,2018-01-12 06:00:00,33,2,35
"26557",10602,"Corner Brook","NL",48.95224,-57.92207,2018-01-12 07:00:00,34,2,36
"26558",10602,"Corner Brook","NL",48.95224,-57.92207,2018-01-12 08:00:00,35,2,37
"26559",10602,"Corner Brook","NL",48.95224,-57.92207,2018-01-12 09:00:00,36,1,37
"26560",10602,"Corner Brook","NL",48.95224,-57.92207,2018-01-12 10:00:00,37,1,38
"26561",10602,"Corner Brook","NL",48.95224,-57.92207,2018-01-12 11:00:00,38,1,39
"26562",10602,"Corner Brook","NL",48.95224,-57.92207,2018-01-12 12:00:00,39,1,40
"26563",10602,"Corner Brook","NL",48.95224,-57.92207,2018-01-12 13:00:00,38,1,39
"26564",10602,"Corner Brook","NL",48.95224,-57.92207,2018-01-12 14:00:00,39,2,41
"26565",10602,"Corner Brook","NL",48.95224,-57.92207,2018-01-12 15:00:00,40,1,41
"26566",10602,"Corner Brook","NL",48.95224,-57.92207,2018-01-12 16:00:00,40,1,41
"26567",10602,"Corner Brook","NL",48.95224,-57.92207,2018-01-12 17:00:00,40,1,41
"26568",10602,"Corner Brook","NL",48.95224,-57.92207,2018-01-12 18:00:00,39,1,40
"26569",10602,"Corner Brook","NL",48.95224,-57.92207,2018-01-12 19:00:00,39,1,40
"26570",10602,"Corner Brook","NL",48.95224,-57.92207,2018-01-12 20:00:00,40,1,41
"26571",10602,"Corner Brook","NL",48.95224,-57.92207,2018-01-12 21:00:00,39,1,40
"26572",10602,"Corner Brook","NL",48.95224,-57.92207,2018-01-12 22:00:00,39,1,40
"26573",10602,"Corner Brook","NL",48.95224,-57.92207,2018-01-12 23:00:00,39,0,39
"26574",10602,"Corner Brook","NL",48.95224,-57.92207,2018-01-13 00:00:00,39,0,39
"26575",10602,"Corner Brook","NL",48.95224,-57.92207,2018-01-13 01:00:00,38,0,38
"26576",10602,"Corner Brook","NL",48.95224,-57.92207,2018-01-13 02:00:00,39,0,39
"26577",10602,"Corner Brook","NL",48.95224,-57.92207,2018-01-13 03:00:00,39,0,39
"26578",10602,"Corner Brook","NL",48.95224,-57.92207,2018-01-13 04:00:00,39,0,39
"26579",10602,"Corner Brook","NL",48.95224,-57.92207,2018-01-13 05:00:00,38,0,38
"26580",10602,"Corner Brook","NL",48.95224,-57.92207,2018-01-13 06:00:00,37,0,37
"26581",10602,"Corner Brook","NL",48.95224,-57.92207,2018-01-13 07:00:00,37,1,38
"26582",10602,"Corner Brook","NL",48.95224,-57.92207,2018-01-13 08:00:00,37,0,37
"26583",10602,"Corner Brook","NL",48.95224,-57.92207,2018-01-13 09:00:00,36,1,37
"26584",10602,"Corner Brook","NL",48.95224,-57.92207,2018-01-13 10:00:00,36,1,37
"26585",10602,"Corner Brook","NL",48.95224,-57.92207,2018-01-13 11:00:00,36,1,37
"26586",10602,"Corner Brook","NL",48.95224,-57.92207,2018-01-13 12:00:00,36,1,37
"26587",10602,"Corner Brook","NL",48.95224,-57.92207,2018-01-13 13:00:00,36,1,37
"26588",10602,"Corner Brook","NL",48.95224,-57.92207,2018-01-13 14:00:00,36,0,36
"26589",10602,"Corner Brook","NL",48.95224,-57.92207,2018-01-13 15:00:00,36,0,36
"26590",10602,"Corner Brook","NL",48.95224,-57.92207,2018-01-13 16:00:00,36,0,36
"26591",10602,"Corner Brook","NL",48.95224,-57.92207,2018-01-13 17:00:00,36,0,36
"26592",10602,"Corner Brook","NL",48.95224,-57.92207,2018-01-13 18:00:00,36,1,37
"26593",10602,"Corner Brook","NL",48.95224,-57.92207,2018-01-13 19:00:00,38,0,38
"26594",10602,"Corner Brook","NL",48.95224,-57.92207,2018-01-13 20:00:00,37,1,38
"26595",10602,"Corner Brook","NL",48.95224,-57.92207,2018-01-13 21:00:00,35,1,36
"26596",10602,"Corner Brook","NL",48.95224,-57.92207,2018-01-13 22:00:00,33,2,35
"26597",10602,"Corner Brook","NL",48.95224,-57.92207,2018-01-13 23:00:00,34,1,35
"26598",10602,"Corner Brook","NL",48.95224,-57.92207,2018-01-14 00:00:00,35,0,35
"26599",10602,"Corner Brook","NL",48.95224,-57.92207,2018-01-14 01:00:00,31,5,36
"26600",10602,"Corner Brook","NL",48.95224,-57.92207,2018-01-14 02:00:00,35,2,37
"26601",10602,"Corner Brook","NL",48.95224,-57.92207,2018-01-14 03:00:00,31,6,37
"26602",10602,"Corner Brook","NL",48.95224,-57.92207,2018-01-14 04:00:00,25,13,38
"26603",10602,"Corner Brook","NL",48.95224,-57.92207,2018-01-14 05:00:00,35,4,39
"26604",10602,"Corner Brook","NL",48.95224,-57.92207,2018-01-14 06:00:00,36,2,38
"26605",10602,"Corner Brook","NL",48.95224,-57.92207,2018-01-14 07:00:00,33,5,38
"26606",10602,"Corner Brook","NL",48.95224,-57.92207,2018-01-14 08:00:00,35,4,39
"26607",10602,"Corner Brook","NL",48.95224,-57.92207,2018-01-14 09:00:00,35,3,38
"26608",10602,"Corner Brook","NL",48.95224,-57.92207,2018-01-14 10:00:00,35,3,38
"26609",10602,"Corner Brook","NL",48.95224,-57.92207,2018-01-14 11:00:00,37,3,40
"26610",10602,"Corner Brook","NL",48.95224,-57.92207,2018-01-14 12:00:00,37,3,40
"26611",10602,"Corner Brook","NL",48.95224,-57.92207,2018-01-14 13:00:00,37,3,40
"26612",10602,"Corner Brook","NL",48.95224,-57.92207,2018-01-14 14:00:00,37,2,39
"26613",10602,"Corner Brook","NL",48.95224,-57.92207,2018-01-14 15:00:00,38,2,40
"26614",10602,"Corner Brook","NL",48.95224,-57.92207,2018-01-14 16:00:00,37,2,39
"26615",10602,"Corner Brook","NL",48.95224,-57.92207,2018-01-14 17:00:00,37,3,40
"26616",10602,"Corner Brook","NL",48.95224,-57.92207,2018-01-14 18:00:00,35,5,40
"26617",10602,"Corner Brook","NL",48.95224,-57.92207,2018-01-14 19:00:00,36,5,41
"26618",10602,"Corner Brook","NL",48.95224,-57.92207,2018-01-14 20:00:00,38,2,40
"26619",10602,"Corner Brook","NL",48.95224,-57.92207,2018-01-14 21:00:00,37,2,39
"26620",10602,"Corner Brook","NL",48.95224,-57.92207,2018-01-14 22:00:00,37,2,39
"26621",10602,"Corner Brook","NL",48.95224,-57.92207,2018-01-14 23:00:00,39,1,40
"26622",10602,"Corner Brook","NL",48.95224,-57.92207,2018-01-15 00:00:00,39,1,40
"26623",10602,"Corner Brook","NL",48.95224,-57.92207,2018-01-15 01:00:00,39,1,40
"26624",10602,"Corner Brook","NL",48.95224,-57.92207,2018-01-15 02:00:00,38,1,39
"26625",10602,"Corner Brook","NL",48.95224,-57.92207,2018-01-15 03:00:00,38,1,39
"26626",10602,"Corner Brook","NL",48.95224,-57.92207,2018-01-15 04:00:00,37,1,38
"26627",10602,"Corner Brook","NL",48.95224,-57.92207,2018-01-15 05:00:00,37,1,38
"26628",10602,"Corner Brook","NL",48.95224,-57.92207,2018-01-15 06:00:00,36,2,38
"26629",10602,"Corner Brook","NL",48.95224,-57.92207,2018-01-15 07:00:00,35,2,37
"26630",10602,"Corner Brook","NL",48.95224,-57.92207,2018-01-15 08:00:00,35,3,38
"26631",10602,"Corner Brook","NL",48.95224,-57.92207,2018-01-15 09:00:00,35,3,38
"26632",10602,"Corner Brook","NL",48.95224,-57.92207,2018-01-15 10:00:00,36,2,38
"26633",10602,"Corner Brook","NL",48.95224,-57.92207,2018-01-15 11:00:00,37,2,39
"26634",10602,"Corner Brook","NL",48.95224,-57.92207,2018-01-15 12:00:00,34,2,36
"26635",10602,"Corner Brook","NL",48.95224,-57.92207,2018-01-15 13:00:00,36,2,38
"26636",10602,"Corner Brook","NL",48.95224,-57.92207,2018-01-15 14:00:00,36,5,41
"26637",10602,"Corner Brook","NL",48.95224,-57.92207,2018-01-15 15:00:00,35,7,42
"26638",10602,"Corner Brook","NL",48.95224,-57.92207,2018-01-15 16:00:00,36,2,38
"26639",10602,"Corner Brook","NL",48.95224,-57.92207,2018-01-15 17:00:00,35,2,37
"26640",10602,"Corner Brook","NL",48.95224,-57.92207,2018-01-15 18:00:00,33,4,37
"26641",10602,"Corner Brook","NL",48.95224,-57.92207,2018-01-15 19:00:00,33,2,35
"26642",10602,"Corner Brook","NL",48.95224,-57.92207,2018-01-15 20:00:00,33,3,36
"26643",10602,"Corner Brook","NL",48.95224,-57.92207,2018-01-15 21:00:00,34,2,36
"26644",10602,"Corner Brook","NL",48.95224,-57.92207,2018-01-15 22:00:00,34,3,37
"26645",10602,"Corner Brook","NL",48.95224,-57.92207,2018-01-15 23:00:00,35,2,37
"26646",10602,"Corner Brook","NL",48.95224,-57.92207,2018-01-16 00:00:00,35,2,37
"26647",10602,"Corner Brook","NL",48.95224,-57.92207,2018-01-16 01:00:00,35,1,36
"26648",10602,"Corner Brook","NL",48.95224,-57.92207,2018-01-16 02:00:00,35,1,36
"26649",10602,"Corner Brook","NL",48.95224,-57.92207,2018-01-16 03:00:00,37,1,38
"26650",10602,"Corner Brook","NL",48.95224,-57.92207,2018-01-16 04:00:00,38,1,39
"26651",10602,"Corner Brook","NL",48.95224,-57.92207,2018-01-16 05:00:00,37,1,38
"26652",10602,"Corner Brook","NL",48.95224,-57.92207,2018-01-16 06:00:00,37,1,38
"26653",10602,"Corner Brook","NL",48.95224,-57.92207,2018-01-16 07:00:00,37,1,38
"26654",10602,"Corner Brook","NL",48.95224,-57.92207,2018-01-16 08:00:00,37,2,39
"26655",10602,"Corner Brook","NL",48.95224,-57.92207,2018-01-16 09:00:00,34,4,38
"26656",10602,"Corner Brook","NL",48.95224,-57.92207,2018-01-16 10:00:00,33,7,40
"26657",10602,"Corner Brook","NL",48.95224,-57.92207,2018-01-16 11:00:00,33,7,40
"26658",10602,"Corner Brook","NL",48.95224,-57.92207,2018-01-16 12:00:00,35,4,39
"26659",10602,"Corner Brook","NL",48.95224,-57.92207,2018-01-16 13:00:00,36,3,39
"26660",10602,"Corner Brook","NL",48.95224,-57.92207,2018-01-16 14:00:00,37,2,39
"26661",10602,"Corner Brook","NL",48.95224,-57.92207,2018-01-16 15:00:00,36,3,39
"26662",10602,"Corner Brook","NL",48.95224,-57.92207,2018-01-16 16:00:00,36,4,40
"26663",10602,"Corner Brook","NL",48.95224,-57.92207,2018-01-16 17:00:00,35,3,38
"26664",10602,"Corner Brook","NL",48.95224,-57.92207,2018-01-16 18:00:00,33,5,38
"26665",10602,"Corner Brook","NL",48.95224,-57.92207,2018-01-16 19:00:00,30,6,36
"26666",10602,"Corner Brook","NL",48.95224,-57.92207,2018-01-16 20:00:00,31,5,36
"26667",10602,"Corner Brook","NL",48.95224,-57.92207,2018-01-16 21:00:00,30,4,34
"26668",10602,"Corner Brook","NL",48.95224,-57.92207,2018-01-16 22:00:00,26,5,31
"26669",10602,"Corner Brook","NL",48.95224,-57.92207,2018-01-16 23:00:00,31,3,34
"26670",10602,"Corner Brook","NL",48.95224,-57.92207,2018-01-17 00:00:00,33,1,34
"26671",10602,"Corner Brook","NL",48.95224,-57.92207,2018-01-17 01:00:00,34,1,35
"26672",10602,"Corner Brook","NL",48.95224,-57.92207,2018-01-17 02:00:00,36,2,38
"26673",10602,"Corner Brook","NL",48.95224,-57.92207,2018-01-17 03:00:00,37,4,41
"26674",10602,"Corner Brook","NL",48.95224,-57.92207,2018-01-17 04:00:00,39,2,41
"26675",10602,"Corner Brook","NL",48.95224,-57.92207,2018-01-17 05:00:00,37,3,40
"26676",10602,"Corner Brook","NL",48.95224,-57.92207,2018-01-17 06:00:00,35,5,40
"26677",10602,"Corner Brook","NL",48.95224,-57.92207,2018-01-17 07:00:00,35,4,39
"26678",10602,"Corner Brook","NL",48.95224,-57.92207,2018-01-17 08:00:00,36,2,38
"26679",10602,"Corner Brook","NL",48.95224,-57.92207,2018-01-17 09:00:00,36,3,39
"26680",10602,"Corner Brook","NL",48.95224,-57.92207,2018-01-17 10:00:00,39,1,40
"26681",10602,"Corner Brook","NL",48.95224,-57.92207,2018-01-17 11:00:00,39,2,41
"26682",10602,"Corner Brook","NL",48.95224,-57.92207,2018-01-17 12:00:00,40,1,41
"26683",10602,"Corner Brook","NL",48.95224,-57.92207,2018-01-17 13:00:00,40,1,41
"26684",10602,"Corner Brook","NL",48.95224,-57.92207,2018-01-17 14:00:00,39,2,41
"26685",10602,"Corner Brook","NL",48.95224,-57.92207,2018-01-17 15:00:00,39,2,41
"26686",10602,"Corner Brook","NL",48.95224,-57.92207,2018-01-17 16:00:00,38,2,40
"26687",10602,"Corner Brook","NL",48.95224,-57.92207,2018-01-17 17:00:00,38,2,40
"26688",10602,"Corner Brook","NL",48.95224,-57.92207,2018-01-17 18:00:00,36,3,39
"26689",10602,"Corner Brook","NL",48.95224,-57.92207,2018-01-17 19:00:00,35,3,38
"26690",10602,"Corner Brook","NL",48.95224,-57.92207,2018-01-17 20:00:00,35,2,37
"26691",10602,"Corner Brook","NL",48.95224,-57.92207,2018-01-17 21:00:00,35,2,37
"26692",10602,"Corner Brook","NL",48.95224,-57.92207,2018-01-17 22:00:00,32,4,36
"26693",10602,"Corner Brook","NL",48.95224,-57.92207,2018-01-17 23:00:00,33,3,36
"26694",10602,"Corner Brook","NL",48.95224,-57.92207,2018-01-18 00:00:00,33,2,35
"26695",10602,"Corner Brook","NL",48.95224,-57.92207,2018-01-18 01:00:00,30,4,34
"26696",10602,"Corner Brook","NL",48.95224,-57.92207,2018-01-18 02:00:00,31,3,34
"26697",10602,"Corner Brook","NL",48.95224,-57.92207,2018-01-18 03:00:00,32,2,34
"26698",10602,"Corner Brook","NL",48.95224,-57.92207,2018-01-18 04:00:00,30,3,33
"26699",10602,"Corner Brook","NL",48.95224,-57.92207,2018-01-18 05:00:00,31,2,33
"26700",10602,"Corner Brook","NL",48.95224,-57.92207,2018-01-18 06:00:00,27,5,32
"26701",10602,"Corner Brook","NL",48.95224,-57.92207,2018-01-18 07:00:00,23,8,31
"26702",10602,"Corner Brook","NL",48.95224,-57.92207,2018-01-18 08:00:00,28,5,33
"26703",10602,"Corner Brook","NL",48.95224,-57.92207,2018-01-18 09:00:00,30,4,34
"26704",10602,"Corner Brook","NL",48.95224,-57.92207,2018-01-18 10:00:00,29,5,34
"26705",10602,"Corner Brook","NL",48.95224,-57.92207,2018-01-18 11:00:00,31,3,34
"26706",10602,"Corner Brook","NL",48.95224,-57.92207,2018-01-18 12:00:00,30,4,34
"26707",10602,"Corner Brook","NL",48.95224,-57.92207,2018-01-18 13:00:00,30,4,34
"26708",10602,"Corner Brook","NL",48.95224,-57.92207,2018-01-18 14:00:00,29,5,34
"26709",10602,"Corner Brook","NL",48.95224,-57.92207,2018-01-18 15:00:00,28,5,33
"26710",10602,"Corner Brook","NL",48.95224,-57.92207,2018-01-18 16:00:00,29,4,33
"26711",10602,"Corner Brook","NL",48.95224,-57.92207,2018-01-18 17:00:00,25,7,32
"26712",10602,"Corner Brook","NL",48.95224,-57.92207,2018-01-18 18:00:00,24,9,33
"26713",10602,"Corner Brook","NL",48.95224,-57.92207,2018-01-18 19:00:00,25,8,33
"26714",10602,"Corner Brook","NL",48.95224,-57.92207,2018-01-18 20:00:00,34,3,37
"26715",10602,"Corner Brook","NL",48.95224,-57.92207,2018-01-18 21:00:00,33,3,36
"26716",10602,"Corner Brook","NL",48.95224,-57.92207,2018-01-18 22:00:00,33,4,37
"26717",10602,"Corner Brook","NL",48.95224,-57.92207,2018-01-18 23:00:00,34,2,36
"26718",10602,"Corner Brook","NL",48.95224,-57.92207,2018-01-19 00:00:00,35,2,37
"26719",10602,"Corner Brook","NL",48.95224,-57.92207,2018-01-19 01:00:00,34,2,36
"26720",10602,"Corner Brook","NL",48.95224,-57.92207,2018-01-19 02:00:00,33,2,35
"26721",10602,"Corner Brook","NL",48.95224,-57.92207,2018-01-19 03:00:00,31,3,34
"26722",10602,"Corner Brook","NL",48.95224,-57.92207,2018-01-19 04:00:00,31,3,34
"26723",10602,"Corner Brook","NL",48.95224,-57.92207,2018-01-19 05:00:00,29,5,34
"26724",10602,"Corner Brook","NL",48.95224,-57.92207,2018-01-19 06:00:00,30,5,35
"26725",10602,"Corner Brook","NL",48.95224,-57.92207,2018-01-19 07:00:00,32,3,35
"26726",10602,"Corner Brook","NL",48.95224,-57.92207,2018-01-19 08:00:00,33,3,36
"26727",10602,"Corner Brook","NL",48.95224,-57.92207,2018-01-19 09:00:00,31,4,35
"26728",10602,"Corner Brook","NL",48.95224,-57.92207,2018-01-19 10:00:00,30,4,34
"26729",10602,"Corner Brook","NL",48.95224,-57.92207,2018-01-19 11:00:00,31,3,34
"26730",10602,"Corner Brook","NL",48.95224,-57.92207,2018-01-19 12:00:00,32,2,34
"26731",10602,"Corner Brook","NL",48.95224,-57.92207,2018-01-19 13:00:00,32,2,34
"26732",10602,"Corner Brook","NL",48.95224,-57.92207,2018-01-19 14:00:00,32,3,35
"26733",10602,"Corner Brook","NL",48.95224,-57.92207,2018-01-19 15:00:00,33,3,36
"26734",10602,"Corner Brook","NL",48.95224,-57.92207,2018-01-19 16:00:00,34,3,37
"26735",10602,"Corner Brook","NL",48.95224,-57.92207,2018-01-19 17:00:00,34,2,36
"26736",10602,"Corner Brook","NL",48.95224,-57.92207,2018-01-19 18:00:00,34,2,36
"26737",10602,"Corner Brook","NL",48.95224,-57.92207,2018-01-19 19:00:00,34,3,37
"26738",10602,"Corner Brook","NL",48.95224,-57.92207,2018-01-19 20:00:00,35,2,37
"26739",10602,"Corner Brook","NL",48.95224,-57.92207,2018-01-19 21:00:00,35,2,37
"26740",10602,"Corner Brook","NL",48.95224,-57.92207,2018-01-19 22:00:00,36,2,38
"26741",10602,"Corner Brook","NL",48.95224,-57.92207,2018-01-19 23:00:00,35,3,38
"26742",10602,"Corner Brook","NL",48.95224,-57.92207,2018-01-20 00:00:00,34,3,37
"26743",10602,"Corner Brook","NL",48.95224,-57.92207,2018-01-20 01:00:00,35,3,38
"26744",10602,"Corner Brook","NL",48.95224,-57.92207,2018-01-20 02:00:00,35,3,38
"26745",10602,"Corner Brook","NL",48.95224,-57.92207,2018-01-20 03:00:00,35,2,37
"26746",10602,"Corner Brook","NL",48.95224,-57.92207,2018-01-20 04:00:00,35,1,36
"26747",10602,"Corner Brook","NL",48.95224,-57.92207,2018-01-20 05:00:00,34,1,35
"26748",10602,"Corner Brook","NL",48.95224,-57.92207,2018-01-20 06:00:00,35,1,36
"26749",10602,"Corner Brook","NL",48.95224,-57.92207,2018-01-20 07:00:00,36,2,38
"26750",10602,"Corner Brook","NL",48.95224,-57.92207,2018-01-20 08:00:00,36,1,37
"26751",10602,"Corner Brook","NL",48.95224,-57.92207,2018-01-20 09:00:00,36,2,38
"26752",10602,"Corner Brook","NL",48.95224,-57.92207,2018-01-20 10:00:00,35,1,36
"26753",10602,"Corner Brook","NL",48.95224,-57.92207,2018-01-20 11:00:00,36,1,37
"26754",10602,"Corner Brook","NL",48.95224,-57.92207,2018-01-20 12:00:00,36,2,38
"26755",10602,"Corner Brook","NL",48.95224,-57.92207,2018-01-20 13:00:00,36,2,38
"26756",10602,"Corner Brook","NL",48.95224,-57.92207,2018-01-20 14:00:00,37,1,38
"26757",10602,"Corner Brook","NL",48.95224,-57.92207,2018-01-20 15:00:00,36,1,37
"26758",10602,"Corner Brook","NL",48.95224,-57.92207,2018-01-20 16:00:00,36,2,38
"26759",10602,"Corner Brook","NL",48.95224,-57.92207,2018-01-20 17:00:00,36,2,38
"26760",10602,"Corner Brook","NL",48.95224,-57.92207,2018-01-20 18:00:00,34,3,37
"26761",10602,"Corner Brook","NL",48.95224,-57.92207,2018-01-20 19:00:00,32,5,37
"26762",10602,"Corner Brook","NL",48.95224,-57.92207,2018-01-20 20:00:00,32,4,36
"26763",10602,"Corner Brook","NL",48.95224,-57.92207,2018-01-20 21:00:00,29,6,35
"26764",10602,"Corner Brook","NL",48.95224,-57.92207,2018-01-20 22:00:00,31,3,34
"26765",10602,"Corner Brook","NL",48.95224,-57.92207,2018-01-20 23:00:00,31,4,35
"26766",10602,"Corner Brook","NL",48.95224,-57.92207,2018-01-21 00:00:00,30,3,33
"26767",10602,"Corner Brook","NL",48.95224,-57.92207,2018-01-21 01:00:00,30,2,32
"26768",10602,"Corner Brook","NL",48.95224,-57.92207,2018-01-21 02:00:00,29,2,31
"26769",10602,"Corner Brook","NL",48.95224,-57.92207,2018-01-21 03:00:00,27,4,31
"26770",10602,"Corner Brook","NL",48.95224,-57.92207,2018-01-21 04:00:00,29,2,31
"26771",10602,"Corner Brook","NL",48.95224,-57.92207,2018-01-21 05:00:00,26,6,32
"26772",10602,"Corner Brook","NL",48.95224,-57.92207,2018-01-21 06:00:00,29,5,34
"26773",10602,"Corner Brook","NL",48.95224,-57.92207,2018-01-21 07:00:00,29,5,34
"26774",10602,"Corner Brook","NL",48.95224,-57.92207,2018-01-21 08:00:00,30,4,34
"26775",10602,"Corner Brook","NL",48.95224,-57.92207,2018-01-21 09:00:00,31,5,36
"26776",10602,"Corner Brook","NL",48.95224,-57.92207,2018-01-21 10:00:00,32,6,38
"26777",10602,"Corner Brook","NL",48.95224,-57.92207,2018-01-21 11:00:00,36,4,40
"26778",10602,"Corner Brook","NL",48.95224,-57.92207,2018-01-21 12:00:00,36,4,40
"26779",10602,"Corner Brook","NL",48.95224,-57.92207,2018-01-21 13:00:00,35,5,40
"26780",10602,"Corner Brook","NL",48.95224,-57.92207,2018-01-21 14:00:00,38,2,40
"26781",10602,"Corner Brook","NL",48.95224,-57.92207,2018-01-21 15:00:00,38,1,39
"26782",10602,"Corner Brook","NL",48.95224,-57.92207,2018-01-21 16:00:00,37,1,38
"26783",10602,"Corner Brook","NL",48.95224,-57.92207,2018-01-21 17:00:00,37,2,39
"26784",10602,"Corner Brook","NL",48.95224,-57.92207,2018-01-21 18:00:00,37,2,39
"26785",10602,"Corner Brook","NL",48.95224,-57.92207,2018-01-21 19:00:00,37,2,39
"26786",10602,"Corner Brook","NL",48.95224,-57.92207,2018-01-21 20:00:00,37,2,39
"26787",10602,"Corner Brook","NL",48.95224,-57.92207,2018-01-21 21:00:00,35,3,38
"26788",10602,"Corner Brook","NL",48.95224,-57.92207,2018-01-21 22:00:00,35,3,38
"26789",10602,"Corner Brook","NL",48.95224,-57.92207,2018-01-21 23:00:00,36,2,38
"26790",10602,"Corner Brook","NL",48.95224,-57.92207,2018-01-22 00:00:00,34,3,37
"26791",10602,"Corner Brook","NL",48.95224,-57.92207,2018-01-22 01:00:00,33,5,38
"26792",10602,"Corner Brook","NL",48.95224,-57.92207,2018-01-22 02:00:00,35,3,38
"26793",10602,"Corner Brook","NL",48.95224,-57.92207,2018-01-22 03:00:00,36,2,38
"26794",10602,"Corner Brook","NL",48.95224,-57.92207,2018-01-22 04:00:00,37,2,39
"26795",10602,"Corner Brook","NL",48.95224,-57.92207,2018-01-22 05:00:00,35,4,39
"26796",10602,"Corner Brook","NL",48.95224,-57.92207,2018-01-22 06:00:00,36,3,39
"26797",10602,"Corner Brook","NL",48.95224,-57.92207,2018-01-22 07:00:00,37,2,39
"26798",10602,"Corner Brook","NL",48.95224,-57.92207,2018-01-22 08:00:00,37,2,39
"26799",10602,"Corner Brook","NL",48.95224,-57.92207,2018-01-22 09:00:00,37,3,40
"26800",10602,"Corner Brook","NL",48.95224,-57.92207,2018-01-22 10:00:00,37,3,40
"26801",10602,"Corner Brook","NL",48.95224,-57.92207,2018-01-22 11:00:00,36,3,39
"26802",10602,"Corner Brook","NL",48.95224,-57.92207,2018-01-22 12:00:00,36,3,39
"26803",10602,"Corner Brook","NL",48.95224,-57.92207,2018-01-22 13:00:00,35,3,38
"26804",10602,"Corner Brook","NL",48.95224,-57.92207,2018-01-22 14:00:00,36,2,38
"26805",10602,"Corner Brook","NL",48.95224,-57.92207,2018-01-22 15:00:00,35,3,38
"26806",10602,"Corner Brook","NL",48.95224,-57.92207,2018-01-22 16:00:00,36,3,39
"26807",10602,"Corner Brook","NL",48.95224,-57.92207,2018-01-22 17:00:00,35,3,38
"26808",10602,"Corner Brook","NL",48.95224,-57.92207,2018-01-22 18:00:00,36,3,39
"26809",10602,"Corner Brook","NL",48.95224,-57.92207,2018-01-22 19:00:00,36,2,38
"26810",10602,"Corner Brook","NL",48.95224,-57.92207,2018-01-22 20:00:00,35,2,37
"26811",10602,"Corner Brook","NL",48.95224,-57.92207,2018-01-22 21:00:00,36,2,38
"26812",10602,"Corner Brook","NL",48.95224,-57.92207,2018-01-22 22:00:00,36,3,39
"26813",10602,"Corner Brook","NL",48.95224,-57.92207,2018-01-22 23:00:00,38,2,40
"26814",10602,"Corner Brook","NL",48.95224,-57.92207,2018-01-23 00:00:00,38,3,41
"26815",10602,"Corner Brook","NL",48.95224,-57.92207,2018-01-23 01:00:00,41,1,42
"26816",10602,"Corner Brook","NL",48.95224,-57.92207,2018-01-23 02:00:00,41,1,42
"26817",10602,"Corner Brook","NL",48.95224,-57.92207,2018-01-23 03:00:00,41,1,42
"26818",10602,"Corner Brook","NL",48.95224,-57.92207,2018-01-23 04:00:00,40,2,42
"26819",10602,"Corner Brook","NL",48.95224,-57.92207,2018-01-23 05:00:00,39,3,42
"26820",10602,"Corner Brook","NL",48.95224,-57.92207,2018-01-23 06:00:00,37,4,41
"26821",10602,"Corner Brook","NL",48.95224,-57.92207,2018-01-23 07:00:00,39,2,41
"26822",10602,"Corner Brook","NL",48.95224,-57.92207,2018-01-23 08:00:00,33,8,41
"26823",10602,"Corner Brook","NL",48.95224,-57.92207,2018-01-23 09:00:00,34,6,40
"26824",10602,"Corner Brook","NL",48.95224,-57.92207,2018-01-23 10:00:00,37,3,40
"26825",10602,"Corner Brook","NL",48.95224,-57.92207,2018-01-23 11:00:00,39,3,42
"26826",10602,"Corner Brook","NL",48.95224,-57.92207,2018-01-23 12:00:00,39,2,41
"26827",10602,"Corner Brook","NL",48.95224,-57.92207,2018-01-23 13:00:00,40,1,41
"26828",10602,"Corner Brook","NL",48.95224,-57.92207,2018-01-23 14:00:00,39,1,40
"26829",10602,"Corner Brook","NL",48.95224,-57.92207,2018-01-23 15:00:00,39,2,41
"26830",10602,"Corner Brook","NL",48.95224,-57.92207,2018-01-23 16:00:00,38,2,40
"26831",10602,"Corner Brook","NL",48.95224,-57.92207,2018-01-23 17:00:00,38,2,40
"26832",10602,"Corner Brook","NL",48.95224,-57.92207,2018-01-23 18:00:00,34,5,39
"26833",10602,"Corner Brook","NL",48.95224,-57.92207,2018-01-23 19:00:00,30,8,38
"26834",10602,"Corner Brook","NL",48.95224,-57.92207,2018-01-23 20:00:00,35,4,39
"26835",10602,"Corner Brook","NL",48.95224,-57.92207,2018-01-23 21:00:00,35,4,39
"26836",10602,"Corner Brook","NL",48.95224,-57.92207,2018-01-23 22:00:00,39,2,41
"26837",10602,"Corner Brook","NL",48.95224,-57.92207,2018-01-23 23:00:00,39,1,40
"26838",10602,"Corner Brook","NL",48.95224,-57.92207,2018-01-24 00:00:00,39,1,40
"26839",10602,"Corner Brook","NL",48.95224,-57.92207,2018-01-24 01:00:00,39,1,40
"26840",10602,"Corner Brook","NL",48.95224,-57.92207,2018-01-24 02:00:00,39,1,40
"26841",10602,"Corner Brook","NL",48.95224,-57.92207,2018-01-24 03:00:00,40,1,41
"26842",10602,"Corner Brook","NL",48.95224,-57.92207,2018-01-24 04:00:00,40,1,41
"26843",10602,"Corner Brook","NL",48.95224,-57.92207,2018-01-24 05:00:00,40,1,41
"26844",10602,"Corner Brook","NL",48.95224,-57.92207,2018-01-24 06:00:00,40,0,40
"26845",10602,"Corner Brook","NL",48.95224,-57.92207,2018-01-24 07:00:00,41,0,41
"26846",10602,"Corner Brook","NL",48.95224,-57.92207,2018-01-24 08:00:00,41,1,42
"26847",10602,"Corner Brook","NL",48.95224,-57.92207,2018-01-24 09:00:00,41,1,42
"26848",10602,"Corner Brook","NL",48.95224,-57.92207,2018-01-24 10:00:00,42,1,43
"26849",10602,"Corner Brook","NL",48.95224,-57.92207,2018-01-24 11:00:00,42,1,43
"26850",10602,"Corner Brook","NL",48.95224,-57.92207,2018-01-24 12:00:00,42,1,43
"26851",10602,"Corner Brook","NL",48.95224,-57.92207,2018-01-24 13:00:00,42,1,43
"26852",10602,"Corner Brook","NL",48.95224,-57.92207,2018-01-24 14:00:00,41,1,42
"26853",10602,"Corner Brook","NL",48.95224,-57.92207,2018-01-24 15:00:00,38,1,39
"26854",10602,"Corner Brook","NL",48.95224,-57.92207,2018-01-24 16:00:00,32,1,33
"26855",10602,"Corner Brook","NL",48.95224,-57.92207,2018-01-24 17:00:00,32,1,33
"26856",10602,"Corner Brook","NL",48.95224,-57.92207,2018-01-24 18:00:00,33,2,35
"26857",10602,"Corner Brook","NL",48.95224,-57.92207,2018-01-24 19:00:00,35,1,36
"26858",10602,"Corner Brook","NL",48.95224,-57.92207,2018-01-24 20:00:00,35,1,36
"26859",10602,"Corner Brook","NL",48.95224,-57.92207,2018-01-24 21:00:00,34,2,36
"26860",10602,"Corner Brook","NL",48.95224,-57.92207,2018-01-24 22:00:00,34,1,35
"26861",10602,"Corner Brook","NL",48.95224,-57.92207,2018-01-24 23:00:00,34,1,35
"26862",10602,"Corner Brook","NL",48.95224,-57.92207,2018-01-25 00:00:00,35,1,36
"26863",10602,"Corner Brook","NL",48.95224,-57.92207,2018-01-25 01:00:00,36,1,37
"26864",10602,"Corner Brook","NL",48.95224,-57.92207,2018-01-25 02:00:00,37,1,38
"26865",10602,"Corner Brook","NL",48.95224,-57.92207,2018-01-25 03:00:00,38,1,39
"26866",10602,"Corner Brook","NL",48.95224,-57.92207,2018-01-25 04:00:00,38,1,39
"26867",10602,"Corner Brook","NL",48.95224,-57.92207,2018-01-25 05:00:00,39,1,40
"26868",10602,"Corner Brook","NL",48.95224,-57.92207,2018-01-25 06:00:00,38,1,39
"26869",10602,"Corner Brook","NL",48.95224,-57.92207,2018-01-25 07:00:00,38,1,39
"26870",10602,"Corner Brook","NL",48.95224,-57.92207,2018-01-25 08:00:00,36,3,39
"26871",10602,"Corner Brook","NL",48.95224,-57.92207,2018-01-25 09:00:00,37,2,39
"26872",10602,"Corner Brook","NL",48.95224,-57.92207,2018-01-25 10:00:00,38,2,40
"26873",10602,"Corner Brook","NL",48.95224,-57.92207,2018-01-25 11:00:00,38,2,40
"26874",10602,"Corner Brook","NL",48.95224,-57.92207,2018-01-25 12:00:00,37,2,39
"26875",10602,"Corner Brook","NL",48.95224,-57.92207,2018-01-25 13:00:00,37,1,38
"26876",10602,"Corner Brook","NL",48.95224,-57.92207,2018-01-25 14:00:00,37,1,38
"26877",10602,"Corner Brook","NL",48.95224,-57.92207,2018-01-25 15:00:00,36,1,37
"26878",10602,"Corner Brook","NL",48.95224,-57.92207,2018-01-25 16:00:00,35,2,37
"26879",10602,"Corner Brook","NL",48.95224,-57.92207,2018-01-25 17:00:00,35,1,36
"26880",10602,"Corner Brook","NL",48.95224,-57.92207,2018-01-25 18:00:00,34,2,36
"26881",10602,"Corner Brook","NL",48.95224,-57.92207,2018-01-25 19:00:00,32,3,35
"26882",10602,"Corner Brook","NL",48.95224,-57.92207,2018-01-25 20:00:00,33,2,35
"26883",10602,"Corner Brook","NL",48.95224,-57.92207,2018-01-25 21:00:00,34,1,35
"26884",10602,"Corner Brook","NL",48.95224,-57.92207,2018-01-25 22:00:00,35,1,36
"26885",10602,"Corner Brook","NL",48.95224,-57.92207,2018-01-25 23:00:00,34,1,35
"26886",10602,"Corner Brook","NL",48.95224,-57.92207,2018-01-26 00:00:00,33,2,35
"26887",10602,"Corner Brook","NL",48.95224,-57.92207,2018-01-26 01:00:00,32,2,34
"26888",10602,"Corner Brook","NL",48.95224,-57.92207,2018-01-26 02:00:00,31,4,35
"26889",10602,"Corner Brook","NL",48.95224,-57.92207,2018-01-26 03:00:00,34,2,36
"26890",10602,"Corner Brook","NL",48.95224,-57.92207,2018-01-26 04:00:00,34,2,36
"26891",10602,"Corner Brook","NL",48.95224,-57.92207,2018-01-26 05:00:00,34,2,36
"26892",10602,"Corner Brook","NL",48.95224,-57.92207,2018-01-26 06:00:00,30,6,36
"26893",10602,"Corner Brook","NL",48.95224,-57.92207,2018-01-26 07:00:00,32,4,36
"26894",10602,"Corner Brook","NL",48.95224,-57.92207,2018-01-26 08:00:00,32,4,36
"26895",10602,"Corner Brook","NL",48.95224,-57.92207,2018-01-26 09:00:00,35,3,38
"26896",10602,"Corner Brook","NL",48.95224,-57.92207,2018-01-26 10:00:00,34,3,37
"26897",10602,"Corner Brook","NL",48.95224,-57.92207,2018-01-26 11:00:00,35,3,38
"26898",10602,"Corner Brook","NL",48.95224,-57.92207,2018-01-26 12:00:00,36,2,38
"26899",10602,"Corner Brook","NL",48.95224,-57.92207,2018-01-26 13:00:00,37,1,38
"26900",10602,"Corner Brook","NL",48.95224,-57.92207,2018-01-26 14:00:00,37,2,39
"26901",10602,"Corner Brook","NL",48.95224,-57.92207,2018-01-26 15:00:00,38,1,39
"26902",10602,"Corner Brook","NL",48.95224,-57.92207,2018-01-26 16:00:00,38,1,39
"26903",10602,"Corner Brook","NL",48.95224,-57.92207,2018-01-26 17:00:00,39,1,40
"26904",10602,"Corner Brook","NL",48.95224,-57.92207,2018-01-26 18:00:00,39,1,40
"26905",10602,"Corner Brook","NL",48.95224,-57.92207,2018-01-26 19:00:00,39,1,40
"26906",10602,"Corner Brook","NL",48.95224,-57.92207,2018-01-26 20:00:00,39,1,40
"26907",10602,"Corner Brook","NL",48.95224,-57.92207,2018-01-26 21:00:00,40,1,41
"26908",10602,"Corner Brook","NL",48.95224,-57.92207,2018-01-26 22:00:00,40,1,41
"26909",10602,"Corner Brook","NL",48.95224,-57.92207,2018-01-26 23:00:00,40,1,41
"26910",10602,"Corner Brook","NL",48.95224,-57.92207,2018-01-27 00:00:00,40,1,41
"26911",10602,"Corner Brook","NL",48.95224,-57.92207,2018-01-27 01:00:00,41,1,42
"26912",10602,"Corner Brook","NL",48.95224,-57.92207,2018-01-27 02:00:00,41,1,42
"26913",10602,"Corner Brook","NL",48.95224,-57.92207,2018-01-27 03:00:00,39,2,41
"26914",10602,"Corner Brook","NL",48.95224,-57.92207,2018-01-27 04:00:00,39,2,41
"26915",10602,"Corner Brook","NL",48.95224,-57.92207,2018-01-27 05:00:00,38,2,40
"26916",10602,"Corner Brook","NL",48.95224,-57.92207,2018-01-27 06:00:00,38,2,40
"26917",10602,"Corner Brook","NL",48.95224,-57.92207,2018-01-27 07:00:00,39,2,41
"26918",10602,"Corner Brook","NL",48.95224,-57.92207,2018-01-27 08:00:00,38,2,40
"26919",10602,"Corner Brook","NL",48.95224,-57.92207,2018-01-27 09:00:00,38,2,40
"26920",10602,"Corner Brook","NL",48.95224,-57.92207,2018-01-27 10:00:00,37,2,39
"26921",10602,"Corner Brook","NL",48.95224,-57.92207,2018-01-27 11:00:00,37,3,40
"26922",10602,"Corner Brook","NL",48.95224,-57.92207,2018-01-27 12:00:00,39,1,40
"26923",10602,"Corner Brook","NL",48.95224,-57.92207,2018-01-27 13:00:00,40,1,41
"26924",10602,"Corner Brook","NL",48.95224,-57.92207,2018-01-27 14:00:00,40,1,41
"26925",10602,"Corner Brook","NL",48.95224,-57.92207,2018-01-27 15:00:00,40,1,41
"26926",10602,"Corner Brook","NL",48.95224,-57.92207,2018-01-27 16:00:00,40,1,41
"26927",10602,"Corner Brook","NL",48.95224,-57.92207,2018-01-27 17:00:00,40,1,41
"26928",10602,"Corner Brook","NL",48.95224,-57.92207,2018-01-27 18:00:00,40,1,41
"26929",10602,"Corner Brook","NL",48.95224,-57.92207,2018-01-27 19:00:00,38,2,40
"26930",10602,"Corner Brook","NL",48.95224,-57.92207,2018-01-27 20:00:00,39,2,41
"26931",10602,"Corner Brook","NL",48.95224,-57.92207,2018-01-27 21:00:00,38,2,40
"26932",10602,"Corner Brook","NL",48.95224,-57.92207,2018-01-27 22:00:00,37,4,41
"26933",10602,"Corner Brook","NL",48.95224,-57.92207,2018-01-27 23:00:00,39,1,40
"26934",10602,"Corner Brook","NL",48.95224,-57.92207,2018-01-28 00:00:00,39,1,40
"26935",10602,"Corner Brook","NL",48.95224,-57.92207,2018-01-28 01:00:00,39,1,40
"26936",10602,"Corner Brook","NL",48.95224,-57.92207,2018-01-28 02:00:00,38,2,40
"26937",10602,"Corner Brook","NL",48.95224,-57.92207,2018-01-28 03:00:00,39,1,40
"26938",10602,"Corner Brook","NL",48.95224,-57.92207,2018-01-28 04:00:00,40,1,41
"26939",10602,"Corner Brook","NL",48.95224,-57.92207,2018-01-28 05:00:00,39,1,40
"26940",10602,"Corner Brook","NL",48.95224,-57.92207,2018-01-28 06:00:00,39,1,40
"26941",10602,"Corner Brook","NL",48.95224,-57.92207,2018-01-28 07:00:00,38,1,39
"26942",10602,"Corner Brook","NL",48.95224,-57.92207,2018-01-28 08:00:00,38,1,39
"26943",10602,"Corner Brook","NL",48.95224,-57.92207,2018-01-28 09:00:00,37,1,38
"26944",10602,"Corner Brook","NL",48.95224,-57.92207,2018-01-28 10:00:00,37,1,38
"26945",10602,"Corner Brook","NL",48.95224,-57.92207,2018-01-28 11:00:00,38,1,39
"26946",10602,"Corner Brook","NL",48.95224,-57.92207,2018-01-28 12:00:00,37,1,38
"26947",10602,"Corner Brook","NL",48.95224,-57.92207,2018-01-28 13:00:00,35,1,36
"26948",10602,"Corner Brook","NL",48.95224,-57.92207,2018-01-28 14:00:00,34,2,36
"26949",10602,"Corner Brook","NL",48.95224,-57.92207,2018-01-28 15:00:00,34,1,35
"26950",10602,"Corner Brook","NL",48.95224,-57.92207,2018-01-28 16:00:00,34,2,36
"26951",10602,"Corner Brook","NL",48.95224,-57.92207,2018-01-28 17:00:00,34,1,35
"26952",10602,"Corner Brook","NL",48.95224,-57.92207,2018-01-28 18:00:00,34,2,36
"26953",10602,"Corner Brook","NL",48.95224,-57.92207,2018-01-28 19:00:00,35,1,36
"26954",10602,"Corner Brook","NL",48.95224,-57.92207,2018-01-28 20:00:00,35,2,37
"26955",10602,"Corner Brook","NL",48.95224,-57.92207,2018-01-28 21:00:00,33,2,35
"26956",10602,"Corner Brook","NL",48.95224,-57.92207,2018-01-28 22:00:00,33,1,34
"26957",10602,"Corner Brook","NL",48.95224,-57.92207,2018-01-28 23:00:00,32,1,33
"26958",10602,"Corner Brook","NL",48.95224,-57.92207,2018-01-29 00:00:00,32,1,33
"26959",10602,"Corner Brook","NL",48.95224,-57.92207,2018-01-29 01:00:00,30,2,32
"26960",10602,"Corner Brook","NL",48.95224,-57.92207,2018-01-29 02:00:00,25,5,30
"26961",10602,"Corner Brook","NL",48.95224,-57.92207,2018-01-29 03:00:00,31,3,34
"26962",10602,"Corner Brook","NL",48.95224,-57.92207,2018-01-29 04:00:00,35,2,37
"26963",10602,"Corner Brook","NL",48.95224,-57.92207,2018-01-29 05:00:00,36,1,37
"26964",10602,"Corner Brook","NL",48.95224,-57.92207,2018-01-29 06:00:00,36,1,37
"26965",10602,"Corner Brook","NL",48.95224,-57.92207,2018-01-29 07:00:00,36,1,37
"26966",10602,"Corner Brook","NL",48.95224,-57.92207,2018-01-29 08:00:00,37,1,38
"26967",10602,"Corner Brook","NL",48.95224,-57.92207,2018-01-29 09:00:00,37,2,39
"26968",10602,"Corner Brook","NL",48.95224,-57.92207,2018-01-29 10:00:00,39,1,40
"26969",10602,"Corner Brook","NL",48.95224,-57.92207,2018-01-29 11:00:00,38,2,40
"26970",10602,"Corner Brook","NL",48.95224,-57.92207,2018-01-29 12:00:00,38,3,41
"26971",10602,"Corner Brook","NL",48.95224,-57.92207,2018-01-29 13:00:00,39,2,41
"26972",10602,"Corner Brook","NL",48.95224,-57.92207,2018-01-29 14:00:00,37,3,40
"26973",10602,"Corner Brook","NL",48.95224,-57.92207,2018-01-29 15:00:00,37,3,40
"26974",10602,"Corner Brook","NL",48.95224,-57.92207,2018-01-29 16:00:00,37,2,39
"26975",10602,"Corner Brook","NL",48.95224,-57.92207,2018-01-29 17:00:00,35,3,38
"26976",10602,"Corner Brook","NL",48.95224,-57.92207,2018-01-29 18:00:00,35,3,38
"26977",10602,"Corner Brook","NL",48.95224,-57.92207,2018-01-29 19:00:00,36,4,40
"26978",10602,"Corner Brook","NL",48.95224,-57.92207,2018-01-29 20:00:00,38,2,40
"26979",10602,"Corner Brook","NL",48.95224,-57.92207,2018-01-29 21:00:00,38,2,40
"26980",10602,"Corner Brook","NL",48.95224,-57.92207,2018-01-29 22:00:00,39,2,41
"26981",10602,"Corner Brook","NL",48.95224,-57.92207,2018-01-29 23:00:00,37,2,39
"26982",10602,"Corner Brook","NL",48.95224,-57.92207,2018-01-30 00:00:00,36,2,38
"26983",10602,"Corner Brook","NL",48.95224,-57.92207,2018-01-30 01:00:00,33,2,35
"26984",10602,"Corner Brook","NL",48.95224,-57.92207,2018-01-30 02:00:00,34,3,37
"26985",10602,"Corner Brook","NL",48.95224,-57.92207,2018-01-30 03:00:00,36,2,38
"26986",10602,"Corner Brook","NL",48.95224,-57.92207,2018-01-30 04:00:00,37,1,38
"26987",10602,"Corner Brook","NL",48.95224,-57.92207,2018-01-30 05:00:00,36,1,37
"26988",10602,"Corner Brook","NL",48.95224,-57.92207,2018-01-30 06:00:00,36,1,37
"26989",10602,"Corner Brook","NL",48.95224,-57.92207,2018-01-30 07:00:00,35,1,36
"26990",10602,"Corner Brook","NL",48.95224,-57.92207,2018-01-30 08:00:00,34,2,36
"26991",10602,"Corner Brook","NL",48.95224,-57.92207,2018-01-30 09:00:00,33,3,36
"26992",10602,"Corner Brook","NL",48.95224,-57.92207,2018-01-30 10:00:00,33,3,36
"26993",10602,"Corner Brook","NL",48.95224,-57.92207,2018-01-30 11:00:00,34,3,37
"26994",10602,"Corner Brook","NL",48.95224,-57.92207,2018-01-30 12:00:00,34,2,36
"26995",10602,"Corner Brook","NL",48.95224,-57.92207,2018-01-30 13:00:00,34,2,36
"26996",10602,"Corner Brook","NL",48.95224,-57.92207,2018-01-30 14:00:00,34,2,36
"26997",10602,"Corner Brook","NL",48.95224,-57.92207,2018-01-30 15:00:00,34,2,36
"26998",10602,"Corner Brook","NL",48.95224,-57.92207,2018-01-30 16:00:00,34,1,35
"26999",10602,"Corner Brook","NL",48.95224,-57.92207,2018-01-30 17:00:00,35,2,37
"27000",10602,"Corner Brook","NL",48.95224,-57.92207,2018-01-30 18:00:00,35,1,36
"27001",10602,"Corner Brook","NL",48.95224,-57.92207,2018-01-30 19:00:00,35,1,36
"27002",10602,"Corner Brook","NL",48.95224,-57.92207,2018-01-30 20:00:00,35,1,36
"27003",10602,"Corner Brook","NL",48.95224,-57.92207,2018-01-30 21:00:00,34,1,35
"27004",10602,"Corner Brook","NL",48.95224,-57.92207,2018-01-30 22:00:00,35,1,36
"27005",10602,"Corner Brook","NL",48.95224,-57.92207,2018-01-30 23:00:00,35,1,36
"27006",10602,"Corner Brook","NL",48.95224,-57.92207,2018-01-31 00:00:00,36,1,37
"27007",10602,"Corner Brook","NL",48.95224,-57.92207,2018-01-31 01:00:00,36,0,36
"27008",10602,"Corner Brook","NL",48.95224,-57.92207,2018-01-31 02:00:00,38,0,38
"27009",10602,"Corner Brook","NL",48.95224,-57.92207,2018-01-31 03:00:00,38,0,38
"27010",10602,"Corner Brook","NL",48.95224,-57.92207,2018-01-31 04:00:00,37,1,38
"27011",10602,"Corner Brook","NL",48.95224,-57.92207,2018-01-31 05:00:00,37,1,38
"27012",10602,"Corner Brook","NL",48.95224,-57.92207,2018-01-31 06:00:00,37,1,38
"27013",10602,"Corner Brook","NL",48.95224,-57.92207,2018-01-31 07:00:00,37,1,38
"27014",10602,"Corner Brook","NL",48.95224,-57.92207,2018-01-31 08:00:00,40,2,42
"27015",10602,"Corner Brook","NL",48.95224,-57.92207,2018-01-31 09:00:00,37,1,38
"27016",10602,"Corner Brook","NL",48.95224,-57.92207,2018-01-31 10:00:00,36,1,37
"27017",10602,"Corner Brook","NL",48.95224,-57.92207,2018-01-31 11:00:00,36,1,37
"27018",10602,"Corner Brook","NL",48.95224,-57.92207,2018-01-31 12:00:00,36,0,36
"27019",10602,"Corner Brook","NL",48.95224,-57.92207,2018-01-31 13:00:00,36,1,37
"27020",10602,"Corner Brook","NL",48.95224,-57.92207,2018-01-31 14:00:00,36,1,37
"27021",10602,"Corner Brook","NL",48.95224,-57.92207,2018-01-31 15:00:00,36,1,37
"27022",10602,"Corner Brook","NL",48.95224,-57.92207,2018-01-31 16:00:00,36,1,37
"27023",10602,"Corner Brook","NL",48.95224,-57.92207,2018-01-31 17:00:00,36,1,37
"27024",10602,"Corner Brook","NL",48.95224,-57.92207,2018-01-31 18:00:00,36,1,37
"27025",10602,"Corner Brook","NL",48.95224,-57.92207,2018-01-31 19:00:00,36,1,37
"27026",10602,"Corner Brook","NL",48.95224,-57.92207,2018-01-31 20:00:00,35,1,36
"27027",10602,"Corner Brook","NL",48.95224,-57.92207,2018-01-31 21:00:00,36,1,37
"27028",10602,"Corner Brook","NL",48.95224,-57.92207,2018-01-31 22:00:00,35,1,36
"27029",10602,"Corner Brook","NL",48.95224,-57.92207,2018-01-31 23:00:00,36,1,37
"27030",10602,"Corner Brook","NL",48.95224,-57.92207,2018-02-01 00:00:00,36,2,38
"27031",10602,"Corner Brook","NL",48.95224,-57.92207,2018-02-01 01:00:00,36,2,38
"27032",10602,"Corner Brook","NL",48.95224,-57.92207,2018-02-01 02:00:00,36,2,38
"27033",10602,"Corner Brook","NL",48.95224,-57.92207,2018-02-01 03:00:00,35,3,38
"27034",10602,"Corner Brook","NL",48.95224,-57.92207,2018-02-01 04:00:00,36,2,38
"27035",10602,"Corner Brook","NL",48.95224,-57.92207,2018-02-01 05:00:00,37,1,38
"27036",10602,"Corner Brook","NL",48.95224,-57.92207,2018-02-01 06:00:00,36,2,38
"27037",10602,"Corner Brook","NL",48.95224,-57.92207,2018-02-01 07:00:00,36,3,39
"27038",10602,"Corner Brook","NL",48.95224,-57.92207,2018-02-01 08:00:00,36,2,38
"27039",10602,"Corner Brook","NL",48.95224,-57.92207,2018-02-01 09:00:00,37,1,38
"27040",10602,"Corner Brook","NL",48.95224,-57.92207,2018-02-01 10:00:00,37,1,38
"27041",10602,"Corner Brook","NL",48.95224,-57.92207,2018-02-01 11:00:00,38,2,40
"27042",10602,"Corner Brook","NL",48.95224,-57.92207,2018-02-01 12:00:00,38,1,39
"27043",10602,"Corner Brook","NL",48.95224,-57.92207,2018-02-01 13:00:00,39,1,40
"27044",10602,"Corner Brook","NL",48.95224,-57.92207,2018-02-01 14:00:00,41,1,42
"27045",10602,"Corner Brook","NL",48.95224,-57.92207,2018-02-01 15:00:00,39,2,41
"27046",10602,"Corner Brook","NL",48.95224,-57.92207,2018-02-01 16:00:00,39,2,41
"27047",10602,"Corner Brook","NL",48.95224,-57.92207,2018-02-01 17:00:00,39,2,41
"27048",10602,"Corner Brook","NL",48.95224,-57.92207,2018-02-01 18:00:00,39,2,41
"27049",10602,"Corner Brook","NL",48.95224,-57.92207,2018-02-01 19:00:00,36,4,40
"27050",10602,"Corner Brook","NL",48.95224,-57.92207,2018-02-01 20:00:00,36,3,39
"27051",10602,"Corner Brook","NL",48.95224,-57.92207,2018-02-01 21:00:00,35,3,38
"27052",10602,"Corner Brook","NL",48.95224,-57.92207,2018-02-01 22:00:00,35,3,38
"27053",10602,"Corner Brook","NL",48.95224,-57.92207,2018-02-01 23:00:00,37,2,39
"27054",10602,"Corner Brook","NL",48.95224,-57.92207,2018-02-02 00:00:00,37,1,38
"27055",10602,"Corner Brook","NL",48.95224,-57.92207,2018-02-02 01:00:00,36,2,38
"27056",10602,"Corner Brook","NL",48.95224,-57.92207,2018-02-02 02:00:00,37,1,38
"27057",10602,"Corner Brook","NL",48.95224,-57.92207,2018-02-02 03:00:00,38,1,39
"27058",10602,"Corner Brook","NL",48.95224,-57.92207,2018-02-02 04:00:00,39,1,40
"27059",10602,"Corner Brook","NL",48.95224,-57.92207,2018-02-02 05:00:00,39,1,40
"27060",10602,"Corner Brook","NL",48.95224,-57.92207,2018-02-02 06:00:00,39,2,41
"27061",10602,"Corner Brook","NL",48.95224,-57.92207,2018-02-02 07:00:00,38,3,41
"27062",10602,"Corner Brook","NL",48.95224,-57.92207,2018-02-02 08:00:00,38,2,40
"27063",10602,"Corner Brook","NL",48.95224,-57.92207,2018-02-02 09:00:00,36,3,39
"27064",10602,"Corner Brook","NL",48.95224,-57.92207,2018-02-02 10:00:00,31,9,40
"27065",10602,"Corner Brook","NL",48.95224,-57.92207,2018-02-02 11:00:00,32,8,40
"27066",10602,"Corner Brook","NL",48.95224,-57.92207,2018-02-02 12:00:00,37,4,41
"27067",10602,"Corner Brook","NL",48.95224,-57.92207,2018-02-02 13:00:00,35,7,42
"27068",10602,"Corner Brook","NL",48.95224,-57.92207,2018-02-02 14:00:00,43,2,45
"27069",10602,"Corner Brook","NL",48.95224,-57.92207,2018-02-02 15:00:00,44,1,45
"27070",10602,"Corner Brook","NL",48.95224,-57.92207,2018-02-02 16:00:00,44,2,46
"27071",10602,"Corner Brook","NL",48.95224,-57.92207,2018-02-02 17:00:00,45,1,46
"27072",10602,"Corner Brook","NL",48.95224,-57.92207,2018-02-02 18:00:00,45,1,46
"27073",10602,"Corner Brook","NL",48.95224,-57.92207,2018-02-02 19:00:00,45,1,46
"27074",10602,"Corner Brook","NL",48.95224,-57.92207,2018-02-02 20:00:00,46,0,46
"27075",10602,"Corner Brook","NL",48.95224,-57.92207,2018-02-02 21:00:00,47,0,47
"27076",10602,"Corner Brook","NL",48.95224,-57.92207,2018-02-02 22:00:00,46,1,47
"27077",10602,"Corner Brook","NL",48.95224,-57.92207,2018-02-02 23:00:00,46,1,47
"27078",10602,"Corner Brook","NL",48.95224,-57.92207,2018-02-03 00:00:00,44,1,45
"27079",10602,"Corner Brook","NL",48.95224,-57.92207,2018-02-03 01:00:00,34,1,35
"27080",10602,"Corner Brook","NL",48.95224,-57.92207,2018-02-03 02:00:00,33,1,34
"27081",10602,"Corner Brook","NL",48.95224,-57.92207,2018-02-03 03:00:00,33,1,34
"27082",10602,"Corner Brook","NL",48.95224,-57.92207,2018-02-03 04:00:00,33,1,34
"27083",10602,"Corner Brook","NL",48.95224,-57.92207,2018-02-03 05:00:00,34,1,35
"27084",10602,"Corner Brook","NL",48.95224,-57.92207,2018-02-03 06:00:00,34,1,35
"27085",10602,"Corner Brook","NL",48.95224,-57.92207,2018-02-03 07:00:00,33,1,34
"27086",10602,"Corner Brook","NL",48.95224,-57.92207,2018-02-03 08:00:00,34,1,35
"27087",10602,"Corner Brook","NL",48.95224,-57.92207,2018-02-03 09:00:00,33,2,35
"27088",10602,"Corner Brook","NL",48.95224,-57.92207,2018-02-03 10:00:00,33,2,35
"27089",10602,"Corner Brook","NL",48.95224,-57.92207,2018-02-03 11:00:00,34,2,36
"27090",10602,"Corner Brook","NL",48.95224,-57.92207,2018-02-03 12:00:00,35,1,36
"27091",10602,"Corner Brook","NL",48.95224,-57.92207,2018-02-03 13:00:00,34,5,39
"27092",10602,"Corner Brook","NL",48.95224,-57.92207,2018-02-03 14:00:00,37,1,38
"27093",10602,"Corner Brook","NL",48.95224,-57.92207,2018-02-03 15:00:00,37,1,38
"27094",10602,"Corner Brook","NL",48.95224,-57.92207,2018-02-03 16:00:00,37,1,38
"27095",10602,"Corner Brook","NL",48.95224,-57.92207,2018-02-03 17:00:00,38,1,39
"27096",10602,"Corner Brook","NL",48.95224,-57.92207,2018-02-03 18:00:00,38,1,39
"27097",10602,"Corner Brook","NL",48.95224,-57.92207,2018-02-03 19:00:00,38,2,40
"27098",10602,"Corner Brook","NL",48.95224,-57.92207,2018-02-03 20:00:00,38,2,40
"27099",10602,"Corner Brook","NL",48.95224,-57.92207,2018-02-03 21:00:00,39,2,41
"27100",10602,"Corner Brook","NL",48.95224,-57.92207,2018-02-03 22:00:00,39,1,40
"27101",10602,"Corner Brook","NL",48.95224,-57.92207,2018-02-03 23:00:00,38,1,39
"27102",10602,"Corner Brook","NL",48.95224,-57.92207,2018-02-04 00:00:00,36,1,37
"27103",10602,"Corner Brook","NL",48.95224,-57.92207,2018-02-04 01:00:00,35,1,36
"27104",10602,"Corner Brook","NL",48.95224,-57.92207,2018-02-04 02:00:00,33,3,36
"27105",10602,"Corner Brook","NL",48.95224,-57.92207,2018-02-04 03:00:00,36,2,38
"27106",10602,"Corner Brook","NL",48.95224,-57.92207,2018-02-04 04:00:00,37,1,38
"27107",10602,"Corner Brook","NL",48.95224,-57.92207,2018-02-04 05:00:00,36,2,38
"27108",10602,"Corner Brook","NL",48.95224,-57.92207,2018-02-04 06:00:00,39,1,40
"27109",10602,"Corner Brook","NL",48.95224,-57.92207,2018-02-04 07:00:00,39,1,40
"27110",10602,"Corner Brook","NL",48.95224,-57.92207,2018-02-04 08:00:00,38,1,39
"27111",10602,"Corner Brook","NL",48.95224,-57.92207,2018-02-04 09:00:00,39,1,40
"27112",10602,"Corner Brook","NL",48.95224,-57.92207,2018-02-04 10:00:00,38,1,39
"27113",10602,"Corner Brook","NL",48.95224,-57.92207,2018-02-04 11:00:00,39,1,40
"27114",10602,"Corner Brook","NL",48.95224,-57.92207,2018-02-04 12:00:00,38,1,39
"27115",10602,"Corner Brook","NL",48.95224,-57.92207,2018-02-04 13:00:00,38,1,39
"27116",10602,"Corner Brook","NL",48.95224,-57.92207,2018-02-04 14:00:00,39,1,40
"27117",10602,"Corner Brook","NL",48.95224,-57.92207,2018-02-04 15:00:00,39,1,40
"27118",10602,"Corner Brook","NL",48.95224,-57.92207,2018-02-04 16:00:00,39,1,40
"27119",10602,"Corner Brook","NL",48.95224,-57.92207,2018-02-04 17:00:00,39,1,40
"27120",10602,"Corner Brook","NL",48.95224,-57.92207,2018-02-04 18:00:00,40,1,41
"27121",10602,"Corner Brook","NL",48.95224,-57.92207,2018-02-04 19:00:00,40,1,41
"27122",10602,"Corner Brook","NL",48.95224,-57.92207,2018-02-04 20:00:00,40,1,41
"27123",10602,"Corner Brook","NL",48.95224,-57.92207,2018-02-04 21:00:00,41,1,42
"27124",10602,"Corner Brook","NL",48.95224,-57.92207,2018-02-04 22:00:00,41,1,42
"27125",10602,"Corner Brook","NL",48.95224,-57.92207,2018-02-04 23:00:00,41,1,42
"27126",10602,"Corner Brook","NL",48.95224,-57.92207,2018-02-05 00:00:00,41,1,42
"27127",10602,"Corner Brook","NL",48.95224,-57.92207,2018-02-05 01:00:00,41,0,41
"27128",10602,"Corner Brook","NL",48.95224,-57.92207,2018-02-05 02:00:00,41,0,41
"27129",10602,"Corner Brook","NL",48.95224,-57.92207,2018-02-05 03:00:00,41,0,41
"27130",10602,"Corner Brook","NL",48.95224,-57.92207,2018-02-05 04:00:00,41,0,41
"27131",10602,"Corner Brook","NL",48.95224,-57.92207,2018-02-05 05:00:00,41,1,42
"27132",10602,"Corner Brook","NL",48.95224,-57.92207,2018-02-05 06:00:00,42,0,42
"27133",10602,"Corner Brook","NL",48.95224,-57.92207,2018-02-05 07:00:00,42,1,43
"27134",10602,"Corner Brook","NL",48.95224,-57.92207,2018-02-05 08:00:00,42,1,43
"27135",10602,"Corner Brook","NL",48.95224,-57.92207,2018-02-05 09:00:00,41,1,42
"27136",10602,"Corner Brook","NL",48.95224,-57.92207,2018-02-05 10:00:00,41,1,42
"27137",10602,"Corner Brook","NL",48.95224,-57.92207,2018-02-05 11:00:00,42,1,43
"27138",10602,"Corner Brook","NL",48.95224,-57.92207,2018-02-05 12:00:00,42,0,42
"27139",10602,"Corner Brook","NL",48.95224,-57.92207,2018-02-05 13:00:00,43,1,44
"27140",10602,"Corner Brook","NL",48.95224,-57.92207,2018-02-05 14:00:00,44,0,44
"27141",10602,"Corner Brook","NL",48.95224,-57.92207,2018-02-05 15:00:00,44,1,45
"27142",10602,"Corner Brook","NL",48.95224,-57.92207,2018-02-05 16:00:00,43,1,44
"27143",10602,"Corner Brook","NL",48.95224,-57.92207,2018-02-05 17:00:00,43,0,43
"27144",10602,"Corner Brook","NL",48.95224,-57.92207,2018-02-05 18:00:00,42,0,42
"27145",10602,"Corner Brook","NL",48.95224,-57.92207,2018-02-05 19:00:00,42,0,42
"27146",10602,"Corner Brook","NL",48.95224,-57.92207,2018-02-05 20:00:00,41,0,41
"27147",10602,"Corner Brook","NL",48.95224,-57.92207,2018-02-05 21:00:00,40,0,40
"27148",10602,"Corner Brook","NL",48.95224,-57.92207,2018-02-05 22:00:00,40,1,41
"27149",10602,"Corner Brook","NL",48.95224,-57.92207,2018-02-05 23:00:00,39,1,40
"27150",10602,"Corner Brook","NL",48.95224,-57.92207,2018-02-06 00:00:00,34,4,38
"27151",10602,"Corner Brook","NL",48.95224,-57.92207,2018-02-06 01:00:00,34,1,35
"27152",10602,"Corner Brook","NL",48.95224,-57.92207,2018-02-06 02:00:00,33,1,34
"27153",10602,"Corner Brook","NL",48.95224,-57.92207,2018-02-06 03:00:00,32,2,34
"27154",10602,"Corner Brook","NL",48.95224,-57.92207,2018-02-06 04:00:00,32,4,36
"27155",10602,"Corner Brook","NL",48.95224,-57.92207,2018-02-06 05:00:00,35,3,38
"27156",10602,"Corner Brook","NL",48.95224,-57.92207,2018-02-06 06:00:00,35,4,39
"27157",10602,"Corner Brook","NL",48.95224,-57.92207,2018-02-06 07:00:00,36,4,40
"27158",10602,"Corner Brook","NL",48.95224,-57.92207,2018-02-06 08:00:00,35,5,40
"27159",10602,"Corner Brook","NL",48.95224,-57.92207,2018-02-06 09:00:00,38,2,40
"27160",10602,"Corner Brook","NL",48.95224,-57.92207,2018-02-06 10:00:00,39,2,41
"27161",10602,"Corner Brook","NL",48.95224,-57.92207,2018-02-06 11:00:00,40,1,41
"27162",10602,"Corner Brook","NL",48.95224,-57.92207,2018-02-06 12:00:00,39,2,41
"27163",10602,"Corner Brook","NL",48.95224,-57.92207,2018-02-06 13:00:00,39,2,41
"27164",10602,"Corner Brook","NL",48.95224,-57.92207,2018-02-06 14:00:00,39,2,41
"27165",10602,"Corner Brook","NL",48.95224,-57.92207,2018-02-06 15:00:00,39,2,41
"27166",10602,"Corner Brook","NL",48.95224,-57.92207,2018-02-06 16:00:00,38,2,40
"27167",10602,"Corner Brook","NL",48.95224,-57.92207,2018-02-06 17:00:00,38,2,40
"27168",10602,"Corner Brook","NL",48.95224,-57.92207,2018-02-06 18:00:00,37,3,40
"27169",10602,"Corner Brook","NL",48.95224,-57.92207,2018-02-06 19:00:00,36,4,40
"27170",10602,"Corner Brook","NL",48.95224,-57.92207,2018-02-06 20:00:00,37,2,39
"27171",10602,"Corner Brook","NL",48.95224,-57.92207,2018-02-06 21:00:00,36,3,39
"27172",10602,"Corner Brook","NL",48.95224,-57.92207,2018-02-06 22:00:00,37,2,39
"27173",10602,"Corner Brook","NL",48.95224,-57.92207,2018-02-06 23:00:00,36,2,38
"27174",10602,"Corner Brook","NL",48.95224,-57.92207,2018-02-07 00:00:00,37,2,39
"27175",10602,"Corner Brook","NL",48.95224,-57.92207,2018-02-07 01:00:00,36,3,39
"27176",10602,"Corner Brook","NL",48.95224,-57.92207,2018-02-07 02:00:00,37,2,39
"27177",10602,"Corner Brook","NL",48.95224,-57.92207,2018-02-07 03:00:00,36,2,38
"27178",10602,"Corner Brook","NL",48.95224,-57.92207,2018-02-07 04:00:00,38,2,40
"27179",10602,"Corner Brook","NL",48.95224,-57.92207,2018-02-07 05:00:00,37,2,39
"27180",10602,"Corner Brook","NL",48.95224,-57.92207,2018-02-07 06:00:00,35,4,39
"27181",10602,"Corner Brook","NL",48.95224,-57.92207,2018-02-07 07:00:00,31,6,37
"27182",10602,"Corner Brook","NL",48.95224,-57.92207,2018-02-07 08:00:00,27,10,37
"27183",10602,"Corner Brook","NL",48.95224,-57.92207,2018-02-07 09:00:00,34,4,38
"27184",10602,"Corner Brook","NL",48.95224,-57.92207,2018-02-07 10:00:00,35,4,39
"27185",10602,"Corner Brook","NL",48.95224,-57.92207,2018-02-07 11:00:00,38,2,40
"27186",10602,"Corner Brook","NL",48.95224,-57.92207,2018-02-07 12:00:00,40,1,41
"27187",10602,"Corner Brook","NL",48.95224,-57.92207,2018-02-07 13:00:00,41,2,43
"27188",10602,"Corner Brook","NL",48.95224,-57.92207,2018-02-07 14:00:00,41,1,42
"27189",10602,"Corner Brook","NL",48.95224,-57.92207,2018-02-07 15:00:00,41,2,43
"27190",10602,"Corner Brook","NL",48.95224,-57.92207,2018-02-07 16:00:00,40,2,42
"27191",10602,"Corner Brook","NL",48.95224,-57.92207,2018-02-07 17:00:00,41,2,43
"27192",10602,"Corner Brook","NL",48.95224,-57.92207,2018-02-07 18:00:00,37,4,41
"27193",10602,"Corner Brook","NL",48.95224,-57.92207,2018-02-07 19:00:00,35,5,40
"27194",10602,"Corner Brook","NL",48.95224,-57.92207,2018-02-07 20:00:00,34,4,38
"27195",10602,"Corner Brook","NL",48.95224,-57.92207,2018-02-07 21:00:00,35,3,38
"27196",10602,"Corner Brook","NL",48.95224,-57.92207,2018-02-07 22:00:00,38,3,41
"27197",10602,"Corner Brook","NL",48.95224,-57.92207,2018-02-07 23:00:00,38,2,40
"27198",10602,"Corner Brook","NL",48.95224,-57.92207,2018-02-08 00:00:00,36,3,39
"27199",10602,"Corner Brook","NL",48.95224,-57.92207,2018-02-08 01:00:00,36,2,38
"27200",10602,"Corner Brook","NL",48.95224,-57.92207,2018-02-08 02:00:00,37,1,38
"27201",10602,"Corner Brook","NL",48.95224,-57.92207,2018-02-08 03:00:00,37,2,39
"27202",10602,"Corner Brook","NL",48.95224,-57.92207,2018-02-08 04:00:00,35,2,37
"27203",10602,"Corner Brook","NL",48.95224,-57.92207,2018-02-08 05:00:00,36,2,38
"27204",10602,"Corner Brook","NL",48.95224,-57.92207,2018-02-08 06:00:00,36,2,38
"27205",10602,"Corner Brook","NL",48.95224,-57.92207,2018-02-08 07:00:00,36,2,38
"27206",10602,"Corner Brook","NL",48.95224,-57.92207,2018-02-08 08:00:00,35,3,38
"27207",10602,"Corner Brook","NL",48.95224,-57.92207,2018-02-08 09:00:00,31,6,37
"27208",10602,"Corner Brook","NL",48.95224,-57.92207,2018-02-08 10:00:00,31,6,37
"27209",10602,"Corner Brook","NL",48.95224,-57.92207,2018-02-08 11:00:00,30,6,36
"27210",10602,"Corner Brook","NL",48.95224,-57.92207,2018-02-08 12:00:00,28,8,36
"27211",10602,"Corner Brook","NL",48.95224,-57.92207,2018-02-08 13:00:00,32,6,38
"27212",10602,"Corner Brook","NL",48.95224,-57.92207,2018-02-08 14:00:00,37,2,39
"27213",10602,"Corner Brook","NL",48.95224,-57.92207,2018-02-08 15:00:00,35,7,42
"27214",10602,"Corner Brook","NL",48.95224,-57.92207,2018-02-08 16:00:00,37,3,40
"27215",10602,"Corner Brook","NL",48.95224,-57.92207,2018-02-08 17:00:00,39,1,40
"27216",10602,"Corner Brook","NL",48.95224,-57.92207,2018-02-08 18:00:00,37,3,40
"27217",10602,"Corner Brook","NL",48.95224,-57.92207,2018-02-08 19:00:00,36,3,39
"27218",10602,"Corner Brook","NL",48.95224,-57.92207,2018-02-08 20:00:00,38,2,40
"27219",10602,"Corner Brook","NL",48.95224,-57.92207,2018-02-08 21:00:00,37,4,41
"27220",10602,"Corner Brook","NL",48.95224,-57.92207,2018-02-08 22:00:00,37,4,41
"27221",10602,"Corner Brook","NL",48.95224,-57.92207,2018-02-08 23:00:00,38,3,41
"27222",10602,"Corner Brook","NL",48.95224,-57.92207,2018-02-09 00:00:00,37,3,40
"27223",10602,"Corner Brook","NL",48.95224,-57.92207,2018-02-09 01:00:00,37,3,40
"27224",10602,"Corner Brook","NL",48.95224,-57.92207,2018-02-09 02:00:00,38,3,41
"27225",10602,"Corner Brook","NL",48.95224,-57.92207,2018-02-09 03:00:00,38,2,40
"27226",10602,"Corner Brook","NL",48.95224,-57.92207,2018-02-09 04:00:00,35,4,39
"27227",10602,"Corner Brook","NL",48.95224,-57.92207,2018-02-09 05:00:00,31,7,38
"27228",10602,"Corner Brook","NL",48.95224,-57.92207,2018-02-09 06:00:00,36,3,39
"27229",10602,"Corner Brook","NL",48.95224,-57.92207,2018-02-09 07:00:00,36,2,38
"27230",10602,"Corner Brook","NL",48.95224,-57.92207,2018-02-09 08:00:00,35,3,38
"27231",10602,"Corner Brook","NL",48.95224,-57.92207,2018-02-09 09:00:00,34,3,37
"27232",10602,"Corner Brook","NL",48.95224,-57.92207,2018-02-09 10:00:00,34,4,38
"27233",10602,"Corner Brook","NL",48.95224,-57.92207,2018-02-09 11:00:00,35,3,38
"27234",10602,"Corner Brook","NL",48.95224,-57.92207,2018-02-09 12:00:00,35,3,38
"27235",10602,"Corner Brook","NL",48.95224,-57.92207,2018-02-09 13:00:00,37,2,39
"27236",10602,"Corner Brook","NL",48.95224,-57.92207,2018-02-09 14:00:00,37,1,38
"27237",10602,"Corner Brook","NL",48.95224,-57.92207,2018-02-09 15:00:00,36,2,38
"27238",10602,"Corner Brook","NL",48.95224,-57.92207,2018-02-09 16:00:00,36,3,39
"27239",10602,"Corner Brook","NL",48.95224,-57.92207,2018-02-09 17:00:00,35,3,38
"27240",10602,"Corner Brook","NL",48.95224,-57.92207,2018-02-09 18:00:00,32,5,37
"27241",10602,"Corner Brook","NL",48.95224,-57.92207,2018-02-09 19:00:00,34,4,38
"27242",10602,"Corner Brook","NL",48.95224,-57.92207,2018-02-09 20:00:00,34,3,37
"27243",10602,"Corner Brook","NL",48.95224,-57.92207,2018-02-09 21:00:00,38,1,39
"27244",10602,"Corner Brook","NL",48.95224,-57.92207,2018-02-09 22:00:00,38,1,39
"27245",10602,"Corner Brook","NL",48.95224,-57.92207,2018-02-09 23:00:00,37,1,38
"27246",10602,"Corner Brook","NL",48.95224,-57.92207,2018-02-10 00:00:00,38,1,39
"27247",10602,"Corner Brook","NL",48.95224,-57.92207,2018-02-10 01:00:00,39,1,40
"27248",10602,"Corner Brook","NL",48.95224,-57.92207,2018-02-10 02:00:00,39,1,40
"27249",10602,"Corner Brook","NL",48.95224,-57.92207,2018-02-10 03:00:00,39,1,40
"27250",10602,"Corner Brook","NL",48.95224,-57.92207,2018-02-10 04:00:00,40,1,41
"27251",10602,"Corner Brook","NL",48.95224,-57.92207,2018-02-10 05:00:00,39,1,40
"27252",10602,"Corner Brook","NL",48.95224,-57.92207,2018-02-10 06:00:00,39,2,41
"27253",10602,"Corner Brook","NL",48.95224,-57.92207,2018-02-10 07:00:00,35,4,39
"27254",10602,"Corner Brook","NL",48.95224,-57.92207,2018-02-10 08:00:00,33,6,39
"27255",10602,"Corner Brook","NL",48.95224,-57.92207,2018-02-10 09:00:00,34,5,39
"27256",10602,"Corner Brook","NL",48.95224,-57.92207,2018-02-10 10:00:00,33,6,39
"27257",10602,"Corner Brook","NL",48.95224,-57.92207,2018-02-10 11:00:00,39,2,41
"27258",10602,"Corner Brook","NL",48.95224,-57.92207,2018-02-10 12:00:00,39,1,40
"27259",10602,"Corner Brook","NL",48.95224,-57.92207,2018-02-10 13:00:00,40,1,41
"27260",10602,"Corner Brook","NL",48.95224,-57.92207,2018-02-10 14:00:00,40,1,41
"27261",10602,"Corner Brook","NL",48.95224,-57.92207,2018-02-10 15:00:00,41,1,42
"27262",10602,"Corner Brook","NL",48.95224,-57.92207,2018-02-10 16:00:00,41,1,42
"27263",10602,"Corner Brook","NL",48.95224,-57.92207,2018-02-10 17:00:00,42,1,43
"27264",10602,"Corner Brook","NL",48.95224,-57.92207,2018-02-10 18:00:00,43,2,45
"27265",10602,"Corner Brook","NL",48.95224,-57.92207,2018-02-10 19:00:00,43,1,44
"27266",10602,"Corner Brook","NL",48.95224,-57.92207,2018-02-10 20:00:00,42,2,44
"27267",10602,"Corner Brook","NL",48.95224,-57.92207,2018-02-10 21:00:00,41,2,43
"27268",10602,"Corner Brook","NL",48.95224,-57.92207,2018-02-10 22:00:00,40,3,43
"27269",10602,"Corner Brook","NL",48.95224,-57.92207,2018-02-10 23:00:00,36,4,40
"27270",10602,"Corner Brook","NL",48.95224,-57.92207,2018-02-11 00:00:00,30,7,37
"27271",10602,"Corner Brook","NL",48.95224,-57.92207,2018-02-11 01:00:00,33,4,37
"27272",10602,"Corner Brook","NL",48.95224,-57.92207,2018-02-11 02:00:00,29,5,34
"27273",10602,"Corner Brook","NL",48.95224,-57.92207,2018-02-11 03:00:00,27,8,35
"27274",10602,"Corner Brook","NL",48.95224,-57.92207,2018-02-11 04:00:00,38,2,40
"27275",10602,"Corner Brook","NL",48.95224,-57.92207,2018-02-11 05:00:00,39,2,41
"27276",10602,"Corner Brook","NL",48.95224,-57.92207,2018-02-11 06:00:00,38,4,42
"27277",10602,"Corner Brook","NL",48.95224,-57.92207,2018-02-11 07:00:00,39,3,42
"27278",10602,"Corner Brook","NL",48.95224,-57.92207,2018-02-11 08:00:00,40,5,45
"27279",10602,"Corner Brook","NL",48.95224,-57.92207,2018-02-11 09:00:00,40,5,45
"27280",10602,"Corner Brook","NL",48.95224,-57.92207,2018-02-11 10:00:00,42,2,44
"27281",10602,"Corner Brook","NL",48.95224,-57.92207,2018-02-11 11:00:00,41,3,44
"27282",10602,"Corner Brook","NL",48.95224,-57.92207,2018-02-11 12:00:00,41,4,45
"27283",10602,"Corner Brook","NL",48.95224,-57.92207,2018-02-11 13:00:00,41,3,44
"27284",10602,"Corner Brook","NL",48.95224,-57.92207,2018-02-11 14:00:00,40,5,45
"27285",10602,"Corner Brook","NL",48.95224,-57.92207,2018-02-11 15:00:00,41,4,45
"27286",10602,"Corner Brook","NL",48.95224,-57.92207,2018-02-11 16:00:00,40,3,43
"27287",10602,"Corner Brook","NL",48.95224,-57.92207,2018-02-11 17:00:00,39,5,44
"27288",10602,"Corner Brook","NL",48.95224,-57.92207,2018-02-11 18:00:00,40,3,43
"27289",10602,"Corner Brook","NL",48.95224,-57.92207,2018-02-11 19:00:00,34,6,40
"27290",10602,"Corner Brook","NL",48.95224,-57.92207,2018-02-11 20:00:00,32,6,38
"27291",10602,"Corner Brook","NL",48.95224,-57.92207,2018-02-11 21:00:00,36,4,40
"27292",10602,"Corner Brook","NL",48.95224,-57.92207,2018-02-11 22:00:00,37,3,40
"27293",10602,"Corner Brook","NL",48.95224,-57.92207,2018-02-11 23:00:00,38,3,41
"27294",10602,"Corner Brook","NL",48.95224,-57.92207,2018-02-12 00:00:00,38,2,40
"27295",10602,"Corner Brook","NL",48.95224,-57.92207,2018-02-12 01:00:00,38,2,40
"27296",10602,"Corner Brook","NL",48.95224,-57.92207,2018-02-12 02:00:00,38,3,41
"27297",10602,"Corner Brook","NL",48.95224,-57.92207,2018-02-12 03:00:00,38,3,41
"27298",10602,"Corner Brook","NL",48.95224,-57.92207,2018-02-12 04:00:00,38,3,41
"27299",10602,"Corner Brook","NL",48.95224,-57.92207,2018-02-12 05:00:00,38,3,41
"27300",10602,"Corner Brook","NL",48.95224,-57.92207,2018-02-12 06:00:00,37,3,40
"27301",10602,"Corner Brook","NL",48.95224,-57.92207,2018-02-12 07:00:00,38,2,40
"27302",10602,"Corner Brook","NL",48.95224,-57.92207,2018-02-12 08:00:00,37,2,39
"27303",10602,"Corner Brook","NL",48.95224,-57.92207,2018-02-12 09:00:00,27,10,37
"27304",10602,"Corner Brook","NL",48.95224,-57.92207,2018-02-12 10:00:00,28,11,39
"27305",10602,"Corner Brook","NL",48.95224,-57.92207,2018-02-12 11:00:00,31,7,38
"27306",10602,"Corner Brook","NL",48.95224,-57.92207,2018-02-12 12:00:00,32,3,35
"27307",10602,"Corner Brook","NL",48.95224,-57.92207,2018-02-12 13:00:00,34,3,37
"27308",10602,"Corner Brook","NL",48.95224,-57.92207,2018-02-12 14:00:00,37,2,39
"27309",10602,"Corner Brook","NL",48.95224,-57.92207,2018-02-12 15:00:00,36,3,39
"27310",10602,"Corner Brook","NL",48.95224,-57.92207,2018-02-12 16:00:00,39,3,42
"27311",10602,"Corner Brook","NL",48.95224,-57.92207,2018-02-12 17:00:00,41,2,43
"27312",10602,"Corner Brook","NL",48.95224,-57.92207,2018-02-12 18:00:00,43,2,45
"27313",10602,"Corner Brook","NL",48.95224,-57.92207,2018-02-12 19:00:00,43,3,46
"27314",10602,"Corner Brook","NL",48.95224,-57.92207,2018-02-12 20:00:00,42,4,46
"27315",10602,"Corner Brook","NL",48.95224,-57.92207,2018-02-12 21:00:00,39,5,44
"27316",10602,"Corner Brook","NL",48.95224,-57.92207,2018-02-12 22:00:00,37,5,42
"27317",10602,"Corner Brook","NL",48.95224,-57.92207,2018-02-12 23:00:00,37,5,42
"27318",10602,"Corner Brook","NL",48.95224,-57.92207,2018-02-13 00:00:00,39,2,41
"27319",10602,"Corner Brook","NL",48.95224,-57.92207,2018-02-13 01:00:00,40,2,42
"27320",10602,"Corner Brook","NL",48.95224,-57.92207,2018-02-13 02:00:00,39,2,41
"27321",10602,"Corner Brook","NL",48.95224,-57.92207,2018-02-13 03:00:00,39,2,41
"27322",10602,"Corner Brook","NL",48.95224,-57.92207,2018-02-13 04:00:00,39,1,40
"27323",10602,"Corner Brook","NL",48.95224,-57.92207,2018-02-13 05:00:00,39,1,40
"27324",10602,"Corner Brook","NL",48.95224,-57.92207,2018-02-13 06:00:00,39,1,40
"27325",10602,"Corner Brook","NL",48.95224,-57.92207,2018-02-13 07:00:00,39,1,40
"27326",10602,"Corner Brook","NL",48.95224,-57.92207,2018-02-13 08:00:00,38,1,39
"27327",10602,"Corner Brook","NL",48.95224,-57.92207,2018-02-13 09:00:00,38,2,40
"27328",10602,"Corner Brook","NL",48.95224,-57.92207,2018-02-13 10:00:00,37,2,39
"27329",10602,"Corner Brook","NL",48.95224,-57.92207,2018-02-13 11:00:00,37,3,40
"27330",10602,"Corner Brook","NL",48.95224,-57.92207,2018-02-13 12:00:00,37,3,40
"27331",10602,"Corner Brook","NL",48.95224,-57.92207,2018-02-13 13:00:00,37,1,38
"27332",10602,"Corner Brook","NL",48.95224,-57.92207,2018-02-13 14:00:00,37,2,39
"27333",10602,"Corner Brook","NL",48.95224,-57.92207,2018-02-13 15:00:00,36,2,38
"27334",10602,"Corner Brook","NL",48.95224,-57.92207,2018-02-13 16:00:00,36,3,39
"27335",10602,"Corner Brook","NL",48.95224,-57.92207,2018-02-13 17:00:00,37,2,39
"27336",10602,"Corner Brook","NL",48.95224,-57.92207,2018-02-13 18:00:00,34,4,38
"27337",10602,"Corner Brook","NL",48.95224,-57.92207,2018-02-13 19:00:00,34,3,37
"27338",10602,"Corner Brook","NL",48.95224,-57.92207,2018-02-13 20:00:00,35,2,37
"27339",10602,"Corner Brook","NL",48.95224,-57.92207,2018-02-13 21:00:00,34,3,37
"27340",10602,"Corner Brook","NL",48.95224,-57.92207,2018-02-13 22:00:00,34,3,37
"27341",10602,"Corner Brook","NL",48.95224,-57.92207,2018-02-13 23:00:00,35,2,37
"27342",10602,"Corner Brook","NL",48.95224,-57.92207,2018-02-14 00:00:00,36,2,38
"27343",10602,"Corner Brook","NL",48.95224,-57.92207,2018-02-14 01:00:00,36,2,38
"27344",10602,"Corner Brook","NL",48.95224,-57.92207,2018-02-14 02:00:00,35,2,37
"27345",10602,"Corner Brook","NL",48.95224,-57.92207,2018-02-14 03:00:00,36,2,38
"27346",10602,"Corner Brook","NL",48.95224,-57.92207,2018-02-14 04:00:00,38,1,39
"27347",10602,"Corner Brook","NL",48.95224,-57.92207,2018-02-14 05:00:00,38,1,39
"27348",10602,"Corner Brook","NL",48.95224,-57.92207,2018-02-14 06:00:00,37,1,38
"27349",10602,"Corner Brook","NL",48.95224,-57.92207,2018-02-14 07:00:00,39,1,40
"27350",10602,"Corner Brook","NL",48.95224,-57.92207,2018-02-14 08:00:00,39,2,41
"27351",10602,"Corner Brook","NL",48.95224,-57.92207,2018-02-14 09:00:00,39,1,40
"27352",10602,"Corner Brook","NL",48.95224,-57.92207,2018-02-14 10:00:00,40,1,41
"27353",10602,"Corner Brook","NL",48.95224,-57.92207,2018-02-14 11:00:00,40,1,41
"27354",10602,"Corner Brook","NL",48.95224,-57.92207,2018-02-14 12:00:00,41,1,42
"27355",10602,"Corner Brook","NL",48.95224,-57.92207,2018-02-14 13:00:00,42,1,43
"27356",10602,"Corner Brook","NL",48.95224,-57.92207,2018-02-14 14:00:00,42,1,43
"27357",10602,"Corner Brook","NL",48.95224,-57.92207,2018-02-14 15:00:00,41,2,43
"27358",10602,"Corner Brook","NL",48.95224,-57.92207,2018-02-14 16:00:00,41,2,43
"27359",10602,"Corner Brook","NL",48.95224,-57.92207,2018-02-14 17:00:00,42,1,43
"27360",10602,"Corner Brook","NL",48.95224,-57.92207,2018-02-14 18:00:00,42,2,44
"27361",10602,"Corner Brook","NL",48.95224,-57.92207,2018-02-14 19:00:00,41,2,43
"27362",10602,"Corner Brook","NL",48.95224,-57.92207,2018-02-14 20:00:00,41,2,43
"27363",10602,"Corner Brook","NL",48.95224,-57.92207,2018-02-14 21:00:00,40,3,43
"27364",10602,"Corner Brook","NL",48.95224,-57.92207,2018-02-14 22:00:00,41,2,43
"27365",10602,"Corner Brook","NL",48.95224,-57.92207,2018-02-14 23:00:00,40,3,43
"27366",10602,"Corner Brook","NL",48.95224,-57.92207,2018-02-15 00:00:00,39,4,43
"27367",10602,"Corner Brook","NL",48.95224,-57.92207,2018-02-15 01:00:00,41,2,43
"27368",10602,"Corner Brook","NL",48.95224,-57.92207,2018-02-15 02:00:00,40,1,41
"27369",10602,"Corner Brook","NL",48.95224,-57.92207,2018-02-15 03:00:00,39,2,41
"27370",10602,"Corner Brook","NL",48.95224,-57.92207,2018-02-15 04:00:00,38,2,40
"27371",10602,"Corner Brook","NL",48.95224,-57.92207,2018-02-15 05:00:00,38,3,41
"27372",10602,"Corner Brook","NL",48.95224,-57.92207,2018-02-15 06:00:00,40,1,41
"27373",10602,"Corner Brook","NL",48.95224,-57.92207,2018-02-15 07:00:00,39,2,41
"27374",10602,"Corner Brook","NL",48.95224,-57.92207,2018-02-15 08:00:00,38,3,41
"27375",10602,"Corner Brook","NL",48.95224,-57.92207,2018-02-15 09:00:00,37,3,40
"27376",10602,"Corner Brook","NL",48.95224,-57.92207,2018-02-15 10:00:00,39,3,42
"27377",10602,"Corner Brook","NL",48.95224,-57.92207,2018-02-15 11:00:00,39,3,42
"27378",10602,"Corner Brook","NL",48.95224,-57.92207,2018-02-15 12:00:00,41,2,43
"27379",10602,"Corner Brook","NL",48.95224,-57.92207,2018-02-15 13:00:00,42,2,44
"27380",10602,"Corner Brook","NL",48.95224,-57.92207,2018-02-15 14:00:00,42,2,44
"27381",10602,"Corner Brook","NL",48.95224,-57.92207,2018-02-15 15:00:00,42,3,45
"27382",10602,"Corner Brook","NL",48.95224,-57.92207,2018-02-15 16:00:00,40,6,46
"27383",10602,"Corner Brook","NL",48.95224,-57.92207,2018-02-15 17:00:00,41,4,45
"27384",10602,"Corner Brook","NL",48.95224,-57.92207,2018-02-15 18:00:00,41,3,44
"27385",10602,"Corner Brook","NL",48.95224,-57.92207,2018-02-15 19:00:00,38,5,43
"27386",10602,"Corner Brook","NL",48.95224,-57.92207,2018-02-15 20:00:00,37,5,42
"27387",10602,"Corner Brook","NL",48.95224,-57.92207,2018-02-15 21:00:00,36,5,41
"27388",10602,"Corner Brook","NL",48.95224,-57.92207,2018-02-15 22:00:00,37,4,41
"27389",10602,"Corner Brook","NL",48.95224,-57.92207,2018-02-15 23:00:00,37,3,40
"27390",10602,"Corner Brook","NL",48.95224,-57.92207,2018-02-16 00:00:00,39,3,42
"27391",10602,"Corner Brook","NL",48.95224,-57.92207,2018-02-16 01:00:00,42,2,44
"27392",10602,"Corner Brook","NL",48.95224,-57.92207,2018-02-16 02:00:00,43,2,45
"27393",10602,"Corner Brook","NL",48.95224,-57.92207,2018-02-16 03:00:00,42,2,44
"27394",10602,"Corner Brook","NL",48.95224,-57.92207,2018-02-16 04:00:00,40,3,43
"27395",10602,"Corner Brook","NL",48.95224,-57.92207,2018-02-16 05:00:00,40,4,44
"27396",10602,"Corner Brook","NL",48.95224,-57.92207,2018-02-16 06:00:00,42,3,45
"27397",10602,"Corner Brook","NL",48.95224,-57.92207,2018-02-16 07:00:00,39,4,43
"27398",10602,"Corner Brook","NL",48.95224,-57.92207,2018-02-16 08:00:00,39,3,42
"27399",10602,"Corner Brook","NL",48.95224,-57.92207,2018-02-16 09:00:00,36,6,42
"27400",10602,"Corner Brook","NL",48.95224,-57.92207,2018-02-16 10:00:00,35,6,41
"27401",10602,"Corner Brook","NL",48.95224,-57.92207,2018-02-16 11:00:00,24,15,39
"27402",10602,"Corner Brook","NL",48.95224,-57.92207,2018-02-16 12:00:00,34,8,42
"27403",10602,"Corner Brook","NL",48.95224,-57.92207,2018-02-16 13:00:00,39,3,42
"27404",10602,"Corner Brook","NL",48.95224,-57.92207,2018-02-16 14:00:00,38,2,40
"27405",10602,"Corner Brook","NL",48.95224,-57.92207,2018-02-16 15:00:00,34,2,36
"27406",10602,"Corner Brook","NL",48.95224,-57.92207,2018-02-16 16:00:00,34,2,36
"27407",10602,"Corner Brook","NL",48.95224,-57.92207,2018-02-16 17:00:00,37,3,40
"27408",10602,"Corner Brook","NL",48.95224,-57.92207,2018-02-16 18:00:00,37,3,40
"27409",10602,"Corner Brook","NL",48.95224,-57.92207,2018-02-16 19:00:00,37,4,41
"27410",10602,"Corner Brook","NL",48.95224,-57.92207,2018-02-16 20:00:00,32,9,41
"27411",10602,"Corner Brook","NL",48.95224,-57.92207,2018-02-16 21:00:00,35,5,40
"27412",10602,"Corner Brook","NL",48.95224,-57.92207,2018-02-16 22:00:00,32,8,40
"27413",10602,"Corner Brook","NL",48.95224,-57.92207,2018-02-16 23:00:00,38,3,41
"27414",10602,"Corner Brook","NL",48.95224,-57.92207,2018-02-17 00:00:00,36,5,41
"27415",10602,"Corner Brook","NL",48.95224,-57.92207,2018-02-17 01:00:00,33,8,41
"27416",10602,"Corner Brook","NL",48.95224,-57.92207,2018-02-17 02:00:00,35,5,40
"27417",10602,"Corner Brook","NL",48.95224,-57.92207,2018-02-17 03:00:00,37,2,39
"27418",10602,"Corner Brook","NL",48.95224,-57.92207,2018-02-17 04:00:00,35,4,39
"27419",10602,"Corner Brook","NL",48.95224,-57.92207,2018-02-17 05:00:00,35,4,39
"27420",10602,"Corner Brook","NL",48.95224,-57.92207,2018-02-17 06:00:00,34,4,38
"27421",10602,"Corner Brook","NL",48.95224,-57.92207,2018-02-17 07:00:00,36,1,37
"27422",10602,"Corner Brook","NL",48.95224,-57.92207,2018-02-17 08:00:00,36,1,37
"27423",10602,"Corner Brook","NL",48.95224,-57.92207,2018-02-17 09:00:00,37,1,38
"27424",10602,"Corner Brook","NL",48.95224,-57.92207,2018-02-17 10:00:00,37,2,39
"27425",10602,"Corner Brook","NL",48.95224,-57.92207,2018-02-17 11:00:00,36,2,38
"27426",10602,"Corner Brook","NL",48.95224,-57.92207,2018-02-17 12:00:00,36,2,38
"27427",10602,"Corner Brook","NL",48.95224,-57.92207,2018-02-17 13:00:00,37,1,38
"27428",10602,"Corner Brook","NL",48.95224,-57.92207,2018-02-17 14:00:00,38,1,39
"27429",10602,"Corner Brook","NL",48.95224,-57.92207,2018-02-17 15:00:00,37,2,39
"27430",10602,"Corner Brook","NL",48.95224,-57.92207,2018-02-17 16:00:00,35,2,37
"27431",10602,"Corner Brook","NL",48.95224,-57.92207,2018-02-17 17:00:00,33,3,36
"27432",10602,"Corner Brook","NL",48.95224,-57.92207,2018-02-17 18:00:00,32,3,35
"27433",10602,"Corner Brook","NL",48.95224,-57.92207,2018-02-17 19:00:00,33,3,36
"27434",10602,"Corner Brook","NL",48.95224,-57.92207,2018-02-17 20:00:00,32,4,36
"27435",10602,"Corner Brook","NL",48.95224,-57.92207,2018-02-17 21:00:00,33,4,37
"27436",10602,"Corner Brook","NL",48.95224,-57.92207,2018-02-17 22:00:00,35,1,36
"27437",10602,"Corner Brook","NL",48.95224,-57.92207,2018-02-17 23:00:00,34,2,36
"27438",10602,"Corner Brook","NL",48.95224,-57.92207,2018-02-18 00:00:00,33,4,37
"27439",10602,"Corner Brook","NL",48.95224,-57.92207,2018-02-18 01:00:00,35,2,37
"27440",10602,"Corner Brook","NL",48.95224,-57.92207,2018-02-18 02:00:00,35,2,37
"27441",10602,"Corner Brook","NL",48.95224,-57.92207,2018-02-18 03:00:00,35,2,37
"27442",10602,"Corner Brook","NL",48.95224,-57.92207,2018-02-18 04:00:00,35,1,36
"27443",10602,"Corner Brook","NL",48.95224,-57.92207,2018-02-18 05:00:00,35,2,37
"27444",10602,"Corner Brook","NL",48.95224,-57.92207,2018-02-18 06:00:00,35,2,37
"27445",10602,"Corner Brook","NL",48.95224,-57.92207,2018-02-18 07:00:00,35,1,36
"27446",10602,"Corner Brook","NL",48.95224,-57.92207,2018-02-18 08:00:00,35,1,36
"27447",10602,"Corner Brook","NL",48.95224,-57.92207,2018-02-18 09:00:00,36,1,37
"27448",10602,"Corner Brook","NL",48.95224,-57.92207,2018-02-18 10:00:00,35,2,37
"27449",10602,"Corner Brook","NL",48.95224,-57.92207,2018-02-18 11:00:00,37,1,38
"27450",10602,"Corner Brook","NL",48.95224,-57.92207,2018-02-18 12:00:00,37,1,38
"27451",10602,"Corner Brook","NL",48.95224,-57.92207,2018-02-18 13:00:00,37,1,38
"27452",10602,"Corner Brook","NL",48.95224,-57.92207,2018-02-18 14:00:00,39,1,40
"27453",10602,"Corner Brook","NL",48.95224,-57.92207,2018-02-18 15:00:00,39,1,40
"27454",10602,"Corner Brook","NL",48.95224,-57.92207,2018-02-18 16:00:00,38,1,39
"27455",10602,"Corner Brook","NL",48.95224,-57.92207,2018-02-18 17:00:00,37,2,39
"27456",10602,"Corner Brook","NL",48.95224,-57.92207,2018-02-18 18:00:00,31,6,37
"27457",10602,"Corner Brook","NL",48.95224,-57.92207,2018-02-18 19:00:00,29,8,37
"27458",10602,"Corner Brook","NL",48.95224,-57.92207,2018-02-18 20:00:00,26,9,35
"27459",10602,"Corner Brook","NL",48.95224,-57.92207,2018-02-18 21:00:00,30,5,35
"27460",10602,"Corner Brook","NL",48.95224,-57.92207,2018-02-18 22:00:00,31,4,35
"27461",10602,"Corner Brook","NL",48.95224,-57.92207,2018-02-18 23:00:00,29,6,35
"27462",10602,"Corner Brook","NL",48.95224,-57.92207,2018-02-19 00:00:00,26,8,34
"27463",10602,"Corner Brook","NL",48.95224,-57.92207,2018-02-19 01:00:00,31,5,36
"27464",10602,"Corner Brook","NL",48.95224,-57.92207,2018-02-19 02:00:00,33,3,36
"27465",10602,"Corner Brook","NL",48.95224,-57.92207,2018-02-19 03:00:00,23,9,32
"27466",10602,"Corner Brook","NL",48.95224,-57.92207,2018-02-19 04:00:00,25,8,33
"27467",10602,"Corner Brook","NL",48.95224,-57.92207,2018-02-19 05:00:00,30,6,36
"27468",10602,"Corner Brook","NL",48.95224,-57.92207,2018-02-19 06:00:00,33,3,36
"27469",10602,"Corner Brook","NL",48.95224,-57.92207,2018-02-19 07:00:00,29,8,37
"27470",10602,"Corner Brook","NL",48.95224,-57.92207,2018-02-19 08:00:00,26,10,36
"27471",10602,"Corner Brook","NL",48.95224,-57.92207,2018-02-19 09:00:00,30,7,37
"27472",10602,"Corner Brook","NL",48.95224,-57.92207,2018-02-19 10:00:00,33,5,38
"27473",10602,"Corner Brook","NL",48.95224,-57.92207,2018-02-19 11:00:00,37,1,38
"27474",10602,"Corner Brook","NL",48.95224,-57.92207,2018-02-19 12:00:00,38,1,39
"27475",10602,"Corner Brook","NL",48.95224,-57.92207,2018-02-19 13:00:00,39,2,41
"27476",10602,"Corner Brook","NL",48.95224,-57.92207,2018-02-19 14:00:00,40,1,41
"27477",10602,"Corner Brook","NL",48.95224,-57.92207,2018-02-19 15:00:00,41,1,42
"27478",10602,"Corner Brook","NL",48.95224,-57.92207,2018-02-19 16:00:00,40,1,41
"27479",10602,"Corner Brook","NL",48.95224,-57.92207,2018-02-19 17:00:00,40,2,42
"27480",10602,"Corner Brook","NL",48.95224,-57.92207,2018-02-19 18:00:00,40,2,42
"27481",10602,"Corner Brook","NL",48.95224,-57.92207,2018-02-19 19:00:00,39,2,41
"27482",10602,"Corner Brook","NL",48.95224,-57.92207,2018-02-19 20:00:00,39,2,41
"27483",10602,"Corner Brook","NL",48.95224,-57.92207,2018-02-19 21:00:00,38,3,41
"27484",10602,"Corner Brook","NL",48.95224,-57.92207,2018-02-19 22:00:00,39,2,41
"27485",10602,"Corner Brook","NL",48.95224,-57.92207,2018-02-19 23:00:00,40,1,41
"27486",10602,"Corner Brook","NL",48.95224,-57.92207,2018-02-20 00:00:00,38,3,41
"27487",10602,"Corner Brook","NL",48.95224,-57.92207,2018-02-20 01:00:00,39,2,41
"27488",10602,"Corner Brook","NL",48.95224,-57.92207,2018-02-20 02:00:00,38,3,41
"27489",10602,"Corner Brook","NL",48.95224,-57.92207,2018-02-20 03:00:00,40,1,41
"27490",10602,"Corner Brook","NL",48.95224,-57.92207,2018-02-20 04:00:00,40,1,41
"27491",10602,"Corner Brook","NL",48.95224,-57.92207,2018-02-20 05:00:00,40,1,41
"27492",10602,"Corner Brook","NL",48.95224,-57.92207,2018-02-20 06:00:00,41,1,42
"27493",10602,"Corner Brook","NL",48.95224,-57.92207,2018-02-20 07:00:00,39,2,41
"27494",10602,"Corner Brook","NL",48.95224,-57.92207,2018-02-20 08:00:00,31,9,40
"27495",10602,"Corner Brook","NL",48.95224,-57.92207,2018-02-20 09:00:00,37,5,42
"27496",10602,"Corner Brook","NL",48.95224,-57.92207,2018-02-20 10:00:00,37,4,41
"27497",10602,"Corner Brook","NL",48.95224,-57.92207,2018-02-20 11:00:00,31,10,41
"27498",10602,"Corner Brook","NL",48.95224,-57.92207,2018-02-20 12:00:00,34,9,43
"27499",10602,"Corner Brook","NL",48.95224,-57.92207,2018-02-20 13:00:00,33,7,40
"27500",10602,"Corner Brook","NL",48.95224,-57.92207,2018-02-20 14:00:00,36,6,42
"27501",10602,"Corner Brook","NL",48.95224,-57.92207,2018-02-20 15:00:00,33,10,43
"27502",10602,"Corner Brook","NL",48.95224,-57.92207,2018-02-20 16:00:00,29,12,41
"27503",10602,"Corner Brook","NL",48.95224,-57.92207,2018-02-20 17:00:00,31,10,41
"27504",10602,"Corner Brook","NL",48.95224,-57.92207,2018-02-20 18:00:00,31,11,42
"27505",10602,"Corner Brook","NL",48.95224,-57.92207,2018-02-20 19:00:00,35,5,40
"27506",10602,"Corner Brook","NL",48.95224,-57.92207,2018-02-20 20:00:00,35,5,40
"27507",10602,"Corner Brook","NL",48.95224,-57.92207,2018-02-20 21:00:00,31,7,38
"27508",10602,"Corner Brook","NL",48.95224,-57.92207,2018-02-20 22:00:00,32,6,38
"27509",10602,"Corner Brook","NL",48.95224,-57.92207,2018-02-20 23:00:00,31,6,37
"27510",10602,"Corner Brook","NL",48.95224,-57.92207,2018-02-21 00:00:00,28,8,36
"27511",10602,"Corner Brook","NL",48.95224,-57.92207,2018-02-21 01:00:00,36,3,39
"27512",10602,"Corner Brook","NL",48.95224,-57.92207,2018-02-21 02:00:00,39,1,40
"27513",10602,"Corner Brook","NL",48.95224,-57.92207,2018-02-21 03:00:00,37,3,40
"27514",10602,"Corner Brook","NL",48.95224,-57.92207,2018-02-21 04:00:00,38,2,40
"27515",10602,"Corner Brook","NL",48.95224,-57.92207,2018-02-21 05:00:00,37,2,39
"27516",10602,"Corner Brook","NL",48.95224,-57.92207,2018-02-21 06:00:00,37,2,39
"27517",10602,"Corner Brook","NL",48.95224,-57.92207,2018-02-21 07:00:00,38,1,39
"27518",10602,"Corner Brook","NL",48.95224,-57.92207,2018-02-21 08:00:00,37,2,39
"27519",10602,"Corner Brook","NL",48.95224,-57.92207,2018-02-21 09:00:00,34,5,39
"27520",10602,"Corner Brook","NL",48.95224,-57.92207,2018-02-21 10:00:00,29,9,38
"27521",10602,"Corner Brook","NL",48.95224,-57.92207,2018-02-21 11:00:00,21,17,38
"27522",10602,"Corner Brook","NL",48.95224,-57.92207,2018-02-21 12:00:00,22,16,38
"27523",10602,"Corner Brook","NL",48.95224,-57.92207,2018-02-21 13:00:00,29,9,38
"27524",10602,"Corner Brook","NL",48.95224,-57.92207,2018-02-21 14:00:00,29,8,37
"27525",10602,"Corner Brook","NL",48.95224,-57.92207,2018-02-21 15:00:00,30,7,37
"27526",10602,"Corner Brook","NL",48.95224,-57.92207,2018-02-21 16:00:00,31,7,38
"27527",10602,"Corner Brook","NL",48.95224,-57.92207,2018-02-21 17:00:00,32,7,39
"27528",10602,"Corner Brook","NL",48.95224,-57.92207,2018-02-21 18:00:00,32,6,38
"27529",10602,"Corner Brook","NL",48.95224,-57.92207,2018-02-21 19:00:00,37,1,38
"27530",10602,"Corner Brook","NL",48.95224,-57.92207,2018-02-21 20:00:00,36,2,38
"27531",10602,"Corner Brook","NL",48.95224,-57.92207,2018-02-21 21:00:00,35,2,37
"27532",10602,"Corner Brook","NL",48.95224,-57.92207,2018-02-21 22:00:00,34,1,35
"27533",10602,"Corner Brook","NL",48.95224,-57.92207,2018-02-21 23:00:00,33,2,35
"27534",10602,"Corner Brook","NL",48.95224,-57.92207,2018-02-22 00:00:00,31,4,35
"27535",10602,"Corner Brook","NL",48.95224,-57.92207,2018-02-22 01:00:00,32,5,37
"27536",10602,"Corner Brook","NL",48.95224,-57.92207,2018-02-22 02:00:00,31,6,37
"27537",10602,"Corner Brook","NL",48.95224,-57.92207,2018-02-22 03:00:00,35,1,36
"27538",10602,"Corner Brook","NL",48.95224,-57.92207,2018-02-22 04:00:00,36,1,37
"27539",10602,"Corner Brook","NL",48.95224,-57.92207,2018-02-22 05:00:00,35,1,36
"27540",10602,"Corner Brook","NL",48.95224,-57.92207,2018-02-22 06:00:00,36,1,37
"27541",10602,"Corner Brook","NL",48.95224,-57.92207,2018-02-22 07:00:00,37,1,38
"27542",10602,"Corner Brook","NL",48.95224,-57.92207,2018-02-22 08:00:00,37,1,38
"27543",10602,"Corner Brook","NL",48.95224,-57.92207,2018-02-22 09:00:00,37,1,38
"27544",10602,"Corner Brook","NL",48.95224,-57.92207,2018-02-22 10:00:00,36,1,37
"27545",10602,"Corner Brook","NL",48.95224,-57.92207,2018-02-22 11:00:00,37,1,38
"27546",10602,"Corner Brook","NL",48.95224,-57.92207,2018-02-22 12:00:00,37,1,38
"27547",10602,"Corner Brook","NL",48.95224,-57.92207,2018-02-22 13:00:00,38,1,39
"27548",10602,"Corner Brook","NL",48.95224,-57.92207,2018-02-22 14:00:00,38,1,39
"27549",10602,"Corner Brook","NL",48.95224,-57.92207,2018-02-22 15:00:00,38,1,39
"27550",10602,"Corner Brook","NL",48.95224,-57.92207,2018-02-22 16:00:00,39,1,40
"27551",10602,"Corner Brook","NL",48.95224,-57.92207,2018-02-22 17:00:00,38,2,40
"27552",10602,"Corner Brook","NL",48.95224,-57.92207,2018-02-22 18:00:00,38,2,40
"27553",10602,"Corner Brook","NL",48.95224,-57.92207,2018-02-22 19:00:00,37,3,40
"27554",10602,"Corner Brook","NL",48.95224,-57.92207,2018-02-22 20:00:00,37,3,40
"27555",10602,"Corner Brook","NL",48.95224,-57.92207,2018-02-22 21:00:00,36,4,40
"27556",10602,"Corner Brook","NL",48.95224,-57.92207,2018-02-22 22:00:00,35,4,39
"27557",10602,"Corner Brook","NL",48.95224,-57.92207,2018-02-22 23:00:00,38,2,40
"27558",10602,"Corner Brook","NL",48.95224,-57.92207,2018-02-23 00:00:00,40,1,41
"27559",10602,"Corner Brook","NL",48.95224,-57.92207,2018-02-23 01:00:00,40,1,41
"27560",10602,"Corner Brook","NL",48.95224,-57.92207,2018-02-23 02:00:00,40,1,41
"27561",10602,"Corner Brook","NL",48.95224,-57.92207,2018-02-23 03:00:00,40,1,41
"27562",10602,"Corner Brook","NL",48.95224,-57.92207,2018-02-23 04:00:00,41,1,42
"27563",10602,"Corner Brook","NL",48.95224,-57.92207,2018-02-23 05:00:00,41,1,42
"27564",10602,"Corner Brook","NL",48.95224,-57.92207,2018-02-23 06:00:00,41,1,42
"27565",10602,"Corner Brook","NL",48.95224,-57.92207,2018-02-23 07:00:00,41,1,42
"27566",10602,"Corner Brook","NL",48.95224,-57.92207,2018-02-23 08:00:00,41,1,42
"27567",10602,"Corner Brook","NL",48.95224,-57.92207,2018-02-23 09:00:00,40,1,41
"27568",10602,"Corner Brook","NL",48.95224,-57.92207,2018-02-23 10:00:00,40,1,41
"27569",10602,"Corner Brook","NL",48.95224,-57.92207,2018-02-23 11:00:00,40,1,41
"27570",10602,"Corner Brook","NL",48.95224,-57.92207,2018-02-23 12:00:00,40,1,41
"27571",10602,"Corner Brook","NL",48.95224,-57.92207,2018-02-23 13:00:00,40,1,41
"27572",10602,"Corner Brook","NL",48.95224,-57.92207,2018-02-23 14:00:00,40,2,42
"27573",10602,"Corner Brook","NL",48.95224,-57.92207,2018-02-23 15:00:00,38,4,42
"27574",10602,"Corner Brook","NL",48.95224,-57.92207,2018-02-23 16:00:00,37,6,43
"27575",10602,"Corner Brook","NL",48.95224,-57.92207,2018-02-23 17:00:00,37,4,41
"27576",10602,"Corner Brook","NL",48.95224,-57.92207,2018-02-23 18:00:00,38,3,41
"27577",10602,"Corner Brook","NL",48.95224,-57.92207,2018-02-23 19:00:00,37,4,41
"27578",10602,"Corner Brook","NL",48.95224,-57.92207,2018-02-23 20:00:00,38,3,41
"27579",10602,"Corner Brook","NL",48.95224,-57.92207,2018-02-23 21:00:00,38,2,40
"27580",10602,"Corner Brook","NL",48.95224,-57.92207,2018-02-23 22:00:00,40,1,41
"27581",10602,"Corner Brook","NL",48.95224,-57.92207,2018-02-23 23:00:00,40,1,41
"27582",10602,"Corner Brook","NL",48.95224,-57.92207,2018-02-24 00:00:00,41,1,42
"27583",10602,"Corner Brook","NL",48.95224,-57.92207,2018-02-24 01:00:00,41,1,42
"27584",10602,"Corner Brook","NL",48.95224,-57.92207,2018-02-24 02:00:00,41,1,42
"27585",10602,"Corner Brook","NL",48.95224,-57.92207,2018-02-24 03:00:00,40,1,41
"27586",10602,"Corner Brook","NL",48.95224,-57.92207,2018-02-24 04:00:00,40,1,41
"27587",10602,"Corner Brook","NL",48.95224,-57.92207,2018-02-24 05:00:00,39,1,40
"27588",10602,"Corner Brook","NL",48.95224,-57.92207,2018-02-24 06:00:00,41,1,42
"27589",10602,"Corner Brook","NL",48.95224,-57.92207,2018-02-24 07:00:00,40,2,42
"27590",10602,"Corner Brook","NL",48.95224,-57.92207,2018-02-24 08:00:00,40,2,42
"27591",10602,"Corner Brook","NL",48.95224,-57.92207,2018-02-24 09:00:00,40,1,41
"27592",10602,"Corner Brook","NL",48.95224,-57.92207,2018-02-24 10:00:00,40,1,41
"27593",10602,"Corner Brook","NL",48.95224,-57.92207,2018-02-24 11:00:00,40,1,41
"27594",10602,"Corner Brook","NL",48.95224,-57.92207,2018-02-24 12:00:00,39,1,40
"27595",10602,"Corner Brook","NL",48.95224,-57.92207,2018-02-24 13:00:00,39,1,40
"27596",10602,"Corner Brook","NL",48.95224,-57.92207,2018-02-24 14:00:00,40,1,41
"27597",10602,"Corner Brook","NL",48.95224,-57.92207,2018-02-24 15:00:00,40,1,41
"27598",10602,"Corner Brook","NL",48.95224,-57.92207,2018-02-24 16:00:00,41,1,42
"27599",10602,"Corner Brook","NL",48.95224,-57.92207,2018-02-24 17:00:00,41,1,42
"27600",10602,"Corner Brook","NL",48.95224,-57.92207,2018-02-24 18:00:00,42,2,44
"27601",10602,"Corner Brook","NL",48.95224,-57.92207,2018-02-24 19:00:00,41,2,43
"27602",10602,"Corner Brook","NL",48.95224,-57.92207,2018-02-24 20:00:00,41,2,43
"27603",10602,"Corner Brook","NL",48.95224,-57.92207,2018-02-24 21:00:00,40,3,43
"27604",10602,"Corner Brook","NL",48.95224,-57.92207,2018-02-24 22:00:00,42,2,44
"27605",10602,"Corner Brook","NL",48.95224,-57.92207,2018-02-24 23:00:00,43,2,45
"27606",10602,"Corner Brook","NL",48.95224,-57.92207,2018-02-25 00:00:00,43,2,45
"27607",10602,"Corner Brook","NL",48.95224,-57.92207,2018-02-25 01:00:00,43,2,45
"27608",10602,"Corner Brook","NL",48.95224,-57.92207,2018-02-25 02:00:00,42,2,44
"27609",10602,"Corner Brook","NL",48.95224,-57.92207,2018-02-25 03:00:00,40,2,42
"27610",10602,"Corner Brook","NL",48.95224,-57.92207,2018-02-25 04:00:00,39,3,42
"27611",10602,"Corner Brook","NL",48.95224,-57.92207,2018-02-25 05:00:00,38,3,41
"27612",10602,"Corner Brook","NL",48.95224,-57.92207,2018-02-25 06:00:00,38,3,41
"27613",10602,"Corner Brook","NL",48.95224,-57.92207,2018-02-25 07:00:00,38,2,40
"27614",10602,"Corner Brook","NL",48.95224,-57.92207,2018-02-25 08:00:00,32,6,38
"27615",10602,"Corner Brook","NL",48.95224,-57.92207,2018-02-25 09:00:00,29,10,39
"27616",10602,"Corner Brook","NL",48.95224,-57.92207,2018-02-25 10:00:00,36,4,40
"27617",10602,"Corner Brook","NL",48.95224,-57.92207,2018-02-25 11:00:00,38,2,40
"27618",10602,"Corner Brook","NL",48.95224,-57.92207,2018-02-25 12:00:00,38,2,40
"27619",10602,"Corner Brook","NL",48.95224,-57.92207,2018-02-25 13:00:00,38,2,40
"27620",10602,"Corner Brook","NL",48.95224,-57.92207,2018-02-25 14:00:00,35,8,43
"27621",10602,"Corner Brook","NL",48.95224,-57.92207,2018-02-25 15:00:00,38,3,41
"27622",10602,"Corner Brook","NL",48.95224,-57.92207,2018-02-25 16:00:00,39,2,41
"27623",10602,"Corner Brook","NL",48.95224,-57.92207,2018-02-25 17:00:00,37,3,40
"27624",10602,"Corner Brook","NL",48.95224,-57.92207,2018-02-25 18:00:00,36,4,40
"27625",10602,"Corner Brook","NL",48.95224,-57.92207,2018-02-25 19:00:00,33,5,38
"27626",10602,"Corner Brook","NL",48.95224,-57.92207,2018-02-25 20:00:00,32,7,39
"27627",10602,"Corner Brook","NL",48.95224,-57.92207,2018-02-25 21:00:00,30,7,37
"27628",10602,"Corner Brook","NL",48.95224,-57.92207,2018-02-25 22:00:00,27,9,36
"27629",10602,"Corner Brook","NL",48.95224,-57.92207,2018-02-25 23:00:00,27,9,36
"27630",10602,"Corner Brook","NL",48.95224,-57.92207,2018-02-26 00:00:00,29,7,36
"27631",10602,"Corner Brook","NL",48.95224,-57.92207,2018-02-26 01:00:00,30,6,36
"27632",10602,"Corner Brook","NL",48.95224,-57.92207,2018-02-26 02:00:00,26,9,35
"27633",10602,"Corner Brook","NL",48.95224,-57.92207,2018-02-26 03:00:00,29,6,35
"27634",10602,"Corner Brook","NL",48.95224,-57.92207,2018-02-26 04:00:00,20,13,33
"27635",10602,"Corner Brook","NL",48.95224,-57.92207,2018-02-26 05:00:00,28,8,36
"27636",10602,"Corner Brook","NL",48.95224,-57.92207,2018-02-26 06:00:00,32,5,37
"27637",10602,"Corner Brook","NL",48.95224,-57.92207,2018-02-26 07:00:00,25,9,34
"27638",10602,"Corner Brook","NL",48.95224,-57.92207,2018-02-26 08:00:00,26,10,36
"27639",10602,"Corner Brook","NL",48.95224,-57.92207,2018-02-26 09:00:00,22,16,38
"27640",10602,"Corner Brook","NL",48.95224,-57.92207,2018-02-26 10:00:00,16,23,39
"27641",10602,"Corner Brook","NL",48.95224,-57.92207,2018-02-26 11:00:00,33,8,41
"27642",10602,"Corner Brook","NL",48.95224,-57.92207,2018-02-26 12:00:00,41,1,42
"27643",10602,"Corner Brook","NL",48.95224,-57.92207,2018-02-26 13:00:00,41,1,42
"27644",10602,"Corner Brook","NL",48.95224,-57.92207,2018-02-26 14:00:00,41,1,42
"27645",10602,"Corner Brook","NL",48.95224,-57.92207,2018-02-26 15:00:00,41,2,43
"27646",10602,"Corner Brook","NL",48.95224,-57.92207,2018-02-26 16:00:00,41,1,42
"27647",10602,"Corner Brook","NL",48.95224,-57.92207,2018-02-26 17:00:00,41,2,43
"27648",10602,"Corner Brook","NL",48.95224,-57.92207,2018-02-26 18:00:00,41,2,43
"27649",10602,"Corner Brook","NL",48.95224,-57.92207,2018-02-26 19:00:00,40,2,42
"27650",10602,"Corner Brook","NL",48.95224,-57.92207,2018-02-26 20:00:00,40,2,42
"27651",10602,"Corner Brook","NL",48.95224,-57.92207,2018-02-26 21:00:00,39,2,41
"27652",10602,"Corner Brook","NL",48.95224,-57.92207,2018-02-26 22:00:00,38,2,40
"27653",10602,"Corner Brook","NL",48.95224,-57.92207,2018-02-26 23:00:00,40,2,42
"27654",10602,"Corner Brook","NL",48.95224,-57.92207,2018-02-27 00:00:00,39,2,41
"27655",10602,"Corner Brook","NL",48.95224,-57.92207,2018-02-27 01:00:00,38,3,41
"27656",10602,"Corner Brook","NL",48.95224,-57.92207,2018-02-27 02:00:00,37,3,40
"27657",10602,"Corner Brook","NL",48.95224,-57.92207,2018-02-27 03:00:00,36,4,40
"27658",10602,"Corner Brook","NL",48.95224,-57.92207,2018-02-27 04:00:00,34,5,39
"27659",10602,"Corner Brook","NL",48.95224,-57.92207,2018-02-27 05:00:00,34,5,39
"27660",10602,"Corner Brook","NL",48.95224,-57.92207,2018-02-27 06:00:00,36,3,39
"27661",10602,"Corner Brook","NL",48.95224,-57.92207,2018-02-27 07:00:00,35,4,39
"27662",10602,"Corner Brook","NL",48.95224,-57.92207,2018-02-27 08:00:00,32,6,38
"27663",10602,"Corner Brook","NL",48.95224,-57.92207,2018-02-27 09:00:00,29,9,38
"27664",10602,"Corner Brook","NL",48.95224,-57.92207,2018-02-27 10:00:00,33,5,38
"27665",10602,"Corner Brook","NL",48.95224,-57.92207,2018-02-27 11:00:00,34,4,38
"27666",10602,"Corner Brook","NL",48.95224,-57.92207,2018-02-27 12:00:00,35,3,38
"27667",10602,"Corner Brook","NL",48.95224,-57.92207,2018-02-27 13:00:00,36,3,39
"27668",10602,"Corner Brook","NL",48.95224,-57.92207,2018-02-27 14:00:00,38,2,40
"27669",10602,"Corner Brook","NL",48.95224,-57.92207,2018-02-27 15:00:00,35,4,39
"27670",10602,"Corner Brook","NL",48.95224,-57.92207,2018-02-27 16:00:00,36,4,40
"27671",10602,"Corner Brook","NL",48.95224,-57.92207,2018-02-27 17:00:00,37,3,40
"27672",10602,"Corner Brook","NL",48.95224,-57.92207,2018-02-27 18:00:00,38,2,40
"27673",10602,"Corner Brook","NL",48.95224,-57.92207,2018-02-27 19:00:00,39,2,41
"27674",10602,"Corner Brook","NL",48.95224,-57.92207,2018-02-27 20:00:00,39,1,40
"27675",10602,"Corner Brook","NL",48.95224,-57.92207,2018-02-27 21:00:00,40,1,41
"27676",10602,"Corner Brook","NL",48.95224,-57.92207,2018-02-27 22:00:00,40,1,41
"27677",10602,"Corner Brook","NL",48.95224,-57.92207,2018-02-27 23:00:00,40,2,42
"27678",10602,"Corner Brook","NL",48.95224,-57.92207,2018-02-28 00:00:00,38,3,41
"27679",10602,"Corner Brook","NL",48.95224,-57.92207,2018-02-28 01:00:00,36,4,40
"27680",10602,"Corner Brook","NL",48.95224,-57.92207,2018-02-28 02:00:00,38,2,40
"27681",10602,"Corner Brook","NL",48.95224,-57.92207,2018-02-28 03:00:00,37,2,39
"27682",10602,"Corner Brook","NL",48.95224,-57.92207,2018-02-28 04:00:00,34,4,38
"27683",10602,"Corner Brook","NL",48.95224,-57.92207,2018-02-28 05:00:00,36,2,38
"27684",10602,"Corner Brook","NL",48.95224,-57.92207,2018-02-28 06:00:00,32,4,36
"27685",10602,"Corner Brook","NL",48.95224,-57.92207,2018-02-28 07:00:00,30,6,36
"27686",10602,"Corner Brook","NL",48.95224,-57.92207,2018-02-28 08:00:00,31,7,38
"27687",10602,"Corner Brook","NL",48.95224,-57.92207,2018-02-28 09:00:00,34,6,40
"27688",10602,"Corner Brook","NL",48.95224,-57.92207,2018-02-28 10:00:00,36,4,40
"27689",10602,"Corner Brook","NL",48.95224,-57.92207,2018-02-28 11:00:00,38,3,41
"27690",10602,"Corner Brook","NL",48.95224,-57.92207,2018-02-28 12:00:00,40,2,42
"27691",10602,"Corner Brook","NL",48.95224,-57.92207,2018-02-28 13:00:00,41,1,42
"27692",10602,"Corner Brook","NL",48.95224,-57.92207,2018-02-28 14:00:00,40,2,42
"27693",10602,"Corner Brook","NL",48.95224,-57.92207,2018-02-28 15:00:00,35,9,44
"27694",10602,"Corner Brook","NL",48.95224,-57.92207,2018-02-28 16:00:00,32,9,41
"27695",10602,"Corner Brook","NL",48.95224,-57.92207,2018-02-28 17:00:00,32,9,41
"27696",10602,"Corner Brook","NL",48.95224,-57.92207,2018-02-28 18:00:00,33,8,41
"27697",10602,"Corner Brook","NL",48.95224,-57.92207,2018-02-28 19:00:00,35,5,40
"27698",10602,"Corner Brook","NL",48.95224,-57.92207,2018-02-28 20:00:00,32,8,40
"27699",10602,"Corner Brook","NL",48.95224,-57.92207,2018-02-28 21:00:00,35,4,39
"27700",10602,"Corner Brook","NL",48.95224,-57.92207,2018-02-28 22:00:00,38,3,41
"27701",10602,"Corner Brook","NL",48.95224,-57.92207,2018-02-28 23:00:00,36,4,40
"27702",10602,"Corner Brook","NL",48.95224,-57.92207,2018-03-01 00:00:00,39,3,42
"27703",10602,"Corner Brook","NL",48.95224,-57.92207,2018-03-01 01:00:00,38,4,42
"27704",10602,"Corner Brook","NL",48.95224,-57.92207,2018-03-01 02:00:00,37,4,41
"27705",10602,"Corner Brook","NL",48.95224,-57.92207,2018-03-01 03:00:00,35,4,39
"27706",10602,"Corner Brook","NL",48.95224,-57.92207,2018-03-01 04:00:00,36,4,40
"27707",10602,"Corner Brook","NL",48.95224,-57.92207,2018-03-01 05:00:00,35,4,39
"27708",10602,"Corner Brook","NL",48.95224,-57.92207,2018-03-01 06:00:00,36,4,40
"27709",10602,"Corner Brook","NL",48.95224,-57.92207,2018-03-01 07:00:00,33,5,38
"27710",10602,"Corner Brook","NL",48.95224,-57.92207,2018-03-01 08:00:00,29,7,36
"27711",10602,"Corner Brook","NL",48.95224,-57.92207,2018-03-01 09:00:00,31,9,40
"27712",10602,"Corner Brook","NL",48.95224,-57.92207,2018-03-01 10:00:00,38,4,42
"27713",10602,"Corner Brook","NL",48.95224,-57.92207,2018-03-01 11:00:00,38,4,42
"27714",10602,"Corner Brook","NL",48.95224,-57.92207,2018-03-01 12:00:00,37,5,42
"27715",10602,"Corner Brook","NL",48.95224,-57.92207,2018-03-01 13:00:00,39,6,45
"27716",10602,"Corner Brook","NL",48.95224,-57.92207,2018-03-01 14:00:00,39,3,42
"27717",10602,"Corner Brook","NL",48.95224,-57.92207,2018-03-01 15:00:00,35,8,43
"27718",10602,"Corner Brook","NL",48.95224,-57.92207,2018-03-01 16:00:00,32,13,45
"27719",10602,"Corner Brook","NL",48.95224,-57.92207,2018-03-01 17:00:00,38,5,43
"27720",10602,"Corner Brook","NL",48.95224,-57.92207,2018-03-01 18:00:00,39,4,43
"27721",10602,"Corner Brook","NL",48.95224,-57.92207,2018-03-01 19:00:00,39,3,42
"27722",10602,"Corner Brook","NL",48.95224,-57.92207,2018-03-01 20:00:00,37,4,41
"27723",10602,"Corner Brook","NL",48.95224,-57.92207,2018-03-01 21:00:00,39,3,42
"27724",10602,"Corner Brook","NL",48.95224,-57.92207,2018-03-01 22:00:00,37,4,41
"27725",10602,"Corner Brook","NL",48.95224,-57.92207,2018-03-01 23:00:00,36,4,40
"27726",10602,"Corner Brook","NL",48.95224,-57.92207,2018-03-02 00:00:00,36,4,40
"27727",10602,"Corner Brook","NL",48.95224,-57.92207,2018-03-02 01:00:00,36,4,40
"27728",10602,"Corner Brook","NL",48.95224,-57.92207,2018-03-02 02:00:00,33,5,38
"27729",10602,"Corner Brook","NL",48.95224,-57.92207,2018-03-02 03:00:00,32,5,37
"27730",10602,"Corner Brook","NL",48.95224,-57.92207,2018-03-02 04:00:00,31,5,36
"27731",10602,"Corner Brook","NL",48.95224,-57.92207,2018-03-02 05:00:00,28,6,34
"27732",10602,"Corner Brook","NL",48.95224,-57.92207,2018-03-02 06:00:00,26,7,33
"27733",10602,"Corner Brook","NL",48.95224,-57.92207,2018-03-02 07:00:00,24,9,33
"27734",10602,"Corner Brook","NL",48.95224,-57.92207,2018-03-02 08:00:00,32,3,35
"27735",10602,"Corner Brook","NL",48.95224,-57.92207,2018-03-02 09:00:00,32,3,35
"27736",10602,"Corner Brook","NL",48.95224,-57.92207,2018-03-02 10:00:00,33,3,36
"27737",10602,"Corner Brook","NL",48.95224,-57.92207,2018-03-02 11:00:00,35,2,37
"27738",10602,"Corner Brook","NL",48.95224,-57.92207,2018-03-02 12:00:00,35,3,38
"27739",10602,"Corner Brook","NL",48.95224,-57.92207,2018-03-02 13:00:00,36,2,38
"27740",10602,"Corner Brook","NL",48.95224,-57.92207,2018-03-02 14:00:00,37,3,40
"27741",10602,"Corner Brook","NL",48.95224,-57.92207,2018-03-02 15:00:00,39,2,41
"27742",10602,"Corner Brook","NL",48.95224,-57.92207,2018-03-02 16:00:00,37,4,41
"27743",10602,"Corner Brook","NL",48.95224,-57.92207,2018-03-02 17:00:00,38,5,43
"27744",10602,"Corner Brook","NL",48.95224,-57.92207,2018-03-02 18:00:00,38,4,42
"27745",10602,"Corner Brook","NL",48.95224,-57.92207,2018-03-02 19:00:00,42,2,44
"27746",10602,"Corner Brook","NL",48.95224,-57.92207,2018-03-02 20:00:00,43,1,44
"27747",10602,"Corner Brook","NL",48.95224,-57.92207,2018-03-02 21:00:00,43,1,44
"27748",10602,"Corner Brook","NL",48.95224,-57.92207,2018-03-02 22:00:00,43,1,44
"27749",10602,"Corner Brook","NL",48.95224,-57.92207,2018-03-02 23:00:00,44,1,45
"27750",10602,"Corner Brook","NL",48.95224,-57.92207,2018-03-03 00:00:00,43,1,44
"27751",10602,"Corner Brook","NL",48.95224,-57.92207,2018-03-03 01:00:00,43,1,44
"27752",10602,"Corner Brook","NL",48.95224,-57.92207,2018-03-03 02:00:00,43,1,44
"27753",10602,"Corner Brook","NL",48.95224,-57.92207,2018-03-03 03:00:00,42,1,43
"27754",10602,"Corner Brook","NL",48.95224,-57.92207,2018-03-03 04:00:00,42,1,43
"27755",10602,"Corner Brook","NL",48.95224,-57.92207,2018-03-03 05:00:00,42,1,43
"27756",10602,"Corner Brook","NL",48.95224,-57.92207,2018-03-03 06:00:00,41,1,42
"27757",10602,"Corner Brook","NL",48.95224,-57.92207,2018-03-03 07:00:00,41,1,42
"27758",10602,"Corner Brook","NL",48.95224,-57.92207,2018-03-03 08:00:00,42,1,43
"27759",10602,"Corner Brook","NL",48.95224,-57.92207,2018-03-03 09:00:00,42,1,43
"27760",10602,"Corner Brook","NL",48.95224,-57.92207,2018-03-03 10:00:00,43,1,44
"27761",10602,"Corner Brook","NL",48.95224,-57.92207,2018-03-03 11:00:00,43,1,44
"27762",10602,"Corner Brook","NL",48.95224,-57.92207,2018-03-03 12:00:00,44,1,45
"27763",10602,"Corner Brook","NL",48.95224,-57.92207,2018-03-03 13:00:00,44,1,45
"27764",10602,"Corner Brook","NL",48.95224,-57.92207,2018-03-03 14:00:00,44,1,45
"27765",10602,"Corner Brook","NL",48.95224,-57.92207,2018-03-03 15:00:00,44,1,45
"27766",10602,"Corner Brook","NL",48.95224,-57.92207,2018-03-03 16:00:00,44,1,45
"27767",10602,"Corner Brook","NL",48.95224,-57.92207,2018-03-03 17:00:00,44,1,45
"27768",10602,"Corner Brook","NL",48.95224,-57.92207,2018-03-03 18:00:00,43,1,44
"27769",10602,"Corner Brook","NL",48.95224,-57.92207,2018-03-03 19:00:00,44,1,45
"27770",10602,"Corner Brook","NL",48.95224,-57.92207,2018-03-03 20:00:00,45,1,46
"27771",10602,"Corner Brook","NL",48.95224,-57.92207,2018-03-03 21:00:00,46,1,47
"27772",10602,"Corner Brook","NL",48.95224,-57.92207,2018-03-03 22:00:00,46,1,47
"27773",10602,"Corner Brook","NL",48.95224,-57.92207,2018-03-03 23:00:00,46,1,47
"27774",10602,"Corner Brook","NL",48.95224,-57.92207,2018-03-04 00:00:00,45,1,46
"27775",10602,"Corner Brook","NL",48.95224,-57.92207,2018-03-04 01:00:00,45,1,46
"27776",10602,"Corner Brook","NL",48.95224,-57.92207,2018-03-04 02:00:00,44,1,45
"27777",10602,"Corner Brook","NL",48.95224,-57.92207,2018-03-04 03:00:00,44,1,45
"27778",10602,"Corner Brook","NL",48.95224,-57.92207,2018-03-04 04:00:00,44,1,45
"27779",10602,"Corner Brook","NL",48.95224,-57.92207,2018-03-04 05:00:00,44,1,45
"27780",10602,"Corner Brook","NL",48.95224,-57.92207,2018-03-04 06:00:00,45,1,46
"27781",10602,"Corner Brook","NL",48.95224,-57.92207,2018-03-04 07:00:00,44,1,45
"27782",10602,"Corner Brook","NL",48.95224,-57.92207,2018-03-04 08:00:00,45,1,46
"27783",10602,"Corner Brook","NL",48.95224,-57.92207,2018-03-04 09:00:00,45,1,46
"27784",10602,"Corner Brook","NL",48.95224,-57.92207,2018-03-04 10:00:00,45,1,46
"27785",10602,"Corner Brook","NL",48.95224,-57.92207,2018-03-04 11:00:00,46,1,47
"27786",10602,"Corner Brook","NL",48.95224,-57.92207,2018-03-04 12:00:00,46,1,47
"27787",10602,"Corner Brook","NL",48.95224,-57.92207,2018-03-04 13:00:00,47,1,48
"27788",10602,"Corner Brook","NL",48.95224,-57.92207,2018-03-04 14:00:00,47,1,48
"27789",10602,"Corner Brook","NL",48.95224,-57.92207,2018-03-04 15:00:00,47,1,48
"27790",10602,"Corner Brook","NL",48.95224,-57.92207,2018-03-04 16:00:00,46,1,47
"27791",10602,"Corner Brook","NL",48.95224,-57.92207,2018-03-04 17:00:00,46,1,47
"27792",10602,"Corner Brook","NL",48.95224,-57.92207,2018-03-04 18:00:00,45,1,46
"27793",10602,"Corner Brook","NL",48.95224,-57.92207,2018-03-04 19:00:00,46,1,47
"27794",10602,"Corner Brook","NL",48.95224,-57.92207,2018-03-04 20:00:00,45,1,46
"27795",10602,"Corner Brook","NL",48.95224,-57.92207,2018-03-04 21:00:00,45,1,46
"27796",10602,"Corner Brook","NL",48.95224,-57.92207,2018-03-04 22:00:00,45,1,46
"27797",10602,"Corner Brook","NL",48.95224,-57.92207,2018-03-04 23:00:00,45,1,46
"27798",10602,"Corner Brook","NL",48.95224,-57.92207,2018-03-05 00:00:00,45,1,46
"27799",10602,"Corner Brook","NL",48.95224,-57.92207,2018-03-05 01:00:00,45,1,46
"27800",10602,"Corner Brook","NL",48.95224,-57.92207,2018-03-05 02:00:00,45,1,46
"27801",10602,"Corner Brook","NL",48.95224,-57.92207,2018-03-05 03:00:00,45,1,46
"27802",10602,"Corner Brook","NL",48.95224,-57.92207,2018-03-05 04:00:00,46,1,47
"27803",10602,"Corner Brook","NL",48.95224,-57.92207,2018-03-05 05:00:00,46,1,47
"27804",10602,"Corner Brook","NL",48.95224,-57.92207,2018-03-05 06:00:00,46,1,47
"27805",10602,"Corner Brook","NL",48.95224,-57.92207,2018-03-05 07:00:00,45,1,46
"27806",10602,"Corner Brook","NL",48.95224,-57.92207,2018-03-05 08:00:00,45,1,46
"27807",10602,"Corner Brook","NL",48.95224,-57.92207,2018-03-05 09:00:00,45,2,47
"27808",10602,"Corner Brook","NL",48.95224,-57.92207,2018-03-05 10:00:00,45,2,47
"27809",10602,"Corner Brook","NL",48.95224,-57.92207,2018-03-05 11:00:00,44,2,46
"27810",10602,"Corner Brook","NL",48.95224,-57.92207,2018-03-05 12:00:00,45,2,47
"27811",10602,"Corner Brook","NL",48.95224,-57.92207,2018-03-05 13:00:00,45,1,46
"27812",10602,"Corner Brook","NL",48.95224,-57.92207,2018-03-05 14:00:00,45,1,46
"27813",10602,"Corner Brook","NL",48.95224,-57.92207,2018-03-05 15:00:00,45,1,46
"27814",10602,"Corner Brook","NL",48.95224,-57.92207,2018-03-05 16:00:00,45,1,46
"27815",10602,"Corner Brook","NL",48.95224,-57.92207,2018-03-05 17:00:00,44,1,45
"27816",10602,"Corner Brook","NL",48.95224,-57.92207,2018-03-05 18:00:00,45,1,46
"27817",10602,"Corner Brook","NL",48.95224,-57.92207,2018-03-05 19:00:00,45,1,46
"27818",10602,"Corner Brook","NL",48.95224,-57.92207,2018-03-05 20:00:00,45,1,46
"27819",10602,"Corner Brook","NL",48.95224,-57.92207,2018-03-05 21:00:00,45,1,46
"27820",10602,"Corner Brook","NL",48.95224,-57.92207,2018-03-05 22:00:00,44,1,45
"27821",10602,"Corner Brook","NL",48.95224,-57.92207,2018-03-05 23:00:00,44,1,45
"27822",10602,"Corner Brook","NL",48.95224,-57.92207,2018-03-06 00:00:00,44,1,45
"27823",10602,"Corner Brook","NL",48.95224,-57.92207,2018-03-06 01:00:00,44,1,45
"27824",10602,"Corner Brook","NL",48.95224,-57.92207,2018-03-06 02:00:00,45,1,46
"27825",10602,"Corner Brook","NL",48.95224,-57.92207,2018-03-06 03:00:00,44,1,45
"27826",10602,"Corner Brook","NL",48.95224,-57.92207,2018-03-06 04:00:00,44,1,45
"27827",10602,"Corner Brook","NL",48.95224,-57.92207,2018-03-06 05:00:00,43,1,44
"27828",10602,"Corner Brook","NL",48.95224,-57.92207,2018-03-06 06:00:00,43,1,44
"27829",10602,"Corner Brook","NL",48.95224,-57.92207,2018-03-06 07:00:00,44,1,45
"27830",10602,"Corner Brook","NL",48.95224,-57.92207,2018-03-06 08:00:00,46,1,47
"27831",10602,"Corner Brook","NL",48.95224,-57.92207,2018-03-06 09:00:00,46,1,47
"27832",10602,"Corner Brook","NL",48.95224,-57.92207,2018-03-06 10:00:00,45,2,47
"27833",10602,"Corner Brook","NL",48.95224,-57.92207,2018-03-06 11:00:00,46,1,47
"27834",10602,"Corner Brook","NL",48.95224,-57.92207,2018-03-06 12:00:00,45,1,46
"27835",10602,"Corner Brook","NL",48.95224,-57.92207,2018-03-06 13:00:00,44,1,45
"27836",10602,"Corner Brook","NL",48.95224,-57.92207,2018-03-06 14:00:00,45,1,46
"27837",10602,"Corner Brook","NL",48.95224,-57.92207,2018-03-06 15:00:00,45,1,46
"27838",10602,"Corner Brook","NL",48.95224,-57.92207,2018-03-06 16:00:00,46,1,47
"27839",10602,"Corner Brook","NL",48.95224,-57.92207,2018-03-06 17:00:00,45,2,47
"27840",10602,"Corner Brook","NL",48.95224,-57.92207,2018-03-06 18:00:00,46,2,48
"27841",10602,"Corner Brook","NL",48.95224,-57.92207,2018-03-06 19:00:00,46,1,47
"27842",10602,"Corner Brook","NL",48.95224,-57.92207,2018-03-06 20:00:00,47,1,48
"27843",10602,"Corner Brook","NL",48.95224,-57.92207,2018-03-06 21:00:00,47,1,48
"27844",10602,"Corner Brook","NL",48.95224,-57.92207,2018-03-06 22:00:00,47,1,48
"27845",10602,"Corner Brook","NL",48.95224,-57.92207,2018-03-06 23:00:00,48,1,49
"27846",10602,"Corner Brook","NL",48.95224,-57.92207,2018-03-07 00:00:00,48,0,48
"27847",10602,"Corner Brook","NL",48.95224,-57.92207,2018-03-07 01:00:00,48,0,48
"27848",10602,"Corner Brook","NL",48.95224,-57.92207,2018-03-07 02:00:00,47,1,48
"27849",10602,"Corner Brook","NL",48.95224,-57.92207,2018-03-07 03:00:00,46,1,47
"27850",10602,"Corner Brook","NL",48.95224,-57.92207,2018-03-07 04:00:00,47,1,48
"27851",10602,"Corner Brook","NL",48.95224,-57.92207,2018-03-07 05:00:00,47,1,48
"27852",10602,"Corner Brook","NL",48.95224,-57.92207,2018-03-07 06:00:00,47,1,48
"27853",10602,"Corner Brook","NL",48.95224,-57.92207,2018-03-07 07:00:00,46,1,47
"27854",10602,"Corner Brook","NL",48.95224,-57.92207,2018-03-07 08:00:00,43,2,45
"27855",10602,"Corner Brook","NL",48.95224,-57.92207,2018-03-07 09:00:00,43,2,45
"27856",10602,"Corner Brook","NL",48.95224,-57.92207,2018-03-07 10:00:00,43,1,44
"27857",10602,"Corner Brook","NL",48.95224,-57.92207,2018-03-07 11:00:00,44,1,45
"27858",10602,"Corner Brook","NL",48.95224,-57.92207,2018-03-07 12:00:00,45,1,46
"27859",10602,"Corner Brook","NL",48.95224,-57.92207,2018-03-07 13:00:00,45,1,46
"27860",10602,"Corner Brook","NL",48.95224,-57.92207,2018-03-07 14:00:00,44,2,46
"27861",10602,"Corner Brook","NL",48.95224,-57.92207,2018-03-07 15:00:00,44,1,45
"27862",10602,"Corner Brook","NL",48.95224,-57.92207,2018-03-07 16:00:00,43,2,45
"27863",10602,"Corner Brook","NL",48.95224,-57.92207,2018-03-07 17:00:00,45,2,47
"27864",10602,"Corner Brook","NL",48.95224,-57.92207,2018-03-07 18:00:00,45,1,46
"27865",10602,"Corner Brook","NL",48.95224,-57.92207,2018-03-07 19:00:00,45,1,46
"27866",10602,"Corner Brook","NL",48.95224,-57.92207,2018-03-07 20:00:00,45,1,46
"27867",10602,"Corner Brook","NL",48.95224,-57.92207,2018-03-07 21:00:00,46,1,47
"27868",10602,"Corner Brook","NL",48.95224,-57.92207,2018-03-07 22:00:00,46,1,47
"27869",10602,"Corner Brook","NL",48.95224,-57.92207,2018-03-07 23:00:00,46,1,47
"27870",10602,"Corner Brook","NL",48.95224,-57.92207,2018-03-08 00:00:00,46,1,47
"27871",10602,"Corner Brook","NL",48.95224,-57.92207,2018-03-08 01:00:00,46,1,47
"27872",10602,"Corner Brook","NL",48.95224,-57.92207,2018-03-08 02:00:00,47,1,48
"27873",10602,"Corner Brook","NL",48.95224,-57.92207,2018-03-08 03:00:00,47,1,48
"27874",10602,"Corner Brook","NL",48.95224,-57.92207,2018-03-08 04:00:00,46,1,47
"27875",10602,"Corner Brook","NL",48.95224,-57.92207,2018-03-08 05:00:00,45,1,46
"27876",10602,"Corner Brook","NL",48.95224,-57.92207,2018-03-08 06:00:00,46,1,47
"27877",10602,"Corner Brook","NL",48.95224,-57.92207,2018-03-08 07:00:00,46,1,47
"27878",10602,"Corner Brook","NL",48.95224,-57.92207,2018-03-08 08:00:00,46,1,47
"27879",10602,"Corner Brook","NL",48.95224,-57.92207,2018-03-08 09:00:00,46,1,47
"27880",10602,"Corner Brook","NL",48.95224,-57.92207,2018-03-08 10:00:00,46,1,47
"27881",10602,"Corner Brook","NL",48.95224,-57.92207,2018-03-08 11:00:00,46,1,47
"27882",10602,"Corner Brook","NL",48.95224,-57.92207,2018-03-08 12:00:00,46,1,47
"27883",10602,"Corner Brook","NL",48.95224,-57.92207,2018-03-08 13:00:00,45,1,46
"27884",10602,"Corner Brook","NL",48.95224,-57.92207,2018-03-08 14:00:00,46,1,47
"27885",10602,"Corner Brook","NL",48.95224,-57.92207,2018-03-08 15:00:00,45,1,46
"27886",10602,"Corner Brook","NL",48.95224,-57.92207,2018-03-08 16:00:00,44,2,46
"27887",10602,"Corner Brook","NL",48.95224,-57.92207,2018-03-08 17:00:00,45,1,46
"27888",10602,"Corner Brook","NL",48.95224,-57.92207,2018-03-08 18:00:00,45,1,46
"27889",10602,"Corner Brook","NL",48.95224,-57.92207,2018-03-08 19:00:00,45,1,46
"27890",10602,"Corner Brook","NL",48.95224,-57.92207,2018-03-08 20:00:00,45,1,46
"27891",10602,"Corner Brook","NL",48.95224,-57.92207,2018-03-08 21:00:00,45,1,46
"27892",10602,"Corner Brook","NL",48.95224,-57.92207,2018-03-08 22:00:00,46,1,47
"27893",10602,"Corner Brook","NL",48.95224,-57.92207,2018-03-08 23:00:00,46,1,47
"27894",10602,"Corner Brook","NL",48.95224,-57.92207,2018-03-09 00:00:00,46,1,47
"27895",10602,"Corner Brook","NL",48.95224,-57.92207,2018-03-09 01:00:00,46,1,47
"27896",10602,"Corner Brook","NL",48.95224,-57.92207,2018-03-09 02:00:00,46,0,46
"27897",10602,"Corner Brook","NL",48.95224,-57.92207,2018-03-09 03:00:00,46,0,46
"27898",10602,"Corner Brook","NL",48.95224,-57.92207,2018-03-09 04:00:00,46,1,47
"27899",10602,"Corner Brook","NL",48.95224,-57.92207,2018-03-09 05:00:00,46,1,47
"27900",10602,"Corner Brook","NL",48.95224,-57.92207,2018-03-09 06:00:00,46,1,47
"27901",10602,"Corner Brook","NL",48.95224,-57.92207,2018-03-09 07:00:00,46,1,47
"27902",10602,"Corner Brook","NL",48.95224,-57.92207,2018-03-09 08:00:00,45,1,46
"27903",10602,"Corner Brook","NL",48.95224,-57.92207,2018-03-09 09:00:00,44,2,46
"27904",10602,"Corner Brook","NL",48.95224,-57.92207,2018-03-09 10:00:00,43,2,45
"27905",10602,"Corner Brook","NL",48.95224,-57.92207,2018-03-09 11:00:00,43,2,45
"27906",10602,"Corner Brook","NL",48.95224,-57.92207,2018-03-09 12:00:00,43,1,44
"27907",10602,"Corner Brook","NL",48.95224,-57.92207,2018-03-09 13:00:00,44,1,45
"27908",10602,"Corner Brook","NL",48.95224,-57.92207,2018-03-09 14:00:00,44,2,46
"27909",10602,"Corner Brook","NL",48.95224,-57.92207,2018-03-09 15:00:00,44,1,45
"27910",10602,"Corner Brook","NL",48.95224,-57.92207,2018-03-09 16:00:00,44,1,45
"27911",10602,"Corner Brook","NL",48.95224,-57.92207,2018-03-09 17:00:00,45,1,46
"27912",10602,"Corner Brook","NL",48.95224,-57.92207,2018-03-09 18:00:00,46,1,47
"27913",10602,"Corner Brook","NL",48.95224,-57.92207,2018-03-09 19:00:00,46,1,47
"27914",10602,"Corner Brook","NL",48.95224,-57.92207,2018-03-09 20:00:00,46,1,47
"27915",10602,"Corner Brook","NL",48.95224,-57.92207,2018-03-09 21:00:00,46,1,47
"27916",10602,"Corner Brook","NL",48.95224,-57.92207,2018-03-09 22:00:00,46,1,47
"27917",10602,"Corner Brook","NL",48.95224,-57.92207,2018-03-09 23:00:00,46,1,47
"27918",10602,"Corner Brook","NL",48.95224,-57.92207,2018-03-10 00:00:00,46,1,47
"27919",10602,"Corner Brook","NL",48.95224,-57.92207,2018-03-10 01:00:00,46,1,47
"27920",10602,"Corner Brook","NL",48.95224,-57.92207,2018-03-10 02:00:00,46,1,47
"27921",10602,"Corner Brook","NL",48.95224,-57.92207,2018-03-10 03:00:00,46,1,47
"27922",10602,"Corner Brook","NL",48.95224,-57.92207,2018-03-10 04:00:00,45,1,46
"27923",10602,"Corner Brook","NL",48.95224,-57.92207,2018-03-10 05:00:00,45,1,46
"27924",10602,"Corner Brook","NL",48.95224,-57.92207,2018-03-10 06:00:00,46,1,47
"27925",10602,"Corner Brook","NL",48.95224,-57.92207,2018-03-10 07:00:00,46,1,47
"27926",10602,"Corner Brook","NL",48.95224,-57.92207,2018-03-10 08:00:00,45,1,46
"27927",10602,"Corner Brook","NL",48.95224,-57.92207,2018-03-10 09:00:00,44,1,45
"27928",10602,"Corner Brook","NL",48.95224,-57.92207,2018-03-10 10:00:00,43,2,45
"27929",10602,"Corner Brook","NL",48.95224,-57.92207,2018-03-10 11:00:00,44,2,46
"27930",10602,"Corner Brook","NL",48.95224,-57.92207,2018-03-10 12:00:00,44,1,45
"27931",10602,"Corner Brook","NL",48.95224,-57.92207,2018-03-10 13:00:00,44,1,45
"27932",10602,"Corner Brook","NL",48.95224,-57.92207,2018-03-10 14:00:00,44,1,45
"27933",10602,"Corner Brook","NL",48.95224,-57.92207,2018-03-10 15:00:00,44,1,45
"27934",10602,"Corner Brook","NL",48.95224,-57.92207,2018-03-10 16:00:00,44,1,45
"27935",10602,"Corner Brook","NL",48.95224,-57.92207,2018-03-10 17:00:00,43,2,45
"27936",10602,"Corner Brook","NL",48.95224,-57.92207,2018-03-10 18:00:00,42,2,44
"27937",10602,"Corner Brook","NL",48.95224,-57.92207,2018-03-10 19:00:00,43,1,44
"27938",10602,"Corner Brook","NL",48.95224,-57.92207,2018-03-10 20:00:00,43,1,44
"27939",10602,"Corner Brook","NL",48.95224,-57.92207,2018-03-10 21:00:00,43,1,44
"27940",10602,"Corner Brook","NL",48.95224,-57.92207,2018-03-10 22:00:00,43,1,44
"27941",10602,"Corner Brook","NL",48.95224,-57.92207,2018-03-10 23:00:00,42,1,43
"27942",10602,"Corner Brook","NL",48.95224,-57.92207,2018-03-11 00:00:00,42,1,43
"27943",10602,"Corner Brook","NL",48.95224,-57.92207,2018-03-11 01:00:00,40,1,41
"27944",10602,"Corner Brook","NL",48.95224,-57.92207,2018-03-11 01:00:00,40,1,41
"27945",10602,"Corner Brook","NL",48.95224,-57.92207,2018-03-11 01:00:00,40,1,41
"27946",10602,"Corner Brook","NL",48.95224,-57.92207,2018-03-11 01:00:00,40,1,41
"27947",10602,"Corner Brook","NL",48.95224,-57.92207,2018-03-11 03:00:00,40,1,41
"27948",10602,"Corner Brook","NL",48.95224,-57.92207,2018-03-11 04:00:00,40,1,41
"27949",10602,"Corner Brook","NL",48.95224,-57.92207,2018-03-11 05:00:00,40,1,41
"27950",10602,"Corner Brook","NL",48.95224,-57.92207,2018-03-11 06:00:00,39,1,40
"27951",10602,"Corner Brook","NL",48.95224,-57.92207,2018-03-11 07:00:00,38,1,39
"27952",10602,"Corner Brook","NL",48.95224,-57.92207,2018-03-11 08:00:00,39,1,40
"27953",10602,"Corner Brook","NL",48.95224,-57.92207,2018-03-11 09:00:00,40,1,41
"27954",10602,"Corner Brook","NL",48.95224,-57.92207,2018-03-11 10:00:00,41,1,42
"27955",10602,"Corner Brook","NL",48.95224,-57.92207,2018-03-11 11:00:00,42,1,43
"27956",10602,"Corner Brook","NL",48.95224,-57.92207,2018-03-11 12:00:00,43,1,44
"27957",10602,"Corner Brook","NL",48.95224,-57.92207,2018-03-11 13:00:00,43,1,44
"27958",10602,"Corner Brook","NL",48.95224,-57.92207,2018-03-11 14:00:00,43,1,44
"27959",10602,"Corner Brook","NL",48.95224,-57.92207,2018-03-11 15:00:00,46,1,47
"27960",10602,"Corner Brook","NL",48.95224,-57.92207,2018-03-11 16:00:00,46,1,47
"27961",10602,"Corner Brook","NL",48.95224,-57.92207,2018-03-11 17:00:00,47,1,48
"27962",10602,"Corner Brook","NL",48.95224,-57.92207,2018-03-11 18:00:00,47,1,48
"27963",10602,"Corner Brook","NL",48.95224,-57.92207,2018-03-11 19:00:00,49,1,50
"27964",10602,"Corner Brook","NL",48.95224,-57.92207,2018-03-11 20:00:00,49,1,50
"27965",10602,"Corner Brook","NL",48.95224,-57.92207,2018-03-11 21:00:00,48,1,49
"27966",10602,"Corner Brook","NL",48.95224,-57.92207,2018-03-11 22:00:00,48,1,49
"27967",10602,"Corner Brook","NL",48.95224,-57.92207,2018-03-11 23:00:00,47,1,48
"27968",10602,"Corner Brook","NL",48.95224,-57.92207,2018-03-12 00:00:00,47,1,48
"27969",10602,"Corner Brook","NL",48.95224,-57.92207,2018-03-12 01:00:00,46,2,48
"27970",10602,"Corner Brook","NL",48.95224,-57.92207,2018-03-12 02:00:00,46,1,47
"27971",10602,"Corner Brook","NL",48.95224,-57.92207,2018-03-12 03:00:00,46,1,47
"27972",10602,"Corner Brook","NL",48.95224,-57.92207,2018-03-12 04:00:00,45,2,47
"27973",10602,"Corner Brook","NL",48.95224,-57.92207,2018-03-12 05:00:00,45,2,47
"27974",10602,"Corner Brook","NL",48.95224,-57.92207,2018-03-12 06:00:00,42,4,46
"27975",10602,"Corner Brook","NL",48.95224,-57.92207,2018-03-12 07:00:00,41,4,45
"27976",10602,"Corner Brook","NL",48.95224,-57.92207,2018-03-12 08:00:00,36,9,45
"27977",10602,"Corner Brook","NL",48.95224,-57.92207,2018-03-12 09:00:00,42,4,46
"27978",10602,"Corner Brook","NL",48.95224,-57.92207,2018-03-12 10:00:00,43,4,47
"27979",10602,"Corner Brook","NL",48.95224,-57.92207,2018-03-12 11:00:00,45,2,47
"27980",10602,"Corner Brook","NL",48.95224,-57.92207,2018-03-12 12:00:00,45,1,46
"27981",10602,"Corner Brook","NL",48.95224,-57.92207,2018-03-12 13:00:00,45,1,46
"27982",10602,"Corner Brook","NL",48.95224,-57.92207,2018-03-12 14:00:00,42,4,46
"27983",10602,"Corner Brook","NL",48.95224,-57.92207,2018-03-12 15:00:00,42,3,45
"27984",10602,"Corner Brook","NL",48.95224,-57.92207,2018-03-12 16:00:00,44,1,45
"27985",10602,"Corner Brook","NL",48.95224,-57.92207,2018-03-12 17:00:00,43,1,44
"27986",10602,"Corner Brook","NL",48.95224,-57.92207,2018-03-12 18:00:00,42,2,44
"27987",10602,"Corner Brook","NL",48.95224,-57.92207,2018-03-12 19:00:00,42,2,44
"27988",10602,"Corner Brook","NL",48.95224,-57.92207,2018-03-12 20:00:00,39,4,43
"27989",10602,"Corner Brook","NL",48.95224,-57.92207,2018-03-12 21:00:00,36,5,41
"27990",10602,"Corner Brook","NL",48.95224,-57.92207,2018-03-12 22:00:00,36,5,41
"27991",10602,"Corner Brook","NL",48.95224,-57.92207,2018-03-12 23:00:00,32,7,39
"27992",10602,"Corner Brook","NL",48.95224,-57.92207,2018-03-13 00:00:00,28,9,37
"27993",10602,"Corner Brook","NL",48.95224,-57.92207,2018-03-13 01:00:00,33,6,39
"27994",10602,"Corner Brook","NL",48.95224,-57.92207,2018-03-13 02:00:00,33,4,37
"27995",10602,"Corner Brook","NL",48.95224,-57.92207,2018-03-13 03:00:00,37,2,39
"27996",10602,"Corner Brook","NL",48.95224,-57.92207,2018-03-13 04:00:00,38,1,39
"27997",10602,"Corner Brook","NL",48.95224,-57.92207,2018-03-13 05:00:00,37,1,38
"27998",10602,"Corner Brook","NL",48.95224,-57.92207,2018-03-13 06:00:00,37,1,38
"27999",10602,"Corner Brook","NL",48.95224,-57.92207,2018-03-13 07:00:00,37,1,38
"28000",10602,"Corner Brook","NL",48.95224,-57.92207,2018-03-13 08:00:00,36,2,38
"28001",10602,"Corner Brook","NL",48.95224,-57.92207,2018-03-13 09:00:00,36,2,38
"28002",10602,"Corner Brook","NL",48.95224,-57.92207,2018-03-13 10:00:00,36,2,38
"28003",10602,"Corner Brook","NL",48.95224,-57.92207,2018-03-13 11:00:00,38,3,41
"28004",10602,"Corner Brook","NL",48.95224,-57.92207,2018-03-13 12:00:00,41,1,42
"28005",10602,"Corner Brook","NL",48.95224,-57.92207,2018-03-13 13:00:00,42,1,43
"28006",10602,"Corner Brook","NL",48.95224,-57.92207,2018-03-13 14:00:00,42,1,43
"28007",10602,"Corner Brook","NL",48.95224,-57.92207,2018-03-13 15:00:00,41,2,43
"28008",10602,"Corner Brook","NL",48.95224,-57.92207,2018-03-13 16:00:00,42,1,43
"28009",10602,"Corner Brook","NL",48.95224,-57.92207,2018-03-13 17:00:00,42,1,43
"28010",10602,"Corner Brook","NL",48.95224,-57.92207,2018-03-13 18:00:00,42,1,43
"28011",10602,"Corner Brook","NL",48.95224,-57.92207,2018-03-13 19:00:00,42,1,43
"28012",10602,"Corner Brook","NL",48.95224,-57.92207,2018-03-13 20:00:00,41,1,42
"28013",10602,"Corner Brook","NL",48.95224,-57.92207,2018-03-13 21:00:00,41,1,42
"28014",10602,"Corner Brook","NL",48.95224,-57.92207,2018-03-13 22:00:00,41,0,41
"28015",10602,"Corner Brook","NL",48.95224,-57.92207,2018-03-13 23:00:00,43,1,44
"28016",10602,"Corner Brook","NL",48.95224,-57.92207,2018-03-14 00:00:00,44,0,44
"28017",10602,"Corner Brook","NL",48.95224,-57.92207,2018-03-14 01:00:00,44,0,44
"28018",10602,"Corner Brook","NL",48.95224,-57.92207,2018-03-14 02:00:00,44,0,44
"28019",10602,"Corner Brook","NL",48.95224,-57.92207,2018-03-14 03:00:00,44,0,44
"28020",10602,"Corner Brook","NL",48.95224,-57.92207,2018-03-14 04:00:00,NA,NA,NA
"28021",10602,"Corner Brook","NL",48.95224,-57.92207,2018-03-14 05:00:00,NA,NA,NA
"28022",10602,"Corner Brook","NL",48.95224,-57.92207,2018-03-14 06:00:00,NA,NA,NA
"28023",10602,"Corner Brook","NL",48.95224,-57.92207,2018-03-14 07:00:00,NA,NA,NA
"28024",10602,"Corner Brook","NL",48.95224,-57.92207,2018-03-14 08:00:00,NA,NA,NA
"28025",10602,"Corner Brook","NL",48.95224,-57.92207,2018-03-14 09:00:00,NA,NA,NA
"28026",10602,"Corner Brook","NL",48.95224,-57.92207,2018-03-14 10:00:00,NA,NA,NA
"28027",10602,"Corner Brook","NL",48.95224,-57.92207,2018-03-14 11:00:00,NA,NA,NA
"28028",10602,"Corner Brook","NL",48.95224,-57.92207,2018-03-14 12:00:00,NA,NA,NA
"28029",10602,"Corner Brook","NL",48.95224,-57.92207,2018-03-14 13:00:00,46,1,47
"28030",10602,"Corner Brook","NL",48.95224,-57.92207,2018-03-14 14:00:00,46,1,47
"28031",10602,"Corner Brook","NL",48.95224,-57.92207,2018-03-14 15:00:00,46,1,47
"28032",10602,"Corner Brook","NL",48.95224,-57.92207,2018-03-14 16:00:00,45,1,46
"28033",10602,"Corner Brook","NL",48.95224,-57.92207,2018-03-14 17:00:00,44,1,45
"28034",10602,"Corner Brook","NL",48.95224,-57.92207,2018-03-14 18:00:00,43,1,44
"28035",10602,"Corner Brook","NL",48.95224,-57.92207,2018-03-14 19:00:00,42,1,43
"28036",10602,"Corner Brook","NL",48.95224,-57.92207,2018-03-14 20:00:00,45,1,46
"28037",10602,"Corner Brook","NL",48.95224,-57.92207,2018-03-14 21:00:00,46,1,47
"28038",10602,"Corner Brook","NL",48.95224,-57.92207,2018-03-14 22:00:00,47,1,48
"28039",10602,"Corner Brook","NL",48.95224,-57.92207,2018-03-14 23:00:00,49,1,50
"28040",10602,"Corner Brook","NL",48.95224,-57.92207,2018-03-15 00:00:00,50,1,51
"28041",10602,"Corner Brook","NL",48.95224,-57.92207,2018-03-15 01:00:00,50,1,51
"28042",10602,"Corner Brook","NL",48.95224,-57.92207,2018-03-15 02:00:00,49,1,50
"28043",10602,"Corner Brook","NL",48.95224,-57.92207,2018-03-15 03:00:00,51,1,52
"28044",10602,"Corner Brook","NL",48.95224,-57.92207,2018-03-15 04:00:00,51,1,52
"28045",10602,"Corner Brook","NL",48.95224,-57.92207,2018-03-15 05:00:00,51,1,52
"28046",10602,"Corner Brook","NL",48.95224,-57.92207,2018-03-15 06:00:00,51,1,52
"28047",10602,"Corner Brook","NL",48.95224,-57.92207,2018-03-15 07:00:00,49,2,51
"28048",10602,"Corner Brook","NL",48.95224,-57.92207,2018-03-15 08:00:00,47,2,49
"28049",10602,"Corner Brook","NL",48.95224,-57.92207,2018-03-15 09:00:00,48,1,49
"28050",10602,"Corner Brook","NL",48.95224,-57.92207,2018-03-15 10:00:00,48,1,49
"28051",10602,"Corner Brook","NL",48.95224,-57.92207,2018-03-15 11:00:00,47,1,48
"28052",10602,"Corner Brook","NL",48.95224,-57.92207,2018-03-15 12:00:00,48,1,49
"28053",10602,"Corner Brook","NL",48.95224,-57.92207,2018-03-15 13:00:00,48,1,49
"28054",10602,"Corner Brook","NL",48.95224,-57.92207,2018-03-15 14:00:00,48,1,49
"28055",10602,"Corner Brook","NL",48.95224,-57.92207,2018-03-15 15:00:00,50,1,51
"28056",10602,"Corner Brook","NL",48.95224,-57.92207,2018-03-15 16:00:00,50,1,51
"28057",10602,"Corner Brook","NL",48.95224,-57.92207,2018-03-15 17:00:00,50,1,51
"28058",10602,"Corner Brook","NL",48.95224,-57.92207,2018-03-15 18:00:00,50,1,51
"28059",10602,"Corner Brook","NL",48.95224,-57.92207,2018-03-15 19:00:00,44,4,48
"28060",10602,"Corner Brook","NL",48.95224,-57.92207,2018-03-15 20:00:00,45,3,48
"28061",10602,"Corner Brook","NL",48.95224,-57.92207,2018-03-15 21:00:00,48,2,50
"28062",10602,"Corner Brook","NL",48.95224,-57.92207,2018-03-15 22:00:00,47,2,49
"28063",10602,"Corner Brook","NL",48.95224,-57.92207,2018-03-15 23:00:00,47,2,49
"28064",10602,"Corner Brook","NL",48.95224,-57.92207,2018-03-16 00:00:00,46,1,47
"28065",10602,"Corner Brook","NL",48.95224,-57.92207,2018-03-16 01:00:00,42,2,44
"28066",10602,"Corner Brook","NL",48.95224,-57.92207,2018-03-16 02:00:00,41,1,42
"28067",10602,"Corner Brook","NL",48.95224,-57.92207,2018-03-16 03:00:00,41,1,42
"28068",10602,"Corner Brook","NL",48.95224,-57.92207,2018-03-16 04:00:00,39,1,40
"28069",10602,"Corner Brook","NL",48.95224,-57.92207,2018-03-16 05:00:00,39,1,40
"28070",10602,"Corner Brook","NL",48.95224,-57.92207,2018-03-16 06:00:00,39,1,40
"28071",10602,"Corner Brook","NL",48.95224,-57.92207,2018-03-16 07:00:00,39,1,40
"28072",10602,"Corner Brook","NL",48.95224,-57.92207,2018-03-16 08:00:00,38,1,39
"28073",10602,"Corner Brook","NL",48.95224,-57.92207,2018-03-16 09:00:00,39,1,40
"28074",10602,"Corner Brook","NL",48.95224,-57.92207,2018-03-16 10:00:00,39,1,40
"28075",10602,"Corner Brook","NL",48.95224,-57.92207,2018-03-16 11:00:00,39,1,40
"28076",10602,"Corner Brook","NL",48.95224,-57.92207,2018-03-16 12:00:00,39,1,40
"28077",10602,"Corner Brook","NL",48.95224,-57.92207,2018-03-16 13:00:00,40,1,41
"28078",10602,"Corner Brook","NL",48.95224,-57.92207,2018-03-16 14:00:00,40,1,41
"28079",10602,"Corner Brook","NL",48.95224,-57.92207,2018-03-16 15:00:00,40,1,41
"28080",10602,"Corner Brook","NL",48.95224,-57.92207,2018-03-16 16:00:00,39,1,40
"28081",10602,"Corner Brook","NL",48.95224,-57.92207,2018-03-16 17:00:00,39,1,40
"28082",10602,"Corner Brook","NL",48.95224,-57.92207,2018-03-16 18:00:00,39,1,40
"28083",10602,"Corner Brook","NL",48.95224,-57.92207,2018-03-16 19:00:00,39,1,40
"28084",10602,"Corner Brook","NL",48.95224,-57.92207,2018-03-16 20:00:00,40,1,41
"28085",10602,"Corner Brook","NL",48.95224,-57.92207,2018-03-16 21:00:00,41,1,42
"28086",10602,"Corner Brook","NL",48.95224,-57.92207,2018-03-16 22:00:00,40,1,41
"28087",10602,"Corner Brook","NL",48.95224,-57.92207,2018-03-16 23:00:00,40,1,41
"28088",10602,"Corner Brook","NL",48.95224,-57.92207,2018-03-17 00:00:00,40,1,41
"28089",10602,"Corner Brook","NL",48.95224,-57.92207,2018-03-17 01:00:00,40,0,40
"28090",10602,"Corner Brook","NL",48.95224,-57.92207,2018-03-17 02:00:00,40,0,40
"28091",10602,"Corner Brook","NL",48.95224,-57.92207,2018-03-17 03:00:00,40,1,41
"28092",10602,"Corner Brook","NL",48.95224,-57.92207,2018-03-17 04:00:00,40,1,41
"28093",10602,"Corner Brook","NL",48.95224,-57.92207,2018-03-17 05:00:00,40,2,42
"28094",10602,"Corner Brook","NL",48.95224,-57.92207,2018-03-17 06:00:00,39,2,41
"28095",10602,"Corner Brook","NL",48.95224,-57.92207,2018-03-17 07:00:00,39,2,41
"28096",10602,"Corner Brook","NL",48.95224,-57.92207,2018-03-17 08:00:00,39,2,41
"28097",10602,"Corner Brook","NL",48.95224,-57.92207,2018-03-17 09:00:00,39,1,40
"28098",10602,"Corner Brook","NL",48.95224,-57.92207,2018-03-17 10:00:00,39,1,40
"28099",10602,"Corner Brook","NL",48.95224,-57.92207,2018-03-17 11:00:00,40,1,41
"28100",10602,"Corner Brook","NL",48.95224,-57.92207,2018-03-17 12:00:00,40,1,41
"28101",10602,"Corner Brook","NL",48.95224,-57.92207,2018-03-17 13:00:00,40,1,41
"28102",10602,"Corner Brook","NL",48.95224,-57.92207,2018-03-17 14:00:00,41,1,42
"28103",10602,"Corner Brook","NL",48.95224,-57.92207,2018-03-17 15:00:00,40,1,41
"28104",10602,"Corner Brook","NL",48.95224,-57.92207,2018-03-17 16:00:00,40,1,41
"28105",10602,"Corner Brook","NL",48.95224,-57.92207,2018-03-17 17:00:00,39,2,41
"28106",10602,"Corner Brook","NL",48.95224,-57.92207,2018-03-17 18:00:00,39,2,41
"28107",10602,"Corner Brook","NL",48.95224,-57.92207,2018-03-17 19:00:00,38,2,40
"28108",10602,"Corner Brook","NL",48.95224,-57.92207,2018-03-17 20:00:00,37,2,39
"28109",10602,"Corner Brook","NL",48.95224,-57.92207,2018-03-17 21:00:00,38,1,39
"28110",10602,"Corner Brook","NL",48.95224,-57.92207,2018-03-17 22:00:00,38,2,40
"28111",10602,"Corner Brook","NL",48.95224,-57.92207,2018-03-17 23:00:00,38,1,39
"28112",10602,"Corner Brook","NL",48.95224,-57.92207,2018-03-18 00:00:00,37,2,39
"28113",10602,"Corner Brook","NL",48.95224,-57.92207,2018-03-18 01:00:00,36,3,39
"28114",10602,"Corner Brook","NL",48.95224,-57.92207,2018-03-18 02:00:00,37,2,39
"28115",10602,"Corner Brook","NL",48.95224,-57.92207,2018-03-18 03:00:00,37,2,39
"28116",10602,"Corner Brook","NL",48.95224,-57.92207,2018-03-18 04:00:00,38,1,39
"28117",10602,"Corner Brook","NL",48.95224,-57.92207,2018-03-18 05:00:00,37,2,39
"28118",10602,"Corner Brook","NL",48.95224,-57.92207,2018-03-18 06:00:00,36,3,39
"28119",10602,"Corner Brook","NL",48.95224,-57.92207,2018-03-18 07:00:00,34,5,39
"28120",10602,"Corner Brook","NL",48.95224,-57.92207,2018-03-18 08:00:00,35,2,37
"28121",10602,"Corner Brook","NL",48.95224,-57.92207,2018-03-18 09:00:00,35,3,38
"28122",10602,"Corner Brook","NL",48.95224,-57.92207,2018-03-18 10:00:00,38,1,39
"28123",10602,"Corner Brook","NL",48.95224,-57.92207,2018-03-18 11:00:00,38,1,39
"28124",10602,"Corner Brook","NL",48.95224,-57.92207,2018-03-18 12:00:00,39,1,40
"28125",10602,"Corner Brook","NL",48.95224,-57.92207,2018-03-18 13:00:00,38,1,39
"28126",10602,"Corner Brook","NL",48.95224,-57.92207,2018-03-18 14:00:00,38,1,39
"28127",10602,"Corner Brook","NL",48.95224,-57.92207,2018-03-18 15:00:00,32,6,38
"28128",10602,"Corner Brook","NL",48.95224,-57.92207,2018-03-18 16:00:00,36,2,38
"28129",10602,"Corner Brook","NL",48.95224,-57.92207,2018-03-18 17:00:00,36,2,38
"28130",10602,"Corner Brook","NL",48.95224,-57.92207,2018-03-18 18:00:00,35,3,38
"28131",10602,"Corner Brook","NL",48.95224,-57.92207,2018-03-18 19:00:00,36,1,37
"28132",10602,"Corner Brook","NL",48.95224,-57.92207,2018-03-18 20:00:00,36,1,37
"28133",10602,"Corner Brook","NL",48.95224,-57.92207,2018-03-18 21:00:00,35,2,37
"28134",10602,"Corner Brook","NL",48.95224,-57.92207,2018-03-18 22:00:00,35,2,37
"28135",10602,"Corner Brook","NL",48.95224,-57.92207,2018-03-18 23:00:00,36,2,38
"28136",10602,"Corner Brook","NL",48.95224,-57.92207,2018-03-19 00:00:00,36,1,37
"28137",10602,"Corner Brook","NL",48.95224,-57.92207,2018-03-19 01:00:00,36,2,38
"28138",10602,"Corner Brook","NL",48.95224,-57.92207,2018-03-19 02:00:00,35,2,37
"28139",10602,"Corner Brook","NL",48.95224,-57.92207,2018-03-19 03:00:00,34,3,37
"28140",10602,"Corner Brook","NL",48.95224,-57.92207,2018-03-19 04:00:00,33,4,37
"28141",10602,"Corner Brook","NL",48.95224,-57.92207,2018-03-19 05:00:00,34,4,38
"28142",10602,"Corner Brook","NL",48.95224,-57.92207,2018-03-19 06:00:00,37,2,39
"28143",10602,"Corner Brook","NL",48.95224,-57.92207,2018-03-19 07:00:00,35,3,38
"28144",10602,"Corner Brook","NL",48.95224,-57.92207,2018-03-19 08:00:00,36,2,38
"28145",10602,"Corner Brook","NL",48.95224,-57.92207,2018-03-19 09:00:00,37,2,39
"28146",10602,"Corner Brook","NL",48.95224,-57.92207,2018-03-19 10:00:00,38,2,40
"28147",10602,"Corner Brook","NL",48.95224,-57.92207,2018-03-19 11:00:00,38,1,39
"28148",10602,"Corner Brook","NL",48.95224,-57.92207,2018-03-19 12:00:00,38,1,39
"28149",10602,"Corner Brook","NL",48.95224,-57.92207,2018-03-19 13:00:00,38,1,39
"28150",10602,"Corner Brook","NL",48.95224,-57.92207,2018-03-19 14:00:00,37,2,39
"28151",10602,"Corner Brook","NL",48.95224,-57.92207,2018-03-19 15:00:00,37,2,39
"28152",10602,"Corner Brook","NL",48.95224,-57.92207,2018-03-19 16:00:00,36,1,37
"28153",10602,"Corner Brook","NL",48.95224,-57.92207,2018-03-19 17:00:00,35,1,36
"28154",10602,"Corner Brook","NL",48.95224,-57.92207,2018-03-19 18:00:00,35,1,36
"28155",10602,"Corner Brook","NL",48.95224,-57.92207,2018-03-19 19:00:00,34,1,35
"28156",10602,"Corner Brook","NL",48.95224,-57.92207,2018-03-19 20:00:00,36,1,37
"28157",10602,"Corner Brook","NL",48.95224,-57.92207,2018-03-19 21:00:00,36,1,37
"28158",10602,"Corner Brook","NL",48.95224,-57.92207,2018-03-19 22:00:00,35,1,36
"28159",10602,"Corner Brook","NL",48.95224,-57.92207,2018-03-19 23:00:00,35,1,36
"28160",10602,"Corner Brook","NL",48.95224,-57.92207,2018-03-20 00:00:00,34,1,35
"28161",10602,"Corner Brook","NL",48.95224,-57.92207,2018-03-20 01:00:00,34,1,35
"28162",10602,"Corner Brook","NL",48.95224,-57.92207,2018-03-20 02:00:00,35,1,36
"28163",10602,"Corner Brook","NL",48.95224,-57.92207,2018-03-20 03:00:00,35,1,36
"28164",10602,"Corner Brook","NL",48.95224,-57.92207,2018-03-20 04:00:00,37,1,38
"28165",10602,"Corner Brook","NL",48.95224,-57.92207,2018-03-20 05:00:00,38,1,39
"28166",10602,"Corner Brook","NL",48.95224,-57.92207,2018-03-20 06:00:00,38,1,39
"28167",10602,"Corner Brook","NL",48.95224,-57.92207,2018-03-20 07:00:00,39,1,40
"28168",10602,"Corner Brook","NL",48.95224,-57.92207,2018-03-20 08:00:00,38,2,40
"28169",10602,"Corner Brook","NL",48.95224,-57.92207,2018-03-20 09:00:00,39,2,41
"28170",10602,"Corner Brook","NL",48.95224,-57.92207,2018-03-20 10:00:00,40,2,42
"28171",10602,"Corner Brook","NL",48.95224,-57.92207,2018-03-20 11:00:00,41,1,42
"28172",10602,"Corner Brook","NL",48.95224,-57.92207,2018-03-20 12:00:00,41,1,42
"28173",10602,"Corner Brook","NL",48.95224,-57.92207,2018-03-20 13:00:00,42,1,43
"28174",10602,"Corner Brook","NL",48.95224,-57.92207,2018-03-20 14:00:00,42,1,43
"28175",10602,"Corner Brook","NL",48.95224,-57.92207,2018-03-20 15:00:00,42,1,43
"28176",10602,"Corner Brook","NL",48.95224,-57.92207,2018-03-20 16:00:00,42,1,43
"28177",10602,"Corner Brook","NL",48.95224,-57.92207,2018-03-20 17:00:00,43,1,44
"28178",10602,"Corner Brook","NL",48.95224,-57.92207,2018-03-20 18:00:00,43,1,44
"28179",10602,"Corner Brook","NL",48.95224,-57.92207,2018-03-20 19:00:00,42,2,44
"28180",10602,"Corner Brook","NL",48.95224,-57.92207,2018-03-20 20:00:00,43,2,45
"28181",10602,"Corner Brook","NL",48.95224,-57.92207,2018-03-20 21:00:00,43,1,44
"28182",10602,"Corner Brook","NL",48.95224,-57.92207,2018-03-20 22:00:00,43,1,44
"28183",10602,"Corner Brook","NL",48.95224,-57.92207,2018-03-20 23:00:00,44,1,45
"28184",10602,"Corner Brook","NL",48.95224,-57.92207,2018-03-21 00:00:00,44,1,45
"28185",10602,"Corner Brook","NL",48.95224,-57.92207,2018-03-21 01:00:00,43,1,44
"28186",10602,"Corner Brook","NL",48.95224,-57.92207,2018-03-21 02:00:00,42,1,43
"28187",10602,"Corner Brook","NL",48.95224,-57.92207,2018-03-21 03:00:00,43,0,43
"28188",10602,"Corner Brook","NL",48.95224,-57.92207,2018-03-21 04:00:00,43,1,44
"28189",10602,"Corner Brook","NL",48.95224,-57.92207,2018-03-21 05:00:00,43,1,44
"28190",10602,"Corner Brook","NL",48.95224,-57.92207,2018-03-21 06:00:00,42,1,43
"28191",10602,"Corner Brook","NL",48.95224,-57.92207,2018-03-21 07:00:00,40,3,43
"28192",10602,"Corner Brook","NL",48.95224,-57.92207,2018-03-21 08:00:00,41,3,44
"28193",10602,"Corner Brook","NL",48.95224,-57.92207,2018-03-21 09:00:00,41,3,44
"28194",10602,"Corner Brook","NL",48.95224,-57.92207,2018-03-21 10:00:00,40,4,44
"28195",10602,"Corner Brook","NL",48.95224,-57.92207,2018-03-21 11:00:00,43,2,45
"28196",10602,"Corner Brook","NL",48.95224,-57.92207,2018-03-21 12:00:00,42,2,44
"28197",10602,"Corner Brook","NL",48.95224,-57.92207,2018-03-21 13:00:00,43,2,45
"28198",10602,"Corner Brook","NL",48.95224,-57.92207,2018-03-21 14:00:00,44,1,45
"28199",10602,"Corner Brook","NL",48.95224,-57.92207,2018-03-21 15:00:00,43,2,45
"28200",10602,"Corner Brook","NL",48.95224,-57.92207,2018-03-21 16:00:00,40,5,45
"28201",10602,"Corner Brook","NL",48.95224,-57.92207,2018-03-21 17:00:00,35,9,44
"28202",10602,"Corner Brook","NL",48.95224,-57.92207,2018-03-21 18:00:00,30,13,43
"28203",10602,"Corner Brook","NL",48.95224,-57.92207,2018-03-21 19:00:00,35,7,42
"28204",10602,"Corner Brook","NL",48.95224,-57.92207,2018-03-21 20:00:00,40,3,43
"28205",10602,"Corner Brook","NL",48.95224,-57.92207,2018-03-21 21:00:00,33,7,40
"28206",10602,"Corner Brook","NL",48.95224,-57.92207,2018-03-21 22:00:00,34,5,39
"28207",10602,"Corner Brook","NL",48.95224,-57.92207,2018-03-21 23:00:00,40,2,42
"28208",10602,"Corner Brook","NL",48.95224,-57.92207,2018-03-22 00:00:00,41,1,42
"28209",10602,"Corner Brook","NL",48.95224,-57.92207,2018-03-22 01:00:00,41,1,42
"28210",10602,"Corner Brook","NL",48.95224,-57.92207,2018-03-22 02:00:00,41,1,42
"28211",10602,"Corner Brook","NL",48.95224,-57.92207,2018-03-22 03:00:00,41,1,42
"28212",10602,"Corner Brook","NL",48.95224,-57.92207,2018-03-22 04:00:00,41,1,42
"28213",10602,"Corner Brook","NL",48.95224,-57.92207,2018-03-22 05:00:00,40,1,41
"28214",10602,"Corner Brook","NL",48.95224,-57.92207,2018-03-22 06:00:00,40,2,42
"28215",10602,"Corner Brook","NL",48.95224,-57.92207,2018-03-22 07:00:00,39,4,43
"28216",10602,"Corner Brook","NL",48.95224,-57.92207,2018-03-22 08:00:00,38,4,42
"28217",10602,"Corner Brook","NL",48.95224,-57.92207,2018-03-22 09:00:00,41,3,44
"28218",10602,"Corner Brook","NL",48.95224,-57.92207,2018-03-22 10:00:00,41,3,44
"28219",10602,"Corner Brook","NL",48.95224,-57.92207,2018-03-22 11:00:00,43,2,45
"28220",10602,"Corner Brook","NL",48.95224,-57.92207,2018-03-22 12:00:00,43,2,45
"28221",10602,"Corner Brook","NL",48.95224,-57.92207,2018-03-22 13:00:00,43,2,45
"28222",10602,"Corner Brook","NL",48.95224,-57.92207,2018-03-22 14:00:00,44,2,46
"28223",10602,"Corner Brook","NL",48.95224,-57.92207,2018-03-22 15:00:00,42,4,46
"28224",10602,"Corner Brook","NL",48.95224,-57.92207,2018-03-22 16:00:00,43,2,45
"28225",10602,"Corner Brook","NL",48.95224,-57.92207,2018-03-22 17:00:00,44,1,45
"28226",10602,"Corner Brook","NL",48.95224,-57.92207,2018-03-22 18:00:00,45,1,46
"28227",10602,"Corner Brook","NL",48.95224,-57.92207,2018-03-22 19:00:00,44,1,45
"28228",10602,"Corner Brook","NL",48.95224,-57.92207,2018-03-22 20:00:00,44,1,45
"28229",10602,"Corner Brook","NL",48.95224,-57.92207,2018-03-22 21:00:00,42,1,43
"28230",10602,"Corner Brook","NL",48.95224,-57.92207,2018-03-22 22:00:00,42,1,43
"28231",10602,"Corner Brook","NL",48.95224,-57.92207,2018-03-22 23:00:00,42,1,43
"28232",10602,"Corner Brook","NL",48.95224,-57.92207,2018-03-23 00:00:00,42,1,43
"28233",10602,"Corner Brook","NL",48.95224,-57.92207,2018-03-23 01:00:00,42,1,43
"28234",10602,"Corner Brook","NL",48.95224,-57.92207,2018-03-23 02:00:00,43,1,44
"28235",10602,"Corner Brook","NL",48.95224,-57.92207,2018-03-23 03:00:00,43,1,44
"28236",10602,"Corner Brook","NL",48.95224,-57.92207,2018-03-23 04:00:00,43,1,44
"28237",10602,"Corner Brook","NL",48.95224,-57.92207,2018-03-23 05:00:00,43,1,44
"28238",10602,"Corner Brook","NL",48.95224,-57.92207,2018-03-23 06:00:00,43,2,45
"28239",10602,"Corner Brook","NL",48.95224,-57.92207,2018-03-23 07:00:00,43,2,45
"28240",10602,"Corner Brook","NL",48.95224,-57.92207,2018-03-23 08:00:00,43,1,44
"28241",10602,"Corner Brook","NL",48.95224,-57.92207,2018-03-23 09:00:00,44,1,45
"28242",10602,"Corner Brook","NL",48.95224,-57.92207,2018-03-23 10:00:00,43,2,45
"28243",10602,"Corner Brook","NL",48.95224,-57.92207,2018-03-23 11:00:00,43,2,45
"28244",10602,"Corner Brook","NL",48.95224,-57.92207,2018-03-23 12:00:00,43,2,45
"28245",10602,"Corner Brook","NL",48.95224,-57.92207,2018-03-23 13:00:00,41,4,45
"28246",10602,"Corner Brook","NL",48.95224,-57.92207,2018-03-23 14:00:00,41,3,44
"28247",10602,"Corner Brook","NL",48.95224,-57.92207,2018-03-23 15:00:00,40,3,43
"28248",10602,"Corner Brook","NL",48.95224,-57.92207,2018-03-23 16:00:00,41,2,43
"28249",10602,"Corner Brook","NL",48.95224,-57.92207,2018-03-23 17:00:00,43,2,45
"28250",10602,"Corner Brook","NL",48.95224,-57.92207,2018-03-23 18:00:00,44,1,45
"28251",10602,"Corner Brook","NL",48.95224,-57.92207,2018-03-23 19:00:00,44,1,45
"28252",10602,"Corner Brook","NL",48.95224,-57.92207,2018-03-23 20:00:00,45,1,46
"28253",10602,"Corner Brook","NL",48.95224,-57.92207,2018-03-23 21:00:00,45,1,46
"28254",10602,"Corner Brook","NL",48.95224,-57.92207,2018-03-23 22:00:00,45,1,46
"28255",10602,"Corner Brook","NL",48.95224,-57.92207,2018-03-23 23:00:00,42,2,44
"28256",10602,"Corner Brook","NL",48.95224,-57.92207,2018-03-24 00:00:00,43,1,44
"28257",10602,"Corner Brook","NL",48.95224,-57.92207,2018-03-24 01:00:00,44,1,45
"28258",10602,"Corner Brook","NL",48.95224,-57.92207,2018-03-24 02:00:00,44,1,45
"28259",10602,"Corner Brook","NL",48.95224,-57.92207,2018-03-24 03:00:00,44,1,45
"28260",10602,"Corner Brook","NL",48.95224,-57.92207,2018-03-24 04:00:00,44,1,45
"28261",10602,"Corner Brook","NL",48.95224,-57.92207,2018-03-24 05:00:00,43,2,45
"28262",10602,"Corner Brook","NL",48.95224,-57.92207,2018-03-24 06:00:00,43,2,45
"28263",10602,"Corner Brook","NL",48.95224,-57.92207,2018-03-24 07:00:00,42,1,43
"28264",10602,"Corner Brook","NL",48.95224,-57.92207,2018-03-24 08:00:00,42,1,43
"28265",10602,"Corner Brook","NL",48.95224,-57.92207,2018-03-24 09:00:00,43,1,44
"28266",10602,"Corner Brook","NL",48.95224,-57.92207,2018-03-24 10:00:00,43,1,44
"28267",10602,"Corner Brook","NL",48.95224,-57.92207,2018-03-24 11:00:00,43,1,44
"28268",10602,"Corner Brook","NL",48.95224,-57.92207,2018-03-24 12:00:00,44,1,45
"28269",10602,"Corner Brook","NL",48.95224,-57.92207,2018-03-24 13:00:00,44,1,45
"28270",10602,"Corner Brook","NL",48.95224,-57.92207,2018-03-24 14:00:00,45,1,46
"28271",10602,"Corner Brook","NL",48.95224,-57.92207,2018-03-24 15:00:00,44,1,45
"28272",10602,"Corner Brook","NL",48.95224,-57.92207,2018-03-24 16:00:00,44,1,45
"28273",10602,"Corner Brook","NL",48.95224,-57.92207,2018-03-24 17:00:00,45,1,46
"28274",10602,"Corner Brook","NL",48.95224,-57.92207,2018-03-24 18:00:00,45,1,46
"28275",10602,"Corner Brook","NL",48.95224,-57.92207,2018-03-24 19:00:00,42,3,45
"28276",10602,"Corner Brook","NL",48.95224,-57.92207,2018-03-24 20:00:00,43,2,45
"28277",10602,"Corner Brook","NL",48.95224,-57.92207,2018-03-24 21:00:00,43,1,44
"28278",10602,"Corner Brook","NL",48.95224,-57.92207,2018-03-24 22:00:00,43,1,44
"28279",10602,"Corner Brook","NL",48.95224,-57.92207,2018-03-24 23:00:00,42,1,43
"28280",10602,"Corner Brook","NL",48.95224,-57.92207,2018-03-25 00:00:00,41,1,42
"28281",10602,"Corner Brook","NL",48.95224,-57.92207,2018-03-25 01:00:00,42,1,43
"28282",10602,"Corner Brook","NL",48.95224,-57.92207,2018-03-25 02:00:00,43,1,44
"28283",10602,"Corner Brook","NL",48.95224,-57.92207,2018-03-25 03:00:00,43,1,44
"28284",10602,"Corner Brook","NL",48.95224,-57.92207,2018-03-25 04:00:00,43,1,44
"28285",10602,"Corner Brook","NL",48.95224,-57.92207,2018-03-25 05:00:00,43,1,44
"28286",10602,"Corner Brook","NL",48.95224,-57.92207,2018-03-25 06:00:00,42,1,43
"28287",10602,"Corner Brook","NL",48.95224,-57.92207,2018-03-25 07:00:00,42,1,43
"28288",10602,"Corner Brook","NL",48.95224,-57.92207,2018-03-25 08:00:00,42,1,43
"28289",10602,"Corner Brook","NL",48.95224,-57.92207,2018-03-25 09:00:00,42,1,43
"28290",10602,"Corner Brook","NL",48.95224,-57.92207,2018-03-25 10:00:00,43,1,44
"28291",10602,"Corner Brook","NL",48.95224,-57.92207,2018-03-25 11:00:00,44,1,45
"28292",10602,"Corner Brook","NL",48.95224,-57.92207,2018-03-25 12:00:00,44,1,45
"28293",10602,"Corner Brook","NL",48.95224,-57.92207,2018-03-25 13:00:00,44,1,45
"28294",10602,"Corner Brook","NL",48.95224,-57.92207,2018-03-25 14:00:00,44,1,45
"28295",10602,"Corner Brook","NL",48.95224,-57.92207,2018-03-25 15:00:00,45,1,46
"28296",10602,"Corner Brook","NL",48.95224,-57.92207,2018-03-25 16:00:00,45,1,46
"28297",10602,"Corner Brook","NL",48.95224,-57.92207,2018-03-25 17:00:00,44,1,45
"28298",10602,"Corner Brook","NL",48.95224,-57.92207,2018-03-25 18:00:00,44,1,45
"28299",10602,"Corner Brook","NL",48.95224,-57.92207,2018-03-25 19:00:00,43,2,45
"28300",10602,"Corner Brook","NL",48.95224,-57.92207,2018-03-25 20:00:00,43,1,44
"28301",10602,"Corner Brook","NL",48.95224,-57.92207,2018-03-25 21:00:00,44,1,45
"28302",10602,"Corner Brook","NL",48.95224,-57.92207,2018-03-25 22:00:00,42,2,44
"28303",10602,"Corner Brook","NL",48.95224,-57.92207,2018-03-25 23:00:00,39,3,42
"28304",10602,"Corner Brook","NL",48.95224,-57.92207,2018-03-26 00:00:00,38,2,40
"28305",10602,"Corner Brook","NL",48.95224,-57.92207,2018-03-26 01:00:00,35,4,39
"28306",10602,"Corner Brook","NL",48.95224,-57.92207,2018-03-26 02:00:00,33,6,39
"28307",10602,"Corner Brook","NL",48.95224,-57.92207,2018-03-26 03:00:00,32,7,39
"28308",10602,"Corner Brook","NL",48.95224,-57.92207,2018-03-26 04:00:00,30,8,38
"28309",10602,"Corner Brook","NL",48.95224,-57.92207,2018-03-26 05:00:00,35,5,40
"28310",10602,"Corner Brook","NL",48.95224,-57.92207,2018-03-26 06:00:00,31,8,39
"28311",10602,"Corner Brook","NL",48.95224,-57.92207,2018-03-26 07:00:00,19,19,38
"28312",10602,"Corner Brook","NL",48.95224,-57.92207,2018-03-26 08:00:00,23,17,40
"28313",10602,"Corner Brook","NL",48.95224,-57.92207,2018-03-26 09:00:00,26,17,43
"28314",10602,"Corner Brook","NL",48.95224,-57.92207,2018-03-26 10:00:00,32,13,45
"28315",10602,"Corner Brook","NL",48.95224,-57.92207,2018-03-26 11:00:00,36,13,49
"28316",10602,"Corner Brook","NL",48.95224,-57.92207,2018-03-26 12:00:00,39,8,47
"28317",10602,"Corner Brook","NL",48.95224,-57.92207,2018-03-26 13:00:00,43,3,46
"28318",10602,"Corner Brook","NL",48.95224,-57.92207,2018-03-26 14:00:00,43,4,47
"28319",10602,"Corner Brook","NL",48.95224,-57.92207,2018-03-26 15:00:00,41,4,45
"28320",10602,"Corner Brook","NL",48.95224,-57.92207,2018-03-26 16:00:00,37,9,46
"28321",10602,"Corner Brook","NL",48.95224,-57.92207,2018-03-26 17:00:00,42,3,45
"28322",10602,"Corner Brook","NL",48.95224,-57.92207,2018-03-26 18:00:00,36,8,44
"28323",10602,"Corner Brook","NL",48.95224,-57.92207,2018-03-26 19:00:00,41,3,44
"28324",10602,"Corner Brook","NL",48.95224,-57.92207,2018-03-26 20:00:00,40,3,43
"28325",10602,"Corner Brook","NL",48.95224,-57.92207,2018-03-26 21:00:00,38,4,42
"28326",10602,"Corner Brook","NL",48.95224,-57.92207,2018-03-26 22:00:00,33,6,39
"28327",10602,"Corner Brook","NL",48.95224,-57.92207,2018-03-26 23:00:00,34,8,42
"28328",10602,"Corner Brook","NL",48.95224,-57.92207,2018-03-27 00:00:00,42,1,43
"28329",10602,"Corner Brook","NL",48.95224,-57.92207,2018-03-27 01:00:00,41,1,42
"28330",10602,"Corner Brook","NL",48.95224,-57.92207,2018-03-27 02:00:00,40,2,42
"28331",10602,"Corner Brook","NL",48.95224,-57.92207,2018-03-27 03:00:00,41,2,43
"28332",10602,"Corner Brook","NL",48.95224,-57.92207,2018-03-27 04:00:00,37,3,40
"28333",10602,"Corner Brook","NL",48.95224,-57.92207,2018-03-27 05:00:00,38,4,42
"28334",10602,"Corner Brook","NL",48.95224,-57.92207,2018-03-27 06:00:00,33,7,40
"28335",10602,"Corner Brook","NL",48.95224,-57.92207,2018-03-27 07:00:00,18,20,38
"28336",10602,"Corner Brook","NL",48.95224,-57.92207,2018-03-27 08:00:00,21,20,41
"28337",10602,"Corner Brook","NL",48.95224,-57.92207,2018-03-27 09:00:00,29,15,44
"28338",10602,"Corner Brook","NL",48.95224,-57.92207,2018-03-27 10:00:00,35,9,44
"28339",10602,"Corner Brook","NL",48.95224,-57.92207,2018-03-27 11:00:00,38,10,48
"28340",10602,"Corner Brook","NL",48.95224,-57.92207,2018-03-27 12:00:00,46,5,51
"28341",10602,"Corner Brook","NL",48.95224,-57.92207,2018-03-27 13:00:00,46,5,51
"28342",10602,"Corner Brook","NL",48.95224,-57.92207,2018-03-27 14:00:00,50,2,52
"28343",10602,"Corner Brook","NL",48.95224,-57.92207,2018-03-27 15:00:00,50,2,52
"28344",10602,"Corner Brook","NL",48.95224,-57.92207,2018-03-27 16:00:00,49,2,51
"28345",10602,"Corner Brook","NL",48.95224,-57.92207,2018-03-27 17:00:00,47,2,49
"28346",10602,"Corner Brook","NL",48.95224,-57.92207,2018-03-27 18:00:00,40,8,48
"28347",10602,"Corner Brook","NL",48.95224,-57.92207,2018-03-27 19:00:00,39,8,47
"28348",10602,"Corner Brook","NL",48.95224,-57.92207,2018-03-27 20:00:00,30,12,42
"28349",10602,"Corner Brook","NL",48.95224,-57.92207,2018-03-27 21:00:00,19,23,42
"28350",10602,"Corner Brook","NL",48.95224,-57.92207,2018-03-27 22:00:00,28,12,40
"28351",10602,"Corner Brook","NL",48.95224,-57.92207,2018-03-27 23:00:00,35,7,42
"28352",10602,"Corner Brook","NL",48.95224,-57.92207,2018-03-28 00:00:00,37,6,43
"28353",10602,"Corner Brook","NL",48.95224,-57.92207,2018-03-28 01:00:00,35,7,42
"28354",10602,"Corner Brook","NL",48.95224,-57.92207,2018-03-28 02:00:00,35,7,42
"28355",10602,"Corner Brook","NL",48.95224,-57.92207,2018-03-28 03:00:00,37,5,42
"28356",10602,"Corner Brook","NL",48.95224,-57.92207,2018-03-28 04:00:00,39,5,44
"28357",10602,"Corner Brook","NL",48.95224,-57.92207,2018-03-28 05:00:00,41,3,44
"28358",10602,"Corner Brook","NL",48.95224,-57.92207,2018-03-28 06:00:00,42,3,45
"28359",10602,"Corner Brook","NL",48.95224,-57.92207,2018-03-28 07:00:00,39,5,44
"28360",10602,"Corner Brook","NL",48.95224,-57.92207,2018-03-28 08:00:00,37,7,44
"28361",10602,"Corner Brook","NL",48.95224,-57.92207,2018-03-28 09:00:00,44,3,47
"28362",10602,"Corner Brook","NL",48.95224,-57.92207,2018-03-28 10:00:00,45,3,48
"28363",10602,"Corner Brook","NL",48.95224,-57.92207,2018-03-28 11:00:00,44,5,49
"28364",10602,"Corner Brook","NL",48.95224,-57.92207,2018-03-28 12:00:00,48,3,51
"28365",10602,"Corner Brook","NL",48.95224,-57.92207,2018-03-28 13:00:00,46,4,50
"28366",10602,"Corner Brook","NL",48.95224,-57.92207,2018-03-28 14:00:00,46,4,50
"28367",10602,"Corner Brook","NL",48.95224,-57.92207,2018-03-28 15:00:00,47,2,49
"28368",10602,"Corner Brook","NL",48.95224,-57.92207,2018-03-28 16:00:00,45,3,48
"28369",10602,"Corner Brook","NL",48.95224,-57.92207,2018-03-28 17:00:00,46,2,48
"28370",10602,"Corner Brook","NL",48.95224,-57.92207,2018-03-28 18:00:00,45,2,47
"28371",10602,"Corner Brook","NL",48.95224,-57.92207,2018-03-28 19:00:00,44,2,46
"28372",10602,"Corner Brook","NL",48.95224,-57.92207,2018-03-28 20:00:00,44,2,46
"28373",10602,"Corner Brook","NL",48.95224,-57.92207,2018-03-28 21:00:00,43,2,45
"28374",10602,"Corner Brook","NL",48.95224,-57.92207,2018-03-28 22:00:00,43,1,44
"28375",10602,"Corner Brook","NL",48.95224,-57.92207,2018-03-28 23:00:00,43,1,44
"28376",10602,"Corner Brook","NL",48.95224,-57.92207,2018-03-29 00:00:00,42,2,44
"28377",10602,"Corner Brook","NL",48.95224,-57.92207,2018-03-29 01:00:00,42,2,44
"28378",10602,"Corner Brook","NL",48.95224,-57.92207,2018-03-29 02:00:00,40,2,42
"28379",10602,"Corner Brook","NL",48.95224,-57.92207,2018-03-29 03:00:00,40,2,42
"28380",10602,"Corner Brook","NL",48.95224,-57.92207,2018-03-29 04:00:00,40,2,42
"28381",10602,"Corner Brook","NL",48.95224,-57.92207,2018-03-29 05:00:00,40,2,42
"28382",10602,"Corner Brook","NL",48.95224,-57.92207,2018-03-29 06:00:00,39,3,42
"28383",10602,"Corner Brook","NL",48.95224,-57.92207,2018-03-29 07:00:00,41,3,44
"28384",10602,"Corner Brook","NL",48.95224,-57.92207,2018-03-29 08:00:00,41,3,44
"28385",10602,"Corner Brook","NL",48.95224,-57.92207,2018-03-29 09:00:00,41,3,44
"28386",10602,"Corner Brook","NL",48.95224,-57.92207,2018-03-29 10:00:00,39,4,43
"28387",10602,"Corner Brook","NL",48.95224,-57.92207,2018-03-29 11:00:00,41,3,44
"28388",10602,"Corner Brook","NL",48.95224,-57.92207,2018-03-29 12:00:00,41,4,45
"28389",10602,"Corner Brook","NL",48.95224,-57.92207,2018-03-29 13:00:00,42,3,45
"28390",10602,"Corner Brook","NL",48.95224,-57.92207,2018-03-29 14:00:00,38,5,43
"28391",10602,"Corner Brook","NL",48.95224,-57.92207,2018-03-29 15:00:00,36,6,42
"28392",10602,"Corner Brook","NL",48.95224,-57.92207,2018-03-29 16:00:00,35,7,42
"28393",10602,"Corner Brook","NL",48.95224,-57.92207,2018-03-29 17:00:00,35,7,42
"28394",10602,"Corner Brook","NL",48.95224,-57.92207,2018-03-29 18:00:00,34,8,42
"28395",10602,"Corner Brook","NL",48.95224,-57.92207,2018-03-29 19:00:00,39,6,45
"28396",10602,"Corner Brook","NL",48.95224,-57.92207,2018-03-29 20:00:00,41,4,45
"28397",10602,"Corner Brook","NL",48.95224,-57.92207,2018-03-29 21:00:00,40,4,44
"28398",10602,"Corner Brook","NL",48.95224,-57.92207,2018-03-29 22:00:00,39,5,44
"28399",10602,"Corner Brook","NL",48.95224,-57.92207,2018-03-29 23:00:00,40,3,43
"28400",10602,"Corner Brook","NL",48.95224,-57.92207,2018-03-30 00:00:00,36,7,43
"28401",10602,"Corner Brook","NL",48.95224,-57.92207,2018-03-30 01:00:00,38,4,42
"28402",10602,"Corner Brook","NL",48.95224,-57.92207,2018-03-30 02:00:00,37,4,41
"28403",10602,"Corner Brook","NL",48.95224,-57.92207,2018-03-30 03:00:00,39,3,42
"28404",10602,"Corner Brook","NL",48.95224,-57.92207,2018-03-30 04:00:00,37,4,41
"28405",10602,"Corner Brook","NL",48.95224,-57.92207,2018-03-30 05:00:00,37,3,40
"28406",10602,"Corner Brook","NL",48.95224,-57.92207,2018-03-30 06:00:00,36,4,40
"28407",10602,"Corner Brook","NL",48.95224,-57.92207,2018-03-30 07:00:00,35,5,40
"28408",10602,"Corner Brook","NL",48.95224,-57.92207,2018-03-30 08:00:00,37,5,42
"28409",10602,"Corner Brook","NL",48.95224,-57.92207,2018-03-30 09:00:00,40,3,43
"28410",10602,"Corner Brook","NL",48.95224,-57.92207,2018-03-30 10:00:00,39,3,42
"28411",10602,"Corner Brook","NL",48.95224,-57.92207,2018-03-30 11:00:00,43,3,46
"28412",10602,"Corner Brook","NL",48.95224,-57.92207,2018-03-30 12:00:00,45,1,46
"28413",10602,"Corner Brook","NL",48.95224,-57.92207,2018-03-30 13:00:00,45,1,46
"28414",10602,"Corner Brook","NL",48.95224,-57.92207,2018-03-30 14:00:00,46,1,47
"28415",10602,"Corner Brook","NL",48.95224,-57.92207,2018-03-30 15:00:00,44,1,45
"28416",10602,"Corner Brook","NL",48.95224,-57.92207,2018-03-30 16:00:00,43,1,44
"28417",10602,"Corner Brook","NL",48.95224,-57.92207,2018-03-30 17:00:00,39,3,42
"28418",10602,"Corner Brook","NL",48.95224,-57.92207,2018-03-30 18:00:00,41,2,43
"28419",10602,"Corner Brook","NL",48.95224,-57.92207,2018-03-30 19:00:00,43,1,44
"28420",10602,"Corner Brook","NL",48.95224,-57.92207,2018-03-30 20:00:00,44,2,46
"28421",10602,"Corner Brook","NL",48.95224,-57.92207,2018-03-30 21:00:00,43,2,45
"28422",10602,"Corner Brook","NL",48.95224,-57.92207,2018-03-30 22:00:00,42,3,45
"28423",10602,"Corner Brook","NL",48.95224,-57.92207,2018-03-30 23:00:00,40,4,44
"28424",10602,"Corner Brook","NL",48.95224,-57.92207,2018-03-31 00:00:00,44,2,46
"28425",10602,"Corner Brook","NL",48.95224,-57.92207,2018-03-31 01:00:00,40,2,42
"28426",10602,"Corner Brook","NL",48.95224,-57.92207,2018-03-31 02:00:00,41,2,43
"28427",10602,"Corner Brook","NL",48.95224,-57.92207,2018-03-31 03:00:00,33,4,37
"28428",10602,"Corner Brook","NL",48.95224,-57.92207,2018-03-31 04:00:00,34,3,37
"28429",10602,"Corner Brook","NL",48.95224,-57.92207,2018-03-31 05:00:00,37,2,39
"28430",10602,"Corner Brook","NL",48.95224,-57.92207,2018-03-31 06:00:00,33,3,36
"28431",10602,"Corner Brook","NL",48.95224,-57.92207,2018-03-31 07:00:00,30,4,34
"28432",10602,"Corner Brook","NL",48.95224,-57.92207,2018-03-31 08:00:00,18,12,30
"28433",10602,"Corner Brook","NL",48.95224,-57.92207,2018-03-31 09:00:00,15,17,32
"28434",10602,"Corner Brook","NL",48.95224,-57.92207,2018-03-31 10:00:00,32,6,38
"28435",10602,"Corner Brook","NL",48.95224,-57.92207,2018-03-31 11:00:00,40,2,42
"28436",10602,"Corner Brook","NL",48.95224,-57.92207,2018-03-31 12:00:00,42,1,43
"28437",10602,"Corner Brook","NL",48.95224,-57.92207,2018-03-31 13:00:00,42,2,44
"28438",10602,"Corner Brook","NL",48.95224,-57.92207,2018-03-31 14:00:00,41,1,42
"28439",10602,"Corner Brook","NL",48.95224,-57.92207,2018-03-31 15:00:00,38,1,39
"28440",10602,"Corner Brook","NL",48.95224,-57.92207,2018-03-31 16:00:00,39,1,40
"28441",10602,"Corner Brook","NL",48.95224,-57.92207,2018-03-31 17:00:00,35,2,37
"28442",10602,"Corner Brook","NL",48.95224,-57.92207,2018-03-31 18:00:00,36,1,37
"28443",10602,"Corner Brook","NL",48.95224,-57.92207,2018-03-31 19:00:00,37,2,39
"28444",10602,"Corner Brook","NL",48.95224,-57.92207,2018-03-31 20:00:00,38,4,42
"28445",10602,"Corner Brook","NL",48.95224,-57.92207,2018-03-31 21:00:00,43,1,44
"28446",10602,"Corner Brook","NL",48.95224,-57.92207,2018-03-31 22:00:00,45,1,46
"28447",10602,"Corner Brook","NL",48.95224,-57.92207,2018-03-31 23:00:00,45,1,46
"28448",10602,"Corner Brook","NL",48.95224,-57.92207,2018-04-01 00:00:00,41,4,45
"28449",10602,"Corner Brook","NL",48.95224,-57.92207,2018-04-01 01:00:00,43,2,45
"28450",10602,"Corner Brook","NL",48.95224,-57.92207,2018-04-01 02:00:00,43,3,46
"28451",10602,"Corner Brook","NL",48.95224,-57.92207,2018-04-01 03:00:00,42,3,45
"28452",10602,"Corner Brook","NL",48.95224,-57.92207,2018-04-01 04:00:00,41,3,44
"28453",10602,"Corner Brook","NL",48.95224,-57.92207,2018-04-01 05:00:00,43,1,44
"28454",10602,"Corner Brook","NL",48.95224,-57.92207,2018-04-01 06:00:00,42,2,44
"28455",10602,"Corner Brook","NL",48.95224,-57.92207,2018-04-01 07:00:00,41,2,43
"28456",10602,"Corner Brook","NL",48.95224,-57.92207,2018-04-01 08:00:00,42,2,44
"28457",10602,"Corner Brook","NL",48.95224,-57.92207,2018-04-01 09:00:00,42,2,44
"28458",10602,"Corner Brook","NL",48.95224,-57.92207,2018-04-01 10:00:00,41,3,44
"28459",10602,"Corner Brook","NL",48.95224,-57.92207,2018-04-01 11:00:00,43,1,44
"28460",10602,"Corner Brook","NL",48.95224,-57.92207,2018-04-01 12:00:00,43,1,44
"28461",10602,"Corner Brook","NL",48.95224,-57.92207,2018-04-01 13:00:00,44,1,45
"28462",10602,"Corner Brook","NL",48.95224,-57.92207,2018-04-01 14:00:00,45,1,46
"28463",10602,"Corner Brook","NL",48.95224,-57.92207,2018-04-01 15:00:00,46,1,47
"28464",10602,"Corner Brook","NL",48.95224,-57.92207,2018-04-01 16:00:00,46,1,47
"28465",10602,"Corner Brook","NL",48.95224,-57.92207,2018-04-01 17:00:00,47,1,48
"28466",10602,"Corner Brook","NL",48.95224,-57.92207,2018-04-01 18:00:00,47,1,48
"28467",10602,"Corner Brook","NL",48.95224,-57.92207,2018-04-01 19:00:00,47,1,48
"28468",10602,"Corner Brook","NL",48.95224,-57.92207,2018-04-01 20:00:00,45,1,46
"28469",10602,"Corner Brook","NL",48.95224,-57.92207,2018-04-01 21:00:00,44,1,45
"28470",10602,"Corner Brook","NL",48.95224,-57.92207,2018-04-01 22:00:00,43,1,44
"28471",10602,"Corner Brook","NL",48.95224,-57.92207,2018-04-01 23:00:00,42,1,43
"28472",10602,"Corner Brook","NL",48.95224,-57.92207,2018-04-02 00:00:00,43,1,44
"28473",10602,"Corner Brook","NL",48.95224,-57.92207,2018-04-02 01:00:00,44,1,45
"28474",10602,"Corner Brook","NL",48.95224,-57.92207,2018-04-02 02:00:00,45,1,46
"28475",10602,"Corner Brook","NL",48.95224,-57.92207,2018-04-02 03:00:00,45,1,46
"28476",10602,"Corner Brook","NL",48.95224,-57.92207,2018-04-02 04:00:00,42,1,43
"28477",10602,"Corner Brook","NL",48.95224,-57.92207,2018-04-02 05:00:00,40,1,41
"28478",10602,"Corner Brook","NL",48.95224,-57.92207,2018-04-02 06:00:00,40,1,41
"28479",10602,"Corner Brook","NL",48.95224,-57.92207,2018-04-02 07:00:00,39,2,41
"28480",10602,"Corner Brook","NL",48.95224,-57.92207,2018-04-02 08:00:00,38,3,41
"28481",10602,"Corner Brook","NL",48.95224,-57.92207,2018-04-02 09:00:00,39,2,41
"28482",10602,"Corner Brook","NL",48.95224,-57.92207,2018-04-02 10:00:00,40,2,42
"28483",10602,"Corner Brook","NL",48.95224,-57.92207,2018-04-02 11:00:00,36,5,41
"28484",10602,"Corner Brook","NL",48.95224,-57.92207,2018-04-02 12:00:00,37,4,41
"28485",10602,"Corner Brook","NL",48.95224,-57.92207,2018-04-02 13:00:00,40,1,41
"28486",10602,"Corner Brook","NL",48.95224,-57.92207,2018-04-02 14:00:00,40,1,41
"28487",10602,"Corner Brook","NL",48.95224,-57.92207,2018-04-02 15:00:00,39,2,41
"28488",10602,"Corner Brook","NL",48.95224,-57.92207,2018-04-02 16:00:00,37,4,41
"28489",10602,"Corner Brook","NL",48.95224,-57.92207,2018-04-02 17:00:00,37,4,41
"28490",10602,"Corner Brook","NL",48.95224,-57.92207,2018-04-02 18:00:00,37,4,41
"28491",10602,"Corner Brook","NL",48.95224,-57.92207,2018-04-02 19:00:00,37,4,41
"28492",10602,"Corner Brook","NL",48.95224,-57.92207,2018-04-02 20:00:00,39,2,41
"28493",10602,"Corner Brook","NL",48.95224,-57.92207,2018-04-02 21:00:00,38,2,40
"28494",10602,"Corner Brook","NL",48.95224,-57.92207,2018-04-02 22:00:00,39,2,41
"28495",10602,"Corner Brook","NL",48.95224,-57.92207,2018-04-02 23:00:00,39,2,41
"28496",10602,"Corner Brook","NL",48.95224,-57.92207,2018-04-03 00:00:00,40,2,42
"28497",10602,"Corner Brook","NL",48.95224,-57.92207,2018-04-03 01:00:00,40,2,42
"28498",10602,"Corner Brook","NL",48.95224,-57.92207,2018-04-03 02:00:00,39,2,41
"28499",10602,"Corner Brook","NL",48.95224,-57.92207,2018-04-03 03:00:00,39,2,41
"28500",10602,"Corner Brook","NL",48.95224,-57.92207,2018-04-03 04:00:00,39,1,40
"28501",10602,"Corner Brook","NL",48.95224,-57.92207,2018-04-03 05:00:00,38,2,40
"28502",10602,"Corner Brook","NL",48.95224,-57.92207,2018-04-03 06:00:00,39,2,41
"28503",10602,"Corner Brook","NL",48.95224,-57.92207,2018-04-03 07:00:00,38,3,41
"28504",10602,"Corner Brook","NL",48.95224,-57.92207,2018-04-03 08:00:00,38,4,42
"28505",10602,"Corner Brook","NL",48.95224,-57.92207,2018-04-03 09:00:00,38,4,42
"28506",10602,"Corner Brook","NL",48.95224,-57.92207,2018-04-03 10:00:00,41,1,42
"28507",10602,"Corner Brook","NL",48.95224,-57.92207,2018-04-03 11:00:00,41,2,43
"28508",10602,"Corner Brook","NL",48.95224,-57.92207,2018-04-03 12:00:00,39,4,43
"28509",10602,"Corner Brook","NL",48.95224,-57.92207,2018-04-03 13:00:00,41,2,43
"28510",10602,"Corner Brook","NL",48.95224,-57.92207,2018-04-03 14:00:00,41,1,42
"28511",10602,"Corner Brook","NL",48.95224,-57.92207,2018-04-03 15:00:00,41,1,42
"28512",10602,"Corner Brook","NL",48.95224,-57.92207,2018-04-03 16:00:00,41,1,42
"28513",10602,"Corner Brook","NL",48.95224,-57.92207,2018-04-03 17:00:00,41,1,42
"28514",10602,"Corner Brook","NL",48.95224,-57.92207,2018-04-03 18:00:00,41,1,42
"28515",10602,"Corner Brook","NL",48.95224,-57.92207,2018-04-03 19:00:00,41,2,43
"28516",10602,"Corner Brook","NL",48.95224,-57.92207,2018-04-03 20:00:00,38,4,42
"28517",10602,"Corner Brook","NL",48.95224,-57.92207,2018-04-03 21:00:00,40,2,42
"28518",10602,"Corner Brook","NL",48.95224,-57.92207,2018-04-03 22:00:00,41,1,42
"28519",10602,"Corner Brook","NL",48.95224,-57.92207,2018-04-03 23:00:00,40,2,42
"28520",10602,"Corner Brook","NL",48.95224,-57.92207,2018-04-04 00:00:00,40,2,42
"28521",10602,"Corner Brook","NL",48.95224,-57.92207,2018-04-04 01:00:00,40,1,41
"28522",10602,"Corner Brook","NL",48.95224,-57.92207,2018-04-04 02:00:00,36,3,39
"28523",10602,"Corner Brook","NL",48.95224,-57.92207,2018-04-04 03:00:00,37,3,40
"28524",10602,"Corner Brook","NL",48.95224,-57.92207,2018-04-04 04:00:00,40,2,42
"28525",10602,"Corner Brook","NL",48.95224,-57.92207,2018-04-04 05:00:00,41,2,43
"28526",10602,"Corner Brook","NL",48.95224,-57.92207,2018-04-04 06:00:00,40,2,42
"28527",10602,"Corner Brook","NL",48.95224,-57.92207,2018-04-04 07:00:00,40,3,43
"28528",10602,"Corner Brook","NL",48.95224,-57.92207,2018-04-04 08:00:00,40,3,43
"28529",10602,"Corner Brook","NL",48.95224,-57.92207,2018-04-04 09:00:00,40,2,42
"28530",10602,"Corner Brook","NL",48.95224,-57.92207,2018-04-04 10:00:00,40,3,43
"28531",10602,"Corner Brook","NL",48.95224,-57.92207,2018-04-04 11:00:00,42,2,44
"28532",10602,"Corner Brook","NL",48.95224,-57.92207,2018-04-04 12:00:00,44,1,45
"28533",10602,"Corner Brook","NL",48.95224,-57.92207,2018-04-04 13:00:00,43,1,44
"28534",10602,"Corner Brook","NL",48.95224,-57.92207,2018-04-04 14:00:00,44,1,45
"28535",10602,"Corner Brook","NL",48.95224,-57.92207,2018-04-04 15:00:00,43,1,44
"28536",10602,"Corner Brook","NL",48.95224,-57.92207,2018-04-04 16:00:00,43,2,45
"28537",10602,"Corner Brook","NL",48.95224,-57.92207,2018-04-04 17:00:00,43,2,45
"28538",10602,"Corner Brook","NL",48.95224,-57.92207,2018-04-04 18:00:00,43,2,45
"28539",10602,"Corner Brook","NL",48.95224,-57.92207,2018-04-04 19:00:00,44,2,46
"28540",10602,"Corner Brook","NL",48.95224,-57.92207,2018-04-04 20:00:00,43,2,45
"28541",10602,"Corner Brook","NL",48.95224,-57.92207,2018-04-04 21:00:00,46,1,47
"28542",10602,"Corner Brook","NL",48.95224,-57.92207,2018-04-04 22:00:00,47,1,48
"28543",10602,"Corner Brook","NL",48.95224,-57.92207,2018-04-04 23:00:00,48,1,49
"28544",10602,"Corner Brook","NL",48.95224,-57.92207,2018-04-05 00:00:00,48,1,49
"28545",10602,"Corner Brook","NL",48.95224,-57.92207,2018-04-05 01:00:00,48,1,49
"28546",10602,"Corner Brook","NL",48.95224,-57.92207,2018-04-05 02:00:00,47,1,48
"28547",10602,"Corner Brook","NL",48.95224,-57.92207,2018-04-05 03:00:00,44,2,46
"28548",10602,"Corner Brook","NL",48.95224,-57.92207,2018-04-05 04:00:00,42,2,44
"28549",10602,"Corner Brook","NL",48.95224,-57.92207,2018-04-05 05:00:00,36,5,41
"28550",10602,"Corner Brook","NL",48.95224,-57.92207,2018-04-05 06:00:00,37,3,40
"28551",10602,"Corner Brook","NL",48.95224,-57.92207,2018-04-05 07:00:00,33,1,34
"28552",10602,"Corner Brook","NL",48.95224,-57.92207,2018-04-05 08:00:00,29,2,31
"28553",10602,"Corner Brook","NL",48.95224,-57.92207,2018-04-05 09:00:00,23,7,30
"28554",10602,"Corner Brook","NL",48.95224,-57.92207,2018-04-05 10:00:00,36,1,37
"28555",10602,"Corner Brook","NL",48.95224,-57.92207,2018-04-05 11:00:00,39,1,40
"28556",10602,"Corner Brook","NL",48.95224,-57.92207,2018-04-05 12:00:00,42,1,43
"28557",10602,"Corner Brook","NL",48.95224,-57.92207,2018-04-05 13:00:00,NA,4,NA
"28558",10602,"Corner Brook","NL",48.95224,-57.92207,2018-04-05 14:00:00,NA,8,NA
"28559",10602,"Corner Brook","NL",48.95224,-57.92207,2018-04-05 15:00:00,NA,2,NA
"28560",10602,"Corner Brook","NL",48.95224,-57.92207,2018-04-05 16:00:00,39,1,40
"28561",10602,"Corner Brook","NL",48.95224,-57.92207,2018-04-05 17:00:00,38,1,39
"28562",10602,"Corner Brook","NL",48.95224,-57.92207,2018-04-05 18:00:00,38,1,39
"28563",10602,"Corner Brook","NL",48.95224,-57.92207,2018-04-05 19:00:00,37,1,38
"28564",10602,"Corner Brook","NL",48.95224,-57.92207,2018-04-05 20:00:00,37,1,38
"28565",10602,"Corner Brook","NL",48.95224,-57.92207,2018-04-05 21:00:00,37,1,38
"28566",10602,"Corner Brook","NL",48.95224,-57.92207,2018-04-05 22:00:00,38,1,39
"28567",10602,"Corner Brook","NL",48.95224,-57.92207,2018-04-05 23:00:00,38,1,39
"28568",10602,"Corner Brook","NL",48.95224,-57.92207,2018-04-06 00:00:00,38,2,40
"28569",10602,"Corner Brook","NL",48.95224,-57.92207,2018-04-06 01:00:00,38,1,39
"28570",10602,"Corner Brook","NL",48.95224,-57.92207,2018-04-06 02:00:00,38,1,39
"28571",10602,"Corner Brook","NL",48.95224,-57.92207,2018-04-06 03:00:00,38,1,39
"28572",10602,"Corner Brook","NL",48.95224,-57.92207,2018-04-06 04:00:00,38,1,39
"28573",10602,"Corner Brook","NL",48.95224,-57.92207,2018-04-06 05:00:00,38,1,39
"28574",10602,"Corner Brook","NL",48.95224,-57.92207,2018-04-06 06:00:00,37,1,38
"28575",10602,"Corner Brook","NL",48.95224,-57.92207,2018-04-06 07:00:00,36,1,37
"28576",10602,"Corner Brook","NL",48.95224,-57.92207,2018-04-06 08:00:00,36,2,38
"28577",10602,"Corner Brook","NL",48.95224,-57.92207,2018-04-06 09:00:00,37,2,39
"28578",10602,"Corner Brook","NL",48.95224,-57.92207,2018-04-06 10:00:00,38,2,40
"28579",10602,"Corner Brook","NL",48.95224,-57.92207,2018-04-06 11:00:00,38,1,39
"28580",10602,"Corner Brook","NL",48.95224,-57.92207,2018-04-06 12:00:00,38,3,41
"28581",10602,"Corner Brook","NL",48.95224,-57.92207,2018-04-06 13:00:00,39,1,40
"28582",10602,"Corner Brook","NL",48.95224,-57.92207,2018-04-06 14:00:00,41,1,42
"28583",10602,"Corner Brook","NL",48.95224,-57.92207,2018-04-06 15:00:00,40,1,41
"28584",10602,"Corner Brook","NL",48.95224,-57.92207,2018-04-06 16:00:00,41,1,42
"28585",10602,"Corner Brook","NL",48.95224,-57.92207,2018-04-06 17:00:00,40,1,41
"28586",10602,"Corner Brook","NL",48.95224,-57.92207,2018-04-06 18:00:00,40,1,41
"28587",10602,"Corner Brook","NL",48.95224,-57.92207,2018-04-06 19:00:00,40,1,41
"28588",10602,"Corner Brook","NL",48.95224,-57.92207,2018-04-06 20:00:00,43,1,44
"28589",10602,"Corner Brook","NL",48.95224,-57.92207,2018-04-06 21:00:00,43,1,44
"28590",10602,"Corner Brook","NL",48.95224,-57.92207,2018-04-06 22:00:00,41,1,42
"28591",10602,"Corner Brook","NL",48.95224,-57.92207,2018-04-06 23:00:00,40,1,41
"28592",10602,"Corner Brook","NL",48.95224,-57.92207,2018-04-07 00:00:00,41,2,43
"28593",10602,"Corner Brook","NL",48.95224,-57.92207,2018-04-07 01:00:00,41,1,42
"28594",10602,"Corner Brook","NL",48.95224,-57.92207,2018-04-07 02:00:00,41,0,41
"28595",10602,"Corner Brook","NL",48.95224,-57.92207,2018-04-07 03:00:00,41,1,42
"28596",10602,"Corner Brook","NL",48.95224,-57.92207,2018-04-07 04:00:00,41,1,42
"28597",10602,"Corner Brook","NL",48.95224,-57.92207,2018-04-07 05:00:00,40,1,41
"28598",10602,"Corner Brook","NL",48.95224,-57.92207,2018-04-07 06:00:00,38,2,40
"28599",10602,"Corner Brook","NL",48.95224,-57.92207,2018-04-07 07:00:00,33,6,39
"28600",10602,"Corner Brook","NL",48.95224,-57.92207,2018-04-07 08:00:00,36,5,41
"28601",10602,"Corner Brook","NL",48.95224,-57.92207,2018-04-07 09:00:00,42,2,44
"28602",10602,"Corner Brook","NL",48.95224,-57.92207,2018-04-07 10:00:00,42,2,44
"28603",10602,"Corner Brook","NL",48.95224,-57.92207,2018-04-07 11:00:00,42,2,44
"28604",10602,"Corner Brook","NL",48.95224,-57.92207,2018-04-07 12:00:00,42,4,46
"28605",10602,"Corner Brook","NL",48.95224,-57.92207,2018-04-07 13:00:00,43,2,45
"28606",10602,"Corner Brook","NL",48.95224,-57.92207,2018-04-07 14:00:00,44,2,46
"28607",10602,"Corner Brook","NL",48.95224,-57.92207,2018-04-07 15:00:00,42,2,44
"28608",10602,"Corner Brook","NL",48.95224,-57.92207,2018-04-07 16:00:00,41,3,44
"28609",10602,"Corner Brook","NL",48.95224,-57.92207,2018-04-07 17:00:00,42,2,44
"28610",10602,"Corner Brook","NL",48.95224,-57.92207,2018-04-07 18:00:00,40,2,42
"28611",10602,"Corner Brook","NL",48.95224,-57.92207,2018-04-07 19:00:00,40,2,42
"28612",10602,"Corner Brook","NL",48.95224,-57.92207,2018-04-07 20:00:00,38,4,42
"28613",10602,"Corner Brook","NL",48.95224,-57.92207,2018-04-07 21:00:00,37,4,41
"28614",10602,"Corner Brook","NL",48.95224,-57.92207,2018-04-07 22:00:00,35,4,39
"28615",10602,"Corner Brook","NL",48.95224,-57.92207,2018-04-07 23:00:00,40,2,42
"28616",10602,"Corner Brook","NL",48.95224,-57.92207,2018-04-08 00:00:00,37,6,43
"28617",10602,"Corner Brook","NL",48.95224,-57.92207,2018-04-08 01:00:00,38,3,41
"28618",10602,"Corner Brook","NL",48.95224,-57.92207,2018-04-08 02:00:00,38,3,41
"28619",10602,"Corner Brook","NL",48.95224,-57.92207,2018-04-08 03:00:00,41,2,43
"28620",10602,"Corner Brook","NL",48.95224,-57.92207,2018-04-08 04:00:00,41,2,43
"28621",10602,"Corner Brook","NL",48.95224,-57.92207,2018-04-08 05:00:00,42,2,44
"28622",10602,"Corner Brook","NL",48.95224,-57.92207,2018-04-08 06:00:00,40,2,42
"28623",10602,"Corner Brook","NL",48.95224,-57.92207,2018-04-08 07:00:00,39,2,41
"28624",10602,"Corner Brook","NL",48.95224,-57.92207,2018-04-08 08:00:00,39,3,42
"28625",10602,"Corner Brook","NL",48.95224,-57.92207,2018-04-08 09:00:00,38,3,41
"28626",10602,"Corner Brook","NL",48.95224,-57.92207,2018-04-08 10:00:00,36,2,38
"28627",10602,"Corner Brook","NL",48.95224,-57.92207,2018-04-08 11:00:00,41,1,42
"28628",10602,"Corner Brook","NL",48.95224,-57.92207,2018-04-08 12:00:00,43,4,47
"28629",10602,"Corner Brook","NL",48.95224,-57.92207,2018-04-08 13:00:00,45,1,46
"28630",10602,"Corner Brook","NL",48.95224,-57.92207,2018-04-08 14:00:00,43,1,44
"28631",10602,"Corner Brook","NL",48.95224,-57.92207,2018-04-08 15:00:00,42,1,43
"28632",10602,"Corner Brook","NL",48.95224,-57.92207,2018-04-08 16:00:00,43,1,44
"28633",10602,"Corner Brook","NL",48.95224,-57.92207,2018-04-08 17:00:00,43,1,44
"28634",10602,"Corner Brook","NL",48.95224,-57.92207,2018-04-08 18:00:00,42,2,44
"28635",10602,"Corner Brook","NL",48.95224,-57.92207,2018-04-08 19:00:00,41,2,43
"28636",10602,"Corner Brook","NL",48.95224,-57.92207,2018-04-08 20:00:00,41,2,43
"28637",10602,"Corner Brook","NL",48.95224,-57.92207,2018-04-08 21:00:00,40,1,41
"28638",10602,"Corner Brook","NL",48.95224,-57.92207,2018-04-08 22:00:00,40,1,41
"28639",10602,"Corner Brook","NL",48.95224,-57.92207,2018-04-08 23:00:00,39,1,40
"28640",10602,"Corner Brook","NL",48.95224,-57.92207,2018-04-09 00:00:00,40,5,45
"28641",10602,"Corner Brook","NL",48.95224,-57.92207,2018-04-09 01:00:00,42,1,43
"28642",10602,"Corner Brook","NL",48.95224,-57.92207,2018-04-09 02:00:00,44,1,45
"28643",10602,"Corner Brook","NL",48.95224,-57.92207,2018-04-09 03:00:00,45,1,46
"28644",10602,"Corner Brook","NL",48.95224,-57.92207,2018-04-09 04:00:00,45,1,46
"28645",10602,"Corner Brook","NL",48.95224,-57.92207,2018-04-09 05:00:00,45,2,47
"28646",10602,"Corner Brook","NL",48.95224,-57.92207,2018-04-09 06:00:00,44,2,46
"28647",10602,"Corner Brook","NL",48.95224,-57.92207,2018-04-09 07:00:00,43,2,45
"28648",10602,"Corner Brook","NL",48.95224,-57.92207,2018-04-09 08:00:00,43,2,45
"28649",10602,"Corner Brook","NL",48.95224,-57.92207,2018-04-09 09:00:00,42,3,45
"28650",10602,"Corner Brook","NL",48.95224,-57.92207,2018-04-09 10:00:00,42,2,44
"28651",10602,"Corner Brook","NL",48.95224,-57.92207,2018-04-09 11:00:00,42,2,44
"28652",10602,"Corner Brook","NL",48.95224,-57.92207,2018-04-09 12:00:00,42,5,47
"28653",10602,"Corner Brook","NL",48.95224,-57.92207,2018-04-09 13:00:00,42,1,43
"28654",10602,"Corner Brook","NL",48.95224,-57.92207,2018-04-09 14:00:00,42,1,43
"28655",10602,"Corner Brook","NL",48.95224,-57.92207,2018-04-09 15:00:00,39,4,43
"28656",10602,"Corner Brook","NL",48.95224,-57.92207,2018-04-09 16:00:00,39,5,44
"28657",10602,"Corner Brook","NL",48.95224,-57.92207,2018-04-09 17:00:00,40,4,44
"28658",10602,"Corner Brook","NL",48.95224,-57.92207,2018-04-09 18:00:00,39,5,44
"28659",10602,"Corner Brook","NL",48.95224,-57.92207,2018-04-09 19:00:00,40,2,42
"28660",10602,"Corner Brook","NL",48.95224,-57.92207,2018-04-09 20:00:00,38,3,41
"28661",10602,"Corner Brook","NL",48.95224,-57.92207,2018-04-09 21:00:00,39,4,43
"28662",10602,"Corner Brook","NL",48.95224,-57.92207,2018-04-09 22:00:00,41,2,43
"28663",10602,"Corner Brook","NL",48.95224,-57.92207,2018-04-09 23:00:00,41,2,43
"28664",10602,"Corner Brook","NL",48.95224,-57.92207,2018-04-10 00:00:00,39,6,45
"28665",10602,"Corner Brook","NL",48.95224,-57.92207,2018-04-10 01:00:00,40,2,42
"28666",10602,"Corner Brook","NL",48.95224,-57.92207,2018-04-10 02:00:00,39,3,42
"28667",10602,"Corner Brook","NL",48.95224,-57.92207,2018-04-10 03:00:00,37,3,40
"28668",10602,"Corner Brook","NL",48.95224,-57.92207,2018-04-10 04:00:00,36,3,39
"28669",10602,"Corner Brook","NL",48.95224,-57.92207,2018-04-10 05:00:00,35,4,39
"28670",10602,"Corner Brook","NL",48.95224,-57.92207,2018-04-10 06:00:00,35,5,40
"28671",10602,"Corner Brook","NL",48.95224,-57.92207,2018-04-10 07:00:00,37,4,41
"28672",10602,"Corner Brook","NL",48.95224,-57.92207,2018-04-10 08:00:00,38,3,41
"28673",10602,"Corner Brook","NL",48.95224,-57.92207,2018-04-10 09:00:00,36,4,40
"28674",10602,"Corner Brook","NL",48.95224,-57.92207,2018-04-10 10:00:00,38,3,41
"28675",10602,"Corner Brook","NL",48.95224,-57.92207,2018-04-10 11:00:00,40,2,42
"28676",10602,"Corner Brook","NL",48.95224,-57.92207,2018-04-10 12:00:00,41,6,47
"28677",10602,"Corner Brook","NL",48.95224,-57.92207,2018-04-10 13:00:00,40,4,44
"28678",10602,"Corner Brook","NL",48.95224,-57.92207,2018-04-10 14:00:00,41,NA,NA
"28679",10602,"Corner Brook","NL",48.95224,-57.92207,2018-04-10 15:00:00,42,NA,NA
"28680",10602,"Corner Brook","NL",48.95224,-57.92207,2018-04-10 16:00:00,44,NA,NA
"28681",10602,"Corner Brook","NL",48.95224,-57.92207,2018-04-10 17:00:00,43,2,45
"28682",10602,"Corner Brook","NL",48.95224,-57.92207,2018-04-10 18:00:00,41,4,45
"28683",10602,"Corner Brook","NL",48.95224,-57.92207,2018-04-10 19:00:00,42,3,45
"28684",10602,"Corner Brook","NL",48.95224,-57.92207,2018-04-10 20:00:00,41,2,43
"28685",10602,"Corner Brook","NL",48.95224,-57.92207,2018-04-10 21:00:00,40,4,44
"28686",10602,"Corner Brook","NL",48.95224,-57.92207,2018-04-10 22:00:00,40,3,43
"28687",10602,"Corner Brook","NL",48.95224,-57.92207,2018-04-10 23:00:00,40,2,42
"28688",10602,"Corner Brook","NL",48.95224,-57.92207,2018-04-11 00:00:00,40,7,47
"28689",10602,"Corner Brook","NL",48.95224,-57.92207,2018-04-11 01:00:00,40,3,43
"28690",10602,"Corner Brook","NL",48.95224,-57.92207,2018-04-11 02:00:00,39,2,41
"28691",10602,"Corner Brook","NL",48.95224,-57.92207,2018-04-11 03:00:00,37,2,39
"28692",10602,"Corner Brook","NL",48.95224,-57.92207,2018-04-11 04:00:00,35,2,37
"28693",10602,"Corner Brook","NL",48.95224,-57.92207,2018-04-11 05:00:00,34,3,37
"28694",10602,"Corner Brook","NL",48.95224,-57.92207,2018-04-11 06:00:00,35,2,37
"28695",10602,"Corner Brook","NL",48.95224,-57.92207,2018-04-11 07:00:00,33,3,36
"28696",10602,"Corner Brook","NL",48.95224,-57.92207,2018-04-11 08:00:00,33,4,37
"28697",10602,"Corner Brook","NL",48.95224,-57.92207,2018-04-11 09:00:00,35,2,37
"28698",10602,"Corner Brook","NL",48.95224,-57.92207,2018-04-11 10:00:00,35,4,39
"28699",10602,"Corner Brook","NL",48.95224,-57.92207,2018-04-11 11:00:00,38,2,40
"28700",10602,"Corner Brook","NL",48.95224,-57.92207,2018-04-11 12:00:00,37,7,44
"28701",10602,"Corner Brook","NL",48.95224,-57.92207,2018-04-11 13:00:00,37,7,44
"28702",10602,"Corner Brook","NL",48.95224,-57.92207,2018-04-11 14:00:00,38,4,42
"28703",10602,"Corner Brook","NL",48.95224,-57.92207,2018-04-11 15:00:00,38,3,41
"28704",10602,"Corner Brook","NL",48.95224,-57.92207,2018-04-11 16:00:00,39,3,42
"28705",10602,"Corner Brook","NL",48.95224,-57.92207,2018-04-11 17:00:00,39,4,43
"28706",10602,"Corner Brook","NL",48.95224,-57.92207,2018-04-11 18:00:00,39,2,41
"28707",10602,"Corner Brook","NL",48.95224,-57.92207,2018-04-11 19:00:00,39,2,41
"28708",10602,"Corner Brook","NL",48.95224,-57.92207,2018-04-11 20:00:00,34,5,39
"28709",10602,"Corner Brook","NL",48.95224,-57.92207,2018-04-11 21:00:00,29,8,37
"28710",10602,"Corner Brook","NL",48.95224,-57.92207,2018-04-11 22:00:00,31,7,38
"28711",10602,"Corner Brook","NL",48.95224,-57.92207,2018-04-11 23:00:00,31,6,37
"28712",10602,"Corner Brook","NL",48.95224,-57.92207,2018-04-12 00:00:00,31,8,39
"28713",10602,"Corner Brook","NL",48.95224,-57.92207,2018-04-12 01:00:00,30,5,35
"28714",10602,"Corner Brook","NL",48.95224,-57.92207,2018-04-12 02:00:00,29,6,35
"28715",10602,"Corner Brook","NL",48.95224,-57.92207,2018-04-12 03:00:00,26,9,35
"28716",10602,"Corner Brook","NL",48.95224,-57.92207,2018-04-12 04:00:00,27,8,35
"28717",10602,"Corner Brook","NL",48.95224,-57.92207,2018-04-12 05:00:00,26,8,34
"28718",10602,"Corner Brook","NL",48.95224,-57.92207,2018-04-12 06:00:00,22,11,33
"28719",10602,"Corner Brook","NL",48.95224,-57.92207,2018-04-12 07:00:00,18,17,35
"28720",10602,"Corner Brook","NL",48.95224,-57.92207,2018-04-12 08:00:00,21,18,39
"28721",10602,"Corner Brook","NL",48.95224,-57.92207,2018-04-12 09:00:00,27,14,41
"28722",10602,"Corner Brook","NL",48.95224,-57.92207,2018-04-12 10:00:00,32,10,42
"28723",10602,"Corner Brook","NL",48.95224,-57.92207,2018-04-12 11:00:00,33,21,54
"28724",10602,"Corner Brook","NL",48.95224,-57.92207,2018-04-12 12:00:00,41,10,51
"28725",10602,"Corner Brook","NL",48.95224,-57.92207,2018-04-12 13:00:00,44,2,46
"28726",10602,"Corner Brook","NL",48.95224,-57.92207,2018-04-12 14:00:00,45,NA,NA
"28727",10602,"Corner Brook","NL",48.95224,-57.92207,2018-04-12 15:00:00,46,NA,NA
"28728",10602,"Corner Brook","NL",48.95224,-57.92207,2018-04-12 16:00:00,45,2,47
"28729",10602,"Corner Brook","NL",48.95224,-57.92207,2018-04-12 17:00:00,38,11,49
"28730",10602,"Corner Brook","NL",48.95224,-57.92207,2018-04-12 18:00:00,38,8,46
"28731",10602,"Corner Brook","NL",48.95224,-57.92207,2018-04-12 19:00:00,41,6,47
"28732",10602,"Corner Brook","NL",48.95224,-57.92207,2018-04-12 20:00:00,40,4,44
"28733",10602,"Corner Brook","NL",48.95224,-57.92207,2018-04-12 21:00:00,37,7,44
"28734",10602,"Corner Brook","NL",48.95224,-57.92207,2018-04-12 22:00:00,36,6,42
"28735",10602,"Corner Brook","NL",48.95224,-57.92207,2018-04-12 23:00:00,40,3,43
"28736",10602,"Corner Brook","NL",48.95224,-57.92207,2018-04-13 00:00:00,40,6,46
"28737",10602,"Corner Brook","NL",48.95224,-57.92207,2018-04-13 01:00:00,40,2,42
"28738",10602,"Corner Brook","NL",48.95224,-57.92207,2018-04-13 02:00:00,41,2,43
"28739",10602,"Corner Brook","NL",48.95224,-57.92207,2018-04-13 03:00:00,42,2,44
"28740",10602,"Corner Brook","NL",48.95224,-57.92207,2018-04-13 04:00:00,41,2,43
"28741",10602,"Corner Brook","NL",48.95224,-57.92207,2018-04-13 05:00:00,41,2,43
"28742",10602,"Corner Brook","NL",48.95224,-57.92207,2018-04-13 06:00:00,35,6,41
"28743",10602,"Corner Brook","NL",48.95224,-57.92207,2018-04-13 07:00:00,36,7,43
"28744",10602,"Corner Brook","NL",48.95224,-57.92207,2018-04-13 08:00:00,28,14,42
"28745",10602,"Corner Brook","NL",48.95224,-57.92207,2018-04-13 09:00:00,30,11,41
"28746",10602,"Corner Brook","NL",48.95224,-57.92207,2018-04-13 10:00:00,38,6,44
"28747",10602,"Corner Brook","NL",48.95224,-57.92207,2018-04-13 11:00:00,42,2,44
"28748",10602,"Corner Brook","NL",48.95224,-57.92207,2018-04-13 12:00:00,43,6,49
"28749",10602,"Corner Brook","NL",48.95224,-57.92207,2018-04-13 13:00:00,45,1,46
"28750",10602,"Corner Brook","NL",48.95224,-57.92207,2018-04-13 14:00:00,45,1,46
"28751",10602,"Corner Brook","NL",48.95224,-57.92207,2018-04-13 15:00:00,44,2,46
"28752",10602,"Corner Brook","NL",48.95224,-57.92207,2018-04-13 16:00:00,43,3,46
"28753",10602,"Corner Brook","NL",48.95224,-57.92207,2018-04-13 17:00:00,44,2,46
"28754",10602,"Corner Brook","NL",48.95224,-57.92207,2018-04-13 18:00:00,44,2,46
"28755",10602,"Corner Brook","NL",48.95224,-57.92207,2018-04-13 19:00:00,44,2,46
"28756",10602,"Corner Brook","NL",48.95224,-57.92207,2018-04-13 20:00:00,44,2,46
"28757",10602,"Corner Brook","NL",48.95224,-57.92207,2018-04-13 21:00:00,43,2,45
"28758",10602,"Corner Brook","NL",48.95224,-57.92207,2018-04-13 22:00:00,43,2,45
"28759",10602,"Corner Brook","NL",48.95224,-57.92207,2018-04-13 23:00:00,42,2,44
"28760",10602,"Corner Brook","NL",48.95224,-57.92207,2018-04-14 00:00:00,39,7,46
"28761",10602,"Corner Brook","NL",48.95224,-57.92207,2018-04-14 01:00:00,36,4,40
"28762",10602,"Corner Brook","NL",48.95224,-57.92207,2018-04-14 02:00:00,37,4,41
"28763",10602,"Corner Brook","NL",48.95224,-57.92207,2018-04-14 03:00:00,43,4,47
"28764",10602,"Corner Brook","NL",48.95224,-57.92207,2018-04-14 04:00:00,46,1,47
"28765",10602,"Corner Brook","NL",48.95224,-57.92207,2018-04-14 05:00:00,47,1,48
"28766",10602,"Corner Brook","NL",48.95224,-57.92207,2018-04-14 06:00:00,45,2,47
"28767",10602,"Corner Brook","NL",48.95224,-57.92207,2018-04-14 07:00:00,47,1,48
"28768",10602,"Corner Brook","NL",48.95224,-57.92207,2018-04-14 08:00:00,49,1,50
"28769",10602,"Corner Brook","NL",48.95224,-57.92207,2018-04-14 09:00:00,49,1,50
"28770",10602,"Corner Brook","NL",48.95224,-57.92207,2018-04-14 10:00:00,48,2,50
"28771",10602,"Corner Brook","NL",48.95224,-57.92207,2018-04-14 11:00:00,47,1,48
"28772",10602,"Corner Brook","NL",48.95224,-57.92207,2018-04-14 12:00:00,46,7,53
"28773",10602,"Corner Brook","NL",48.95224,-57.92207,2018-04-14 13:00:00,44,3,47
"28774",10602,"Corner Brook","NL",48.95224,-57.92207,2018-04-14 14:00:00,43,3,46
"28775",10602,"Corner Brook","NL",48.95224,-57.92207,2018-04-14 15:00:00,40,6,46
"28776",10602,"Corner Brook","NL",48.95224,-57.92207,2018-04-14 16:00:00,43,3,46
"28777",10602,"Corner Brook","NL",48.95224,-57.92207,2018-04-14 17:00:00,40,2,42
"28778",10602,"Corner Brook","NL",48.95224,-57.92207,2018-04-14 18:00:00,38,5,43
"28779",10602,"Corner Brook","NL",48.95224,-57.92207,2018-04-14 19:00:00,38,2,40
"28780",10602,"Corner Brook","NL",48.95224,-57.92207,2018-04-14 20:00:00,37,2,39
"28781",10602,"Corner Brook","NL",48.95224,-57.92207,2018-04-14 21:00:00,40,2,42
"28782",10602,"Corner Brook","NL",48.95224,-57.92207,2018-04-14 22:00:00,40,2,42
"28783",10602,"Corner Brook","NL",48.95224,-57.92207,2018-04-14 23:00:00,40,2,42
"28784",10602,"Corner Brook","NL",48.95224,-57.92207,2018-04-15 00:00:00,40,5,45
"28785",10602,"Corner Brook","NL",48.95224,-57.92207,2018-04-15 01:00:00,40,1,41
"28786",10602,"Corner Brook","NL",48.95224,-57.92207,2018-04-15 02:00:00,38,2,40
"28787",10602,"Corner Brook","NL",48.95224,-57.92207,2018-04-15 03:00:00,40,1,41
"28788",10602,"Corner Brook","NL",48.95224,-57.92207,2018-04-15 04:00:00,39,1,40
"28789",10602,"Corner Brook","NL",48.95224,-57.92207,2018-04-15 05:00:00,39,2,41
"28790",10602,"Corner Brook","NL",48.95224,-57.92207,2018-04-15 06:00:00,38,2,40
"28791",10602,"Corner Brook","NL",48.95224,-57.92207,2018-04-15 07:00:00,35,2,37
"28792",10602,"Corner Brook","NL",48.95224,-57.92207,2018-04-15 08:00:00,33,2,35
"28793",10602,"Corner Brook","NL",48.95224,-57.92207,2018-04-15 09:00:00,31,1,32
"28794",10602,"Corner Brook","NL",48.95224,-57.92207,2018-04-15 10:00:00,29,2,31
"28795",10602,"Corner Brook","NL",48.95224,-57.92207,2018-04-15 11:00:00,28,1,29
"28796",10602,"Corner Brook","NL",48.95224,-57.92207,2018-04-15 12:00:00,26,4,30
"28797",10602,"Corner Brook","NL",48.95224,-57.92207,2018-04-15 13:00:00,25,2,27
"28798",10602,"Corner Brook","NL",48.95224,-57.92207,2018-04-15 14:00:00,25,1,26
"28799",10602,"Corner Brook","NL",48.95224,-57.92207,2018-04-15 15:00:00,25,1,26
"28800",10602,"Corner Brook","NL",48.95224,-57.92207,2018-04-15 16:00:00,24,2,26
"28801",10602,"Corner Brook","NL",48.95224,-57.92207,2018-04-15 17:00:00,23,3,26
"28802",10602,"Corner Brook","NL",48.95224,-57.92207,2018-04-15 18:00:00,23,4,27
"28803",10602,"Corner Brook","NL",48.95224,-57.92207,2018-04-15 19:00:00,25,3,28
"28804",10602,"Corner Brook","NL",48.95224,-57.92207,2018-04-15 20:00:00,24,4,28
"28805",10602,"Corner Brook","NL",48.95224,-57.92207,2018-04-15 21:00:00,22,5,27
"28806",10602,"Corner Brook","NL",48.95224,-57.92207,2018-04-15 22:00:00,25,2,27
"28807",10602,"Corner Brook","NL",48.95224,-57.92207,2018-04-15 23:00:00,26,1,27
"28808",10602,"Corner Brook","NL",48.95224,-57.92207,2018-04-16 00:00:00,26,4,30
"28809",10602,"Corner Brook","NL",48.95224,-57.92207,2018-04-16 01:00:00,26,1,27
"28810",10602,"Corner Brook","NL",48.95224,-57.92207,2018-04-16 02:00:00,27,1,28
"28811",10602,"Corner Brook","NL",48.95224,-57.92207,2018-04-16 03:00:00,27,1,28
"28812",10602,"Corner Brook","NL",48.95224,-57.92207,2018-04-16 04:00:00,28,1,29
"28813",10602,"Corner Brook","NL",48.95224,-57.92207,2018-04-16 05:00:00,21,7,28
"28814",10602,"Corner Brook","NL",48.95224,-57.92207,2018-04-16 06:00:00,28,4,32
"28815",10602,"Corner Brook","NL",48.95224,-57.92207,2018-04-16 07:00:00,30,7,37
"28816",10602,"Corner Brook","NL",48.95224,-57.92207,2018-04-16 08:00:00,35,6,41
"28817",10602,"Corner Brook","NL",48.95224,-57.92207,2018-04-16 09:00:00,41,1,42
"28818",10602,"Corner Brook","NL",48.95224,-57.92207,2018-04-16 10:00:00,41,2,43
"28819",10602,"Corner Brook","NL",48.95224,-57.92207,2018-04-16 11:00:00,40,3,43
"28820",10602,"Corner Brook","NL",48.95224,-57.92207,2018-04-16 12:00:00,37,12,49
"28821",10602,"Corner Brook","NL",48.95224,-57.92207,2018-04-16 13:00:00,39,NA,NA
"28822",10602,"Corner Brook","NL",48.95224,-57.92207,2018-04-16 14:00:00,44,NA,NA
"28823",10602,"Corner Brook","NL",48.95224,-57.92207,2018-04-16 15:00:00,44,3,47
"28824",10602,"Corner Brook","NL",48.95224,-57.92207,2018-04-16 16:00:00,44,1,45
"28825",10602,"Corner Brook","NL",48.95224,-57.92207,2018-04-16 17:00:00,44,1,45
"28826",10602,"Corner Brook","NL",48.95224,-57.92207,2018-04-16 18:00:00,42,4,46
"28827",10602,"Corner Brook","NL",48.95224,-57.92207,2018-04-16 19:00:00,44,2,46
"28828",10602,"Corner Brook","NL",48.95224,-57.92207,2018-04-16 20:00:00,41,3,44
"28829",10602,"Corner Brook","NL",48.95224,-57.92207,2018-04-16 21:00:00,40,4,44
"28830",10602,"Corner Brook","NL",48.95224,-57.92207,2018-04-16 22:00:00,41,3,44
"28831",10602,"Corner Brook","NL",48.95224,-57.92207,2018-04-16 23:00:00,43,3,46
"28832",10602,"Corner Brook","NL",48.95224,-57.92207,2018-04-17 00:00:00,43,7,50
"28833",10602,"Corner Brook","NL",48.95224,-57.92207,2018-04-17 01:00:00,43,2,45
"28834",10602,"Corner Brook","NL",48.95224,-57.92207,2018-04-17 02:00:00,44,2,46
"28835",10602,"Corner Brook","NL",48.95224,-57.92207,2018-04-17 03:00:00,42,2,44
"28836",10602,"Corner Brook","NL",48.95224,-57.92207,2018-04-17 04:00:00,40,4,44
"28837",10602,"Corner Brook","NL",48.95224,-57.92207,2018-04-17 05:00:00,37,5,42
"28838",10602,"Corner Brook","NL",48.95224,-57.92207,2018-04-17 06:00:00,37,6,43
"28839",10602,"Corner Brook","NL",48.95224,-57.92207,2018-04-17 07:00:00,40,4,44
"28840",10602,"Corner Brook","NL",48.95224,-57.92207,2018-04-17 08:00:00,36,7,43
"28841",10602,"Corner Brook","NL",48.95224,-57.92207,2018-04-17 09:00:00,39,5,44
"28842",10602,"Corner Brook","NL",48.95224,-57.92207,2018-04-17 10:00:00,41,5,46
"28843",10602,"Corner Brook","NL",48.95224,-57.92207,2018-04-17 11:00:00,44,3,47
"28844",10602,"Corner Brook","NL",48.95224,-57.92207,2018-04-17 12:00:00,46,9,55
"28845",10602,"Corner Brook","NL",48.95224,-57.92207,2018-04-17 13:00:00,47,2,49
"28846",10602,"Corner Brook","NL",48.95224,-57.92207,2018-04-17 14:00:00,48,1,49
"28847",10602,"Corner Brook","NL",48.95224,-57.92207,2018-04-17 15:00:00,49,2,51
"28848",10602,"Corner Brook","NL",48.95224,-57.92207,2018-04-17 16:00:00,50,2,52
"28849",10602,"Corner Brook","NL",48.95224,-57.92207,2018-04-17 17:00:00,50,2,52
"28850",10602,"Corner Brook","NL",48.95224,-57.92207,2018-04-17 18:00:00,50,1,51
"28851",10602,"Corner Brook","NL",48.95224,-57.92207,2018-04-17 19:00:00,49,2,51
"28852",10602,"Corner Brook","NL",48.95224,-57.92207,2018-04-17 20:00:00,49,1,50
"28853",10602,"Corner Brook","NL",48.95224,-57.92207,2018-04-17 21:00:00,49,1,50
"28854",10602,"Corner Brook","NL",48.95224,-57.92207,2018-04-17 22:00:00,49,1,50
"28855",10602,"Corner Brook","NL",48.95224,-57.92207,2018-04-17 23:00:00,51,1,52
"28856",10602,"Corner Brook","NL",48.95224,-57.92207,2018-04-18 00:00:00,53,7,60
"28857",10602,"Corner Brook","NL",48.95224,-57.92207,2018-04-18 01:00:00,51,1,52
"28858",10602,"Corner Brook","NL",48.95224,-57.92207,2018-04-18 02:00:00,52,1,53
"28859",10602,"Corner Brook","NL",48.95224,-57.92207,2018-04-18 03:00:00,51,1,52
"28860",10602,"Corner Brook","NL",48.95224,-57.92207,2018-04-18 04:00:00,50,1,51
"28861",10602,"Corner Brook","NL",48.95224,-57.92207,2018-04-18 05:00:00,50,1,51
"28862",10602,"Corner Brook","NL",48.95224,-57.92207,2018-04-18 06:00:00,49,1,50
"28863",10602,"Corner Brook","NL",48.95224,-57.92207,2018-04-18 07:00:00,47,2,49
"28864",10602,"Corner Brook","NL",48.95224,-57.92207,2018-04-18 08:00:00,46,3,49
"28865",10602,"Corner Brook","NL",48.95224,-57.92207,2018-04-18 09:00:00,44,4,48
"28866",10602,"Corner Brook","NL",48.95224,-57.92207,2018-04-18 10:00:00,45,2,47
"28867",10602,"Corner Brook","NL",48.95224,-57.92207,2018-04-18 11:00:00,43,3,46
"28868",10602,"Corner Brook","NL",48.95224,-57.92207,2018-04-18 12:00:00,42,7,49
"28869",10602,"Corner Brook","NL",48.95224,-57.92207,2018-04-18 13:00:00,41,2,43
"28870",10602,"Corner Brook","NL",48.95224,-57.92207,2018-04-18 14:00:00,40,3,43
"28871",10602,"Corner Brook","NL",48.95224,-57.92207,2018-04-18 15:00:00,37,4,41
"28872",10602,"Corner Brook","NL",48.95224,-57.92207,2018-04-18 16:00:00,36,4,40
"28873",10602,"Corner Brook","NL",48.95224,-57.92207,2018-04-18 17:00:00,36,4,40
"28874",10602,"Corner Brook","NL",48.95224,-57.92207,2018-04-18 18:00:00,36,3,39
"28875",10602,"Corner Brook","NL",48.95224,-57.92207,2018-04-18 19:00:00,34,4,38
"28876",10602,"Corner Brook","NL",48.95224,-57.92207,2018-04-18 20:00:00,34,3,37
"28877",10602,"Corner Brook","NL",48.95224,-57.92207,2018-04-18 21:00:00,32,5,37
"28878",10602,"Corner Brook","NL",48.95224,-57.92207,2018-04-18 22:00:00,26,6,32
"28879",10602,"Corner Brook","NL",48.95224,-57.92207,2018-04-18 23:00:00,30,4,34
"28880",10602,"Corner Brook","NL",48.95224,-57.92207,2018-04-19 00:00:00,34,7,41
"28881",10602,"Corner Brook","NL",48.95224,-57.92207,2018-04-19 01:00:00,35,3,38
"28882",10602,"Corner Brook","NL",48.95224,-57.92207,2018-04-19 02:00:00,33,3,36
"28883",10602,"Corner Brook","NL",48.95224,-57.92207,2018-04-19 03:00:00,34,2,36
"28884",10602,"Corner Brook","NL",48.95224,-57.92207,2018-04-19 04:00:00,34,2,36
"28885",10602,"Corner Brook","NL",48.95224,-57.92207,2018-04-19 05:00:00,35,2,37
"28886",10602,"Corner Brook","NL",48.95224,-57.92207,2018-04-19 06:00:00,34,2,36
"28887",10602,"Corner Brook","NL",48.95224,-57.92207,2018-04-19 07:00:00,33,2,35
"28888",10602,"Corner Brook","NL",48.95224,-57.92207,2018-04-19 08:00:00,33,2,35
"28889",10602,"Corner Brook","NL",48.95224,-57.92207,2018-04-19 09:00:00,32,1,33
"28890",10602,"Corner Brook","NL",48.95224,-57.92207,2018-04-19 10:00:00,34,1,35
"28891",10602,"Corner Brook","NL",48.95224,-57.92207,2018-04-19 11:00:00,35,1,36
"28892",10602,"Corner Brook","NL",48.95224,-57.92207,2018-04-19 12:00:00,31,8,39
"28893",10602,"Corner Brook","NL",48.95224,-57.92207,2018-04-19 13:00:00,33,2,35
"28894",10602,"Corner Brook","NL",48.95224,-57.92207,2018-04-19 14:00:00,32,3,35
"28895",10602,"Corner Brook","NL",48.95224,-57.92207,2018-04-19 15:00:00,29,5,34
"28896",10602,"Corner Brook","NL",48.95224,-57.92207,2018-04-19 16:00:00,30,5,35
"28897",10602,"Corner Brook","NL",48.95224,-57.92207,2018-04-19 17:00:00,28,5,33
"28898",10602,"Corner Brook","NL",48.95224,-57.92207,2018-04-19 18:00:00,25,8,33
"28899",10602,"Corner Brook","NL",48.95224,-57.92207,2018-04-19 19:00:00,30,6,36
"28900",10602,"Corner Brook","NL",48.95224,-57.92207,2018-04-19 20:00:00,38,5,43
"28901",10602,"Corner Brook","NL",48.95224,-57.92207,2018-04-19 21:00:00,37,6,43
"28902",10602,"Corner Brook","NL",48.95224,-57.92207,2018-04-19 22:00:00,41,3,44
"28903",10602,"Corner Brook","NL",48.95224,-57.92207,2018-04-19 23:00:00,37,3,40
"28904",10602,"Corner Brook","NL",48.95224,-57.92207,2018-04-20 00:00:00,34,4,38
"28905",10602,"Corner Brook","NL",48.95224,-57.92207,2018-04-20 01:00:00,35,3,38
"28906",10602,"Corner Brook","NL",48.95224,-57.92207,2018-04-20 02:00:00,38,2,40
"28907",10602,"Corner Brook","NL",48.95224,-57.92207,2018-04-20 03:00:00,33,3,36
"28908",10602,"Corner Brook","NL",48.95224,-57.92207,2018-04-20 04:00:00,38,2,40
"28909",10602,"Corner Brook","NL",48.95224,-57.92207,2018-04-20 05:00:00,39,1,40
"28910",10602,"Corner Brook","NL",48.95224,-57.92207,2018-04-20 06:00:00,38,1,39
"28911",10602,"Corner Brook","NL",48.95224,-57.92207,2018-04-20 07:00:00,36,1,37
"28912",10602,"Corner Brook","NL",48.95224,-57.92207,2018-04-20 08:00:00,34,2,36
"28913",10602,"Corner Brook","NL",48.95224,-57.92207,2018-04-20 09:00:00,35,2,37
"28914",10602,"Corner Brook","NL",48.95224,-57.92207,2018-04-20 10:00:00,34,2,36
"28915",10602,"Corner Brook","NL",48.95224,-57.92207,2018-04-20 11:00:00,35,2,37
"28916",10602,"Corner Brook","NL",48.95224,-57.92207,2018-04-20 12:00:00,36,1,37
"28917",10602,"Corner Brook","NL",48.95224,-57.92207,2018-04-20 13:00:00,35,2,37
"28918",10602,"Corner Brook","NL",48.95224,-57.92207,2018-04-20 14:00:00,35,2,37
"28919",10602,"Corner Brook","NL",48.95224,-57.92207,2018-04-20 15:00:00,35,2,37
"28920",10602,"Corner Brook","NL",48.95224,-57.92207,2018-04-20 16:00:00,33,3,36
"28921",10602,"Corner Brook","NL",48.95224,-57.92207,2018-04-20 17:00:00,33,2,35
"28922",10602,"Corner Brook","NL",48.95224,-57.92207,2018-04-20 18:00:00,34,2,36
"28923",10602,"Corner Brook","NL",48.95224,-57.92207,2018-04-20 19:00:00,33,3,36
"28924",10602,"Corner Brook","NL",48.95224,-57.92207,2018-04-20 20:00:00,30,6,36
"28925",10602,"Corner Brook","NL",48.95224,-57.92207,2018-04-20 21:00:00,30,6,36
"28926",10602,"Corner Brook","NL",48.95224,-57.92207,2018-04-20 22:00:00,33,4,37
"28927",10602,"Corner Brook","NL",48.95224,-57.92207,2018-04-20 23:00:00,30,6,36
"28928",10602,"Corner Brook","NL",48.95224,-57.92207,2018-04-21 00:00:00,27,10,37
"28929",10602,"Corner Brook","NL",48.95224,-57.92207,2018-04-21 01:00:00,32,6,38
"28930",10602,"Corner Brook","NL",48.95224,-57.92207,2018-04-21 02:00:00,33,5,38
"28931",10602,"Corner Brook","NL",48.95224,-57.92207,2018-04-21 03:00:00,34,5,39
"28932",10602,"Corner Brook","NL",48.95224,-57.92207,2018-04-21 04:00:00,35,7,42
"28933",10602,"Corner Brook","NL",48.95224,-57.92207,2018-04-21 05:00:00,35,6,41
"28934",10602,"Corner Brook","NL",48.95224,-57.92207,2018-04-21 06:00:00,35,6,41
"28935",10602,"Corner Brook","NL",48.95224,-57.92207,2018-04-21 07:00:00,35,7,42
"28936",10602,"Corner Brook","NL",48.95224,-57.92207,2018-04-21 08:00:00,36,7,43
"28937",10602,"Corner Brook","NL",48.95224,-57.92207,2018-04-21 09:00:00,37,6,43
"28938",10602,"Corner Brook","NL",48.95224,-57.92207,2018-04-21 10:00:00,39,4,43
"28939",10602,"Corner Brook","NL",48.95224,-57.92207,2018-04-21 11:00:00,39,4,43
"28940",10602,"Corner Brook","NL",48.95224,-57.92207,2018-04-21 12:00:00,38,4,42
"28941",10602,"Corner Brook","NL",48.95224,-57.92207,2018-04-21 13:00:00,38,5,43
"28942",10602,"Corner Brook","NL",48.95224,-57.92207,2018-04-21 14:00:00,40,3,43
"28943",10602,"Corner Brook","NL",48.95224,-57.92207,2018-04-21 15:00:00,40,2,42
"28944",10602,"Corner Brook","NL",48.95224,-57.92207,2018-04-21 16:00:00,40,3,43
"28945",10602,"Corner Brook","NL",48.95224,-57.92207,2018-04-21 17:00:00,39,3,42
"28946",10602,"Corner Brook","NL",48.95224,-57.92207,2018-04-21 18:00:00,37,6,43
"28947",10602,"Corner Brook","NL",48.95224,-57.92207,2018-04-21 19:00:00,35,8,43
"28948",10602,"Corner Brook","NL",48.95224,-57.92207,2018-04-21 20:00:00,37,5,42
"28949",10602,"Corner Brook","NL",48.95224,-57.92207,2018-04-21 21:00:00,38,5,43
"28950",10602,"Corner Brook","NL",48.95224,-57.92207,2018-04-21 22:00:00,39,4,43
"28951",10602,"Corner Brook","NL",48.95224,-57.92207,2018-04-21 23:00:00,41,3,44
"28952",10602,"Corner Brook","NL",48.95224,-57.92207,2018-04-22 00:00:00,41,2,43
"28953",10602,"Corner Brook","NL",48.95224,-57.92207,2018-04-22 01:00:00,41,3,44
"28954",10602,"Corner Brook","NL",48.95224,-57.92207,2018-04-22 02:00:00,39,7,46
"28955",10602,"Corner Brook","NL",48.95224,-57.92207,2018-04-22 03:00:00,43,3,46
"28956",10602,"Corner Brook","NL",48.95224,-57.92207,2018-04-22 04:00:00,40,6,46
"28957",10602,"Corner Brook","NL",48.95224,-57.92207,2018-04-22 05:00:00,39,5,44
"28958",10602,"Corner Brook","NL",48.95224,-57.92207,2018-04-22 06:00:00,39,5,44
"28959",10602,"Corner Brook","NL",48.95224,-57.92207,2018-04-22 07:00:00,39,6,45
"28960",10602,"Corner Brook","NL",48.95224,-57.92207,2018-04-22 08:00:00,42,4,46
"28961",10602,"Corner Brook","NL",48.95224,-57.92207,2018-04-22 09:00:00,42,4,46
"28962",10602,"Corner Brook","NL",48.95224,-57.92207,2018-04-22 10:00:00,43,5,48
"28963",10602,"Corner Brook","NL",48.95224,-57.92207,2018-04-22 11:00:00,45,3,48
"28964",10602,"Corner Brook","NL",48.95224,-57.92207,2018-04-22 12:00:00,44,3,47
"28965",10602,"Corner Brook","NL",48.95224,-57.92207,2018-04-22 13:00:00,45,2,47
"28966",10602,"Corner Brook","NL",48.95224,-57.92207,2018-04-22 14:00:00,45,3,48
"28967",10602,"Corner Brook","NL",48.95224,-57.92207,2018-04-22 15:00:00,46,2,48
"28968",10602,"Corner Brook","NL",48.95224,-57.92207,2018-04-22 16:00:00,47,1,48
"28969",10602,"Corner Brook","NL",48.95224,-57.92207,2018-04-22 17:00:00,46,2,48
"28970",10602,"Corner Brook","NL",48.95224,-57.92207,2018-04-22 18:00:00,48,1,49
"28971",10602,"Corner Brook","NL",48.95224,-57.92207,2018-04-22 19:00:00,48,1,49
"28972",10602,"Corner Brook","NL",48.95224,-57.92207,2018-04-22 20:00:00,47,2,49
"28973",10602,"Corner Brook","NL",48.95224,-57.92207,2018-04-22 21:00:00,43,4,47
"28974",10602,"Corner Brook","NL",48.95224,-57.92207,2018-04-22 22:00:00,44,3,47
"28975",10602,"Corner Brook","NL",48.95224,-57.92207,2018-04-22 23:00:00,45,2,47
"28976",10602,"Corner Brook","NL",48.95224,-57.92207,2018-04-23 00:00:00,46,1,47
"28977",10602,"Corner Brook","NL",48.95224,-57.92207,2018-04-23 01:00:00,46,1,47
"28978",10602,"Corner Brook","NL",48.95224,-57.92207,2018-04-23 02:00:00,46,1,47
"28979",10602,"Corner Brook","NL",48.95224,-57.92207,2018-04-23 03:00:00,46,1,47
"28980",10602,"Corner Brook","NL",48.95224,-57.92207,2018-04-23 04:00:00,46,1,47
"28981",10602,"Corner Brook","NL",48.95224,-57.92207,2018-04-23 05:00:00,45,1,46
"28982",10602,"Corner Brook","NL",48.95224,-57.92207,2018-04-23 06:00:00,45,1,46
"28983",10602,"Corner Brook","NL",48.95224,-57.92207,2018-04-23 07:00:00,44,2,46
"28984",10602,"Corner Brook","NL",48.95224,-57.92207,2018-04-23 08:00:00,43,2,45
"28985",10602,"Corner Brook","NL",48.95224,-57.92207,2018-04-23 09:00:00,43,4,47
"28986",10602,"Corner Brook","NL",48.95224,-57.92207,2018-04-23 10:00:00,44,5,49
"28987",10602,"Corner Brook","NL",48.95224,-57.92207,2018-04-23 11:00:00,44,6,50
"28988",10602,"Corner Brook","NL",48.95224,-57.92207,2018-04-23 12:00:00,46,5,51
"28989",10602,"Corner Brook","NL",48.95224,-57.92207,2018-04-23 13:00:00,46,4,50
"28990",10602,"Corner Brook","NL",48.95224,-57.92207,2018-04-23 14:00:00,45,5,50
"28991",10602,"Corner Brook","NL",48.95224,-57.92207,2018-04-23 15:00:00,45,6,51
"28992",10602,"Corner Brook","NL",48.95224,-57.92207,2018-04-23 16:00:00,47,4,51
"28993",10602,"Corner Brook","NL",48.95224,-57.92207,2018-04-23 17:00:00,48,4,52
"28994",10602,"Corner Brook","NL",48.95224,-57.92207,2018-04-23 18:00:00,47,5,52
"28995",10602,"Corner Brook","NL",48.95224,-57.92207,2018-04-23 19:00:00,42,10,52
"28996",10602,"Corner Brook","NL",48.95224,-57.92207,2018-04-23 20:00:00,48,3,51
"28997",10602,"Corner Brook","NL",48.95224,-57.92207,2018-04-23 21:00:00,49,1,50
"28998",10602,"Corner Brook","NL",48.95224,-57.92207,2018-04-23 22:00:00,47,1,48
"28999",10602,"Corner Brook","NL",48.95224,-57.92207,2018-04-23 23:00:00,47,1,48
"29000",10602,"Corner Brook","NL",48.95224,-57.92207,2018-04-24 00:00:00,48,1,49
"29001",10602,"Corner Brook","NL",48.95224,-57.92207,2018-04-24 01:00:00,47,1,48
"29002",10602,"Corner Brook","NL",48.95224,-57.92207,2018-04-24 02:00:00,48,1,49
"29003",10602,"Corner Brook","NL",48.95224,-57.92207,2018-04-24 03:00:00,48,1,49
"29004",10602,"Corner Brook","NL",48.95224,-57.92207,2018-04-24 04:00:00,48,1,49
"29005",10602,"Corner Brook","NL",48.95224,-57.92207,2018-04-24 05:00:00,48,1,49
"29006",10602,"Corner Brook","NL",48.95224,-57.92207,2018-04-24 06:00:00,47,3,50
"29007",10602,"Corner Brook","NL",48.95224,-57.92207,2018-04-24 07:00:00,48,2,50
"29008",10602,"Corner Brook","NL",48.95224,-57.92207,2018-04-24 08:00:00,48,2,50
"29009",10602,"Corner Brook","NL",48.95224,-57.92207,2018-04-24 09:00:00,48,2,50
"29010",10602,"Corner Brook","NL",48.95224,-57.92207,2018-04-24 10:00:00,51,1,52
"29011",10602,"Corner Brook","NL",48.95224,-57.92207,2018-04-24 11:00:00,52,1,53
"29012",10602,"Corner Brook","NL",48.95224,-57.92207,2018-04-24 12:00:00,53,1,54
"29013",10602,"Corner Brook","NL",48.95224,-57.92207,2018-04-24 13:00:00,54,1,55
"29014",10602,"Corner Brook","NL",48.95224,-57.92207,2018-04-24 14:00:00,53,1,54
"29015",10602,"Corner Brook","NL",48.95224,-57.92207,2018-04-24 15:00:00,54,1,55
"29016",10602,"Corner Brook","NL",48.95224,-57.92207,2018-04-24 16:00:00,55,1,56
"29017",10602,"Corner Brook","NL",48.95224,-57.92207,2018-04-24 17:00:00,57,1,58
"29018",10602,"Corner Brook","NL",48.95224,-57.92207,2018-04-24 18:00:00,57,1,58
"29019",10602,"Corner Brook","NL",48.95224,-57.92207,2018-04-24 19:00:00,55,2,57
"29020",10602,"Corner Brook","NL",48.95224,-57.92207,2018-04-24 20:00:00,54,1,55
"29021",10602,"Corner Brook","NL",48.95224,-57.92207,2018-04-24 21:00:00,53,2,55
"29022",10602,"Corner Brook","NL",48.95224,-57.92207,2018-04-24 22:00:00,55,1,56
"29023",10602,"Corner Brook","NL",48.95224,-57.92207,2018-04-24 23:00:00,55,1,56
"29024",10602,"Corner Brook","NL",48.95224,-57.92207,2018-04-25 00:00:00,55,1,56
"29025",10602,"Corner Brook","NL",48.95224,-57.92207,2018-04-25 01:00:00,54,1,55
"29026",10602,"Corner Brook","NL",48.95224,-57.92207,2018-04-25 02:00:00,54,1,55
"29027",10602,"Corner Brook","NL",48.95224,-57.92207,2018-04-25 03:00:00,54,1,55
"29028",10602,"Corner Brook","NL",48.95224,-57.92207,2018-04-25 04:00:00,52,2,54
"29029",10602,"Corner Brook","NL",48.95224,-57.92207,2018-04-25 05:00:00,53,1,54
"29030",10602,"Corner Brook","NL",48.95224,-57.92207,2018-04-25 06:00:00,53,2,55
"29031",10602,"Corner Brook","NL",48.95224,-57.92207,2018-04-25 07:00:00,53,2,55
"29032",10602,"Corner Brook","NL",48.95224,-57.92207,2018-04-25 08:00:00,55,2,57
"29033",10602,"Corner Brook","NL",48.95224,-57.92207,2018-04-25 09:00:00,56,1,57
"29034",10602,"Corner Brook","NL",48.95224,-57.92207,2018-04-25 10:00:00,57,1,58
"29035",10602,"Corner Brook","NL",48.95224,-57.92207,2018-04-25 11:00:00,57,1,58
"29036",10602,"Corner Brook","NL",48.95224,-57.92207,2018-04-25 12:00:00,59,1,60
"29037",10602,"Corner Brook","NL",48.95224,-57.92207,2018-04-25 13:00:00,59,1,60
"29038",10602,"Corner Brook","NL",48.95224,-57.92207,2018-04-25 14:00:00,60,1,61
"29039",10602,"Corner Brook","NL",48.95224,-57.92207,2018-04-25 15:00:00,60,1,61
"29040",10602,"Corner Brook","NL",48.95224,-57.92207,2018-04-25 16:00:00,60,1,61
"29041",10602,"Corner Brook","NL",48.95224,-57.92207,2018-04-25 17:00:00,59,2,61
"29042",10602,"Corner Brook","NL",48.95224,-57.92207,2018-04-25 18:00:00,57,2,59
"29043",10602,"Corner Brook","NL",48.95224,-57.92207,2018-04-25 19:00:00,54,1,55
"29044",10602,"Corner Brook","NL",48.95224,-57.92207,2018-04-25 20:00:00,52,2,54
"29045",10602,"Corner Brook","NL",48.95224,-57.92207,2018-04-25 21:00:00,53,1,54
"29046",10602,"Corner Brook","NL",48.95224,-57.92207,2018-04-25 22:00:00,53,1,54
"29047",10602,"Corner Brook","NL",48.95224,-57.92207,2018-04-25 23:00:00,52,1,53
"29048",10602,"Corner Brook","NL",48.95224,-57.92207,2018-04-26 00:00:00,50,1,51
"29049",10602,"Corner Brook","NL",48.95224,-57.92207,2018-04-26 01:00:00,47,3,50
"29050",10602,"Corner Brook","NL",48.95224,-57.92207,2018-04-26 02:00:00,49,1,50
"29051",10602,"Corner Brook","NL",48.95224,-57.92207,2018-04-26 03:00:00,48,1,49
"29052",10602,"Corner Brook","NL",48.95224,-57.92207,2018-04-26 04:00:00,48,1,49
"29053",10602,"Corner Brook","NL",48.95224,-57.92207,2018-04-26 05:00:00,47,1,48
"29054",10602,"Corner Brook","NL",48.95224,-57.92207,2018-04-26 06:00:00,46,2,48
"29055",10602,"Corner Brook","NL",48.95224,-57.92207,2018-04-26 07:00:00,38,7,45
"29056",10602,"Corner Brook","NL",48.95224,-57.92207,2018-04-26 08:00:00,41,6,47
"29057",10602,"Corner Brook","NL",48.95224,-57.92207,2018-04-26 09:00:00,47,1,48
"29058",10602,"Corner Brook","NL",48.95224,-57.92207,2018-04-26 10:00:00,45,2,47
"29059",10602,"Corner Brook","NL",48.95224,-57.92207,2018-04-26 11:00:00,48,1,49
"29060",10602,"Corner Brook","NL",48.95224,-57.92207,2018-04-26 12:00:00,48,1,49
"29061",10602,"Corner Brook","NL",48.95224,-57.92207,2018-04-26 13:00:00,48,1,49
"29062",10602,"Corner Brook","NL",48.95224,-57.92207,2018-04-26 14:00:00,48,1,49
"29063",10602,"Corner Brook","NL",48.95224,-57.92207,2018-04-26 15:00:00,48,1,49
"29064",10602,"Corner Brook","NL",48.95224,-57.92207,2018-04-26 16:00:00,49,1,50
"29065",10602,"Corner Brook","NL",48.95224,-57.92207,2018-04-26 17:00:00,49,1,50
"29066",10602,"Corner Brook","NL",48.95224,-57.92207,2018-04-26 18:00:00,49,1,50
"29067",10602,"Corner Brook","NL",48.95224,-57.92207,2018-04-26 19:00:00,50,1,51
"29068",10602,"Corner Brook","NL",48.95224,-57.92207,2018-04-26 20:00:00,50,1,51
"29069",10602,"Corner Brook","NL",48.95224,-57.92207,2018-04-26 21:00:00,48,1,49
"29070",10602,"Corner Brook","NL",48.95224,-57.92207,2018-04-26 22:00:00,49,1,50
"29071",10602,"Corner Brook","NL",48.95224,-57.92207,2018-04-26 23:00:00,49,0,49
"29072",10602,"Corner Brook","NL",48.95224,-57.92207,2018-04-27 00:00:00,50,0,50
"29073",10602,"Corner Brook","NL",48.95224,-57.92207,2018-04-27 01:00:00,49,0,49
"29074",10602,"Corner Brook","NL",48.95224,-57.92207,2018-04-27 02:00:00,49,0,49
"29075",10602,"Corner Brook","NL",48.95224,-57.92207,2018-04-27 03:00:00,46,1,47
"29076",10602,"Corner Brook","NL",48.95224,-57.92207,2018-04-27 04:00:00,47,1,48
"29077",10602,"Corner Brook","NL",48.95224,-57.92207,2018-04-27 05:00:00,48,1,49
"29078",10602,"Corner Brook","NL",48.95224,-57.92207,2018-04-27 06:00:00,48,1,49
"29079",10602,"Corner Brook","NL",48.95224,-57.92207,2018-04-27 07:00:00,48,1,49
"29080",10602,"Corner Brook","NL",48.95224,-57.92207,2018-04-27 08:00:00,46,1,47
"29081",10602,"Corner Brook","NL",48.95224,-57.92207,2018-04-27 09:00:00,44,1,45
"29082",10602,"Corner Brook","NL",48.95224,-57.92207,2018-04-27 10:00:00,42,1,43
"29083",10602,"Corner Brook","NL",48.95224,-57.92207,2018-04-27 11:00:00,39,1,40
"29084",10602,"Corner Brook","NL",48.95224,-57.92207,2018-04-27 12:00:00,35,1,36
"29085",10602,"Corner Brook","NL",48.95224,-57.92207,2018-04-27 13:00:00,36,1,37
"29086",10602,"Corner Brook","NL",48.95224,-57.92207,2018-04-27 14:00:00,36,1,37
"29087",10602,"Corner Brook","NL",48.95224,-57.92207,2018-04-27 15:00:00,36,1,37
"29088",10602,"Corner Brook","NL",48.95224,-57.92207,2018-04-27 16:00:00,35,1,36
"29089",10602,"Corner Brook","NL",48.95224,-57.92207,2018-04-27 17:00:00,35,1,36
"29090",10602,"Corner Brook","NL",48.95224,-57.92207,2018-04-27 18:00:00,34,1,35
"29091",10602,"Corner Brook","NL",48.95224,-57.92207,2018-04-27 19:00:00,35,1,36
"29092",10602,"Corner Brook","NL",48.95224,-57.92207,2018-04-27 20:00:00,34,1,35
"29093",10602,"Corner Brook","NL",48.95224,-57.92207,2018-04-27 21:00:00,32,1,33
"29094",10602,"Corner Brook","NL",48.95224,-57.92207,2018-04-27 22:00:00,30,2,32
"29095",10602,"Corner Brook","NL",48.95224,-57.92207,2018-04-27 23:00:00,30,1,31
"29096",10602,"Corner Brook","NL",48.95224,-57.92207,2018-04-28 00:00:00,24,3,27
"29097",10602,"Corner Brook","NL",48.95224,-57.92207,2018-04-28 01:00:00,20,3,23
"29098",10602,"Corner Brook","NL",48.95224,-57.92207,2018-04-28 02:00:00,15,3,18
"29099",10602,"Corner Brook","NL",48.95224,-57.92207,2018-04-28 03:00:00,15,4,19
"29100",10602,"Corner Brook","NL",48.95224,-57.92207,2018-04-28 04:00:00,11,5,16
"29101",10602,"Corner Brook","NL",48.95224,-57.92207,2018-04-28 05:00:00,13,5,18
"29102",10602,"Corner Brook","NL",48.95224,-57.92207,2018-04-28 06:00:00,13,5,18
"29103",10602,"Corner Brook","NL",48.95224,-57.92207,2018-04-28 07:00:00,16,5,21
"29104",10602,"Corner Brook","NL",48.95224,-57.92207,2018-04-28 08:00:00,19,4,23
"29105",10602,"Corner Brook","NL",48.95224,-57.92207,2018-04-28 09:00:00,22,3,25
"29106",10602,"Corner Brook","NL",48.95224,-57.92207,2018-04-28 10:00:00,33,2,35
"29107",10602,"Corner Brook","NL",48.95224,-57.92207,2018-04-28 11:00:00,40,2,42
"29108",10602,"Corner Brook","NL",48.95224,-57.92207,2018-04-28 12:00:00,43,2,45
"29109",10602,"Corner Brook","NL",48.95224,-57.92207,2018-04-28 13:00:00,50,1,51
"29110",10602,"Corner Brook","NL",48.95224,-57.92207,2018-04-28 14:00:00,44,1,45
"29111",10602,"Corner Brook","NL",48.95224,-57.92207,2018-04-28 15:00:00,39,1,40
"29112",10602,"Corner Brook","NL",48.95224,-57.92207,2018-04-28 16:00:00,35,1,36
"29113",10602,"Corner Brook","NL",48.95224,-57.92207,2018-04-28 17:00:00,32,1,33
"29114",10602,"Corner Brook","NL",48.95224,-57.92207,2018-04-28 18:00:00,32,2,34
"29115",10602,"Corner Brook","NL",48.95224,-57.92207,2018-04-28 19:00:00,34,2,36
"29116",10602,"Corner Brook","NL",48.95224,-57.92207,2018-04-28 20:00:00,35,2,37
"29117",10602,"Corner Brook","NL",48.95224,-57.92207,2018-04-28 21:00:00,34,2,36
"29118",10602,"Corner Brook","NL",48.95224,-57.92207,2018-04-28 22:00:00,33,2,35
"29119",10602,"Corner Brook","NL",48.95224,-57.92207,2018-04-28 23:00:00,32,2,34
"29120",10602,"Corner Brook","NL",48.95224,-57.92207,2018-04-29 00:00:00,30,2,32
"29121",10602,"Corner Brook","NL",48.95224,-57.92207,2018-04-29 01:00:00,21,3,24
"29122",10602,"Corner Brook","NL",48.95224,-57.92207,2018-04-29 02:00:00,24,3,27
"29123",10602,"Corner Brook","NL",48.95224,-57.92207,2018-04-29 03:00:00,22,2,24
"29124",10602,"Corner Brook","NL",48.95224,-57.92207,2018-04-29 04:00:00,18,2,20
"29125",10602,"Corner Brook","NL",48.95224,-57.92207,2018-04-29 05:00:00,28,1,29
"29126",10602,"Corner Brook","NL",48.95224,-57.92207,2018-04-29 06:00:00,27,1,28
"29127",10602,"Corner Brook","NL",48.95224,-57.92207,2018-04-29 07:00:00,24,2,26
"29128",10602,"Corner Brook","NL",48.95224,-57.92207,2018-04-29 08:00:00,23,2,25
"29129",10602,"Corner Brook","NL",48.95224,-57.92207,2018-04-29 09:00:00,19,3,22
"29130",10602,"Corner Brook","NL",48.95224,-57.92207,2018-04-29 10:00:00,21,5,26
"29131",10602,"Corner Brook","NL",48.95224,-57.92207,2018-04-29 11:00:00,19,7,26
"29132",10602,"Corner Brook","NL",48.95224,-57.92207,2018-04-29 12:00:00,20,8,28
"29133",10602,"Corner Brook","NL",48.95224,-57.92207,2018-04-29 13:00:00,25,3,28
"29134",10602,"Corner Brook","NL",48.95224,-57.92207,2018-04-29 14:00:00,25,5,30
"29135",10602,"Corner Brook","NL",48.95224,-57.92207,2018-04-29 15:00:00,20,8,28
"29136",10602,"Corner Brook","NL",48.95224,-57.92207,2018-04-29 16:00:00,18,8,26
"29137",10602,"Corner Brook","NL",48.95224,-57.92207,2018-04-29 17:00:00,18,9,27
"29138",10602,"Corner Brook","NL",48.95224,-57.92207,2018-04-29 18:00:00,18,8,26
"29139",10602,"Corner Brook","NL",48.95224,-57.92207,2018-04-29 19:00:00,27,3,30
"29140",10602,"Corner Brook","NL",48.95224,-57.92207,2018-04-29 20:00:00,30,1,31
"29141",10602,"Corner Brook","NL",48.95224,-57.92207,2018-04-29 21:00:00,33,1,34
"29142",10602,"Corner Brook","NL",48.95224,-57.92207,2018-04-29 22:00:00,35,1,36
"29143",10602,"Corner Brook","NL",48.95224,-57.92207,2018-04-29 23:00:00,34,1,35
"29144",10602,"Corner Brook","NL",48.95224,-57.92207,2018-04-30 00:00:00,34,1,35
"29145",10602,"Corner Brook","NL",48.95224,-57.92207,2018-04-30 01:00:00,34,1,35
"29146",10602,"Corner Brook","NL",48.95224,-57.92207,2018-04-30 02:00:00,35,1,36
"29147",10602,"Corner Brook","NL",48.95224,-57.92207,2018-04-30 03:00:00,29,2,31
"29148",10602,"Corner Brook","NL",48.95224,-57.92207,2018-04-30 04:00:00,24,3,27
"29149",10602,"Corner Brook","NL",48.95224,-57.92207,2018-04-30 05:00:00,20,4,24
"29150",10602,"Corner Brook","NL",48.95224,-57.92207,2018-04-30 06:00:00,19,5,24
"29151",10602,"Corner Brook","NL",48.95224,-57.92207,2018-04-30 07:00:00,30,3,33
"29152",10602,"Corner Brook","NL",48.95224,-57.92207,2018-04-30 08:00:00,30,3,33
"29153",10602,"Corner Brook","NL",48.95224,-57.92207,2018-04-30 09:00:00,30,2,32
"29154",10602,"Corner Brook","NL",48.95224,-57.92207,2018-04-30 10:00:00,31,2,33
"29155",10602,"Corner Brook","NL",48.95224,-57.92207,2018-04-30 11:00:00,32,2,34
"29156",10602,"Corner Brook","NL",48.95224,-57.92207,2018-04-30 12:00:00,34,2,36
"29157",10602,"Corner Brook","NL",48.95224,-57.92207,2018-04-30 13:00:00,34,1,35
"29158",10602,"Corner Brook","NL",48.95224,-57.92207,2018-04-30 14:00:00,35,2,37
"29159",10602,"Corner Brook","NL",48.95224,-57.92207,2018-04-30 15:00:00,35,2,37
"29160",10602,"Corner Brook","NL",48.95224,-57.92207,2018-04-30 16:00:00,38,2,40
"29161",10602,"Corner Brook","NL",48.95224,-57.92207,2018-04-30 17:00:00,41,1,42
"29162",10602,"Corner Brook","NL",48.95224,-57.92207,2018-04-30 18:00:00,37,2,39
"29163",10602,"Corner Brook","NL",48.95224,-57.92207,2018-04-30 19:00:00,25,10,35
"29164",10602,"Corner Brook","NL",48.95224,-57.92207,2018-04-30 20:00:00,29,2,31
"29165",10602,"Corner Brook","NL",48.95224,-57.92207,2018-04-30 21:00:00,25,3,28
"29166",10602,"Corner Brook","NL",48.95224,-57.92207,2018-04-30 22:00:00,17,5,22
"29167",10602,"Corner Brook","NL",48.95224,-57.92207,2018-04-30 23:00:00,13,5,18
"29168",10602,"Corner Brook","NL",48.95224,-57.92207,2018-05-01 00:00:00,12,6,18
"29169",10602,"Corner Brook","NL",48.95224,-57.92207,2018-05-01 01:00:00,12,5,17
"29170",10602,"Corner Brook","NL",48.95224,-57.92207,2018-05-01 02:00:00,12,4,16
"29171",10602,"Corner Brook","NL",48.95224,-57.92207,2018-05-01 03:00:00,13,4,17
"29172",10602,"Corner Brook","NL",48.95224,-57.92207,2018-05-01 04:00:00,14,4,18
"29173",10602,"Corner Brook","NL",48.95224,-57.92207,2018-05-01 05:00:00,13,5,18
"29174",10602,"Corner Brook","NL",48.95224,-57.92207,2018-05-01 06:00:00,13,4,17
"29175",10602,"Corner Brook","NL",48.95224,-57.92207,2018-05-01 07:00:00,12,5,17
"29176",10602,"Corner Brook","NL",48.95224,-57.92207,2018-05-01 08:00:00,18,4,22
"29177",10602,"Corner Brook","NL",48.95224,-57.92207,2018-05-01 09:00:00,20,3,23
"29178",10602,"Corner Brook","NL",48.95224,-57.92207,2018-05-01 10:00:00,22,2,24
"29179",10602,"Corner Brook","NL",48.95224,-57.92207,2018-05-01 11:00:00,23,2,25
"29180",10602,"Corner Brook","NL",48.95224,-57.92207,2018-05-01 12:00:00,27,2,29
"29181",10602,"Corner Brook","NL",48.95224,-57.92207,2018-05-01 13:00:00,32,2,34
"29182",10602,"Corner Brook","NL",48.95224,-57.92207,2018-05-01 14:00:00,32,2,34
"29183",10602,"Corner Brook","NL",48.95224,-57.92207,2018-05-01 15:00:00,30,3,33
"29184",10602,"Corner Brook","NL",48.95224,-57.92207,2018-05-01 16:00:00,29,4,33
"29185",10602,"Corner Brook","NL",48.95224,-57.92207,2018-05-01 17:00:00,24,8,32
"29186",10602,"Corner Brook","NL",48.95224,-57.92207,2018-05-01 18:00:00,25,6,31
"29187",10602,"Corner Brook","NL",48.95224,-57.92207,2018-05-01 19:00:00,25,6,31
"29188",10602,"Corner Brook","NL",48.95224,-57.92207,2018-05-01 20:00:00,29,2,31
"29189",10602,"Corner Brook","NL",48.95224,-57.92207,2018-05-01 21:00:00,28,3,31
"29190",10602,"Corner Brook","NL",48.95224,-57.92207,2018-05-01 22:00:00,25,4,29
"29191",10602,"Corner Brook","NL",48.95224,-57.92207,2018-05-01 23:00:00,25,2,27
"29192",10602,"Corner Brook","NL",48.95224,-57.92207,2018-05-02 00:00:00,21,2,23
"29193",10602,"Corner Brook","NL",48.95224,-57.92207,2018-05-02 01:00:00,18,2,20
"29194",10602,"Corner Brook","NL",48.95224,-57.92207,2018-05-02 02:00:00,17,3,20
"29195",10602,"Corner Brook","NL",48.95224,-57.92207,2018-05-02 03:00:00,19,1,20
"29196",10602,"Corner Brook","NL",48.95224,-57.92207,2018-05-02 04:00:00,18,2,20
"29197",10602,"Corner Brook","NL",48.95224,-57.92207,2018-05-02 05:00:00,20,2,22
"29198",10602,"Corner Brook","NL",48.95224,-57.92207,2018-05-02 06:00:00,24,2,26
"29199",10602,"Corner Brook","NL",48.95224,-57.92207,2018-05-02 07:00:00,24,2,26
"29200",10602,"Corner Brook","NL",48.95224,-57.92207,2018-05-02 08:00:00,25,2,27
"29201",10602,"Corner Brook","NL",48.95224,-57.92207,2018-05-02 09:00:00,26,2,28
"29202",10602,"Corner Brook","NL",48.95224,-57.92207,2018-05-02 10:00:00,27,1,28
"29203",10602,"Corner Brook","NL",48.95224,-57.92207,2018-05-02 11:00:00,27,1,28
"29204",10602,"Corner Brook","NL",48.95224,-57.92207,2018-05-02 12:00:00,31,1,32
"29205",10602,"Corner Brook","NL",48.95224,-57.92207,2018-05-02 13:00:00,33,1,34
"29206",10602,"Corner Brook","NL",48.95224,-57.92207,2018-05-02 14:00:00,35,1,36
"29207",10602,"Corner Brook","NL",48.95224,-57.92207,2018-05-02 15:00:00,33,1,34
"29208",10602,"Corner Brook","NL",48.95224,-57.92207,2018-05-02 16:00:00,33,1,34
"29209",10602,"Corner Brook","NL",48.95224,-57.92207,2018-05-02 17:00:00,32,1,33
"29210",10602,"Corner Brook","NL",48.95224,-57.92207,2018-05-02 18:00:00,29,2,31
"29211",10602,"Corner Brook","NL",48.95224,-57.92207,2018-05-02 19:00:00,26,5,31
"29212",10602,"Corner Brook","NL",48.95224,-57.92207,2018-05-02 20:00:00,24,5,29
"29213",10602,"Corner Brook","NL",48.95224,-57.92207,2018-05-02 21:00:00,26,4,30
"29214",10602,"Corner Brook","NL",48.95224,-57.92207,2018-05-02 22:00:00,24,4,28
"29215",10602,"Corner Brook","NL",48.95224,-57.92207,2018-05-02 23:00:00,21,4,25
"29216",10602,"Corner Brook","NL",48.95224,-57.92207,2018-05-03 00:00:00,25,2,27
"29217",10602,"Corner Brook","NL",48.95224,-57.92207,2018-05-03 01:00:00,24,3,27
"29218",10602,"Corner Brook","NL",48.95224,-57.92207,2018-05-03 02:00:00,31,2,33
"29219",10602,"Corner Brook","NL",48.95224,-57.92207,2018-05-03 03:00:00,32,1,33
"29220",10602,"Corner Brook","NL",48.95224,-57.92207,2018-05-03 04:00:00,37,1,38
"29221",10602,"Corner Brook","NL",48.95224,-57.92207,2018-05-03 05:00:00,39,1,40
"29222",10602,"Corner Brook","NL",48.95224,-57.92207,2018-05-03 06:00:00,38,1,39
"29223",10602,"Corner Brook","NL",48.95224,-57.92207,2018-05-03 07:00:00,37,2,39
"29224",10602,"Corner Brook","NL",48.95224,-57.92207,2018-05-03 08:00:00,37,3,40
"29225",10602,"Corner Brook","NL",48.95224,-57.92207,2018-05-03 09:00:00,37,2,39
"29226",10602,"Corner Brook","NL",48.95224,-57.92207,2018-05-03 10:00:00,35,4,39
"29227",10602,"Corner Brook","NL",48.95224,-57.92207,2018-05-03 11:00:00,35,4,39
"29228",10602,"Corner Brook","NL",48.95224,-57.92207,2018-05-03 12:00:00,36,3,39
"29229",10602,"Corner Brook","NL",48.95224,-57.92207,2018-05-03 13:00:00,35,3,38
"29230",10602,"Corner Brook","NL",48.95224,-57.92207,2018-05-03 14:00:00,36,3,39
"29231",10602,"Corner Brook","NL",48.95224,-57.92207,2018-05-03 15:00:00,36,3,39
"29232",10602,"Corner Brook","NL",48.95224,-57.92207,2018-05-03 16:00:00,35,2,37
"29233",10602,"Corner Brook","NL",48.95224,-57.92207,2018-05-03 17:00:00,35,1,36
"29234",10602,"Corner Brook","NL",48.95224,-57.92207,2018-05-03 18:00:00,35,1,36
"29235",10602,"Corner Brook","NL",48.95224,-57.92207,2018-05-03 19:00:00,33,1,34
"29236",10602,"Corner Brook","NL",48.95224,-57.92207,2018-05-03 20:00:00,31,2,33
"29237",10602,"Corner Brook","NL",48.95224,-57.92207,2018-05-03 21:00:00,30,2,32
"29238",10602,"Corner Brook","NL",48.95224,-57.92207,2018-05-03 22:00:00,35,1,36
"29239",10602,"Corner Brook","NL",48.95224,-57.92207,2018-05-03 23:00:00,36,1,37
"29240",10602,"Corner Brook","NL",48.95224,-57.92207,2018-05-04 00:00:00,36,1,37
"29241",10602,"Corner Brook","NL",48.95224,-57.92207,2018-05-04 01:00:00,34,1,35
"29242",10602,"Corner Brook","NL",48.95224,-57.92207,2018-05-04 02:00:00,33,1,34
"29243",10602,"Corner Brook","NL",48.95224,-57.92207,2018-05-04 03:00:00,32,1,33
"29244",10602,"Corner Brook","NL",48.95224,-57.92207,2018-05-04 04:00:00,31,1,32
"29245",10602,"Corner Brook","NL",48.95224,-57.92207,2018-05-04 05:00:00,30,1,31
"29246",10602,"Corner Brook","NL",48.95224,-57.92207,2018-05-04 06:00:00,28,2,30
"29247",10602,"Corner Brook","NL",48.95224,-57.92207,2018-05-04 07:00:00,28,3,31
"29248",10602,"Corner Brook","NL",48.95224,-57.92207,2018-05-04 08:00:00,28,4,32
"29249",10602,"Corner Brook","NL",48.95224,-57.92207,2018-05-04 09:00:00,31,2,33
"29250",10602,"Corner Brook","NL",48.95224,-57.92207,2018-05-04 10:00:00,32,1,33
"29251",10602,"Corner Brook","NL",48.95224,-57.92207,2018-05-04 11:00:00,32,1,33
"29252",10602,"Corner Brook","NL",48.95224,-57.92207,2018-05-04 12:00:00,32,2,34
"29253",10602,"Corner Brook","NL",48.95224,-57.92207,2018-05-04 13:00:00,32,2,34
"29254",10602,"Corner Brook","NL",48.95224,-57.92207,2018-05-04 14:00:00,31,2,33
"29255",10602,"Corner Brook","NL",48.95224,-57.92207,2018-05-04 15:00:00,34,1,35
"29256",10602,"Corner Brook","NL",48.95224,-57.92207,2018-05-04 16:00:00,34,1,35
"29257",10602,"Corner Brook","NL",48.95224,-57.92207,2018-05-04 17:00:00,33,2,35
"29258",10602,"Corner Brook","NL",48.95224,-57.92207,2018-05-04 18:00:00,32,1,33
"29259",10602,"Corner Brook","NL",48.95224,-57.92207,2018-05-04 19:00:00,31,2,33
"29260",10602,"Corner Brook","NL",48.95224,-57.92207,2018-05-04 20:00:00,29,3,32
"29261",10602,"Corner Brook","NL",48.95224,-57.92207,2018-05-04 21:00:00,28,2,30
"29262",10602,"Corner Brook","NL",48.95224,-57.92207,2018-05-04 22:00:00,29,2,31
"29263",10602,"Corner Brook","NL",48.95224,-57.92207,2018-05-04 23:00:00,30,2,32
"29264",10602,"Corner Brook","NL",48.95224,-57.92207,2018-05-05 00:00:00,30,1,31
"29265",10602,"Corner Brook","NL",48.95224,-57.92207,2018-05-05 01:00:00,32,1,33
"29266",10602,"Corner Brook","NL",48.95224,-57.92207,2018-05-05 02:00:00,32,1,33
"29267",10602,"Corner Brook","NL",48.95224,-57.92207,2018-05-05 03:00:00,32,1,33
"29268",10602,"Corner Brook","NL",48.95224,-57.92207,2018-05-05 04:00:00,31,1,32
"29269",10602,"Corner Brook","NL",48.95224,-57.92207,2018-05-05 05:00:00,27,1,28
"29270",10602,"Corner Brook","NL",48.95224,-57.92207,2018-05-05 06:00:00,23,2,25
"29271",10602,"Corner Brook","NL",48.95224,-57.92207,2018-05-05 07:00:00,29,2,31
"29272",10602,"Corner Brook","NL",48.95224,-57.92207,2018-05-05 08:00:00,33,1,34
"29273",10602,"Corner Brook","NL",48.95224,-57.92207,2018-05-05 09:00:00,34,1,35
"29274",10602,"Corner Brook","NL",48.95224,-57.92207,2018-05-05 10:00:00,35,1,36
"29275",10602,"Corner Brook","NL",48.95224,-57.92207,2018-05-05 11:00:00,35,1,36
"29276",10602,"Corner Brook","NL",48.95224,-57.92207,2018-05-05 12:00:00,36,2,38
"29277",10602,"Corner Brook","NL",48.95224,-57.92207,2018-05-05 13:00:00,38,1,39
"29278",10602,"Corner Brook","NL",48.95224,-57.92207,2018-05-05 14:00:00,37,1,38
"29279",10602,"Corner Brook","NL",48.95224,-57.92207,2018-05-05 15:00:00,38,1,39
"29280",10602,"Corner Brook","NL",48.95224,-57.92207,2018-05-05 16:00:00,34,1,35
"29281",10602,"Corner Brook","NL",48.95224,-57.92207,2018-05-05 17:00:00,30,1,31
"29282",10602,"Corner Brook","NL",48.95224,-57.92207,2018-05-05 18:00:00,33,1,34
"29283",10602,"Corner Brook","NL",48.95224,-57.92207,2018-05-05 19:00:00,33,1,34
"29284",10602,"Corner Brook","NL",48.95224,-57.92207,2018-05-05 20:00:00,31,1,32
"29285",10602,"Corner Brook","NL",48.95224,-57.92207,2018-05-05 21:00:00,30,1,31
"29286",10602,"Corner Brook","NL",48.95224,-57.92207,2018-05-05 22:00:00,30,1,31
"29287",10602,"Corner Brook","NL",48.95224,-57.92207,2018-05-05 23:00:00,30,1,31
"29288",10602,"Corner Brook","NL",48.95224,-57.92207,2018-05-06 00:00:00,32,1,33
"29289",10602,"Corner Brook","NL",48.95224,-57.92207,2018-05-06 01:00:00,36,1,37
"29290",10602,"Corner Brook","NL",48.95224,-57.92207,2018-05-06 02:00:00,32,4,36
"29291",10602,"Corner Brook","NL",48.95224,-57.92207,2018-05-06 03:00:00,32,4,36
"29292",10602,"Corner Brook","NL",48.95224,-57.92207,2018-05-06 04:00:00,29,5,34
"29293",10602,"Corner Brook","NL",48.95224,-57.92207,2018-05-06 05:00:00,24,8,32
"29294",10602,"Corner Brook","NL",48.95224,-57.92207,2018-05-06 06:00:00,30,2,32
"29295",10602,"Corner Brook","NL",48.95224,-57.92207,2018-05-06 07:00:00,31,1,32
"29296",10602,"Corner Brook","NL",48.95224,-57.92207,2018-05-06 08:00:00,31,1,32
"29297",10602,"Corner Brook","NL",48.95224,-57.92207,2018-05-06 09:00:00,31,1,32
"29298",10602,"Corner Brook","NL",48.95224,-57.92207,2018-05-06 10:00:00,31,1,32
"29299",10602,"Corner Brook","NL",48.95224,-57.92207,2018-05-06 11:00:00,30,2,32
"29300",10602,"Corner Brook","NL",48.95224,-57.92207,2018-05-06 12:00:00,29,3,32
"29301",10602,"Corner Brook","NL",48.95224,-57.92207,2018-05-06 13:00:00,30,3,33
"29302",10602,"Corner Brook","NL",48.95224,-57.92207,2018-05-06 14:00:00,32,2,34
"29303",10602,"Corner Brook","NL",48.95224,-57.92207,2018-05-06 15:00:00,33,2,35
"29304",10602,"Corner Brook","NL",48.95224,-57.92207,2018-05-06 16:00:00,34,4,38
"29305",10602,"Corner Brook","NL",48.95224,-57.92207,2018-05-06 17:00:00,34,6,40
"29306",10602,"Corner Brook","NL",48.95224,-57.92207,2018-05-06 18:00:00,30,9,39
"29307",10602,"Corner Brook","NL",48.95224,-57.92207,2018-05-06 19:00:00,36,2,38
"29308",10602,"Corner Brook","NL",48.95224,-57.92207,2018-05-06 20:00:00,32,1,33
"29309",10602,"Corner Brook","NL",48.95224,-57.92207,2018-05-06 21:00:00,28,2,30
"29310",10602,"Corner Brook","NL",48.95224,-57.92207,2018-05-06 22:00:00,29,1,30
"29311",10602,"Corner Brook","NL",48.95224,-57.92207,2018-05-06 23:00:00,29,2,31
"29312",10602,"Corner Brook","NL",48.95224,-57.92207,2018-05-07 00:00:00,27,2,29
"29313",10602,"Corner Brook","NL",48.95224,-57.92207,2018-05-07 01:00:00,24,2,26
"29314",10602,"Corner Brook","NL",48.95224,-57.92207,2018-05-07 02:00:00,18,3,21
"29315",10602,"Corner Brook","NL",48.95224,-57.92207,2018-05-07 03:00:00,19,3,22
"29316",10602,"Corner Brook","NL",48.95224,-57.92207,2018-05-07 04:00:00,17,3,20
"29317",10602,"Corner Brook","NL",48.95224,-57.92207,2018-05-07 05:00:00,16,4,20
"29318",10602,"Corner Brook","NL",48.95224,-57.92207,2018-05-07 06:00:00,11,8,19
"29319",10602,"Corner Brook","NL",48.95224,-57.92207,2018-05-07 07:00:00,13,7,20
"29320",10602,"Corner Brook","NL",48.95224,-57.92207,2018-05-07 08:00:00,13,10,23
"29321",10602,"Corner Brook","NL",48.95224,-57.92207,2018-05-07 09:00:00,10,14,24
"29322",10602,"Corner Brook","NL",48.95224,-57.92207,2018-05-07 10:00:00,16,13,29
"29323",10602,"Corner Brook","NL",48.95224,-57.92207,2018-05-07 11:00:00,31,3,34
"29324",10602,"Corner Brook","NL",48.95224,-57.92207,2018-05-07 12:00:00,31,3,34
"29325",10602,"Corner Brook","NL",48.95224,-57.92207,2018-05-07 13:00:00,29,8,37
"29326",10602,"Corner Brook","NL",48.95224,-57.92207,2018-05-07 14:00:00,34,5,39
"29327",10602,"Corner Brook","NL",48.95224,-57.92207,2018-05-07 15:00:00,42,1,43
"29328",10602,"Corner Brook","NL",48.95224,-57.92207,2018-05-07 16:00:00,33,6,39
"29329",10602,"Corner Brook","NL",48.95224,-57.92207,2018-05-07 17:00:00,31,7,38
"29330",10602,"Corner Brook","NL",48.95224,-57.92207,2018-05-07 18:00:00,32,3,35
"29331",10602,"Corner Brook","NL",48.95224,-57.92207,2018-05-07 19:00:00,34,2,36
"29332",10602,"Corner Brook","NL",48.95224,-57.92207,2018-05-07 20:00:00,28,9,37
"29333",10602,"Corner Brook","NL",48.95224,-57.92207,2018-05-07 21:00:00,35,2,37
"29334",10602,"Corner Brook","NL",48.95224,-57.92207,2018-05-07 22:00:00,37,1,38
"29335",10602,"Corner Brook","NL",48.95224,-57.92207,2018-05-07 23:00:00,37,3,40
"29336",10602,"Corner Brook","NL",48.95224,-57.92207,2018-05-08 00:00:00,35,4,39
"29337",10602,"Corner Brook","NL",48.95224,-57.92207,2018-05-08 01:00:00,32,7,39
"29338",10602,"Corner Brook","NL",48.95224,-57.92207,2018-05-08 02:00:00,34,4,38
"29339",10602,"Corner Brook","NL",48.95224,-57.92207,2018-05-08 03:00:00,32,4,36
"29340",10602,"Corner Brook","NL",48.95224,-57.92207,2018-05-08 04:00:00,34,2,36
"29341",10602,"Corner Brook","NL",48.95224,-57.92207,2018-05-08 05:00:00,36,2,38
"29342",10602,"Corner Brook","NL",48.95224,-57.92207,2018-05-08 06:00:00,34,1,35
"29343",10602,"Corner Brook","NL",48.95224,-57.92207,2018-05-08 07:00:00,33,2,35
"29344",10602,"Corner Brook","NL",48.95224,-57.92207,2018-05-08 08:00:00,36,1,37
"29345",10602,"Corner Brook","NL",48.95224,-57.92207,2018-05-08 09:00:00,38,1,39
"29346",10602,"Corner Brook","NL",48.95224,-57.92207,2018-05-08 10:00:00,40,1,41
"29347",10602,"Corner Brook","NL",48.95224,-57.92207,2018-05-08 11:00:00,43,1,44
"29348",10602,"Corner Brook","NL",48.95224,-57.92207,2018-05-08 12:00:00,45,1,46
"29349",10602,"Corner Brook","NL",48.95224,-57.92207,2018-05-08 13:00:00,46,1,47
"29350",10602,"Corner Brook","NL",48.95224,-57.92207,2018-05-08 14:00:00,47,1,48
"29351",10602,"Corner Brook","NL",48.95224,-57.92207,2018-05-08 15:00:00,45,1,46
"29352",10602,"Corner Brook","NL",48.95224,-57.92207,2018-05-08 16:00:00,46,1,47
"29353",10602,"Corner Brook","NL",48.95224,-57.92207,2018-05-08 17:00:00,45,1,46
"29354",10602,"Corner Brook","NL",48.95224,-57.92207,2018-05-08 18:00:00,44,1,45
"29355",10602,"Corner Brook","NL",48.95224,-57.92207,2018-05-08 19:00:00,43,1,44
"29356",10602,"Corner Brook","NL",48.95224,-57.92207,2018-05-08 20:00:00,42,1,43
"29357",10602,"Corner Brook","NL",48.95224,-57.92207,2018-05-08 21:00:00,41,1,42
"29358",10602,"Corner Brook","NL",48.95224,-57.92207,2018-05-08 22:00:00,41,1,42
"29359",10602,"Corner Brook","NL",48.95224,-57.92207,2018-05-08 23:00:00,41,0,41
"29360",10602,"Corner Brook","NL",48.95224,-57.92207,2018-05-09 00:00:00,42,0,42
"29361",10602,"Corner Brook","NL",48.95224,-57.92207,2018-05-09 01:00:00,42,1,43
"29362",10602,"Corner Brook","NL",48.95224,-57.92207,2018-05-09 02:00:00,42,1,43
"29363",10602,"Corner Brook","NL",48.95224,-57.92207,2018-05-09 03:00:00,39,2,41
"29364",10602,"Corner Brook","NL",48.95224,-57.92207,2018-05-09 04:00:00,39,2,41
"29365",10602,"Corner Brook","NL",48.95224,-57.92207,2018-05-09 05:00:00,41,1,42
"29366",10602,"Corner Brook","NL",48.95224,-57.92207,2018-05-09 06:00:00,41,1,42
"29367",10602,"Corner Brook","NL",48.95224,-57.92207,2018-05-09 07:00:00,39,4,43
"29368",10602,"Corner Brook","NL",48.95224,-57.92207,2018-05-09 08:00:00,40,4,44
"29369",10602,"Corner Brook","NL",48.95224,-57.92207,2018-05-09 09:00:00,41,2,43
"29370",10602,"Corner Brook","NL",48.95224,-57.92207,2018-05-09 10:00:00,38,4,42
"29371",10602,"Corner Brook","NL",48.95224,-57.92207,2018-05-09 11:00:00,37,4,41
"29372",10602,"Corner Brook","NL",48.95224,-57.92207,2018-05-09 12:00:00,38,2,40
"29373",10602,"Corner Brook","NL",48.95224,-57.92207,2018-05-09 13:00:00,38,1,39
"29374",10602,"Corner Brook","NL",48.95224,-57.92207,2018-05-09 14:00:00,38,1,39
"29375",10602,"Corner Brook","NL",48.95224,-57.92207,2018-05-09 15:00:00,37,1,38
"29376",10602,"Corner Brook","NL",48.95224,-57.92207,2018-05-09 16:00:00,36,1,37
"29377",10602,"Corner Brook","NL",48.95224,-57.92207,2018-05-09 17:00:00,36,1,37
"29378",10602,"Corner Brook","NL",48.95224,-57.92207,2018-05-09 18:00:00,35,3,38
"29379",10602,"Corner Brook","NL",48.95224,-57.92207,2018-05-09 19:00:00,35,3,38
"29380",10602,"Corner Brook","NL",48.95224,-57.92207,2018-05-09 20:00:00,36,2,38
"29381",10602,"Corner Brook","NL",48.95224,-57.92207,2018-05-09 21:00:00,32,3,35
"29382",10602,"Corner Brook","NL",48.95224,-57.92207,2018-05-09 22:00:00,28,4,32
"29383",10602,"Corner Brook","NL",48.95224,-57.92207,2018-05-09 23:00:00,22,6,28
"29384",10602,"Corner Brook","NL",48.95224,-57.92207,2018-05-10 00:00:00,27,3,30
"29385",10602,"Corner Brook","NL",48.95224,-57.92207,2018-05-10 01:00:00,22,6,28
"29386",10602,"Corner Brook","NL",48.95224,-57.92207,2018-05-10 02:00:00,26,3,29
"29387",10602,"Corner Brook","NL",48.95224,-57.92207,2018-05-10 03:00:00,23,4,27
"29388",10602,"Corner Brook","NL",48.95224,-57.92207,2018-05-10 04:00:00,23,3,26
"29389",10602,"Corner Brook","NL",48.95224,-57.92207,2018-05-10 05:00:00,20,5,25
"29390",10602,"Corner Brook","NL",48.95224,-57.92207,2018-05-10 06:00:00,16,8,24
"29391",10602,"Corner Brook","NL",48.95224,-57.92207,2018-05-10 07:00:00,17,9,26
"29392",10602,"Corner Brook","NL",48.95224,-57.92207,2018-05-10 08:00:00,23,8,31
"29393",10602,"Corner Brook","NL",48.95224,-57.92207,2018-05-10 09:00:00,34,4,38
"29394",10602,"Corner Brook","NL",48.95224,-57.92207,2018-05-10 10:00:00,39,1,40
"29395",10602,"Corner Brook","NL",48.95224,-57.92207,2018-05-10 11:00:00,40,1,41
"29396",10602,"Corner Brook","NL",48.95224,-57.92207,2018-05-10 12:00:00,39,0,39
"29397",10602,"Corner Brook","NL",48.95224,-57.92207,2018-05-10 13:00:00,40,1,41
"29398",10602,"Corner Brook","NL",48.95224,-57.92207,2018-05-10 14:00:00,40,1,41
"29399",10602,"Corner Brook","NL",48.95224,-57.92207,2018-05-10 15:00:00,42,1,43
"29400",10602,"Corner Brook","NL",48.95224,-57.92207,2018-05-10 16:00:00,43,1,44
"29401",10602,"Corner Brook","NL",48.95224,-57.92207,2018-05-10 17:00:00,46,1,47
"29402",10602,"Corner Brook","NL",48.95224,-57.92207,2018-05-10 18:00:00,47,1,48
"29403",10602,"Corner Brook","NL",48.95224,-57.92207,2018-05-10 19:00:00,46,1,47
"29404",10602,"Corner Brook","NL",48.95224,-57.92207,2018-05-10 20:00:00,43,1,44
"29405",10602,"Corner Brook","NL",48.95224,-57.92207,2018-05-10 21:00:00,44,2,46
"29406",10602,"Corner Brook","NL",48.95224,-57.92207,2018-05-10 22:00:00,45,1,46
"29407",10602,"Corner Brook","NL",48.95224,-57.92207,2018-05-10 23:00:00,44,1,45
"29408",10602,"Corner Brook","NL",48.95224,-57.92207,2018-05-11 00:00:00,41,1,42
"29409",10602,"Corner Brook","NL",48.95224,-57.92207,2018-05-11 01:00:00,38,1,39
"29410",10602,"Corner Brook","NL",48.95224,-57.92207,2018-05-11 02:00:00,36,2,38
"29411",10602,"Corner Brook","NL",48.95224,-57.92207,2018-05-11 03:00:00,34,1,35
"29412",10602,"Corner Brook","NL",48.95224,-57.92207,2018-05-11 04:00:00,31,2,33
"29413",10602,"Corner Brook","NL",48.95224,-57.92207,2018-05-11 05:00:00,25,4,29
"29414",10602,"Corner Brook","NL",48.95224,-57.92207,2018-05-11 06:00:00,28,3,31
"29415",10602,"Corner Brook","NL",48.95224,-57.92207,2018-05-11 07:00:00,30,2,32
"29416",10602,"Corner Brook","NL",48.95224,-57.92207,2018-05-11 08:00:00,30,1,31
"29417",10602,"Corner Brook","NL",48.95224,-57.92207,2018-05-11 09:00:00,31,1,32
"29418",10602,"Corner Brook","NL",48.95224,-57.92207,2018-05-11 10:00:00,33,2,35
"29419",10602,"Corner Brook","NL",48.95224,-57.92207,2018-05-11 11:00:00,36,1,37
"29420",10602,"Corner Brook","NL",48.95224,-57.92207,2018-05-11 12:00:00,34,1,35
"29421",10602,"Corner Brook","NL",48.95224,-57.92207,2018-05-11 13:00:00,31,2,33
"29422",10602,"Corner Brook","NL",48.95224,-57.92207,2018-05-11 14:00:00,27,2,29
"29423",10602,"Corner Brook","NL",48.95224,-57.92207,2018-05-11 15:00:00,29,3,32
"29424",10602,"Corner Brook","NL",48.95224,-57.92207,2018-05-11 16:00:00,31,1,32
"29425",10602,"Corner Brook","NL",48.95224,-57.92207,2018-05-11 17:00:00,30,1,31
"29426",10602,"Corner Brook","NL",48.95224,-57.92207,2018-05-11 18:00:00,28,1,29
"29427",10602,"Corner Brook","NL",48.95224,-57.92207,2018-05-11 19:00:00,26,2,28
"29428",10602,"Corner Brook","NL",48.95224,-57.92207,2018-05-11 20:00:00,26,1,27
"29429",10602,"Corner Brook","NL",48.95224,-57.92207,2018-05-11 21:00:00,26,1,27
"29430",10602,"Corner Brook","NL",48.95224,-57.92207,2018-05-11 22:00:00,27,1,28
"29431",10602,"Corner Brook","NL",48.95224,-57.92207,2018-05-11 23:00:00,26,1,27
"29432",10602,"Corner Brook","NL",48.95224,-57.92207,2018-05-12 00:00:00,27,1,28
"29433",10602,"Corner Brook","NL",48.95224,-57.92207,2018-05-12 01:00:00,28,1,29
"29434",10602,"Corner Brook","NL",48.95224,-57.92207,2018-05-12 02:00:00,29,1,30
"29435",10602,"Corner Brook","NL",48.95224,-57.92207,2018-05-12 03:00:00,28,2,30
"29436",10602,"Corner Brook","NL",48.95224,-57.92207,2018-05-12 04:00:00,29,1,30
"29437",10602,"Corner Brook","NL",48.95224,-57.92207,2018-05-12 05:00:00,29,1,30
"29438",10602,"Corner Brook","NL",48.95224,-57.92207,2018-05-12 06:00:00,28,2,30
"29439",10602,"Corner Brook","NL",48.95224,-57.92207,2018-05-12 07:00:00,28,3,31
"29440",10602,"Corner Brook","NL",48.95224,-57.92207,2018-05-12 08:00:00,29,5,34
"29441",10602,"Corner Brook","NL",48.95224,-57.92207,2018-05-12 09:00:00,30,6,36
"29442",10602,"Corner Brook","NL",48.95224,-57.92207,2018-05-12 10:00:00,30,7,37
"29443",10602,"Corner Brook","NL",48.95224,-57.92207,2018-05-12 11:00:00,33,3,36
"29444",10602,"Corner Brook","NL",48.95224,-57.92207,2018-05-12 12:00:00,34,3,37
"29445",10602,"Corner Brook","NL",48.95224,-57.92207,2018-05-12 13:00:00,35,1,36
"29446",10602,"Corner Brook","NL",48.95224,-57.92207,2018-05-12 14:00:00,36,2,38
"29447",10602,"Corner Brook","NL",48.95224,-57.92207,2018-05-12 15:00:00,38,1,39
"29448",10602,"Corner Brook","NL",48.95224,-57.92207,2018-05-12 16:00:00,38,1,39
"29449",10602,"Corner Brook","NL",48.95224,-57.92207,2018-05-12 17:00:00,39,1,40
"29450",10602,"Corner Brook","NL",48.95224,-57.92207,2018-05-12 18:00:00,39,1,40
"29451",10602,"Corner Brook","NL",48.95224,-57.92207,2018-05-12 19:00:00,38,1,39
"29452",10602,"Corner Brook","NL",48.95224,-57.92207,2018-05-12 20:00:00,36,2,38
"29453",10602,"Corner Brook","NL",48.95224,-57.92207,2018-05-12 21:00:00,36,2,38
"29454",10602,"Corner Brook","NL",48.95224,-57.92207,2018-05-12 22:00:00,35,1,36
"29455",10602,"Corner Brook","NL",48.95224,-57.92207,2018-05-12 23:00:00,34,1,35
"29456",10602,"Corner Brook","NL",48.95224,-57.92207,2018-05-13 00:00:00,34,2,36
"29457",10602,"Corner Brook","NL",48.95224,-57.92207,2018-05-13 01:00:00,35,2,37
"29458",10602,"Corner Brook","NL",48.95224,-57.92207,2018-05-13 02:00:00,34,2,36
"29459",10602,"Corner Brook","NL",48.95224,-57.92207,2018-05-13 03:00:00,34,1,35
"29460",10602,"Corner Brook","NL",48.95224,-57.92207,2018-05-13 04:00:00,35,2,37
"29461",10602,"Corner Brook","NL",48.95224,-57.92207,2018-05-13 05:00:00,34,2,36
"29462",10602,"Corner Brook","NL",48.95224,-57.92207,2018-05-13 06:00:00,32,4,36
"29463",10602,"Corner Brook","NL",48.95224,-57.92207,2018-05-13 07:00:00,33,2,35
"29464",10602,"Corner Brook","NL",48.95224,-57.92207,2018-05-13 08:00:00,32,3,35
"29465",10602,"Corner Brook","NL",48.95224,-57.92207,2018-05-13 09:00:00,28,7,35
"29466",10602,"Corner Brook","NL",48.95224,-57.92207,2018-05-13 10:00:00,30,6,36
"29467",10602,"Corner Brook","NL",48.95224,-57.92207,2018-05-13 11:00:00,29,13,42
"29468",10602,"Corner Brook","NL",48.95224,-57.92207,2018-05-13 12:00:00,37,6,43
"29469",10602,"Corner Brook","NL",48.95224,-57.92207,2018-05-13 13:00:00,39,4,43
"29470",10602,"Corner Brook","NL",48.95224,-57.92207,2018-05-13 14:00:00,37,5,42
"29471",10602,"Corner Brook","NL",48.95224,-57.92207,2018-05-13 15:00:00,37,4,41
"29472",10602,"Corner Brook","NL",48.95224,-57.92207,2018-05-13 16:00:00,39,3,42
"29473",10602,"Corner Brook","NL",48.95224,-57.92207,2018-05-13 17:00:00,38,5,43
"29474",10602,"Corner Brook","NL",48.95224,-57.92207,2018-05-13 18:00:00,34,7,41
"29475",10602,"Corner Brook","NL",48.95224,-57.92207,2018-05-13 19:00:00,32,8,40
"29476",10602,"Corner Brook","NL",48.95224,-57.92207,2018-05-13 20:00:00,37,2,39
"29477",10602,"Corner Brook","NL",48.95224,-57.92207,2018-05-13 21:00:00,37,1,38
"29478",10602,"Corner Brook","NL",48.95224,-57.92207,2018-05-13 22:00:00,32,1,33
"29479",10602,"Corner Brook","NL",48.95224,-57.92207,2018-05-13 23:00:00,34,1,35
"29480",10602,"Corner Brook","NL",48.95224,-57.92207,2018-05-14 00:00:00,37,1,38
"29481",10602,"Corner Brook","NL",48.95224,-57.92207,2018-05-14 01:00:00,38,1,39
"29482",10602,"Corner Brook","NL",48.95224,-57.92207,2018-05-14 02:00:00,40,0,40
"29483",10602,"Corner Brook","NL",48.95224,-57.92207,2018-05-14 03:00:00,40,1,41
"29484",10602,"Corner Brook","NL",48.95224,-57.92207,2018-05-14 04:00:00,32,4,36
"29485",10602,"Corner Brook","NL",48.95224,-57.92207,2018-05-14 05:00:00,33,3,36
"29486",10602,"Corner Brook","NL",48.95224,-57.92207,2018-05-14 06:00:00,39,2,41
"29487",10602,"Corner Brook","NL",48.95224,-57.92207,2018-05-14 07:00:00,41,1,42
"29488",10602,"Corner Brook","NL",48.95224,-57.92207,2018-05-14 08:00:00,41,1,42
"29489",10602,"Corner Brook","NL",48.95224,-57.92207,2018-05-14 09:00:00,41,1,42
"29490",10602,"Corner Brook","NL",48.95224,-57.92207,2018-05-14 10:00:00,44,1,45
"29491",10602,"Corner Brook","NL",48.95224,-57.92207,2018-05-14 11:00:00,46,1,47
"29492",10602,"Corner Brook","NL",48.95224,-57.92207,2018-05-14 12:00:00,45,1,46
"29493",10602,"Corner Brook","NL",48.95224,-57.92207,2018-05-14 13:00:00,45,1,46
"29494",10602,"Corner Brook","NL",48.95224,-57.92207,2018-05-14 14:00:00,44,1,45
"29495",10602,"Corner Brook","NL",48.95224,-57.92207,2018-05-14 15:00:00,45,1,46
"29496",10602,"Corner Brook","NL",48.95224,-57.92207,2018-05-14 16:00:00,46,0,46
"29497",10602,"Corner Brook","NL",48.95224,-57.92207,2018-05-14 17:00:00,47,0,47
"29498",10602,"Corner Brook","NL",48.95224,-57.92207,2018-05-14 18:00:00,46,0,46
"29499",10602,"Corner Brook","NL",48.95224,-57.92207,2018-05-14 19:00:00,44,0,44
"29500",10602,"Corner Brook","NL",48.95224,-57.92207,2018-05-14 20:00:00,41,1,42
"29501",10602,"Corner Brook","NL",48.95224,-57.92207,2018-05-14 21:00:00,40,1,41
"29502",10602,"Corner Brook","NL",48.95224,-57.92207,2018-05-14 22:00:00,39,1,40
"29503",10602,"Corner Brook","NL",48.95224,-57.92207,2018-05-14 23:00:00,38,1,39
"29504",10602,"Corner Brook","NL",48.95224,-57.92207,2018-05-15 00:00:00,36,1,37
"29505",10602,"Corner Brook","NL",48.95224,-57.92207,2018-05-15 01:00:00,36,1,37
"29506",10602,"Corner Brook","NL",48.95224,-57.92207,2018-05-15 02:00:00,35,2,37
"29507",10602,"Corner Brook","NL",48.95224,-57.92207,2018-05-15 03:00:00,34,3,37
"29508",10602,"Corner Brook","NL",48.95224,-57.92207,2018-05-15 04:00:00,37,2,39
"29509",10602,"Corner Brook","NL",48.95224,-57.92207,2018-05-15 05:00:00,37,1,38
"29510",10602,"Corner Brook","NL",48.95224,-57.92207,2018-05-15 06:00:00,35,1,36
"29511",10602,"Corner Brook","NL",48.95224,-57.92207,2018-05-15 07:00:00,37,2,39
"29512",10602,"Corner Brook","NL",48.95224,-57.92207,2018-05-15 08:00:00,39,1,40
"29513",10602,"Corner Brook","NL",48.95224,-57.92207,2018-05-15 09:00:00,39,1,40
"29514",10602,"Corner Brook","NL",48.95224,-57.92207,2018-05-15 10:00:00,39,1,40
"29515",10602,"Corner Brook","NL",48.95224,-57.92207,2018-05-15 11:00:00,41,1,42
"29516",10602,"Corner Brook","NL",48.95224,-57.92207,2018-05-15 12:00:00,41,1,42
"29517",10602,"Corner Brook","NL",48.95224,-57.92207,2018-05-15 13:00:00,41,1,42
"29518",10602,"Corner Brook","NL",48.95224,-57.92207,2018-05-15 14:00:00,43,1,44
"29519",10602,"Corner Brook","NL",48.95224,-57.92207,2018-05-15 15:00:00,44,1,45
"29520",10602,"Corner Brook","NL",48.95224,-57.92207,2018-05-15 16:00:00,46,1,47
"29521",10602,"Corner Brook","NL",48.95224,-57.92207,2018-05-15 17:00:00,46,1,47
"29522",10602,"Corner Brook","NL",48.95224,-57.92207,2018-05-15 18:00:00,44,1,45
"29523",10602,"Corner Brook","NL",48.95224,-57.92207,2018-05-15 19:00:00,41,1,42
"29524",10602,"Corner Brook","NL",48.95224,-57.92207,2018-05-15 20:00:00,41,1,42
"29525",10602,"Corner Brook","NL",48.95224,-57.92207,2018-05-15 21:00:00,43,1,44
"29526",10602,"Corner Brook","NL",48.95224,-57.92207,2018-05-15 22:00:00,40,1,41
"29527",10602,"Corner Brook","NL",48.95224,-57.92207,2018-05-15 23:00:00,38,2,40
"29528",10602,"Corner Brook","NL",48.95224,-57.92207,2018-05-16 00:00:00,40,3,43
"29529",10602,"Corner Brook","NL",48.95224,-57.92207,2018-05-16 01:00:00,42,2,44
"29530",10602,"Corner Brook","NL",48.95224,-57.92207,2018-05-16 02:00:00,42,2,44
"29531",10602,"Corner Brook","NL",48.95224,-57.92207,2018-05-16 03:00:00,37,3,40
"29532",10602,"Corner Brook","NL",48.95224,-57.92207,2018-05-16 04:00:00,34,1,35
"29533",10602,"Corner Brook","NL",48.95224,-57.92207,2018-05-16 05:00:00,34,1,35
"29534",10602,"Corner Brook","NL",48.95224,-57.92207,2018-05-16 06:00:00,32,1,33
"29535",10602,"Corner Brook","NL",48.95224,-57.92207,2018-05-16 07:00:00,31,1,32
"29536",10602,"Corner Brook","NL",48.95224,-57.92207,2018-05-16 08:00:00,32,1,33
"29537",10602,"Corner Brook","NL",48.95224,-57.92207,2018-05-16 09:00:00,29,1,30
"29538",10602,"Corner Brook","NL",48.95224,-57.92207,2018-05-16 10:00:00,26,1,27
"29539",10602,"Corner Brook","NL",48.95224,-57.92207,2018-05-16 11:00:00,24,2,26
"29540",10602,"Corner Brook","NL",48.95224,-57.92207,2018-05-16 12:00:00,26,1,27
"29541",10602,"Corner Brook","NL",48.95224,-57.92207,2018-05-16 13:00:00,23,1,24
"29542",10602,"Corner Brook","NL",48.95224,-57.92207,2018-05-16 14:00:00,23,1,24
"29543",10602,"Corner Brook","NL",48.95224,-57.92207,2018-05-16 15:00:00,21,1,22
"29544",10602,"Corner Brook","NL",48.95224,-57.92207,2018-05-16 16:00:00,24,1,25
"29545",10602,"Corner Brook","NL",48.95224,-57.92207,2018-05-16 17:00:00,25,1,26
"29546",10602,"Corner Brook","NL",48.95224,-57.92207,2018-05-16 18:00:00,27,1,28
"29547",10602,"Corner Brook","NL",48.95224,-57.92207,2018-05-16 19:00:00,29,1,30
"29548",10602,"Corner Brook","NL",48.95224,-57.92207,2018-05-16 20:00:00,29,1,30
"29549",10602,"Corner Brook","NL",48.95224,-57.92207,2018-05-16 21:00:00,24,1,25
"29550",10602,"Corner Brook","NL",48.95224,-57.92207,2018-05-16 22:00:00,25,1,26
"29551",10602,"Corner Brook","NL",48.95224,-57.92207,2018-05-16 23:00:00,26,2,28
"29552",10602,"Corner Brook","NL",48.95224,-57.92207,2018-05-17 00:00:00,26,1,27
"29553",10602,"Corner Brook","NL",48.95224,-57.92207,2018-05-17 01:00:00,25,1,26
"29554",10602,"Corner Brook","NL",48.95224,-57.92207,2018-05-17 02:00:00,26,2,28
"29555",10602,"Corner Brook","NL",48.95224,-57.92207,2018-05-17 03:00:00,29,2,31
"29556",10602,"Corner Brook","NL",48.95224,-57.92207,2018-05-17 04:00:00,31,2,33
"29557",10602,"Corner Brook","NL",48.95224,-57.92207,2018-05-17 05:00:00,33,2,35
"29558",10602,"Corner Brook","NL",48.95224,-57.92207,2018-05-17 06:00:00,31,2,33
"29559",10602,"Corner Brook","NL",48.95224,-57.92207,2018-05-17 07:00:00,32,2,34
"29560",10602,"Corner Brook","NL",48.95224,-57.92207,2018-05-17 08:00:00,35,2,37
"29561",10602,"Corner Brook","NL",48.95224,-57.92207,2018-05-17 09:00:00,36,1,37
"29562",10602,"Corner Brook","NL",48.95224,-57.92207,2018-05-17 10:00:00,34,1,35
"29563",10602,"Corner Brook","NL",48.95224,-57.92207,2018-05-17 11:00:00,35,1,36
"29564",10602,"Corner Brook","NL",48.95224,-57.92207,2018-05-17 12:00:00,35,1,36
"29565",10602,"Corner Brook","NL",48.95224,-57.92207,2018-05-17 13:00:00,36,2,38
"29566",10602,"Corner Brook","NL",48.95224,-57.92207,2018-05-17 14:00:00,34,2,36
"29567",10602,"Corner Brook","NL",48.95224,-57.92207,2018-05-17 15:00:00,31,3,34
"29568",10602,"Corner Brook","NL",48.95224,-57.92207,2018-05-17 16:00:00,32,3,35
"29569",10602,"Corner Brook","NL",48.95224,-57.92207,2018-05-17 17:00:00,29,2,31
"29570",10602,"Corner Brook","NL",48.95224,-57.92207,2018-05-17 18:00:00,28,3,31
"29571",10602,"Corner Brook","NL",48.95224,-57.92207,2018-05-17 19:00:00,30,1,31
"29572",10602,"Corner Brook","NL",48.95224,-57.92207,2018-05-17 20:00:00,29,1,30
"29573",10602,"Corner Brook","NL",48.95224,-57.92207,2018-05-17 21:00:00,25,3,28
"29574",10602,"Corner Brook","NL",48.95224,-57.92207,2018-05-17 22:00:00,23,3,26
"29575",10602,"Corner Brook","NL",48.95224,-57.92207,2018-05-17 23:00:00,19,4,23
"29576",10602,"Corner Brook","NL",48.95224,-57.92207,2018-05-18 00:00:00,19,5,24
"29577",10602,"Corner Brook","NL",48.95224,-57.92207,2018-05-18 01:00:00,19,4,23
"29578",10602,"Corner Brook","NL",48.95224,-57.92207,2018-05-18 02:00:00,18,4,22
"29579",10602,"Corner Brook","NL",48.95224,-57.92207,2018-05-18 03:00:00,20,2,22
"29580",10602,"Corner Brook","NL",48.95224,-57.92207,2018-05-18 04:00:00,16,4,20
"29581",10602,"Corner Brook","NL",48.95224,-57.92207,2018-05-18 05:00:00,20,1,21
"29582",10602,"Corner Brook","NL",48.95224,-57.92207,2018-05-18 06:00:00,19,1,20
"29583",10602,"Corner Brook","NL",48.95224,-57.92207,2018-05-18 07:00:00,21,2,23
"29584",10602,"Corner Brook","NL",48.95224,-57.92207,2018-05-18 08:00:00,25,2,27
"29585",10602,"Corner Brook","NL",48.95224,-57.92207,2018-05-18 09:00:00,27,1,28
"29586",10602,"Corner Brook","NL",48.95224,-57.92207,2018-05-18 10:00:00,28,1,29
"29587",10602,"Corner Brook","NL",48.95224,-57.92207,2018-05-18 11:00:00,30,4,34
"29588",10602,"Corner Brook","NL",48.95224,-57.92207,2018-05-18 12:00:00,29,2,31
"29589",10602,"Corner Brook","NL",48.95224,-57.92207,2018-05-18 13:00:00,29,2,31
"29590",10602,"Corner Brook","NL",48.95224,-57.92207,2018-05-18 14:00:00,31,1,32
"29591",10602,"Corner Brook","NL",48.95224,-57.92207,2018-05-18 15:00:00,30,2,32
"29592",10602,"Corner Brook","NL",48.95224,-57.92207,2018-05-18 16:00:00,28,3,31
"29593",10602,"Corner Brook","NL",48.95224,-57.92207,2018-05-18 17:00:00,30,2,32
"29594",10602,"Corner Brook","NL",48.95224,-57.92207,2018-05-18 18:00:00,30,3,33
"29595",10602,"Corner Brook","NL",48.95224,-57.92207,2018-05-18 19:00:00,28,2,30
"29596",10602,"Corner Brook","NL",48.95224,-57.92207,2018-05-18 20:00:00,28,2,30
"29597",10602,"Corner Brook","NL",48.95224,-57.92207,2018-05-18 21:00:00,29,1,30
"29598",10602,"Corner Brook","NL",48.95224,-57.92207,2018-05-18 22:00:00,27,2,29
"29599",10602,"Corner Brook","NL",48.95224,-57.92207,2018-05-18 23:00:00,28,1,29
"29600",10602,"Corner Brook","NL",48.95224,-57.92207,2018-05-19 00:00:00,28,1,29
"29601",10602,"Corner Brook","NL",48.95224,-57.92207,2018-05-19 01:00:00,29,1,30
"29602",10602,"Corner Brook","NL",48.95224,-57.92207,2018-05-19 02:00:00,29,1,30
"29603",10602,"Corner Brook","NL",48.95224,-57.92207,2018-05-19 03:00:00,27,1,28
"29604",10602,"Corner Brook","NL",48.95224,-57.92207,2018-05-19 04:00:00,28,1,29
"29605",10602,"Corner Brook","NL",48.95224,-57.92207,2018-05-19 05:00:00,29,1,30
"29606",10602,"Corner Brook","NL",48.95224,-57.92207,2018-05-19 06:00:00,29,2,31
"29607",10602,"Corner Brook","NL",48.95224,-57.92207,2018-05-19 07:00:00,30,1,31
"29608",10602,"Corner Brook","NL",48.95224,-57.92207,2018-05-19 08:00:00,30,1,31
"29609",10602,"Corner Brook","NL",48.95224,-57.92207,2018-05-19 09:00:00,31,1,32
"29610",10602,"Corner Brook","NL",48.95224,-57.92207,2018-05-19 10:00:00,32,1,33
"29611",10602,"Corner Brook","NL",48.95224,-57.92207,2018-05-19 11:00:00,32,1,33
"29612",10602,"Corner Brook","NL",48.95224,-57.92207,2018-05-19 12:00:00,33,1,34
"29613",10602,"Corner Brook","NL",48.95224,-57.92207,2018-05-19 13:00:00,34,2,36
"29614",10602,"Corner Brook","NL",48.95224,-57.92207,2018-05-19 14:00:00,33,3,36
"29615",10602,"Corner Brook","NL",48.95224,-57.92207,2018-05-19 15:00:00,35,3,38
"29616",10602,"Corner Brook","NL",48.95224,-57.92207,2018-05-19 16:00:00,35,3,38
"29617",10602,"Corner Brook","NL",48.95224,-57.92207,2018-05-19 17:00:00,34,3,37
"29618",10602,"Corner Brook","NL",48.95224,-57.92207,2018-05-19 18:00:00,31,5,36
"29619",10602,"Corner Brook","NL",48.95224,-57.92207,2018-05-19 19:00:00,34,2,36
"29620",10602,"Corner Brook","NL",48.95224,-57.92207,2018-05-19 20:00:00,33,2,35
"29621",10602,"Corner Brook","NL",48.95224,-57.92207,2018-05-19 21:00:00,32,2,34
"29622",10602,"Corner Brook","NL",48.95224,-57.92207,2018-05-19 22:00:00,32,1,33
"29623",10602,"Corner Brook","NL",48.95224,-57.92207,2018-05-19 23:00:00,32,1,33
"29624",10602,"Corner Brook","NL",48.95224,-57.92207,2018-05-20 00:00:00,31,1,32
"29625",10602,"Corner Brook","NL",48.95224,-57.92207,2018-05-20 01:00:00,32,1,33
"29626",10602,"Corner Brook","NL",48.95224,-57.92207,2018-05-20 02:00:00,32,1,33
"29627",10602,"Corner Brook","NL",48.95224,-57.92207,2018-05-20 03:00:00,22,5,27
"29628",10602,"Corner Brook","NL",48.95224,-57.92207,2018-05-20 04:00:00,24,4,28
"29629",10602,"Corner Brook","NL",48.95224,-57.92207,2018-05-20 05:00:00,21,5,26
"29630",10602,"Corner Brook","NL",48.95224,-57.92207,2018-05-20 06:00:00,21,5,26
"29631",10602,"Corner Brook","NL",48.95224,-57.92207,2018-05-20 07:00:00,26,2,28
"29632",10602,"Corner Brook","NL",48.95224,-57.92207,2018-05-20 08:00:00,35,1,36
"29633",10602,"Corner Brook","NL",48.95224,-57.92207,2018-05-20 09:00:00,40,0,40
"29634",10602,"Corner Brook","NL",48.95224,-57.92207,2018-05-20 10:00:00,40,0,40
"29635",10602,"Corner Brook","NL",48.95224,-57.92207,2018-05-20 11:00:00,39,1,40
"29636",10602,"Corner Brook","NL",48.95224,-57.92207,2018-05-20 12:00:00,39,0,39
"29637",10602,"Corner Brook","NL",48.95224,-57.92207,2018-05-20 13:00:00,37,1,38
"29638",10602,"Corner Brook","NL",48.95224,-57.92207,2018-05-20 14:00:00,36,1,37
"29639",10602,"Corner Brook","NL",48.95224,-57.92207,2018-05-20 15:00:00,34,1,35
"29640",10602,"Corner Brook","NL",48.95224,-57.92207,2018-05-20 16:00:00,32,2,34
"29641",10602,"Corner Brook","NL",48.95224,-57.92207,2018-05-20 17:00:00,35,1,36
"29642",10602,"Corner Brook","NL",48.95224,-57.92207,2018-05-20 18:00:00,35,1,36
"29643",10602,"Corner Brook","NL",48.95224,-57.92207,2018-05-20 19:00:00,33,2,35
"29644",10602,"Corner Brook","NL",48.95224,-57.92207,2018-05-20 20:00:00,33,2,35
"29645",10602,"Corner Brook","NL",48.95224,-57.92207,2018-05-20 21:00:00,34,1,35
"29646",10602,"Corner Brook","NL",48.95224,-57.92207,2018-05-20 22:00:00,31,1,32
"29647",10602,"Corner Brook","NL",48.95224,-57.92207,2018-05-20 23:00:00,30,1,31
"29648",10602,"Corner Brook","NL",48.95224,-57.92207,2018-05-21 00:00:00,27,2,29
"29649",10602,"Corner Brook","NL",48.95224,-57.92207,2018-05-21 01:00:00,26,3,29
"29650",10602,"Corner Brook","NL",48.95224,-57.92207,2018-05-21 02:00:00,27,3,30
"29651",10602,"Corner Brook","NL",48.95224,-57.92207,2018-05-21 03:00:00,29,1,30
"29652",10602,"Corner Brook","NL",48.95224,-57.92207,2018-05-21 04:00:00,29,1,30
"29653",10602,"Corner Brook","NL",48.95224,-57.92207,2018-05-21 05:00:00,26,4,30
"29654",10602,"Corner Brook","NL",48.95224,-57.92207,2018-05-21 06:00:00,28,2,30
"29655",10602,"Corner Brook","NL",48.95224,-57.92207,2018-05-21 07:00:00,25,6,31
"29656",10602,"Corner Brook","NL",48.95224,-57.92207,2018-05-21 08:00:00,28,3,31
"29657",10602,"Corner Brook","NL",48.95224,-57.92207,2018-05-21 09:00:00,28,4,32
"29658",10602,"Corner Brook","NL",48.95224,-57.92207,2018-05-21 10:00:00,30,2,32
"29659",10602,"Corner Brook","NL",48.95224,-57.92207,2018-05-21 11:00:00,33,1,34
"29660",10602,"Corner Brook","NL",48.95224,-57.92207,2018-05-21 12:00:00,34,3,37
"29661",10602,"Corner Brook","NL",48.95224,-57.92207,2018-05-21 13:00:00,36,1,37
"29662",10602,"Corner Brook","NL",48.95224,-57.92207,2018-05-21 14:00:00,37,0,37
"29663",10602,"Corner Brook","NL",48.95224,-57.92207,2018-05-21 15:00:00,39,1,40
"29664",10602,"Corner Brook","NL",48.95224,-57.92207,2018-05-21 16:00:00,40,1,41
"29665",10602,"Corner Brook","NL",48.95224,-57.92207,2018-05-21 17:00:00,39,1,40
"29666",10602,"Corner Brook","NL",48.95224,-57.92207,2018-05-21 18:00:00,36,1,37
"29667",10602,"Corner Brook","NL",48.95224,-57.92207,2018-05-21 19:00:00,33,1,34
"29668",10602,"Corner Brook","NL",48.95224,-57.92207,2018-05-21 20:00:00,34,2,36
"29669",10602,"Corner Brook","NL",48.95224,-57.92207,2018-05-21 21:00:00,32,1,33
"29670",10602,"Corner Brook","NL",48.95224,-57.92207,2018-05-21 22:00:00,31,1,32
"29671",10602,"Corner Brook","NL",48.95224,-57.92207,2018-05-21 23:00:00,32,1,33
"29672",10602,"Corner Brook","NL",48.95224,-57.92207,2018-05-22 00:00:00,31,1,32
"29673",10602,"Corner Brook","NL",48.95224,-57.92207,2018-05-22 01:00:00,29,3,32
"29674",10602,"Corner Brook","NL",48.95224,-57.92207,2018-05-22 02:00:00,32,2,34
"29675",10602,"Corner Brook","NL",48.95224,-57.92207,2018-05-22 03:00:00,33,2,35
"29676",10602,"Corner Brook","NL",48.95224,-57.92207,2018-05-22 04:00:00,34,1,35
"29677",10602,"Corner Brook","NL",48.95224,-57.92207,2018-05-22 05:00:00,33,1,34
"29678",10602,"Corner Brook","NL",48.95224,-57.92207,2018-05-22 06:00:00,30,2,32
"29679",10602,"Corner Brook","NL",48.95224,-57.92207,2018-05-22 07:00:00,30,1,31
"29680",10602,"Corner Brook","NL",48.95224,-57.92207,2018-05-22 08:00:00,28,2,30
"29681",10602,"Corner Brook","NL",48.95224,-57.92207,2018-05-22 09:00:00,28,3,31
"29682",10602,"Corner Brook","NL",48.95224,-57.92207,2018-05-22 10:00:00,29,3,32
"29683",10602,"Corner Brook","NL",48.95224,-57.92207,2018-05-22 11:00:00,29,4,33
"29684",10602,"Corner Brook","NL",48.95224,-57.92207,2018-05-22 12:00:00,34,2,36
"29685",10602,"Corner Brook","NL",48.95224,-57.92207,2018-05-22 13:00:00,33,6,39
"29686",10602,"Corner Brook","NL",48.95224,-57.92207,2018-05-22 14:00:00,34,2,36
"29687",10602,"Corner Brook","NL",48.95224,-57.92207,2018-05-22 15:00:00,35,2,37
"29688",10602,"Corner Brook","NL",48.95224,-57.92207,2018-05-22 16:00:00,35,1,36
"29689",10602,"Corner Brook","NL",48.95224,-57.92207,2018-05-22 17:00:00,35,1,36
"29690",10602,"Corner Brook","NL",48.95224,-57.92207,2018-05-22 18:00:00,36,1,37
"29691",10602,"Corner Brook","NL",48.95224,-57.92207,2018-05-22 19:00:00,35,1,36
"29692",10602,"Corner Brook","NL",48.95224,-57.92207,2018-05-22 20:00:00,35,1,36
"29693",10602,"Corner Brook","NL",48.95224,-57.92207,2018-05-22 21:00:00,33,2,35
"29694",10602,"Corner Brook","NL",48.95224,-57.92207,2018-05-22 22:00:00,34,3,37
"29695",10602,"Corner Brook","NL",48.95224,-57.92207,2018-05-22 23:00:00,34,2,36
"29696",10602,"Corner Brook","NL",48.95224,-57.92207,2018-05-23 00:00:00,30,3,33
"29697",10602,"Corner Brook","NL",48.95224,-57.92207,2018-05-23 01:00:00,30,3,33
"29698",10602,"Corner Brook","NL",48.95224,-57.92207,2018-05-23 02:00:00,38,1,39
"29699",10602,"Corner Brook","NL",48.95224,-57.92207,2018-05-23 03:00:00,41,1,42
"29700",10602,"Corner Brook","NL",48.95224,-57.92207,2018-05-23 04:00:00,40,1,41
"29701",10602,"Corner Brook","NL",48.95224,-57.92207,2018-05-23 05:00:00,38,2,40
"29702",10602,"Corner Brook","NL",48.95224,-57.92207,2018-05-23 06:00:00,38,3,41
"29703",10602,"Corner Brook","NL",48.95224,-57.92207,2018-05-23 07:00:00,35,5,40
"29704",10602,"Corner Brook","NL",48.95224,-57.92207,2018-05-23 08:00:00,36,4,40
"29705",10602,"Corner Brook","NL",48.95224,-57.92207,2018-05-23 09:00:00,31,7,38
"29706",10602,"Corner Brook","NL",48.95224,-57.92207,2018-05-23 10:00:00,33,4,37
"29707",10602,"Corner Brook","NL",48.95224,-57.92207,2018-05-23 11:00:00,27,9,36
"29708",10602,"Corner Brook","NL",48.95224,-57.92207,2018-05-23 12:00:00,33,3,36
"29709",10602,"Corner Brook","NL",48.95224,-57.92207,2018-05-23 13:00:00,34,5,39
"29710",10602,"Corner Brook","NL",48.95224,-57.92207,2018-05-23 14:00:00,35,4,39
"29711",10602,"Corner Brook","NL",48.95224,-57.92207,2018-05-23 15:00:00,36,4,40
"29712",10602,"Corner Brook","NL",48.95224,-57.92207,2018-05-23 16:00:00,38,3,41
"29713",10602,"Corner Brook","NL",48.95224,-57.92207,2018-05-23 17:00:00,37,2,39
"29714",10602,"Corner Brook","NL",48.95224,-57.92207,2018-05-23 18:00:00,35,2,37
"29715",10602,"Corner Brook","NL",48.95224,-57.92207,2018-05-23 19:00:00,30,1,31
"29716",10602,"Corner Brook","NL",48.95224,-57.92207,2018-05-23 20:00:00,31,1,32
"29717",10602,"Corner Brook","NL",48.95224,-57.92207,2018-05-23 21:00:00,32,1,33
"29718",10602,"Corner Brook","NL",48.95224,-57.92207,2018-05-23 22:00:00,31,1,32
"29719",10602,"Corner Brook","NL",48.95224,-57.92207,2018-05-23 23:00:00,30,1,31
"29720",10602,"Corner Brook","NL",48.95224,-57.92207,2018-05-24 00:00:00,30,1,31
"29721",10602,"Corner Brook","NL",48.95224,-57.92207,2018-05-24 01:00:00,32,1,33
"29722",10602,"Corner Brook","NL",48.95224,-57.92207,2018-05-24 02:00:00,31,1,32
"29723",10602,"Corner Brook","NL",48.95224,-57.92207,2018-05-24 03:00:00,30,1,31
"29724",10602,"Corner Brook","NL",48.95224,-57.92207,2018-05-24 04:00:00,29,1,30
"29725",10602,"Corner Brook","NL",48.95224,-57.92207,2018-05-24 05:00:00,28,1,29
"29726",10602,"Corner Brook","NL",48.95224,-57.92207,2018-05-24 06:00:00,27,2,29
"29727",10602,"Corner Brook","NL",48.95224,-57.92207,2018-05-24 07:00:00,28,2,30
"29728",10602,"Corner Brook","NL",48.95224,-57.92207,2018-05-24 08:00:00,28,2,30
"29729",10602,"Corner Brook","NL",48.95224,-57.92207,2018-05-24 09:00:00,28,2,30
"29730",10602,"Corner Brook","NL",48.95224,-57.92207,2018-05-24 10:00:00,29,2,31
"29731",10602,"Corner Brook","NL",48.95224,-57.92207,2018-05-24 11:00:00,29,1,30
"29732",10602,"Corner Brook","NL",48.95224,-57.92207,2018-05-24 12:00:00,30,1,31
"29733",10602,"Corner Brook","NL",48.95224,-57.92207,2018-05-24 13:00:00,31,1,32
"29734",10602,"Corner Brook","NL",48.95224,-57.92207,2018-05-24 14:00:00,31,2,33
"29735",10602,"Corner Brook","NL",48.95224,-57.92207,2018-05-24 15:00:00,31,1,32
"29736",10602,"Corner Brook","NL",48.95224,-57.92207,2018-05-24 16:00:00,30,1,31
"29737",10602,"Corner Brook","NL",48.95224,-57.92207,2018-05-24 17:00:00,31,1,32
"29738",10602,"Corner Brook","NL",48.95224,-57.92207,2018-05-24 18:00:00,32,1,33
"29739",10602,"Corner Brook","NL",48.95224,-57.92207,2018-05-24 19:00:00,30,1,31
"29740",10602,"Corner Brook","NL",48.95224,-57.92207,2018-05-24 20:00:00,28,1,29
"29741",10602,"Corner Brook","NL",48.95224,-57.92207,2018-05-24 21:00:00,26,3,29
"29742",10602,"Corner Brook","NL",48.95224,-57.92207,2018-05-24 22:00:00,24,4,28
"29743",10602,"Corner Brook","NL",48.95224,-57.92207,2018-05-24 23:00:00,24,3,27
"29744",10602,"Corner Brook","NL",48.95224,-57.92207,2018-05-25 00:00:00,24,2,26
"29745",10602,"Corner Brook","NL",48.95224,-57.92207,2018-05-25 01:00:00,25,1,26
"29746",10602,"Corner Brook","NL",48.95224,-57.92207,2018-05-25 02:00:00,23,2,25
"29747",10602,"Corner Brook","NL",48.95224,-57.92207,2018-05-25 03:00:00,22,2,24
"29748",10602,"Corner Brook","NL",48.95224,-57.92207,2018-05-25 04:00:00,23,1,24
"29749",10602,"Corner Brook","NL",48.95224,-57.92207,2018-05-25 05:00:00,26,2,28
"29750",10602,"Corner Brook","NL",48.95224,-57.92207,2018-05-25 06:00:00,26,2,28
"29751",10602,"Corner Brook","NL",48.95224,-57.92207,2018-05-25 07:00:00,26,3,29
"29752",10602,"Corner Brook","NL",48.95224,-57.92207,2018-05-25 08:00:00,29,2,31
"29753",10602,"Corner Brook","NL",48.95224,-57.92207,2018-05-25 09:00:00,32,2,34
"29754",10602,"Corner Brook","NL",48.95224,-57.92207,2018-05-25 10:00:00,31,3,34
"29755",10602,"Corner Brook","NL",48.95224,-57.92207,2018-05-25 11:00:00,33,1,34
"29756",10602,"Corner Brook","NL",48.95224,-57.92207,2018-05-25 12:00:00,32,1,33
"29757",10602,"Corner Brook","NL",48.95224,-57.92207,2018-05-25 13:00:00,31,1,32
"29758",10602,"Corner Brook","NL",48.95224,-57.92207,2018-05-25 14:00:00,30,2,32
"29759",10602,"Corner Brook","NL",48.95224,-57.92207,2018-05-25 15:00:00,25,6,31
"29760",10602,"Corner Brook","NL",48.95224,-57.92207,2018-05-25 16:00:00,31,2,33
"29761",10602,"Corner Brook","NL",48.95224,-57.92207,2018-05-25 17:00:00,31,2,33
"29762",10602,"Corner Brook","NL",48.95224,-57.92207,2018-05-25 18:00:00,31,2,33
"29763",10602,"Corner Brook","NL",48.95224,-57.92207,2018-05-25 19:00:00,31,2,33
"29764",10602,"Corner Brook","NL",48.95224,-57.92207,2018-05-25 20:00:00,30,3,33
"29765",10602,"Corner Brook","NL",48.95224,-57.92207,2018-05-25 21:00:00,29,2,31
"29766",10602,"Corner Brook","NL",48.95224,-57.92207,2018-05-25 22:00:00,28,2,30
"29767",10602,"Corner Brook","NL",48.95224,-57.92207,2018-05-25 23:00:00,25,2,27
"29768",10602,"Corner Brook","NL",48.95224,-57.92207,2018-05-26 00:00:00,21,4,25
"29769",10602,"Corner Brook","NL",48.95224,-57.92207,2018-05-26 01:00:00,23,3,26
"29770",10602,"Corner Brook","NL",48.95224,-57.92207,2018-05-26 02:00:00,18,4,22
"29771",10602,"Corner Brook","NL",48.95224,-57.92207,2018-05-26 03:00:00,23,1,24
"29772",10602,"Corner Brook","NL",48.95224,-57.92207,2018-05-26 04:00:00,22,1,23
"29773",10602,"Corner Brook","NL",48.95224,-57.92207,2018-05-26 05:00:00,19,2,21
"29774",10602,"Corner Brook","NL",48.95224,-57.92207,2018-05-26 06:00:00,18,3,21
"29775",10602,"Corner Brook","NL",48.95224,-57.92207,2018-05-26 07:00:00,20,1,21
"29776",10602,"Corner Brook","NL",48.95224,-57.92207,2018-05-26 08:00:00,20,2,22
"29777",10602,"Corner Brook","NL",48.95224,-57.92207,2018-05-26 09:00:00,20,2,22
"29778",10602,"Corner Brook","NL",48.95224,-57.92207,2018-05-26 10:00:00,23,2,25
"29779",10602,"Corner Brook","NL",48.95224,-57.92207,2018-05-26 11:00:00,25,2,27
"29780",10602,"Corner Brook","NL",48.95224,-57.92207,2018-05-26 12:00:00,26,1,27
"29781",10602,"Corner Brook","NL",48.95224,-57.92207,2018-05-26 13:00:00,27,1,28
"29782",10602,"Corner Brook","NL",48.95224,-57.92207,2018-05-26 14:00:00,26,2,28
"29783",10602,"Corner Brook","NL",48.95224,-57.92207,2018-05-26 15:00:00,18,11,29
"29784",10602,"Corner Brook","NL",48.95224,-57.92207,2018-05-26 16:00:00,19,9,28
"29785",10602,"Corner Brook","NL",48.95224,-57.92207,2018-05-26 17:00:00,15,12,27
"29786",10602,"Corner Brook","NL",48.95224,-57.92207,2018-05-26 18:00:00,17,11,28
"29787",10602,"Corner Brook","NL",48.95224,-57.92207,2018-05-26 19:00:00,12,16,28
"29788",10602,"Corner Brook","NL",48.95224,-57.92207,2018-05-26 20:00:00,24,5,29
"29789",10602,"Corner Brook","NL",48.95224,-57.92207,2018-05-26 21:00:00,29,1,30
"29790",10602,"Corner Brook","NL",48.95224,-57.92207,2018-05-26 22:00:00,28,1,29
"29791",10602,"Corner Brook","NL",48.95224,-57.92207,2018-05-26 23:00:00,28,2,30
"29792",10602,"Corner Brook","NL",48.95224,-57.92207,2018-05-27 00:00:00,27,2,29
"29793",10602,"Corner Brook","NL",48.95224,-57.92207,2018-05-27 01:00:00,25,2,27
"29794",10602,"Corner Brook","NL",48.95224,-57.92207,2018-05-27 02:00:00,25,2,27
"29795",10602,"Corner Brook","NL",48.95224,-57.92207,2018-05-27 03:00:00,23,2,25
"29796",10602,"Corner Brook","NL",48.95224,-57.92207,2018-05-27 04:00:00,20,2,22
"29797",10602,"Corner Brook","NL",48.95224,-57.92207,2018-05-27 05:00:00,18,2,20
"29798",10602,"Corner Brook","NL",48.95224,-57.92207,2018-05-27 06:00:00,13,6,19
"29799",10602,"Corner Brook","NL",48.95224,-57.92207,2018-05-27 07:00:00,18,7,25
"29800",10602,"Corner Brook","NL",48.95224,-57.92207,2018-05-27 08:00:00,20,6,26
"29801",10602,"Corner Brook","NL",48.95224,-57.92207,2018-05-27 09:00:00,25,3,28
"29802",10602,"Corner Brook","NL",48.95224,-57.92207,2018-05-27 10:00:00,25,5,30
"29803",10602,"Corner Brook","NL",48.95224,-57.92207,2018-05-27 11:00:00,28,3,31
"29804",10602,"Corner Brook","NL",48.95224,-57.92207,2018-05-27 12:00:00,26,7,33
"29805",10602,"Corner Brook","NL",48.95224,-57.92207,2018-05-27 13:00:00,27,9,36
"29806",10602,"Corner Brook","NL",48.95224,-57.92207,2018-05-27 14:00:00,24,11,35
"29807",10602,"Corner Brook","NL",48.95224,-57.92207,2018-05-27 15:00:00,18,18,36
"29808",10602,"Corner Brook","NL",48.95224,-57.92207,2018-05-27 16:00:00,26,7,33
"29809",10602,"Corner Brook","NL",48.95224,-57.92207,2018-05-27 17:00:00,30,3,33
"29810",10602,"Corner Brook","NL",48.95224,-57.92207,2018-05-27 18:00:00,32,1,33
"29811",10602,"Corner Brook","NL",48.95224,-57.92207,2018-05-27 19:00:00,29,3,32
"29812",10602,"Corner Brook","NL",48.95224,-57.92207,2018-05-27 20:00:00,31,2,33
"29813",10602,"Corner Brook","NL",48.95224,-57.92207,2018-05-27 21:00:00,27,3,30
"29814",10602,"Corner Brook","NL",48.95224,-57.92207,2018-05-27 22:00:00,26,2,28
"29815",10602,"Corner Brook","NL",48.95224,-57.92207,2018-05-27 23:00:00,25,1,26
"29816",10602,"Corner Brook","NL",48.95224,-57.92207,2018-05-28 00:00:00,25,1,26
"29817",10602,"Corner Brook","NL",48.95224,-57.92207,2018-05-28 01:00:00,25,1,26
"29818",10602,"Corner Brook","NL",48.95224,-57.92207,2018-05-28 02:00:00,26,1,27
"29819",10602,"Corner Brook","NL",48.95224,-57.92207,2018-05-28 03:00:00,25,1,26
"29820",10602,"Corner Brook","NL",48.95224,-57.92207,2018-05-28 04:00:00,23,1,24
"29821",10602,"Corner Brook","NL",48.95224,-57.92207,2018-05-28 05:00:00,22,1,23
"29822",10602,"Corner Brook","NL",48.95224,-57.92207,2018-05-28 06:00:00,23,2,25
"29823",10602,"Corner Brook","NL",48.95224,-57.92207,2018-05-28 07:00:00,22,3,25
"29824",10602,"Corner Brook","NL",48.95224,-57.92207,2018-05-28 08:00:00,27,2,29
"29825",10602,"Corner Brook","NL",48.95224,-57.92207,2018-05-28 09:00:00,29,2,31
"29826",10602,"Corner Brook","NL",48.95224,-57.92207,2018-05-28 10:00:00,32,1,33
"29827",10602,"Corner Brook","NL",48.95224,-57.92207,2018-05-28 11:00:00,34,1,35
"29828",10602,"Corner Brook","NL",48.95224,-57.92207,2018-05-28 12:00:00,37,1,38
"29829",10602,"Corner Brook","NL",48.95224,-57.92207,2018-05-28 13:00:00,37,1,38
"29830",10602,"Corner Brook","NL",48.95224,-57.92207,2018-05-28 14:00:00,36,1,37
"29831",10602,"Corner Brook","NL",48.95224,-57.92207,2018-05-28 15:00:00,36,1,37
"29832",10602,"Corner Brook","NL",48.95224,-57.92207,2018-05-28 16:00:00,37,1,38
"29833",10602,"Corner Brook","NL",48.95224,-57.92207,2018-05-28 17:00:00,36,1,37
"29834",10602,"Corner Brook","NL",48.95224,-57.92207,2018-05-28 18:00:00,35,0,35
"29835",10602,"Corner Brook","NL",48.95224,-57.92207,2018-05-28 19:00:00,36,1,37
"29836",10602,"Corner Brook","NL",48.95224,-57.92207,2018-05-28 20:00:00,38,1,39
"29837",10602,"Corner Brook","NL",48.95224,-57.92207,2018-05-28 21:00:00,36,1,37
"29838",10602,"Corner Brook","NL",48.95224,-57.92207,2018-05-28 22:00:00,36,1,37
"29839",10602,"Corner Brook","NL",48.95224,-57.92207,2018-05-28 23:00:00,38,1,39
"29840",10602,"Corner Brook","NL",48.95224,-57.92207,2018-05-29 00:00:00,36,1,37
"29841",10602,"Corner Brook","NL",48.95224,-57.92207,2018-05-29 01:00:00,33,1,34
"29842",10602,"Corner Brook","NL",48.95224,-57.92207,2018-05-29 02:00:00,34,1,35
"29843",10602,"Corner Brook","NL",48.95224,-57.92207,2018-05-29 03:00:00,33,1,34
"29844",10602,"Corner Brook","NL",48.95224,-57.92207,2018-05-29 04:00:00,32,2,34
"29845",10602,"Corner Brook","NL",48.95224,-57.92207,2018-05-29 05:00:00,27,4,31
"29846",10602,"Corner Brook","NL",48.95224,-57.92207,2018-05-29 06:00:00,28,2,30
"29847",10602,"Corner Brook","NL",48.95224,-57.92207,2018-05-29 07:00:00,23,5,28
"29848",10602,"Corner Brook","NL",48.95224,-57.92207,2018-05-29 08:00:00,20,9,29
"29849",10602,"Corner Brook","NL",48.95224,-57.92207,2018-05-29 09:00:00,24,7,31
"29850",10602,"Corner Brook","NL",48.95224,-57.92207,2018-05-29 10:00:00,29,3,32
"29851",10602,"Corner Brook","NL",48.95224,-57.92207,2018-05-29 11:00:00,29,3,32
"29852",10602,"Corner Brook","NL",48.95224,-57.92207,2018-05-29 12:00:00,30,3,33
"29853",10602,"Corner Brook","NL",48.95224,-57.92207,2018-05-29 13:00:00,26,7,33
"29854",10602,"Corner Brook","NL",48.95224,-57.92207,2018-05-29 14:00:00,25,12,37
"29855",10602,"Corner Brook","NL",48.95224,-57.92207,2018-05-29 15:00:00,22,12,34
"29856",10602,"Corner Brook","NL",48.95224,-57.92207,2018-05-29 16:00:00,21,9,30
"29857",10602,"Corner Brook","NL",48.95224,-57.92207,2018-05-29 17:00:00,19,12,31
"29858",10602,"Corner Brook","NL",48.95224,-57.92207,2018-05-29 18:00:00,15,15,30
"29859",10602,"Corner Brook","NL",48.95224,-57.92207,2018-05-29 19:00:00,23,6,29
"29860",10602,"Corner Brook","NL",48.95224,-57.92207,2018-05-29 20:00:00,23,6,29
"29861",10602,"Corner Brook","NL",48.95224,-57.92207,2018-05-29 21:00:00,23,6,29
"29862",10602,"Corner Brook","NL",48.95224,-57.92207,2018-05-29 22:00:00,26,2,28
"29863",10602,"Corner Brook","NL",48.95224,-57.92207,2018-05-29 23:00:00,24,1,25
"29864",10602,"Corner Brook","NL",48.95224,-57.92207,2018-05-30 00:00:00,24,1,25
"29865",10602,"Corner Brook","NL",48.95224,-57.92207,2018-05-30 01:00:00,23,1,24
"29866",10602,"Corner Brook","NL",48.95224,-57.92207,2018-05-30 02:00:00,25,1,26
"29867",10602,"Corner Brook","NL",48.95224,-57.92207,2018-05-30 03:00:00,25,1,26
"29868",10602,"Corner Brook","NL",48.95224,-57.92207,2018-05-30 04:00:00,25,1,26
"29869",10602,"Corner Brook","NL",48.95224,-57.92207,2018-05-30 05:00:00,26,1,27
"29870",10602,"Corner Brook","NL",48.95224,-57.92207,2018-05-30 06:00:00,26,2,28
"29871",10602,"Corner Brook","NL",48.95224,-57.92207,2018-05-30 07:00:00,26,3,29
"29872",10602,"Corner Brook","NL",48.95224,-57.92207,2018-05-30 08:00:00,27,2,29
"29873",10602,"Corner Brook","NL",48.95224,-57.92207,2018-05-30 09:00:00,29,1,30
"29874",10602,"Corner Brook","NL",48.95224,-57.92207,2018-05-30 10:00:00,30,1,31
"29875",10602,"Corner Brook","NL",48.95224,-57.92207,2018-05-30 11:00:00,30,1,31
"29876",10602,"Corner Brook","NL",48.95224,-57.92207,2018-05-30 12:00:00,33,1,34
"29877",10602,"Corner Brook","NL",48.95224,-57.92207,2018-05-30 13:00:00,31,5,36
"29878",10602,"Corner Brook","NL",48.95224,-57.92207,2018-05-30 14:00:00,28,7,35
"29879",10602,"Corner Brook","NL",48.95224,-57.92207,2018-05-30 15:00:00,29,7,36
"29880",10602,"Corner Brook","NL",48.95224,-57.92207,2018-05-30 16:00:00,30,9,39
"29881",10602,"Corner Brook","NL",48.95224,-57.92207,2018-05-30 17:00:00,34,6,40
"29882",10602,"Corner Brook","NL",48.95224,-57.92207,2018-05-30 18:00:00,32,5,37
"29883",10602,"Corner Brook","NL",48.95224,-57.92207,2018-05-30 19:00:00,31,5,36
"29884",10602,"Corner Brook","NL",48.95224,-57.92207,2018-05-30 20:00:00,32,4,36
"29885",10602,"Corner Brook","NL",48.95224,-57.92207,2018-05-30 21:00:00,31,4,35
"29886",10602,"Corner Brook","NL",48.95224,-57.92207,2018-05-30 22:00:00,29,4,33
"29887",10602,"Corner Brook","NL",48.95224,-57.92207,2018-05-30 23:00:00,27,5,32
"29888",10602,"Corner Brook","NL",48.95224,-57.92207,2018-05-31 00:00:00,23,5,28
"29889",10602,"Corner Brook","NL",48.95224,-57.92207,2018-05-31 01:00:00,19,4,23
"29890",10602,"Corner Brook","NL",48.95224,-57.92207,2018-05-31 02:00:00,14,5,19
"29891",10602,"Corner Brook","NL",48.95224,-57.92207,2018-05-31 03:00:00,14,4,18
"29892",10602,"Corner Brook","NL",48.95224,-57.92207,2018-05-31 04:00:00,14,4,18
"29893",10602,"Corner Brook","NL",48.95224,-57.92207,2018-05-31 05:00:00,12,7,19
"29894",10602,"Corner Brook","NL",48.95224,-57.92207,2018-05-31 06:00:00,13,5,18
"29895",10602,"Corner Brook","NL",48.95224,-57.92207,2018-05-31 07:00:00,16,8,24
"29896",10602,"Corner Brook","NL",48.95224,-57.92207,2018-05-31 08:00:00,22,5,27
"29897",10602,"Corner Brook","NL",48.95224,-57.92207,2018-05-31 09:00:00,28,4,32
"29898",10602,"Corner Brook","NL",48.95224,-57.92207,2018-05-31 10:00:00,28,9,37
"29899",10602,"Corner Brook","NL",48.95224,-57.92207,2018-05-31 11:00:00,33,3,36
"29900",10602,"Corner Brook","NL",48.95224,-57.92207,2018-05-31 12:00:00,34,1,35
"29901",10602,"Corner Brook","NL",48.95224,-57.92207,2018-05-31 13:00:00,32,3,35
"29902",10602,"Corner Brook","NL",48.95224,-57.92207,2018-05-31 14:00:00,26,10,36
"29903",10602,"Corner Brook","NL",48.95224,-57.92207,2018-05-31 15:00:00,28,8,36
"29904",10602,"Corner Brook","NL",48.95224,-57.92207,2018-05-31 16:00:00,22,14,36
"29905",10602,"Corner Brook","NL",48.95224,-57.92207,2018-05-31 17:00:00,25,12,37
"29906",10602,"Corner Brook","NL",48.95224,-57.92207,2018-05-31 18:00:00,26,10,36
"29907",10602,"Corner Brook","NL",48.95224,-57.92207,2018-05-31 19:00:00,30,8,38
"29908",10602,"Corner Brook","NL",48.95224,-57.92207,2018-05-31 20:00:00,34,3,37
"29909",10602,"Corner Brook","NL",48.95224,-57.92207,2018-05-31 21:00:00,29,6,35
"29910",10602,"Corner Brook","NL",48.95224,-57.92207,2018-05-31 22:00:00,25,7,32
"29911",10602,"Corner Brook","NL",48.95224,-57.92207,2018-05-31 23:00:00,20,8,28
"29912",10602,"Corner Brook","NL",48.95224,-57.92207,2018-06-01 00:00:00,16,9,25
"29913",10602,"Corner Brook","NL",48.95224,-57.92207,2018-06-01 01:00:00,18,7,25
"29914",10602,"Corner Brook","NL",48.95224,-57.92207,2018-06-01 02:00:00,18,5,23
"29915",10602,"Corner Brook","NL",48.95224,-57.92207,2018-06-01 03:00:00,17,4,21
"29916",10602,"Corner Brook","NL",48.95224,-57.92207,2018-06-01 04:00:00,15,4,19
"29917",10602,"Corner Brook","NL",48.95224,-57.92207,2018-06-01 05:00:00,15,4,19
"29918",10602,"Corner Brook","NL",48.95224,-57.92207,2018-06-01 06:00:00,14,6,20
"29919",10602,"Corner Brook","NL",48.95224,-57.92207,2018-06-01 07:00:00,19,6,25
"29920",10602,"Corner Brook","NL",48.95224,-57.92207,2018-06-01 08:00:00,23,4,27
"29921",10602,"Corner Brook","NL",48.95224,-57.92207,2018-06-01 09:00:00,27,4,31
"29922",10602,"Corner Brook","NL",48.95224,-57.92207,2018-06-01 10:00:00,33,2,35
"29923",10602,"Corner Brook","NL",48.95224,-57.92207,2018-06-01 11:00:00,39,2,41
"29924",10602,"Corner Brook","NL",48.95224,-57.92207,2018-06-01 12:00:00,43,2,45
"29925",10602,"Corner Brook","NL",48.95224,-57.92207,2018-06-01 13:00:00,49,2,51
"29926",10602,"Corner Brook","NL",48.95224,-57.92207,2018-06-01 14:00:00,40,1,41
"29927",10602,"Corner Brook","NL",48.95224,-57.92207,2018-06-01 15:00:00,34,7,41
"29928",10602,"Corner Brook","NL",48.95224,-57.92207,2018-06-01 16:00:00,29,11,40
"29929",10602,"Corner Brook","NL",48.95224,-57.92207,2018-06-01 17:00:00,35,2,37
"29930",10602,"Corner Brook","NL",48.95224,-57.92207,2018-06-01 18:00:00,28,7,35
"29931",10602,"Corner Brook","NL",48.95224,-57.92207,2018-06-01 19:00:00,33,3,36
"29932",10602,"Corner Brook","NL",48.95224,-57.92207,2018-06-01 20:00:00,32,4,36
"29933",10602,"Corner Brook","NL",48.95224,-57.92207,2018-06-01 21:00:00,30,4,34
"29934",10602,"Corner Brook","NL",48.95224,-57.92207,2018-06-01 22:00:00,19,15,34
"29935",10602,"Corner Brook","NL",48.95224,-57.92207,2018-06-01 23:00:00,28,4,32
"29936",10602,"Corner Brook","NL",48.95224,-57.92207,2018-06-02 00:00:00,23,4,27
"29937",10602,"Corner Brook","NL",48.95224,-57.92207,2018-06-02 01:00:00,21,5,26
"29938",10602,"Corner Brook","NL",48.95224,-57.92207,2018-06-02 02:00:00,18,5,23
"29939",10602,"Corner Brook","NL",48.95224,-57.92207,2018-06-02 03:00:00,18,4,22
"29940",10602,"Corner Brook","NL",48.95224,-57.92207,2018-06-02 04:00:00,19,2,21
"29941",10602,"Corner Brook","NL",48.95224,-57.92207,2018-06-02 05:00:00,18,2,20
"29942",10602,"Corner Brook","NL",48.95224,-57.92207,2018-06-02 06:00:00,16,2,18
"29943",10602,"Corner Brook","NL",48.95224,-57.92207,2018-06-02 07:00:00,18,2,20
"29944",10602,"Corner Brook","NL",48.95224,-57.92207,2018-06-02 08:00:00,18,2,20
"29945",10602,"Corner Brook","NL",48.95224,-57.92207,2018-06-02 09:00:00,18,2,20
"29946",10602,"Corner Brook","NL",48.95224,-57.92207,2018-06-02 10:00:00,18,2,20
"29947",10602,"Corner Brook","NL",48.95224,-57.92207,2018-06-02 11:00:00,18,1,19
"29948",10602,"Corner Brook","NL",48.95224,-57.92207,2018-06-02 12:00:00,17,1,18
"29949",10602,"Corner Brook","NL",48.95224,-57.92207,2018-06-02 13:00:00,18,1,19
"29950",10602,"Corner Brook","NL",48.95224,-57.92207,2018-06-02 14:00:00,18,1,19
"29951",10602,"Corner Brook","NL",48.95224,-57.92207,2018-06-02 15:00:00,19,1,20
"29952",10602,"Corner Brook","NL",48.95224,-57.92207,2018-06-02 16:00:00,21,1,22
"29953",10602,"Corner Brook","NL",48.95224,-57.92207,2018-06-02 17:00:00,25,1,26
"29954",10602,"Corner Brook","NL",48.95224,-57.92207,2018-06-02 18:00:00,26,1,27
"29955",10602,"Corner Brook","NL",48.95224,-57.92207,2018-06-02 19:00:00,28,1,29
"29956",10602,"Corner Brook","NL",48.95224,-57.92207,2018-06-02 20:00:00,28,1,29
"29957",10602,"Corner Brook","NL",48.95224,-57.92207,2018-06-02 21:00:00,26,1,27
"29958",10602,"Corner Brook","NL",48.95224,-57.92207,2018-06-02 22:00:00,26,1,27
"29959",10602,"Corner Brook","NL",48.95224,-57.92207,2018-06-02 23:00:00,26,1,27
"29960",10602,"Corner Brook","NL",48.95224,-57.92207,2018-06-03 00:00:00,25,1,26
"29961",10602,"Corner Brook","NL",48.95224,-57.92207,2018-06-03 01:00:00,24,1,25
"29962",10602,"Corner Brook","NL",48.95224,-57.92207,2018-06-03 02:00:00,24,1,25
"29963",10602,"Corner Brook","NL",48.95224,-57.92207,2018-06-03 03:00:00,22,1,23
"29964",10602,"Corner Brook","NL",48.95224,-57.92207,2018-06-03 04:00:00,21,1,22
"29965",10602,"Corner Brook","NL",48.95224,-57.92207,2018-06-03 05:00:00,24,1,25
"29966",10602,"Corner Brook","NL",48.95224,-57.92207,2018-06-03 06:00:00,21,1,22
"29967",10602,"Corner Brook","NL",48.95224,-57.92207,2018-06-03 07:00:00,21,1,22
"29968",10602,"Corner Brook","NL",48.95224,-57.92207,2018-06-03 08:00:00,21,1,22
"29969",10602,"Corner Brook","NL",48.95224,-57.92207,2018-06-03 09:00:00,22,1,23
"29970",10602,"Corner Brook","NL",48.95224,-57.92207,2018-06-03 10:00:00,22,1,23
"29971",10602,"Corner Brook","NL",48.95224,-57.92207,2018-06-03 11:00:00,24,1,25
"29972",10602,"Corner Brook","NL",48.95224,-57.92207,2018-06-03 12:00:00,25,1,26
"29973",10602,"Corner Brook","NL",48.95224,-57.92207,2018-06-03 13:00:00,25,1,26
"29974",10602,"Corner Brook","NL",48.95224,-57.92207,2018-06-03 14:00:00,25,1,26
"29975",10602,"Corner Brook","NL",48.95224,-57.92207,2018-06-03 15:00:00,25,1,26
"29976",10602,"Corner Brook","NL",48.95224,-57.92207,2018-06-03 16:00:00,25,1,26
"29977",10602,"Corner Brook","NL",48.95224,-57.92207,2018-06-03 17:00:00,25,1,26
"29978",10602,"Corner Brook","NL",48.95224,-57.92207,2018-06-03 18:00:00,25,1,26
"29979",10602,"Corner Brook","NL",48.95224,-57.92207,2018-06-03 19:00:00,25,1,26
"29980",10602,"Corner Brook","NL",48.95224,-57.92207,2018-06-03 20:00:00,24,1,25
"29981",10602,"Corner Brook","NL",48.95224,-57.92207,2018-06-03 21:00:00,24,1,25
"29982",10602,"Corner Brook","NL",48.95224,-57.92207,2018-06-03 22:00:00,25,1,26
"29983",10602,"Corner Brook","NL",48.95224,-57.92207,2018-06-03 23:00:00,25,1,26
"29984",10602,"Corner Brook","NL",48.95224,-57.92207,2018-06-04 00:00:00,27,1,28
"29985",10602,"Corner Brook","NL",48.95224,-57.92207,2018-06-04 01:00:00,29,1,30
"29986",10602,"Corner Brook","NL",48.95224,-57.92207,2018-06-04 02:00:00,28,1,29
"29987",10602,"Corner Brook","NL",48.95224,-57.92207,2018-06-04 03:00:00,28,1,29
"29988",10602,"Corner Brook","NL",48.95224,-57.92207,2018-06-04 04:00:00,29,1,30
"29989",10602,"Corner Brook","NL",48.95224,-57.92207,2018-06-04 05:00:00,29,1,30
"29990",10602,"Corner Brook","NL",48.95224,-57.92207,2018-06-04 06:00:00,27,1,28
"29991",10602,"Corner Brook","NL",48.95224,-57.92207,2018-06-04 07:00:00,25,1,26
"29992",10602,"Corner Brook","NL",48.95224,-57.92207,2018-06-04 08:00:00,25,1,26
"29993",10602,"Corner Brook","NL",48.95224,-57.92207,2018-06-04 09:00:00,24,1,25
"29994",10602,"Corner Brook","NL",48.95224,-57.92207,2018-06-04 10:00:00,23,3,26
"29995",10602,"Corner Brook","NL",48.95224,-57.92207,2018-06-04 11:00:00,22,4,26
"29996",10602,"Corner Brook","NL",48.95224,-57.92207,2018-06-04 12:00:00,23,4,27
"29997",10602,"Corner Brook","NL",48.95224,-57.92207,2018-06-04 13:00:00,24,2,26
"29998",10602,"Corner Brook","NL",48.95224,-57.92207,2018-06-04 14:00:00,24,3,27
"29999",10602,"Corner Brook","NL",48.95224,-57.92207,2018-06-04 15:00:00,25,4,29
"30000",10602,"Corner Brook","NL",48.95224,-57.92207,2018-06-04 16:00:00,24,5,29
"30001",10602,"Corner Brook","NL",48.95224,-57.92207,2018-06-04 17:00:00,22,7,29
"30002",10602,"Corner Brook","NL",48.95224,-57.92207,2018-06-04 18:00:00,20,11,31
"30003",10602,"Corner Brook","NL",48.95224,-57.92207,2018-06-04 19:00:00,22,6,28
"30004",10602,"Corner Brook","NL",48.95224,-57.92207,2018-06-04 20:00:00,25,2,27
"30005",10602,"Corner Brook","NL",48.95224,-57.92207,2018-06-04 21:00:00,24,2,26
"30006",10602,"Corner Brook","NL",48.95224,-57.92207,2018-06-04 22:00:00,21,3,24
"30007",10602,"Corner Brook","NL",48.95224,-57.92207,2018-06-04 23:00:00,19,4,23
"30008",10602,"Corner Brook","NL",48.95224,-57.92207,2018-06-05 00:00:00,16,4,20
"30009",10602,"Corner Brook","NL",48.95224,-57.92207,2018-06-05 01:00:00,20,2,22
"30010",10602,"Corner Brook","NL",48.95224,-57.92207,2018-06-05 02:00:00,19,2,21
"30011",10602,"Corner Brook","NL",48.95224,-57.92207,2018-06-05 03:00:00,21,1,22
"30012",10602,"Corner Brook","NL",48.95224,-57.92207,2018-06-05 04:00:00,18,2,20
"30013",10602,"Corner Brook","NL",48.95224,-57.92207,2018-06-05 05:00:00,18,3,21
"30014",10602,"Corner Brook","NL",48.95224,-57.92207,2018-06-05 06:00:00,17,3,20
"30015",10602,"Corner Brook","NL",48.95224,-57.92207,2018-06-05 07:00:00,19,2,21
"30016",10602,"Corner Brook","NL",48.95224,-57.92207,2018-06-05 08:00:00,19,4,23
"30017",10602,"Corner Brook","NL",48.95224,-57.92207,2018-06-05 09:00:00,23,4,27
"30018",10602,"Corner Brook","NL",48.95224,-57.92207,2018-06-05 10:00:00,27,2,29
"30019",10602,"Corner Brook","NL",48.95224,-57.92207,2018-06-05 11:00:00,28,1,29
"30020",10602,"Corner Brook","NL",48.95224,-57.92207,2018-06-05 12:00:00,21,7,28
"30021",10602,"Corner Brook","NL",48.95224,-57.92207,2018-06-05 13:00:00,17,13,30
"30022",10602,"Corner Brook","NL",48.95224,-57.92207,2018-06-05 14:00:00,19,10,29
"30023",10602,"Corner Brook","NL",48.95224,-57.92207,2018-06-05 15:00:00,15,16,31
"30024",10602,"Corner Brook","NL",48.95224,-57.92207,2018-06-05 16:00:00,16,17,33
"30025",10602,"Corner Brook","NL",48.95224,-57.92207,2018-06-05 17:00:00,18,14,32
"30026",10602,"Corner Brook","NL",48.95224,-57.92207,2018-06-05 18:00:00,15,16,31
"30027",10602,"Corner Brook","NL",48.95224,-57.92207,2018-06-05 19:00:00,20,10,30
"30028",10602,"Corner Brook","NL",48.95224,-57.92207,2018-06-05 20:00:00,25,4,29
"30029",10602,"Corner Brook","NL",48.95224,-57.92207,2018-06-05 21:00:00,24,4,28
"30030",10602,"Corner Brook","NL",48.95224,-57.92207,2018-06-05 22:00:00,21,5,26
"30031",10602,"Corner Brook","NL",48.95224,-57.92207,2018-06-05 23:00:00,16,6,22
"30032",10602,"Corner Brook","NL",48.95224,-57.92207,2018-06-06 00:00:00,17,4,21
"30033",10602,"Corner Brook","NL",48.95224,-57.92207,2018-06-06 01:00:00,12,6,18
"30034",10602,"Corner Brook","NL",48.95224,-57.92207,2018-06-06 02:00:00,9,6,15
"30035",10602,"Corner Brook","NL",48.95224,-57.92207,2018-06-06 03:00:00,11,5,16
"30036",10602,"Corner Brook","NL",48.95224,-57.92207,2018-06-06 04:00:00,12,5,17
"30037",10602,"Corner Brook","NL",48.95224,-57.92207,2018-06-06 05:00:00,10,4,14
"30038",10602,"Corner Brook","NL",48.95224,-57.92207,2018-06-06 06:00:00,17,5,22
"30039",10602,"Corner Brook","NL",48.95224,-57.92207,2018-06-06 07:00:00,22,3,25
"30040",10602,"Corner Brook","NL",48.95224,-57.92207,2018-06-06 08:00:00,20,5,25
"30041",10602,"Corner Brook","NL",48.95224,-57.92207,2018-06-06 09:00:00,16,7,23
"30042",10602,"Corner Brook","NL",48.95224,-57.92207,2018-06-06 10:00:00,25,6,31
"30043",10602,"Corner Brook","NL",48.95224,-57.92207,2018-06-06 11:00:00,24,6,30
"30044",10602,"Corner Brook","NL",48.95224,-57.92207,2018-06-06 12:00:00,26,3,29
"30045",10602,"Corner Brook","NL",48.95224,-57.92207,2018-06-06 13:00:00,27,2,29
"30046",10602,"Corner Brook","NL",48.95224,-57.92207,2018-06-06 14:00:00,23,5,28
"30047",10602,"Corner Brook","NL",48.95224,-57.92207,2018-06-06 15:00:00,19,10,29
"30048",10602,"Corner Brook","NL",48.95224,-57.92207,2018-06-06 16:00:00,19,11,30
"30049",10602,"Corner Brook","NL",48.95224,-57.92207,2018-06-06 17:00:00,24,4,28
"30050",10602,"Corner Brook","NL",48.95224,-57.92207,2018-06-06 18:00:00,15,13,28
"30051",10602,"Corner Brook","NL",48.95224,-57.92207,2018-06-06 19:00:00,15,13,28
"30052",10602,"Corner Brook","NL",48.95224,-57.92207,2018-06-06 20:00:00,18,9,27
"30053",10602,"Corner Brook","NL",48.95224,-57.92207,2018-06-06 21:00:00,21,4,25
"30054",10602,"Corner Brook","NL",48.95224,-57.92207,2018-06-06 22:00:00,18,5,23
"30055",10602,"Corner Brook","NL",48.95224,-57.92207,2018-06-06 23:00:00,19,3,22
"30056",10602,"Corner Brook","NL",48.95224,-57.92207,2018-06-07 00:00:00,15,3,18
"30057",10602,"Corner Brook","NL",48.95224,-57.92207,2018-06-07 01:00:00,10,4,14
"30058",10602,"Corner Brook","NL",48.95224,-57.92207,2018-06-07 02:00:00,11,3,14
"30059",10602,"Corner Brook","NL",48.95224,-57.92207,2018-06-07 03:00:00,13,2,15
"30060",10602,"Corner Brook","NL",48.95224,-57.92207,2018-06-07 04:00:00,13,1,14
"30061",10602,"Corner Brook","NL",48.95224,-57.92207,2018-06-07 05:00:00,12,2,14
"30062",10602,"Corner Brook","NL",48.95224,-57.92207,2018-06-07 06:00:00,11,3,14
"30063",10602,"Corner Brook","NL",48.95224,-57.92207,2018-06-07 07:00:00,11,4,15
"30064",10602,"Corner Brook","NL",48.95224,-57.92207,2018-06-07 08:00:00,11,3,14
"30065",10602,"Corner Brook","NL",48.95224,-57.92207,2018-06-07 09:00:00,15,3,18
"30066",10602,"Corner Brook","NL",48.95224,-57.92207,2018-06-07 10:00:00,24,2,26
"30067",10602,"Corner Brook","NL",48.95224,-57.92207,2018-06-07 11:00:00,30,2,32
"30068",10602,"Corner Brook","NL",48.95224,-57.92207,2018-06-07 12:00:00,22,7,29
"30069",10602,"Corner Brook","NL",48.95224,-57.92207,2018-06-07 13:00:00,26,5,31
"30070",10602,"Corner Brook","NL",48.95224,-57.92207,2018-06-07 14:00:00,29,1,30
"30071",10602,"Corner Brook","NL",48.95224,-57.92207,2018-06-07 15:00:00,23,8,31
"30072",10602,"Corner Brook","NL",48.95224,-57.92207,2018-06-07 16:00:00,22,9,31
"30073",10602,"Corner Brook","NL",48.95224,-57.92207,2018-06-07 17:00:00,21,13,34
"30074",10602,"Corner Brook","NL",48.95224,-57.92207,2018-06-07 18:00:00,27,4,31
"30075",10602,"Corner Brook","NL",48.95224,-57.92207,2018-06-07 19:00:00,25,6,31
"30076",10602,"Corner Brook","NL",48.95224,-57.92207,2018-06-07 20:00:00,24,7,31
"30077",10602,"Corner Brook","NL",48.95224,-57.92207,2018-06-07 21:00:00,26,5,31
"30078",10602,"Corner Brook","NL",48.95224,-57.92207,2018-06-07 22:00:00,24,4,28
"30079",10602,"Corner Brook","NL",48.95224,-57.92207,2018-06-07 23:00:00,22,5,27
"30080",10602,"Corner Brook","NL",48.95224,-57.92207,2018-06-08 00:00:00,18,4,22
"30081",10602,"Corner Brook","NL",48.95224,-57.92207,2018-06-08 01:00:00,21,2,23
"30082",10602,"Corner Brook","NL",48.95224,-57.92207,2018-06-08 02:00:00,20,2,22
"30083",10602,"Corner Brook","NL",48.95224,-57.92207,2018-06-08 03:00:00,15,4,19
"30084",10602,"Corner Brook","NL",48.95224,-57.92207,2018-06-08 04:00:00,17,4,21
"30085",10602,"Corner Brook","NL",48.95224,-57.92207,2018-06-08 05:00:00,17,4,21
"30086",10602,"Corner Brook","NL",48.95224,-57.92207,2018-06-08 06:00:00,14,6,20
"30087",10602,"Corner Brook","NL",48.95224,-57.92207,2018-06-08 07:00:00,11,7,18
"30088",10602,"Corner Brook","NL",48.95224,-57.92207,2018-06-08 08:00:00,11,10,21
"30089",10602,"Corner Brook","NL",48.95224,-57.92207,2018-06-08 09:00:00,20,5,25
"30090",10602,"Corner Brook","NL",48.95224,-57.92207,2018-06-08 10:00:00,35,1,36
"30091",10602,"Corner Brook","NL",48.95224,-57.92207,2018-06-08 11:00:00,36,1,37
"30092",10602,"Corner Brook","NL",48.95224,-57.92207,2018-06-08 12:00:00,34,1,35
"30093",10602,"Corner Brook","NL",48.95224,-57.92207,2018-06-08 13:00:00,34,1,35
"30094",10602,"Corner Brook","NL",48.95224,-57.92207,2018-06-08 14:00:00,38,1,39
"30095",10602,"Corner Brook","NL",48.95224,-57.92207,2018-06-08 15:00:00,35,1,36
"30096",10602,"Corner Brook","NL",48.95224,-57.92207,2018-06-08 16:00:00,36,1,37
"30097",10602,"Corner Brook","NL",48.95224,-57.92207,2018-06-08 17:00:00,35,1,36
"30098",10602,"Corner Brook","NL",48.95224,-57.92207,2018-06-08 18:00:00,33,1,34
"30099",10602,"Corner Brook","NL",48.95224,-57.92207,2018-06-08 19:00:00,34,1,35
"30100",10602,"Corner Brook","NL",48.95224,-57.92207,2018-06-08 20:00:00,35,1,36
"30101",10602,"Corner Brook","NL",48.95224,-57.92207,2018-06-08 21:00:00,36,1,37
"30102",10602,"Corner Brook","NL",48.95224,-57.92207,2018-06-08 22:00:00,35,1,36
"30103",10602,"Corner Brook","NL",48.95224,-57.92207,2018-06-08 23:00:00,31,1,32
"30104",10602,"Corner Brook","NL",48.95224,-57.92207,2018-06-09 00:00:00,31,1,32
"30105",10602,"Corner Brook","NL",48.95224,-57.92207,2018-06-09 01:00:00,33,1,34
"30106",10602,"Corner Brook","NL",48.95224,-57.92207,2018-06-09 02:00:00,32,1,33
"30107",10602,"Corner Brook","NL",48.95224,-57.92207,2018-06-09 03:00:00,33,1,34
"30108",10602,"Corner Brook","NL",48.95224,-57.92207,2018-06-09 04:00:00,33,1,34
"30109",10602,"Corner Brook","NL",48.95224,-57.92207,2018-06-09 05:00:00,32,1,33
"30110",10602,"Corner Brook","NL",48.95224,-57.92207,2018-06-09 06:00:00,30,1,31
"30111",10602,"Corner Brook","NL",48.95224,-57.92207,2018-06-09 07:00:00,29,1,30
"30112",10602,"Corner Brook","NL",48.95224,-57.92207,2018-06-09 08:00:00,29,1,30
"30113",10602,"Corner Brook","NL",48.95224,-57.92207,2018-06-09 09:00:00,29,1,30
"30114",10602,"Corner Brook","NL",48.95224,-57.92207,2018-06-09 10:00:00,32,1,33
"30115",10602,"Corner Brook","NL",48.95224,-57.92207,2018-06-09 11:00:00,34,1,35
"30116",10602,"Corner Brook","NL",48.95224,-57.92207,2018-06-09 12:00:00,34,1,35
"30117",10602,"Corner Brook","NL",48.95224,-57.92207,2018-06-09 13:00:00,34,1,35
"30118",10602,"Corner Brook","NL",48.95224,-57.92207,2018-06-09 14:00:00,35,1,36
"30119",10602,"Corner Brook","NL",48.95224,-57.92207,2018-06-09 15:00:00,36,1,37
"30120",10602,"Corner Brook","NL",48.95224,-57.92207,2018-06-09 16:00:00,35,1,36
"30121",10602,"Corner Brook","NL",48.95224,-57.92207,2018-06-09 17:00:00,30,3,33
"30122",10602,"Corner Brook","NL",48.95224,-57.92207,2018-06-09 18:00:00,26,3,29
"30123",10602,"Corner Brook","NL",48.95224,-57.92207,2018-06-09 19:00:00,25,3,28
"30124",10602,"Corner Brook","NL",48.95224,-57.92207,2018-06-09 20:00:00,24,4,28
"30125",10602,"Corner Brook","NL",48.95224,-57.92207,2018-06-09 21:00:00,26,2,28
"30126",10602,"Corner Brook","NL",48.95224,-57.92207,2018-06-09 22:00:00,24,1,25
"30127",10602,"Corner Brook","NL",48.95224,-57.92207,2018-06-09 23:00:00,24,1,25
"30128",10602,"Corner Brook","NL",48.95224,-57.92207,2018-06-10 00:00:00,22,1,23
"30129",10602,"Corner Brook","NL",48.95224,-57.92207,2018-06-10 01:00:00,22,1,23
"30130",10602,"Corner Brook","NL",48.95224,-57.92207,2018-06-10 02:00:00,21,2,23
"30131",10602,"Corner Brook","NL",48.95224,-57.92207,2018-06-10 03:00:00,22,1,23
"30132",10602,"Corner Brook","NL",48.95224,-57.92207,2018-06-10 04:00:00,21,1,22
"30133",10602,"Corner Brook","NL",48.95224,-57.92207,2018-06-10 05:00:00,20,1,21
"30134",10602,"Corner Brook","NL",48.95224,-57.92207,2018-06-10 06:00:00,21,1,22
"30135",10602,"Corner Brook","NL",48.95224,-57.92207,2018-06-10 07:00:00,23,1,24
"30136",10602,"Corner Brook","NL",48.95224,-57.92207,2018-06-10 08:00:00,23,1,24
"30137",10602,"Corner Brook","NL",48.95224,-57.92207,2018-06-10 09:00:00,24,1,25
"30138",10602,"Corner Brook","NL",48.95224,-57.92207,2018-06-10 10:00:00,24,1,25
"30139",10602,"Corner Brook","NL",48.95224,-57.92207,2018-06-10 11:00:00,22,4,26
"30140",10602,"Corner Brook","NL",48.95224,-57.92207,2018-06-10 12:00:00,22,4,26
"30141",10602,"Corner Brook","NL",48.95224,-57.92207,2018-06-10 13:00:00,25,1,26
"30142",10602,"Corner Brook","NL",48.95224,-57.92207,2018-06-10 14:00:00,25,1,26
"30143",10602,"Corner Brook","NL",48.95224,-57.92207,2018-06-10 15:00:00,25,1,26
"30144",10602,"Corner Brook","NL",48.95224,-57.92207,2018-06-10 16:00:00,25,1,26
"30145",10602,"Corner Brook","NL",48.95224,-57.92207,2018-06-10 17:00:00,25,1,26
"30146",10602,"Corner Brook","NL",48.95224,-57.92207,2018-06-10 18:00:00,24,1,25
"30147",10602,"Corner Brook","NL",48.95224,-57.92207,2018-06-10 19:00:00,24,1,25
"30148",10602,"Corner Brook","NL",48.95224,-57.92207,2018-06-10 20:00:00,24,1,25
"30149",10602,"Corner Brook","NL",48.95224,-57.92207,2018-06-10 21:00:00,24,1,25
"30150",10602,"Corner Brook","NL",48.95224,-57.92207,2018-06-10 22:00:00,24,1,25
"30151",10602,"Corner Brook","NL",48.95224,-57.92207,2018-06-10 23:00:00,23,1,24
"30152",10602,"Corner Brook","NL",48.95224,-57.92207,2018-06-11 00:00:00,22,1,23
"30153",10602,"Corner Brook","NL",48.95224,-57.92207,2018-06-11 01:00:00,22,1,23
"30154",10602,"Corner Brook","NL",48.95224,-57.92207,2018-06-11 02:00:00,22,2,24
"30155",10602,"Corner Brook","NL",48.95224,-57.92207,2018-06-11 03:00:00,22,1,23
"30156",10602,"Corner Brook","NL",48.95224,-57.92207,2018-06-11 04:00:00,23,1,24
"30157",10602,"Corner Brook","NL",48.95224,-57.92207,2018-06-11 05:00:00,23,1,24
"30158",10602,"Corner Brook","NL",48.95224,-57.92207,2018-06-11 06:00:00,25,1,26
"30159",10602,"Corner Brook","NL",48.95224,-57.92207,2018-06-11 07:00:00,27,1,28
"30160",10602,"Corner Brook","NL",48.95224,-57.92207,2018-06-11 08:00:00,28,1,29
"30161",10602,"Corner Brook","NL",48.95224,-57.92207,2018-06-11 09:00:00,25,6,31
"30162",10602,"Corner Brook","NL",48.95224,-57.92207,2018-06-11 10:00:00,25,5,30
"30163",10602,"Corner Brook","NL",48.95224,-57.92207,2018-06-11 11:00:00,25,5,30
"30164",10602,"Corner Brook","NL",48.95224,-57.92207,2018-06-11 12:00:00,24,6,30
"30165",10602,"Corner Brook","NL",48.95224,-57.92207,2018-06-11 13:00:00,23,6,29
"30166",10602,"Corner Brook","NL",48.95224,-57.92207,2018-06-11 14:00:00,24,5,29
"30167",10602,"Corner Brook","NL",48.95224,-57.92207,2018-06-11 15:00:00,23,5,28
"30168",10602,"Corner Brook","NL",48.95224,-57.92207,2018-06-11 16:00:00,21,7,28
"30169",10602,"Corner Brook","NL",48.95224,-57.92207,2018-06-11 17:00:00,20,7,27
"30170",10602,"Corner Brook","NL",48.95224,-57.92207,2018-06-11 18:00:00,20,7,27
"30171",10602,"Corner Brook","NL",48.95224,-57.92207,2018-06-11 19:00:00,22,4,26
"30172",10602,"Corner Brook","NL",48.95224,-57.92207,2018-06-11 20:00:00,26,1,27
"30173",10602,"Corner Brook","NL",48.95224,-57.92207,2018-06-11 21:00:00,26,1,27
"30174",10602,"Corner Brook","NL",48.95224,-57.92207,2018-06-11 22:00:00,26,1,27
"30175",10602,"Corner Brook","NL",48.95224,-57.92207,2018-06-11 23:00:00,24,2,26
"30176",10602,"Corner Brook","NL",48.95224,-57.92207,2018-06-12 00:00:00,22,3,25
"30177",10602,"Corner Brook","NL",48.95224,-57.92207,2018-06-12 01:00:00,19,3,22
"30178",10602,"Corner Brook","NL",48.95224,-57.92207,2018-06-12 02:00:00,17,3,20
"30179",10602,"Corner Brook","NL",48.95224,-57.92207,2018-06-12 03:00:00,20,2,22
"30180",10602,"Corner Brook","NL",48.95224,-57.92207,2018-06-12 04:00:00,20,2,22
"30181",10602,"Corner Brook","NL",48.95224,-57.92207,2018-06-12 05:00:00,19,1,20
"30182",10602,"Corner Brook","NL",48.95224,-57.92207,2018-06-12 06:00:00,17,3,20
"30183",10602,"Corner Brook","NL",48.95224,-57.92207,2018-06-12 07:00:00,18,3,21
"30184",10602,"Corner Brook","NL",48.95224,-57.92207,2018-06-12 08:00:00,17,3,20
"30185",10602,"Corner Brook","NL",48.95224,-57.92207,2018-06-12 09:00:00,20,4,24
"30186",10602,"Corner Brook","NL",48.95224,-57.92207,2018-06-12 10:00:00,24,2,26
"30187",10602,"Corner Brook","NL",48.95224,-57.92207,2018-06-12 11:00:00,28,1,29
"30188",10602,"Corner Brook","NL",48.95224,-57.92207,2018-06-12 12:00:00,24,6,30
"30189",10602,"Corner Brook","NL",48.95224,-57.92207,2018-06-12 13:00:00,28,4,32
"30190",10602,"Corner Brook","NL",48.95224,-57.92207,2018-06-12 14:00:00,30,3,33
"30191",10602,"Corner Brook","NL",48.95224,-57.92207,2018-06-12 15:00:00,32,2,34
"30192",10602,"Corner Brook","NL",48.95224,-57.92207,2018-06-12 16:00:00,33,1,34
"30193",10602,"Corner Brook","NL",48.95224,-57.92207,2018-06-12 17:00:00,34,1,35
"30194",10602,"Corner Brook","NL",48.95224,-57.92207,2018-06-12 18:00:00,34,1,35
"30195",10602,"Corner Brook","NL",48.95224,-57.92207,2018-06-12 19:00:00,33,1,34
"30196",10602,"Corner Brook","NL",48.95224,-57.92207,2018-06-12 20:00:00,34,1,35
"30197",10602,"Corner Brook","NL",48.95224,-57.92207,2018-06-12 21:00:00,32,1,33
"30198",10602,"Corner Brook","NL",48.95224,-57.92207,2018-06-12 22:00:00,30,1,31
"30199",10602,"Corner Brook","NL",48.95224,-57.92207,2018-06-12 23:00:00,30,1,31
"30200",10602,"Corner Brook","NL",48.95224,-57.92207,2018-06-13 00:00:00,32,1,33
"30201",10602,"Corner Brook","NL",48.95224,-57.92207,2018-06-13 01:00:00,32,1,33
"30202",10602,"Corner Brook","NL",48.95224,-57.92207,2018-06-13 02:00:00,32,1,33
"30203",10602,"Corner Brook","NL",48.95224,-57.92207,2018-06-13 03:00:00,32,0,32
"30204",10602,"Corner Brook","NL",48.95224,-57.92207,2018-06-13 04:00:00,NA,NA,NA
"30205",10602,"Corner Brook","NL",48.95224,-57.92207,2018-06-13 05:00:00,NA,NA,NA
"30206",10602,"Corner Brook","NL",48.95224,-57.92207,2018-06-13 06:00:00,NA,NA,NA
"30207",10602,"Corner Brook","NL",48.95224,-57.92207,2018-06-13 07:00:00,NA,NA,NA
"30208",10602,"Corner Brook","NL",48.95224,-57.92207,2018-06-13 08:00:00,NA,NA,NA
"30209",10602,"Corner Brook","NL",48.95224,-57.92207,2018-06-13 09:00:00,NA,NA,NA
"30210",10602,"Corner Brook","NL",48.95224,-57.92207,2018-06-13 10:00:00,NA,NA,NA
"30211",10602,"Corner Brook","NL",48.95224,-57.92207,2018-06-13 11:00:00,NA,NA,NA
"30212",10602,"Corner Brook","NL",48.95224,-57.92207,2018-06-13 12:00:00,NA,NA,NA
"30213",10602,"Corner Brook","NL",48.95224,-57.92207,2018-06-13 13:00:00,NA,NA,NA
"30214",10602,"Corner Brook","NL",48.95224,-57.92207,2018-06-13 14:00:00,NA,NA,NA
"30215",10602,"Corner Brook","NL",48.95224,-57.92207,2018-06-13 15:00:00,26,1,27
"30216",10602,"Corner Brook","NL",48.95224,-57.92207,2018-06-13 16:00:00,26,2,28
"30217",10602,"Corner Brook","NL",48.95224,-57.92207,2018-06-13 17:00:00,27,3,30
"30218",10602,"Corner Brook","NL",48.95224,-57.92207,2018-06-13 18:00:00,30,1,31
"30219",10602,"Corner Brook","NL",48.95224,-57.92207,2018-06-13 19:00:00,22,4,26
"30220",10602,"Corner Brook","NL",48.95224,-57.92207,2018-06-13 20:00:00,25,1,26
"30221",10602,"Corner Brook","NL",48.95224,-57.92207,2018-06-13 21:00:00,25,1,26
"30222",10602,"Corner Brook","NL",48.95224,-57.92207,2018-06-13 22:00:00,25,1,26
"30223",10602,"Corner Brook","NL",48.95224,-57.92207,2018-06-13 23:00:00,25,1,26
"30224",10602,"Corner Brook","NL",48.95224,-57.92207,2018-06-14 00:00:00,24,2,26
"30225",10602,"Corner Brook","NL",48.95224,-57.92207,2018-06-14 01:00:00,16,7,23
"30226",10602,"Corner Brook","NL",48.95224,-57.92207,2018-06-14 02:00:00,18,4,22
"30227",10602,"Corner Brook","NL",48.95224,-57.92207,2018-06-14 03:00:00,19,2,21
"30228",10602,"Corner Brook","NL",48.95224,-57.92207,2018-06-14 04:00:00,23,1,24
"30229",10602,"Corner Brook","NL",48.95224,-57.92207,2018-06-14 05:00:00,19,3,22
"30230",10602,"Corner Brook","NL",48.95224,-57.92207,2018-06-14 06:00:00,14,7,21
"30231",10602,"Corner Brook","NL",48.95224,-57.92207,2018-06-14 07:00:00,21,4,25
"30232",10602,"Corner Brook","NL",48.95224,-57.92207,2018-06-14 08:00:00,23,3,26
"30233",10602,"Corner Brook","NL",48.95224,-57.92207,2018-06-14 09:00:00,24,2,26
"30234",10602,"Corner Brook","NL",48.95224,-57.92207,2018-06-14 10:00:00,25,2,27
"30235",10602,"Corner Brook","NL",48.95224,-57.92207,2018-06-14 11:00:00,27,1,28
"30236",10602,"Corner Brook","NL",48.95224,-57.92207,2018-06-14 12:00:00,29,1,30
"30237",10602,"Corner Brook","NL",48.95224,-57.92207,2018-06-14 13:00:00,30,1,31
"30238",10602,"Corner Brook","NL",48.95224,-57.92207,2018-06-14 14:00:00,28,1,29
"30239",10602,"Corner Brook","NL",48.95224,-57.92207,2018-06-14 15:00:00,24,4,28
"30240",10602,"Corner Brook","NL",48.95224,-57.92207,2018-06-14 16:00:00,20,7,27
"30241",10602,"Corner Brook","NL",48.95224,-57.92207,2018-06-14 17:00:00,20,7,27
"30242",10602,"Corner Brook","NL",48.95224,-57.92207,2018-06-14 18:00:00,18,9,27
"30243",10602,"Corner Brook","NL",48.95224,-57.92207,2018-06-14 19:00:00,20,9,29
"30244",10602,"Corner Brook","NL",48.95224,-57.92207,2018-06-14 20:00:00,23,4,27
"30245",10602,"Corner Brook","NL",48.95224,-57.92207,2018-06-14 21:00:00,9,16,25
"30246",10602,"Corner Brook","NL",48.95224,-57.92207,2018-06-14 22:00:00,16,8,24
"30247",10602,"Corner Brook","NL",48.95224,-57.92207,2018-06-14 23:00:00,7,14,21
"30248",10602,"Corner Brook","NL",48.95224,-57.92207,2018-06-15 00:00:00,9,10,19
"30249",10602,"Corner Brook","NL",48.95224,-57.92207,2018-06-15 01:00:00,12,9,21
"30250",10602,"Corner Brook","NL",48.95224,-57.92207,2018-06-15 02:00:00,8,11,19
"30251",10602,"Corner Brook","NL",48.95224,-57.92207,2018-06-15 03:00:00,5,10,15
"30252",10602,"Corner Brook","NL",48.95224,-57.92207,2018-06-15 04:00:00,4,7,11
"30253",10602,"Corner Brook","NL",48.95224,-57.92207,2018-06-15 05:00:00,8,5,13
"30254",10602,"Corner Brook","NL",48.95224,-57.92207,2018-06-15 06:00:00,14,5,19
"30255",10602,"Corner Brook","NL",48.95224,-57.92207,2018-06-15 07:00:00,14,6,20
"30256",10602,"Corner Brook","NL",48.95224,-57.92207,2018-06-15 08:00:00,23,4,27
"30257",10602,"Corner Brook","NL",48.95224,-57.92207,2018-06-15 09:00:00,30,3,33
"30258",10602,"Corner Brook","NL",48.95224,-57.92207,2018-06-15 10:00:00,25,9,34
"30259",10602,"Corner Brook","NL",48.95224,-57.92207,2018-06-15 11:00:00,20,15,35
"30260",10602,"Corner Brook","NL",48.95224,-57.92207,2018-06-15 12:00:00,25,8,33
"30261",10602,"Corner Brook","NL",48.95224,-57.92207,2018-06-15 13:00:00,26,6,32
"30262",10602,"Corner Brook","NL",48.95224,-57.92207,2018-06-15 14:00:00,22,10,32
"30263",10602,"Corner Brook","NL",48.95224,-57.92207,2018-06-15 15:00:00,19,8,27
"30264",10602,"Corner Brook","NL",48.95224,-57.92207,2018-06-15 16:00:00,17,10,27
"30265",10602,"Corner Brook","NL",48.95224,-57.92207,2018-06-15 17:00:00,21,7,28
"30266",10602,"Corner Brook","NL",48.95224,-57.92207,2018-06-15 18:00:00,24,5,29
"30267",10602,"Corner Brook","NL",48.95224,-57.92207,2018-06-15 19:00:00,21,10,31
"30268",10602,"Corner Brook","NL",48.95224,-57.92207,2018-06-15 20:00:00,20,10,30
"30269",10602,"Corner Brook","NL",48.95224,-57.92207,2018-06-15 21:00:00,18,12,30
"30270",10602,"Corner Brook","NL",48.95224,-57.92207,2018-06-15 22:00:00,22,3,25
"30271",10602,"Corner Brook","NL",48.95224,-57.92207,2018-06-15 23:00:00,22,1,23
"30272",10602,"Corner Brook","NL",48.95224,-57.92207,2018-06-16 00:00:00,21,2,23
"30273",10602,"Corner Brook","NL",48.95224,-57.92207,2018-06-16 01:00:00,23,2,25
"30274",10602,"Corner Brook","NL",48.95224,-57.92207,2018-06-16 02:00:00,23,2,25
"30275",10602,"Corner Brook","NL",48.95224,-57.92207,2018-06-16 03:00:00,24,1,25
"30276",10602,"Corner Brook","NL",48.95224,-57.92207,2018-06-16 04:00:00,20,2,22
"30277",10602,"Corner Brook","NL",48.95224,-57.92207,2018-06-16 05:00:00,22,2,24
"30278",10602,"Corner Brook","NL",48.95224,-57.92207,2018-06-16 06:00:00,24,1,25
"30279",10602,"Corner Brook","NL",48.95224,-57.92207,2018-06-16 07:00:00,23,2,25
"30280",10602,"Corner Brook","NL",48.95224,-57.92207,2018-06-16 08:00:00,24,2,26
"30281",10602,"Corner Brook","NL",48.95224,-57.92207,2018-06-16 09:00:00,24,2,26
"30282",10602,"Corner Brook","NL",48.95224,-57.92207,2018-06-16 10:00:00,24,1,25
"30283",10602,"Corner Brook","NL",48.95224,-57.92207,2018-06-16 11:00:00,26,1,27
"30284",10602,"Corner Brook","NL",48.95224,-57.92207,2018-06-16 12:00:00,25,1,26
"30285",10602,"Corner Brook","NL",48.95224,-57.92207,2018-06-16 13:00:00,22,5,27
"30286",10602,"Corner Brook","NL",48.95224,-57.92207,2018-06-16 14:00:00,22,6,28
"30287",10602,"Corner Brook","NL",48.95224,-57.92207,2018-06-16 15:00:00,23,7,30
"30288",10602,"Corner Brook","NL",48.95224,-57.92207,2018-06-16 16:00:00,26,7,33
"30289",10602,"Corner Brook","NL",48.95224,-57.92207,2018-06-16 17:00:00,27,6,33
"30290",10602,"Corner Brook","NL",48.95224,-57.92207,2018-06-16 18:00:00,26,8,34
"30291",10602,"Corner Brook","NL",48.95224,-57.92207,2018-06-16 19:00:00,23,12,35
"30292",10602,"Corner Brook","NL",48.95224,-57.92207,2018-06-16 20:00:00,29,3,32
"30293",10602,"Corner Brook","NL",48.95224,-57.92207,2018-06-16 21:00:00,30,1,31
"30294",10602,"Corner Brook","NL",48.95224,-57.92207,2018-06-16 22:00:00,29,1,30
"30295",10602,"Corner Brook","NL",48.95224,-57.92207,2018-06-16 23:00:00,29,1,30
"30296",10602,"Corner Brook","NL",48.95224,-57.92207,2018-06-17 00:00:00,28,1,29
"30297",10602,"Corner Brook","NL",48.95224,-57.92207,2018-06-17 01:00:00,27,1,28
"30298",10602,"Corner Brook","NL",48.95224,-57.92207,2018-06-17 02:00:00,27,1,28
"30299",10602,"Corner Brook","NL",48.95224,-57.92207,2018-06-17 03:00:00,26,1,27
"30300",10602,"Corner Brook","NL",48.95224,-57.92207,2018-06-17 04:00:00,24,1,25
"30301",10602,"Corner Brook","NL",48.95224,-57.92207,2018-06-17 05:00:00,23,2,25
"30302",10602,"Corner Brook","NL",48.95224,-57.92207,2018-06-17 06:00:00,22,2,24
"30303",10602,"Corner Brook","NL",48.95224,-57.92207,2018-06-17 07:00:00,23,2,25
"30304",10602,"Corner Brook","NL",48.95224,-57.92207,2018-06-17 08:00:00,23,2,25
"30305",10602,"Corner Brook","NL",48.95224,-57.92207,2018-06-17 09:00:00,25,2,27
"30306",10602,"Corner Brook","NL",48.95224,-57.92207,2018-06-17 10:00:00,30,1,31
"30307",10602,"Corner Brook","NL",48.95224,-57.92207,2018-06-17 11:00:00,30,1,31
"30308",10602,"Corner Brook","NL",48.95224,-57.92207,2018-06-17 12:00:00,30,1,31
"30309",10602,"Corner Brook","NL",48.95224,-57.92207,2018-06-17 13:00:00,29,2,31
"30310",10602,"Corner Brook","NL",48.95224,-57.92207,2018-06-17 14:00:00,27,4,31
"30311",10602,"Corner Brook","NL",48.95224,-57.92207,2018-06-17 15:00:00,24,9,33
"30312",10602,"Corner Brook","NL",48.95224,-57.92207,2018-06-17 16:00:00,25,8,33
"30313",10602,"Corner Brook","NL",48.95224,-57.92207,2018-06-17 17:00:00,22,11,33
"30314",10602,"Corner Brook","NL",48.95224,-57.92207,2018-06-17 18:00:00,22,10,32
"30315",10602,"Corner Brook","NL",48.95224,-57.92207,2018-06-17 19:00:00,19,13,32
"30316",10602,"Corner Brook","NL",48.95224,-57.92207,2018-06-17 20:00:00,22,9,31
"30317",10602,"Corner Brook","NL",48.95224,-57.92207,2018-06-17 21:00:00,27,3,30
"30318",10602,"Corner Brook","NL",48.95224,-57.92207,2018-06-17 22:00:00,26,3,29
"30319",10602,"Corner Brook","NL",48.95224,-57.92207,2018-06-17 23:00:00,22,4,26
"30320",10602,"Corner Brook","NL",48.95224,-57.92207,2018-06-18 00:00:00,18,4,22
"30321",10602,"Corner Brook","NL",48.95224,-57.92207,2018-06-18 01:00:00,22,1,23
"30322",10602,"Corner Brook","NL",48.95224,-57.92207,2018-06-18 02:00:00,25,1,26
"30323",10602,"Corner Brook","NL",48.95224,-57.92207,2018-06-18 03:00:00,23,1,24
"30324",10602,"Corner Brook","NL",48.95224,-57.92207,2018-06-18 04:00:00,24,1,25
"30325",10602,"Corner Brook","NL",48.95224,-57.92207,2018-06-18 05:00:00,23,2,25
"30326",10602,"Corner Brook","NL",48.95224,-57.92207,2018-06-18 06:00:00,23,2,25
"30327",10602,"Corner Brook","NL",48.95224,-57.92207,2018-06-18 07:00:00,21,3,24
"30328",10602,"Corner Brook","NL",48.95224,-57.92207,2018-06-18 08:00:00,23,1,24
"30329",10602,"Corner Brook","NL",48.95224,-57.92207,2018-06-18 09:00:00,25,2,27
"30330",10602,"Corner Brook","NL",48.95224,-57.92207,2018-06-18 10:00:00,25,1,26
"30331",10602,"Corner Brook","NL",48.95224,-57.92207,2018-06-18 11:00:00,25,1,26
"30332",10602,"Corner Brook","NL",48.95224,-57.92207,2018-06-18 12:00:00,25,1,26
"30333",10602,"Corner Brook","NL",48.95224,-57.92207,2018-06-18 13:00:00,26,1,27
"30334",10602,"Corner Brook","NL",48.95224,-57.92207,2018-06-18 14:00:00,26,1,27
"30335",10602,"Corner Brook","NL",48.95224,-57.92207,2018-06-18 15:00:00,27,1,28
"30336",10602,"Corner Brook","NL",48.95224,-57.92207,2018-06-18 16:00:00,29,1,30
"30337",10602,"Corner Brook","NL",48.95224,-57.92207,2018-06-18 17:00:00,30,1,31
"30338",10602,"Corner Brook","NL",48.95224,-57.92207,2018-06-18 18:00:00,31,1,32
"30339",10602,"Corner Brook","NL",48.95224,-57.92207,2018-06-18 19:00:00,30,1,31
"30340",10602,"Corner Brook","NL",48.95224,-57.92207,2018-06-18 20:00:00,30,1,31
"30341",10602,"Corner Brook","NL",48.95224,-57.92207,2018-06-18 21:00:00,28,1,29
"30342",10602,"Corner Brook","NL",48.95224,-57.92207,2018-06-18 22:00:00,28,0,28
"30343",10602,"Corner Brook","NL",48.95224,-57.92207,2018-06-18 23:00:00,30,0,30
"30344",10602,"Corner Brook","NL",48.95224,-57.92207,2018-06-19 00:00:00,31,0,31
"30345",10602,"Corner Brook","NL",48.95224,-57.92207,2018-06-19 01:00:00,30,1,31
"30346",10602,"Corner Brook","NL",48.95224,-57.92207,2018-06-19 02:00:00,24,2,26
"30347",10602,"Corner Brook","NL",48.95224,-57.92207,2018-06-19 03:00:00,24,3,27
"30348",10602,"Corner Brook","NL",48.95224,-57.92207,2018-06-19 04:00:00,18,3,21
"30349",10602,"Corner Brook","NL",48.95224,-57.92207,2018-06-19 05:00:00,29,2,31
"30350",10602,"Corner Brook","NL",48.95224,-57.92207,2018-06-19 06:00:00,29,3,32
"30351",10602,"Corner Brook","NL",48.95224,-57.92207,2018-06-19 07:00:00,30,4,34
"30352",10602,"Corner Brook","NL",48.95224,-57.92207,2018-06-19 08:00:00,35,3,38
"30353",10602,"Corner Brook","NL",48.95224,-57.92207,2018-06-19 09:00:00,29,6,35
"30354",10602,"Corner Brook","NL",48.95224,-57.92207,2018-06-19 10:00:00,28,7,35
"30355",10602,"Corner Brook","NL",48.95224,-57.92207,2018-06-19 11:00:00,29,7,36
"30356",10602,"Corner Brook","NL",48.95224,-57.92207,2018-06-19 12:00:00,28,10,38
"30357",10602,"Corner Brook","NL",48.95224,-57.92207,2018-06-19 13:00:00,25,10,35
"30358",10602,"Corner Brook","NL",48.95224,-57.92207,2018-06-19 14:00:00,21,12,33
"30359",10602,"Corner Brook","NL",48.95224,-57.92207,2018-06-19 15:00:00,25,8,33
"30360",10602,"Corner Brook","NL",48.95224,-57.92207,2018-06-19 16:00:00,23,8,31
"30361",10602,"Corner Brook","NL",48.95224,-57.92207,2018-06-19 17:00:00,19,12,31
"30362",10602,"Corner Brook","NL",48.95224,-57.92207,2018-06-19 18:00:00,18,12,30
"30363",10602,"Corner Brook","NL",48.95224,-57.92207,2018-06-19 19:00:00,18,9,27
"30364",10602,"Corner Brook","NL",48.95224,-57.92207,2018-06-19 20:00:00,17,10,27
"30365",10602,"Corner Brook","NL",48.95224,-57.92207,2018-06-19 21:00:00,17,9,26
"30366",10602,"Corner Brook","NL",48.95224,-57.92207,2018-06-19 22:00:00,21,4,25
"30367",10602,"Corner Brook","NL",48.95224,-57.92207,2018-06-19 23:00:00,14,9,23
"30368",10602,"Corner Brook","NL",48.95224,-57.92207,2018-06-20 00:00:00,16,1,17
"30369",10602,"Corner Brook","NL",48.95224,-57.92207,2018-06-20 01:00:00,15,1,16
"30370",10602,"Corner Brook","NL",48.95224,-57.92207,2018-06-20 02:00:00,15,1,16
"30371",10602,"Corner Brook","NL",48.95224,-57.92207,2018-06-20 03:00:00,14,1,15
"30372",10602,"Corner Brook","NL",48.95224,-57.92207,2018-06-20 04:00:00,13,1,14
"30373",10602,"Corner Brook","NL",48.95224,-57.92207,2018-06-20 05:00:00,14,1,15
"30374",10602,"Corner Brook","NL",48.95224,-57.92207,2018-06-20 06:00:00,13,1,14
"30375",10602,"Corner Brook","NL",48.95224,-57.92207,2018-06-20 07:00:00,13,2,15
"30376",10602,"Corner Brook","NL",48.95224,-57.92207,2018-06-20 08:00:00,11,3,14
"30377",10602,"Corner Brook","NL",48.95224,-57.92207,2018-06-20 09:00:00,13,3,16
"30378",10602,"Corner Brook","NL",48.95224,-57.92207,2018-06-20 10:00:00,14,5,19
"30379",10602,"Corner Brook","NL",48.95224,-57.92207,2018-06-20 11:00:00,15,5,20
"30380",10602,"Corner Brook","NL",48.95224,-57.92207,2018-06-20 12:00:00,17,4,21
"30381",10602,"Corner Brook","NL",48.95224,-57.92207,2018-06-20 13:00:00,22,2,24
"30382",10602,"Corner Brook","NL",48.95224,-57.92207,2018-06-20 14:00:00,21,5,26
"30383",10602,"Corner Brook","NL",48.95224,-57.92207,2018-06-20 15:00:00,23,4,27
"30384",10602,"Corner Brook","NL",48.95224,-57.92207,2018-06-20 16:00:00,24,1,25
"30385",10602,"Corner Brook","NL",48.95224,-57.92207,2018-06-20 17:00:00,21,1,22
"30386",10602,"Corner Brook","NL",48.95224,-57.92207,2018-06-20 18:00:00,21,1,22
"30387",10602,"Corner Brook","NL",48.95224,-57.92207,2018-06-20 19:00:00,24,1,25
"30388",10602,"Corner Brook","NL",48.95224,-57.92207,2018-06-20 20:00:00,27,1,28
"30389",10602,"Corner Brook","NL",48.95224,-57.92207,2018-06-20 21:00:00,24,2,26
"30390",10602,"Corner Brook","NL",48.95224,-57.92207,2018-06-20 22:00:00,25,1,26
"30391",10602,"Corner Brook","NL",48.95224,-57.92207,2018-06-20 23:00:00,24,1,25
"30392",10602,"Corner Brook","NL",48.95224,-57.92207,2018-06-21 00:00:00,23,1,24
"30393",10602,"Corner Brook","NL",48.95224,-57.92207,2018-06-21 01:00:00,23,1,24
"30394",10602,"Corner Brook","NL",48.95224,-57.92207,2018-06-21 02:00:00,25,0,25
"30395",10602,"Corner Brook","NL",48.95224,-57.92207,2018-06-21 03:00:00,23,1,24
"30396",10602,"Corner Brook","NL",48.95224,-57.92207,2018-06-21 04:00:00,24,2,26
"30397",10602,"Corner Brook","NL",48.95224,-57.92207,2018-06-21 05:00:00,27,1,28
"30398",10602,"Corner Brook","NL",48.95224,-57.92207,2018-06-21 06:00:00,20,4,24
"30399",10602,"Corner Brook","NL",48.95224,-57.92207,2018-06-21 07:00:00,19,5,24
"30400",10602,"Corner Brook","NL",48.95224,-57.92207,2018-06-21 08:00:00,24,2,26
"30401",10602,"Corner Brook","NL",48.95224,-57.92207,2018-06-21 09:00:00,27,2,29
"30402",10602,"Corner Brook","NL",48.95224,-57.92207,2018-06-21 10:00:00,31,3,34
"30403",10602,"Corner Brook","NL",48.95224,-57.92207,2018-06-21 11:00:00,31,1,32
"30404",10602,"Corner Brook","NL",48.95224,-57.92207,2018-06-21 12:00:00,31,1,32
"30405",10602,"Corner Brook","NL",48.95224,-57.92207,2018-06-21 13:00:00,31,1,32
"30406",10602,"Corner Brook","NL",48.95224,-57.92207,2018-06-21 14:00:00,30,1,31
"30407",10602,"Corner Brook","NL",48.95224,-57.92207,2018-06-21 15:00:00,31,1,32
"30408",10602,"Corner Brook","NL",48.95224,-57.92207,2018-06-21 16:00:00,30,1,31
"30409",10602,"Corner Brook","NL",48.95224,-57.92207,2018-06-21 17:00:00,28,1,29
"30410",10602,"Corner Brook","NL",48.95224,-57.92207,2018-06-21 18:00:00,27,1,28
"30411",10602,"Corner Brook","NL",48.95224,-57.92207,2018-06-21 19:00:00,27,1,28
"30412",10602,"Corner Brook","NL",48.95224,-57.92207,2018-06-21 20:00:00,24,1,25
"30413",10602,"Corner Brook","NL",48.95224,-57.92207,2018-06-21 21:00:00,21,1,22
"30414",10602,"Corner Brook","NL",48.95224,-57.92207,2018-06-21 22:00:00,20,2,22
"30415",10602,"Corner Brook","NL",48.95224,-57.92207,2018-06-21 23:00:00,20,1,21
"30416",10602,"Corner Brook","NL",48.95224,-57.92207,2018-06-22 00:00:00,19,1,20
"30417",10602,"Corner Brook","NL",48.95224,-57.92207,2018-06-22 01:00:00,18,1,19
"30418",10602,"Corner Brook","NL",48.95224,-57.92207,2018-06-22 02:00:00,19,1,20
"30419",10602,"Corner Brook","NL",48.95224,-57.92207,2018-06-22 03:00:00,19,1,20
"30420",10602,"Corner Brook","NL",48.95224,-57.92207,2018-06-22 04:00:00,19,1,20
"30421",10602,"Corner Brook","NL",48.95224,-57.92207,2018-06-22 05:00:00,18,2,20
"30422",10602,"Corner Brook","NL",48.95224,-57.92207,2018-06-22 06:00:00,17,3,20
"30423",10602,"Corner Brook","NL",48.95224,-57.92207,2018-06-22 07:00:00,15,4,19
"30424",10602,"Corner Brook","NL",48.95224,-57.92207,2018-06-22 08:00:00,15,4,19
"30425",10602,"Corner Brook","NL",48.95224,-57.92207,2018-06-22 09:00:00,18,3,21
"30426",10602,"Corner Brook","NL",48.95224,-57.92207,2018-06-22 10:00:00,14,6,20
"30427",10602,"Corner Brook","NL",48.95224,-57.92207,2018-06-22 11:00:00,17,6,23
"30428",10602,"Corner Brook","NL",48.95224,-57.92207,2018-06-22 12:00:00,19,5,24
"30429",10602,"Corner Brook","NL",48.95224,-57.92207,2018-06-22 13:00:00,23,3,26
"30430",10602,"Corner Brook","NL",48.95224,-57.92207,2018-06-22 14:00:00,24,3,27
"30431",10602,"Corner Brook","NL",48.95224,-57.92207,2018-06-22 15:00:00,24,3,27
"30432",10602,"Corner Brook","NL",48.95224,-57.92207,2018-06-22 16:00:00,25,3,28
"30433",10602,"Corner Brook","NL",48.95224,-57.92207,2018-06-22 17:00:00,25,3,28
"30434",10602,"Corner Brook","NL",48.95224,-57.92207,2018-06-22 18:00:00,25,5,30
"30435",10602,"Corner Brook","NL",48.95224,-57.92207,2018-06-22 19:00:00,27,1,28
"30436",10602,"Corner Brook","NL",48.95224,-57.92207,2018-06-22 20:00:00,26,1,27
"30437",10602,"Corner Brook","NL",48.95224,-57.92207,2018-06-22 21:00:00,24,2,26
"30438",10602,"Corner Brook","NL",48.95224,-57.92207,2018-06-22 22:00:00,24,1,25
"30439",10602,"Corner Brook","NL",48.95224,-57.92207,2018-06-22 23:00:00,26,1,27
"30440",10602,"Corner Brook","NL",48.95224,-57.92207,2018-06-23 00:00:00,26,2,28
"30441",10602,"Corner Brook","NL",48.95224,-57.92207,2018-06-23 01:00:00,26,1,27
"30442",10602,"Corner Brook","NL",48.95224,-57.92207,2018-06-23 02:00:00,25,1,26
"30443",10602,"Corner Brook","NL",48.95224,-57.92207,2018-06-23 03:00:00,26,1,27
"30444",10602,"Corner Brook","NL",48.95224,-57.92207,2018-06-23 04:00:00,27,1,28
"30445",10602,"Corner Brook","NL",48.95224,-57.92207,2018-06-23 05:00:00,26,1,27
"30446",10602,"Corner Brook","NL",48.95224,-57.92207,2018-06-23 06:00:00,26,2,28
"30447",10602,"Corner Brook","NL",48.95224,-57.92207,2018-06-23 07:00:00,27,2,29
"30448",10602,"Corner Brook","NL",48.95224,-57.92207,2018-06-23 08:00:00,28,1,29
"30449",10602,"Corner Brook","NL",48.95224,-57.92207,2018-06-23 09:00:00,30,1,31
"30450",10602,"Corner Brook","NL",48.95224,-57.92207,2018-06-23 10:00:00,30,1,31
"30451",10602,"Corner Brook","NL",48.95224,-57.92207,2018-06-23 11:00:00,31,1,32
"30452",10602,"Corner Brook","NL",48.95224,-57.92207,2018-06-23 12:00:00,32,1,33
"30453",10602,"Corner Brook","NL",48.95224,-57.92207,2018-06-23 13:00:00,33,1,34
"30454",10602,"Corner Brook","NL",48.95224,-57.92207,2018-06-23 14:00:00,34,1,35
"30455",10602,"Corner Brook","NL",48.95224,-57.92207,2018-06-23 15:00:00,33,1,34
"30456",10602,"Corner Brook","NL",48.95224,-57.92207,2018-06-23 16:00:00,35,1,36
"30457",10602,"Corner Brook","NL",48.95224,-57.92207,2018-06-23 17:00:00,35,1,36
"30458",10602,"Corner Brook","NL",48.95224,-57.92207,2018-06-23 18:00:00,36,1,37
"30459",10602,"Corner Brook","NL",48.95224,-57.92207,2018-06-23 19:00:00,36,1,37
"30460",10602,"Corner Brook","NL",48.95224,-57.92207,2018-06-23 20:00:00,34,1,35
"30461",10602,"Corner Brook","NL",48.95224,-57.92207,2018-06-23 21:00:00,36,2,38
"30462",10602,"Corner Brook","NL",48.95224,-57.92207,2018-06-23 22:00:00,35,3,38
"30463",10602,"Corner Brook","NL",48.95224,-57.92207,2018-06-23 23:00:00,33,3,36
"30464",10602,"Corner Brook","NL",48.95224,-57.92207,2018-06-24 00:00:00,33,2,35
"30465",10602,"Corner Brook","NL",48.95224,-57.92207,2018-06-24 01:00:00,32,1,33
"30466",10602,"Corner Brook","NL",48.95224,-57.92207,2018-06-24 02:00:00,29,2,31
"30467",10602,"Corner Brook","NL",48.95224,-57.92207,2018-06-24 03:00:00,30,1,31
"30468",10602,"Corner Brook","NL",48.95224,-57.92207,2018-06-24 04:00:00,30,1,31
"30469",10602,"Corner Brook","NL",48.95224,-57.92207,2018-06-24 05:00:00,29,1,30
"30470",10602,"Corner Brook","NL",48.95224,-57.92207,2018-06-24 06:00:00,27,1,28
"30471",10602,"Corner Brook","NL",48.95224,-57.92207,2018-06-24 07:00:00,24,2,26
"30472",10602,"Corner Brook","NL",48.95224,-57.92207,2018-06-24 08:00:00,22,4,26
"30473",10602,"Corner Brook","NL",48.95224,-57.92207,2018-06-24 09:00:00,14,12,26
"30474",10602,"Corner Brook","NL",48.95224,-57.92207,2018-06-24 10:00:00,14,8,22
"30475",10602,"Corner Brook","NL",48.95224,-57.92207,2018-06-24 11:00:00,16,7,23
"30476",10602,"Corner Brook","NL",48.95224,-57.92207,2018-06-24 12:00:00,16,5,21
"30477",10602,"Corner Brook","NL",48.95224,-57.92207,2018-06-24 13:00:00,25,3,28
"30478",10602,"Corner Brook","NL",48.95224,-57.92207,2018-06-24 14:00:00,33,2,35
"30479",10602,"Corner Brook","NL",48.95224,-57.92207,2018-06-24 15:00:00,27,7,34
"30480",10602,"Corner Brook","NL",48.95224,-57.92207,2018-06-24 16:00:00,23,10,33
"30481",10602,"Corner Brook","NL",48.95224,-57.92207,2018-06-24 17:00:00,21,12,33
"30482",10602,"Corner Brook","NL",48.95224,-57.92207,2018-06-24 18:00:00,19,14,33
"30483",10602,"Corner Brook","NL",48.95224,-57.92207,2018-06-24 19:00:00,24,2,26
"30484",10602,"Corner Brook","NL",48.95224,-57.92207,2018-06-24 20:00:00,25,1,26
"30485",10602,"Corner Brook","NL",48.95224,-57.92207,2018-06-24 21:00:00,25,1,26
"30486",10602,"Corner Brook","NL",48.95224,-57.92207,2018-06-24 22:00:00,24,1,25
"30487",10602,"Corner Brook","NL",48.95224,-57.92207,2018-06-24 23:00:00,24,1,25
"30488",10602,"Corner Brook","NL",48.95224,-57.92207,2018-06-25 00:00:00,23,1,24
"30489",10602,"Corner Brook","NL",48.95224,-57.92207,2018-06-25 01:00:00,23,1,24
"30490",10602,"Corner Brook","NL",48.95224,-57.92207,2018-06-25 02:00:00,22,1,23
"30491",10602,"Corner Brook","NL",48.95224,-57.92207,2018-06-25 03:00:00,22,1,23
"30492",10602,"Corner Brook","NL",48.95224,-57.92207,2018-06-25 04:00:00,21,1,22
"30493",10602,"Corner Brook","NL",48.95224,-57.92207,2018-06-25 05:00:00,20,1,21
"30494",10602,"Corner Brook","NL",48.95224,-57.92207,2018-06-25 06:00:00,20,1,21
"30495",10602,"Corner Brook","NL",48.95224,-57.92207,2018-06-25 07:00:00,18,2,20
"30496",10602,"Corner Brook","NL",48.95224,-57.92207,2018-06-25 08:00:00,18,2,20
"30497",10602,"Corner Brook","NL",48.95224,-57.92207,2018-06-25 09:00:00,18,2,20
"30498",10602,"Corner Brook","NL",48.95224,-57.92207,2018-06-25 10:00:00,18,2,20
"30499",10602,"Corner Brook","NL",48.95224,-57.92207,2018-06-25 11:00:00,18,2,20
"30500",10602,"Corner Brook","NL",48.95224,-57.92207,2018-06-25 12:00:00,21,2,23
"30501",10602,"Corner Brook","NL",48.95224,-57.92207,2018-06-25 13:00:00,22,3,25
"30502",10602,"Corner Brook","NL",48.95224,-57.92207,2018-06-25 14:00:00,24,3,27
"30503",10602,"Corner Brook","NL",48.95224,-57.92207,2018-06-25 15:00:00,24,2,26
"30504",10602,"Corner Brook","NL",48.95224,-57.92207,2018-06-25 16:00:00,24,2,26
"30505",10602,"Corner Brook","NL",48.95224,-57.92207,2018-06-25 17:00:00,25,2,27
"30506",10602,"Corner Brook","NL",48.95224,-57.92207,2018-06-25 18:00:00,23,2,25
"30507",10602,"Corner Brook","NL",48.95224,-57.92207,2018-06-25 19:00:00,22,2,24
"30508",10602,"Corner Brook","NL",48.95224,-57.92207,2018-06-25 20:00:00,21,2,23
"30509",10602,"Corner Brook","NL",48.95224,-57.92207,2018-06-25 21:00:00,20,1,21
"30510",10602,"Corner Brook","NL",48.95224,-57.92207,2018-06-25 22:00:00,21,1,22
"30511",10602,"Corner Brook","NL",48.95224,-57.92207,2018-06-25 23:00:00,22,1,23
"30512",10602,"Corner Brook","NL",48.95224,-57.92207,2018-06-26 00:00:00,22,1,23
"30513",10602,"Corner Brook","NL",48.95224,-57.92207,2018-06-26 01:00:00,23,1,24
"30514",10602,"Corner Brook","NL",48.95224,-57.92207,2018-06-26 02:00:00,23,1,24
"30515",10602,"Corner Brook","NL",48.95224,-57.92207,2018-06-26 03:00:00,23,1,24
"30516",10602,"Corner Brook","NL",48.95224,-57.92207,2018-06-26 04:00:00,22,1,23
"30517",10602,"Corner Brook","NL",48.95224,-57.92207,2018-06-26 05:00:00,22,1,23
"30518",10602,"Corner Brook","NL",48.95224,-57.92207,2018-06-26 06:00:00,21,1,22
"30519",10602,"Corner Brook","NL",48.95224,-57.92207,2018-06-26 07:00:00,19,2,21
"30520",10602,"Corner Brook","NL",48.95224,-57.92207,2018-06-26 08:00:00,19,3,22
"30521",10602,"Corner Brook","NL",48.95224,-57.92207,2018-06-26 09:00:00,20,2,22
"30522",10602,"Corner Brook","NL",48.95224,-57.92207,2018-06-26 10:00:00,19,2,21
"30523",10602,"Corner Brook","NL",48.95224,-57.92207,2018-06-26 11:00:00,18,3,21
"30524",10602,"Corner Brook","NL",48.95224,-57.92207,2018-06-26 12:00:00,19,2,21
"30525",10602,"Corner Brook","NL",48.95224,-57.92207,2018-06-26 13:00:00,20,2,22
"30526",10602,"Corner Brook","NL",48.95224,-57.92207,2018-06-26 14:00:00,21,2,23
"30527",10602,"Corner Brook","NL",48.95224,-57.92207,2018-06-26 15:00:00,20,2,22
"30528",10602,"Corner Brook","NL",48.95224,-57.92207,2018-06-26 16:00:00,20,2,22
"30529",10602,"Corner Brook","NL",48.95224,-57.92207,2018-06-26 17:00:00,20,2,22
"30530",10602,"Corner Brook","NL",48.95224,-57.92207,2018-06-26 18:00:00,19,4,23
"30531",10602,"Corner Brook","NL",48.95224,-57.92207,2018-06-26 19:00:00,19,4,23
"30532",10602,"Corner Brook","NL",48.95224,-57.92207,2018-06-26 20:00:00,24,2,26
"30533",10602,"Corner Brook","NL",48.95224,-57.92207,2018-06-26 21:00:00,20,4,24
"30534",10602,"Corner Brook","NL",48.95224,-57.92207,2018-06-26 22:00:00,21,3,24
"30535",10602,"Corner Brook","NL",48.95224,-57.92207,2018-06-26 23:00:00,20,2,22
"30536",10602,"Corner Brook","NL",48.95224,-57.92207,2018-06-27 00:00:00,20,2,22
"30537",10602,"Corner Brook","NL",48.95224,-57.92207,2018-06-27 01:00:00,19,1,20
"30538",10602,"Corner Brook","NL",48.95224,-57.92207,2018-06-27 02:00:00,19,0,19
"30539",10602,"Corner Brook","NL",48.95224,-57.92207,2018-06-27 03:00:00,19,1,20
"30540",10602,"Corner Brook","NL",48.95224,-57.92207,2018-06-27 04:00:00,22,0,22
"30541",10602,"Corner Brook","NL",48.95224,-57.92207,2018-06-27 05:00:00,22,0,22
"30542",10602,"Corner Brook","NL",48.95224,-57.92207,2018-06-27 06:00:00,21,1,22
"30543",10602,"Corner Brook","NL",48.95224,-57.92207,2018-06-27 07:00:00,20,1,21
"30544",10602,"Corner Brook","NL",48.95224,-57.92207,2018-06-27 08:00:00,20,2,22
"30545",10602,"Corner Brook","NL",48.95224,-57.92207,2018-06-27 09:00:00,21,2,23
"30546",10602,"Corner Brook","NL",48.95224,-57.92207,2018-06-27 10:00:00,NA,3,NA
"30547",10602,"Corner Brook","NL",48.95224,-57.92207,2018-06-27 11:00:00,NA,8,NA
"30548",10602,"Corner Brook","NL",48.95224,-57.92207,2018-06-27 12:00:00,20,7,27
"30549",10602,"Corner Brook","NL",48.95224,-57.92207,2018-06-27 13:00:00,NA,7,NA
"30550",10602,"Corner Brook","NL",48.95224,-57.92207,2018-06-27 14:00:00,NA,9,NA
"30551",10602,"Corner Brook","NL",48.95224,-57.92207,2018-06-27 15:00:00,27,1,28
"30552",10602,"Corner Brook","NL",48.95224,-57.92207,2018-06-27 16:00:00,26,4,30
"30553",10602,"Corner Brook","NL",48.95224,-57.92207,2018-06-27 17:00:00,19,12,31
"30554",10602,"Corner Brook","NL",48.95224,-57.92207,2018-06-27 18:00:00,24,6,30
"30555",10602,"Corner Brook","NL",48.95224,-57.92207,2018-06-27 19:00:00,18,13,31
"30556",10602,"Corner Brook","NL",48.95224,-57.92207,2018-06-27 20:00:00,21,8,29
"30557",10602,"Corner Brook","NL",48.95224,-57.92207,2018-06-27 21:00:00,27,1,28
"30558",10602,"Corner Brook","NL",48.95224,-57.92207,2018-06-27 22:00:00,28,2,30
"30559",10602,"Corner Brook","NL",48.95224,-57.92207,2018-06-27 23:00:00,29,1,30
"30560",10602,"Corner Brook","NL",48.95224,-57.92207,2018-06-28 00:00:00,28,1,29
"30561",10602,"Corner Brook","NL",48.95224,-57.92207,2018-06-28 01:00:00,25,2,27
"30562",10602,"Corner Brook","NL",48.95224,-57.92207,2018-06-28 02:00:00,20,2,22
"30563",10602,"Corner Brook","NL",48.95224,-57.92207,2018-06-28 03:00:00,17,2,19
"30564",10602,"Corner Brook","NL",48.95224,-57.92207,2018-06-28 04:00:00,15,3,18
"30565",10602,"Corner Brook","NL",48.95224,-57.92207,2018-06-28 05:00:00,9,5,14
"30566",10602,"Corner Brook","NL",48.95224,-57.92207,2018-06-28 06:00:00,10,4,14
"30567",10602,"Corner Brook","NL",48.95224,-57.92207,2018-06-28 07:00:00,22,4,26
"30568",10602,"Corner Brook","NL",48.95224,-57.92207,2018-06-28 08:00:00,25,3,28
"30569",10602,"Corner Brook","NL",48.95224,-57.92207,2018-06-28 09:00:00,28,2,30
"30570",10602,"Corner Brook","NL",48.95224,-57.92207,2018-06-28 10:00:00,35,1,36
"30571",10602,"Corner Brook","NL",48.95224,-57.92207,2018-06-28 11:00:00,39,1,40
"30572",10602,"Corner Brook","NL",48.95224,-57.92207,2018-06-28 12:00:00,43,1,44
"30573",10602,"Corner Brook","NL",48.95224,-57.92207,2018-06-28 13:00:00,44,2,46
"30574",10602,"Corner Brook","NL",48.95224,-57.92207,2018-06-28 14:00:00,47,2,49
"30575",10602,"Corner Brook","NL",48.95224,-57.92207,2018-06-28 15:00:00,45,1,46
"30576",10602,"Corner Brook","NL",48.95224,-57.92207,2018-06-28 16:00:00,42,1,43
"30577",10602,"Corner Brook","NL",48.95224,-57.92207,2018-06-28 17:00:00,36,2,38
"30578",10602,"Corner Brook","NL",48.95224,-57.92207,2018-06-28 18:00:00,33,1,34
"30579",10602,"Corner Brook","NL",48.95224,-57.92207,2018-06-28 19:00:00,31,2,33
"30580",10602,"Corner Brook","NL",48.95224,-57.92207,2018-06-28 20:00:00,32,1,33
"30581",10602,"Corner Brook","NL",48.95224,-57.92207,2018-06-28 21:00:00,32,1,33
"30582",10602,"Corner Brook","NL",48.95224,-57.92207,2018-06-28 22:00:00,30,1,31
"30583",10602,"Corner Brook","NL",48.95224,-57.92207,2018-06-28 23:00:00,28,2,30
"30584",10602,"Corner Brook","NL",48.95224,-57.92207,2018-06-29 00:00:00,26,2,28
"30585",10602,"Corner Brook","NL",48.95224,-57.92207,2018-06-29 01:00:00,25,2,27
"30586",10602,"Corner Brook","NL",48.95224,-57.92207,2018-06-29 02:00:00,27,2,29
"30587",10602,"Corner Brook","NL",48.95224,-57.92207,2018-06-29 03:00:00,27,2,29
"30588",10602,"Corner Brook","NL",48.95224,-57.92207,2018-06-29 04:00:00,29,1,30
"30589",10602,"Corner Brook","NL",48.95224,-57.92207,2018-06-29 05:00:00,30,0,30
"30590",10602,"Corner Brook","NL",48.95224,-57.92207,2018-06-29 06:00:00,31,0,31
"30591",10602,"Corner Brook","NL",48.95224,-57.92207,2018-06-29 07:00:00,32,0,32
"30592",10602,"Corner Brook","NL",48.95224,-57.92207,2018-06-29 08:00:00,32,1,33
"30593",10602,"Corner Brook","NL",48.95224,-57.92207,2018-06-29 09:00:00,33,1,34
"30594",10602,"Corner Brook","NL",48.95224,-57.92207,2018-06-29 10:00:00,33,1,34
"30595",10602,"Corner Brook","NL",48.95224,-57.92207,2018-06-29 11:00:00,33,0,33
"30596",10602,"Corner Brook","NL",48.95224,-57.92207,2018-06-29 12:00:00,32,1,33
"30597",10602,"Corner Brook","NL",48.95224,-57.92207,2018-06-29 13:00:00,32,1,33
"30598",10602,"Corner Brook","NL",48.95224,-57.92207,2018-06-29 14:00:00,31,1,32
"30599",10602,"Corner Brook","NL",48.95224,-57.92207,2018-06-29 15:00:00,29,1,30
"30600",10602,"Corner Brook","NL",48.95224,-57.92207,2018-06-29 16:00:00,29,1,30
"30601",10602,"Corner Brook","NL",48.95224,-57.92207,2018-06-29 17:00:00,30,1,31
"30602",10602,"Corner Brook","NL",48.95224,-57.92207,2018-06-29 18:00:00,30,1,31
"30603",10602,"Corner Brook","NL",48.95224,-57.92207,2018-06-29 19:00:00,32,1,33
"30604",10602,"Corner Brook","NL",48.95224,-57.92207,2018-06-29 20:00:00,32,1,33
"30605",10602,"Corner Brook","NL",48.95224,-57.92207,2018-06-29 21:00:00,31,1,32
"30606",10602,"Corner Brook","NL",48.95224,-57.92207,2018-06-29 22:00:00,29,1,30
"30607",10602,"Corner Brook","NL",48.95224,-57.92207,2018-06-29 23:00:00,27,1,28
"30608",10602,"Corner Brook","NL",48.95224,-57.92207,2018-06-30 00:00:00,25,1,26
"30609",10602,"Corner Brook","NL",48.95224,-57.92207,2018-06-30 01:00:00,25,1,26
"30610",10602,"Corner Brook","NL",48.95224,-57.92207,2018-06-30 02:00:00,24,1,25
"30611",10602,"Corner Brook","NL",48.95224,-57.92207,2018-06-30 03:00:00,23,1,24
"30612",10602,"Corner Brook","NL",48.95224,-57.92207,2018-06-30 04:00:00,23,2,25
"30613",10602,"Corner Brook","NL",48.95224,-57.92207,2018-06-30 05:00:00,23,1,24
"30614",10602,"Corner Brook","NL",48.95224,-57.92207,2018-06-30 06:00:00,22,1,23
"30615",10602,"Corner Brook","NL",48.95224,-57.92207,2018-06-30 07:00:00,20,1,21
"30616",10602,"Corner Brook","NL",48.95224,-57.92207,2018-06-30 08:00:00,18,1,19
"30617",10602,"Corner Brook","NL",48.95224,-57.92207,2018-06-30 09:00:00,20,1,21
"30618",10602,"Corner Brook","NL",48.95224,-57.92207,2018-06-30 10:00:00,23,1,24
"30619",10602,"Corner Brook","NL",48.95224,-57.92207,2018-06-30 11:00:00,27,1,28
"30620",10602,"Corner Brook","NL",48.95224,-57.92207,2018-06-30 12:00:00,27,1,28
"30621",10602,"Corner Brook","NL",48.95224,-57.92207,2018-06-30 13:00:00,25,1,26
"30622",10602,"Corner Brook","NL",48.95224,-57.92207,2018-06-30 14:00:00,25,3,28
"30623",10602,"Corner Brook","NL",48.95224,-57.92207,2018-06-30 15:00:00,24,4,28
"30624",10602,"Corner Brook","NL",48.95224,-57.92207,2018-06-30 16:00:00,18,9,27
"30625",10602,"Corner Brook","NL",48.95224,-57.92207,2018-06-30 17:00:00,21,4,25
"30626",10602,"Corner Brook","NL",48.95224,-57.92207,2018-06-30 18:00:00,19,3,22
"30627",10602,"Corner Brook","NL",48.95224,-57.92207,2018-06-30 19:00:00,10,10,20
"30628",10602,"Corner Brook","NL",48.95224,-57.92207,2018-06-30 20:00:00,8,11,19
"30629",10602,"Corner Brook","NL",48.95224,-57.92207,2018-06-30 21:00:00,9,9,18
"30630",10602,"Corner Brook","NL",48.95224,-57.92207,2018-06-30 22:00:00,13,3,16
"30631",10602,"Corner Brook","NL",48.95224,-57.92207,2018-06-30 23:00:00,14,2,16
"30632",10602,"Corner Brook","NL",48.95224,-57.92207,2018-07-01 00:00:00,14,2,16
"30633",10602,"Corner Brook","NL",48.95224,-57.92207,2018-07-01 01:00:00,13,2,15
"30634",10602,"Corner Brook","NL",48.95224,-57.92207,2018-07-01 02:00:00,10,5,15
"30635",10602,"Corner Brook","NL",48.95224,-57.92207,2018-07-01 03:00:00,10,1,11
"30636",10602,"Corner Brook","NL",48.95224,-57.92207,2018-07-01 04:00:00,8,2,10
"30637",10602,"Corner Brook","NL",48.95224,-57.92207,2018-07-01 05:00:00,6,2,8
"30638",10602,"Corner Brook","NL",48.95224,-57.92207,2018-07-01 06:00:00,5,2,7
"30639",10602,"Corner Brook","NL",48.95224,-57.92207,2018-07-01 07:00:00,8,2,10
"30640",10602,"Corner Brook","NL",48.95224,-57.92207,2018-07-01 08:00:00,8,2,10
"30641",10602,"Corner Brook","NL",48.95224,-57.92207,2018-07-01 09:00:00,9,3,12
"30642",10602,"Corner Brook","NL",48.95224,-57.92207,2018-07-01 10:00:00,17,2,19
"30643",10602,"Corner Brook","NL",48.95224,-57.92207,2018-07-01 11:00:00,18,2,20
"30644",10602,"Corner Brook","NL",48.95224,-57.92207,2018-07-01 12:00:00,22,2,24
"30645",10602,"Corner Brook","NL",48.95224,-57.92207,2018-07-01 13:00:00,23,3,26
"30646",10602,"Corner Brook","NL",48.95224,-57.92207,2018-07-01 14:00:00,21,3,24
"30647",10602,"Corner Brook","NL",48.95224,-57.92207,2018-07-01 15:00:00,23,2,25
"30648",10602,"Corner Brook","NL",48.95224,-57.92207,2018-07-01 16:00:00,22,2,24
"30649",10602,"Corner Brook","NL",48.95224,-57.92207,2018-07-01 17:00:00,23,2,25
"30650",10602,"Corner Brook","NL",48.95224,-57.92207,2018-07-01 18:00:00,21,4,25
"30651",10602,"Corner Brook","NL",48.95224,-57.92207,2018-07-01 19:00:00,23,4,27
"30652",10602,"Corner Brook","NL",48.95224,-57.92207,2018-07-01 20:00:00,23,3,26
"30653",10602,"Corner Brook","NL",48.95224,-57.92207,2018-07-01 21:00:00,18,4,22
"30654",10602,"Corner Brook","NL",48.95224,-57.92207,2018-07-01 22:00:00,20,4,24
"30655",10602,"Corner Brook","NL",48.95224,-57.92207,2018-07-01 23:00:00,16,6,22
"30656",10602,"Corner Brook","NL",48.95224,-57.92207,2018-07-02 00:00:00,13,4,17
"30657",10602,"Corner Brook","NL",48.95224,-57.92207,2018-07-02 01:00:00,9,5,14
"30658",10602,"Corner Brook","NL",48.95224,-57.92207,2018-07-02 02:00:00,4,8,12
"30659",10602,"Corner Brook","NL",48.95224,-57.92207,2018-07-02 03:00:00,4,5,9
"30660",10602,"Corner Brook","NL",48.95224,-57.92207,2018-07-02 04:00:00,2,5,7
"30661",10602,"Corner Brook","NL",48.95224,-57.92207,2018-07-02 05:00:00,3,4,7
"30662",10602,"Corner Brook","NL",48.95224,-57.92207,2018-07-02 06:00:00,8,3,11
"30663",10602,"Corner Brook","NL",48.95224,-57.92207,2018-07-02 07:00:00,13,2,15
"30664",10602,"Corner Brook","NL",48.95224,-57.92207,2018-07-02 08:00:00,13,2,15
"30665",10602,"Corner Brook","NL",48.95224,-57.92207,2018-07-02 09:00:00,14,2,16
"30666",10602,"Corner Brook","NL",48.95224,-57.92207,2018-07-02 10:00:00,13,2,15
"30667",10602,"Corner Brook","NL",48.95224,-57.92207,2018-07-02 11:00:00,12,1,13
"30668",10602,"Corner Brook","NL",48.95224,-57.92207,2018-07-02 12:00:00,14,1,15
"30669",10602,"Corner Brook","NL",48.95224,-57.92207,2018-07-02 13:00:00,17,1,18
"30670",10602,"Corner Brook","NL",48.95224,-57.92207,2018-07-02 14:00:00,22,2,24
"30671",10602,"Corner Brook","NL",48.95224,-57.92207,2018-07-02 15:00:00,22,2,24
"30672",10602,"Corner Brook","NL",48.95224,-57.92207,2018-07-02 16:00:00,14,12,26
"30673",10602,"Corner Brook","NL",48.95224,-57.92207,2018-07-02 17:00:00,14,15,29
"30674",10602,"Corner Brook","NL",48.95224,-57.92207,2018-07-02 18:00:00,15,12,27
"30675",10602,"Corner Brook","NL",48.95224,-57.92207,2018-07-02 19:00:00,18,8,26
"30676",10602,"Corner Brook","NL",48.95224,-57.92207,2018-07-02 20:00:00,20,5,25
"30677",10602,"Corner Brook","NL",48.95224,-57.92207,2018-07-02 21:00:00,15,6,21
"30678",10602,"Corner Brook","NL",48.95224,-57.92207,2018-07-02 22:00:00,8,7,15
"30679",10602,"Corner Brook","NL",48.95224,-57.92207,2018-07-02 23:00:00,7,6,13
"30680",10602,"Corner Brook","NL",48.95224,-57.92207,2018-07-03 00:00:00,10,2,12
"30681",10602,"Corner Brook","NL",48.95224,-57.92207,2018-07-03 01:00:00,12,2,14
"30682",10602,"Corner Brook","NL",48.95224,-57.92207,2018-07-03 02:00:00,18,1,19
"30683",10602,"Corner Brook","NL",48.95224,-57.92207,2018-07-03 03:00:00,18,1,19
"30684",10602,"Corner Brook","NL",48.95224,-57.92207,2018-07-03 04:00:00,18,2,20
"30685",10602,"Corner Brook","NL",48.95224,-57.92207,2018-07-03 05:00:00,20,2,22
"30686",10602,"Corner Brook","NL",48.95224,-57.92207,2018-07-03 06:00:00,19,2,21
"30687",10602,"Corner Brook","NL",48.95224,-57.92207,2018-07-03 07:00:00,19,3,22
"30688",10602,"Corner Brook","NL",48.95224,-57.92207,2018-07-03 08:00:00,21,3,24
"30689",10602,"Corner Brook","NL",48.95224,-57.92207,2018-07-03 09:00:00,21,2,23
"30690",10602,"Corner Brook","NL",48.95224,-57.92207,2018-07-03 10:00:00,24,1,25
"30691",10602,"Corner Brook","NL",48.95224,-57.92207,2018-07-03 11:00:00,26,1,27
"30692",10602,"Corner Brook","NL",48.95224,-57.92207,2018-07-03 12:00:00,29,1,30
"30693",10602,"Corner Brook","NL",48.95224,-57.92207,2018-07-03 13:00:00,35,1,36
"30694",10602,"Corner Brook","NL",48.95224,-57.92207,2018-07-03 14:00:00,34,1,35
"30695",10602,"Corner Brook","NL",48.95224,-57.92207,2018-07-03 15:00:00,33,1,34
"30696",10602,"Corner Brook","NL",48.95224,-57.92207,2018-07-03 16:00:00,31,1,32
"30697",10602,"Corner Brook","NL",48.95224,-57.92207,2018-07-03 17:00:00,29,1,30
"30698",10602,"Corner Brook","NL",48.95224,-57.92207,2018-07-03 18:00:00,28,2,30
"30699",10602,"Corner Brook","NL",48.95224,-57.92207,2018-07-03 19:00:00,29,2,31
"30700",10602,"Corner Brook","NL",48.95224,-57.92207,2018-07-03 20:00:00,28,1,29
"30701",10602,"Corner Brook","NL",48.95224,-57.92207,2018-07-03 21:00:00,27,1,28
"30702",10602,"Corner Brook","NL",48.95224,-57.92207,2018-07-03 22:00:00,27,1,28
"30703",10602,"Corner Brook","NL",48.95224,-57.92207,2018-07-03 23:00:00,26,1,27
"30704",10602,"Corner Brook","NL",48.95224,-57.92207,2018-07-04 00:00:00,26,1,27
"30705",10602,"Corner Brook","NL",48.95224,-57.92207,2018-07-04 01:00:00,25,0,25
"30706",10602,"Corner Brook","NL",48.95224,-57.92207,2018-07-04 02:00:00,25,1,26
"30707",10602,"Corner Brook","NL",48.95224,-57.92207,2018-07-04 03:00:00,18,5,23
"30708",10602,"Corner Brook","NL",48.95224,-57.92207,2018-07-04 04:00:00,21,2,23
"30709",10602,"Corner Brook","NL",48.95224,-57.92207,2018-07-04 05:00:00,23,1,24
"30710",10602,"Corner Brook","NL",48.95224,-57.92207,2018-07-04 06:00:00,22,1,23
"30711",10602,"Corner Brook","NL",48.95224,-57.92207,2018-07-04 07:00:00,24,4,28
"30712",10602,"Corner Brook","NL",48.95224,-57.92207,2018-07-04 08:00:00,25,5,30
"30713",10602,"Corner Brook","NL",48.95224,-57.92207,2018-07-04 09:00:00,26,6,32
"30714",10602,"Corner Brook","NL",48.95224,-57.92207,2018-07-04 10:00:00,30,5,35
"30715",10602,"Corner Brook","NL",48.95224,-57.92207,2018-07-04 11:00:00,27,8,35
"30716",10602,"Corner Brook","NL",48.95224,-57.92207,2018-07-04 12:00:00,28,9,37
"30717",10602,"Corner Brook","NL",48.95224,-57.92207,2018-07-04 13:00:00,30,7,37
"30718",10602,"Corner Brook","NL",48.95224,-57.92207,2018-07-04 14:00:00,27,9,36
"30719",10602,"Corner Brook","NL",48.95224,-57.92207,2018-07-04 15:00:00,32,5,37
"30720",10602,"Corner Brook","NL",48.95224,-57.92207,2018-07-04 16:00:00,34,3,37
"30721",10602,"Corner Brook","NL",48.95224,-57.92207,2018-07-04 17:00:00,34,4,38
"30722",10602,"Corner Brook","NL",48.95224,-57.92207,2018-07-04 18:00:00,29,11,40
"30723",10602,"Corner Brook","NL",48.95224,-57.92207,2018-07-04 19:00:00,27,11,38
"30724",10602,"Corner Brook","NL",48.95224,-57.92207,2018-07-04 20:00:00,22,16,38
"30725",10602,"Corner Brook","NL",48.95224,-57.92207,2018-07-04 21:00:00,16,19,35
"30726",10602,"Corner Brook","NL",48.95224,-57.92207,2018-07-04 22:00:00,22,8,30
"30727",10602,"Corner Brook","NL",48.95224,-57.92207,2018-07-04 23:00:00,26,3,29
"30728",10602,"Corner Brook","NL",48.95224,-57.92207,2018-07-05 00:00:00,26,1,27
"30729",10602,"Corner Brook","NL",48.95224,-57.92207,2018-07-05 01:00:00,24,1,25
"30730",10602,"Corner Brook","NL",48.95224,-57.92207,2018-07-05 02:00:00,22,1,23
"30731",10602,"Corner Brook","NL",48.95224,-57.92207,2018-07-05 03:00:00,22,1,23
"30732",10602,"Corner Brook","NL",48.95224,-57.92207,2018-07-05 04:00:00,22,2,24
"30733",10602,"Corner Brook","NL",48.95224,-57.92207,2018-07-05 05:00:00,22,2,24
"30734",10602,"Corner Brook","NL",48.95224,-57.92207,2018-07-05 06:00:00,21,2,23
"30735",10602,"Corner Brook","NL",48.95224,-57.92207,2018-07-05 07:00:00,11,9,20
"30736",10602,"Corner Brook","NL",48.95224,-57.92207,2018-07-05 08:00:00,16,7,23
"30737",10602,"Corner Brook","NL",48.95224,-57.92207,2018-07-05 09:00:00,19,6,25
"30738",10602,"Corner Brook","NL",48.95224,-57.92207,2018-07-05 10:00:00,19,7,26
"30739",10602,"Corner Brook","NL",48.95224,-57.92207,2018-07-05 11:00:00,20,6,26
"30740",10602,"Corner Brook","NL",48.95224,-57.92207,2018-07-05 12:00:00,25,3,28
"30741",10602,"Corner Brook","NL",48.95224,-57.92207,2018-07-05 13:00:00,25,5,30
"30742",10602,"Corner Brook","NL",48.95224,-57.92207,2018-07-05 14:00:00,23,8,31
"30743",10602,"Corner Brook","NL",48.95224,-57.92207,2018-07-05 15:00:00,22,9,31
"30744",10602,"Corner Brook","NL",48.95224,-57.92207,2018-07-05 16:00:00,22,8,30
"30745",10602,"Corner Brook","NL",48.95224,-57.92207,2018-07-05 17:00:00,25,6,31
"30746",10602,"Corner Brook","NL",48.95224,-57.92207,2018-07-05 18:00:00,25,5,30
"30747",10602,"Corner Brook","NL",48.95224,-57.92207,2018-07-05 19:00:00,26,4,30
"30748",10602,"Corner Brook","NL",48.95224,-57.92207,2018-07-05 20:00:00,17,12,29
"30749",10602,"Corner Brook","NL",48.95224,-57.92207,2018-07-05 21:00:00,19,7,26
"30750",10602,"Corner Brook","NL",48.95224,-57.92207,2018-07-05 22:00:00,26,3,29
"30751",10602,"Corner Brook","NL",48.95224,-57.92207,2018-07-05 23:00:00,27,2,29
"30752",10602,"Corner Brook","NL",48.95224,-57.92207,2018-07-06 00:00:00,23,3,26
"30753",10602,"Corner Brook","NL",48.95224,-57.92207,2018-07-06 01:00:00,21,3,24
"30754",10602,"Corner Brook","NL",48.95224,-57.92207,2018-07-06 02:00:00,22,2,24
"30755",10602,"Corner Brook","NL",48.95224,-57.92207,2018-07-06 03:00:00,22,2,24
"30756",10602,"Corner Brook","NL",48.95224,-57.92207,2018-07-06 04:00:00,23,1,24
"30757",10602,"Corner Brook","NL",48.95224,-57.92207,2018-07-06 05:00:00,26,1,27
"30758",10602,"Corner Brook","NL",48.95224,-57.92207,2018-07-06 06:00:00,28,1,29
"30759",10602,"Corner Brook","NL",48.95224,-57.92207,2018-07-06 07:00:00,25,2,27
"30760",10602,"Corner Brook","NL",48.95224,-57.92207,2018-07-06 08:00:00,22,4,26
"30761",10602,"Corner Brook","NL",48.95224,-57.92207,2018-07-06 09:00:00,26,3,29
"30762",10602,"Corner Brook","NL",48.95224,-57.92207,2018-07-06 10:00:00,33,1,34
"30763",10602,"Corner Brook","NL",48.95224,-57.92207,2018-07-06 11:00:00,34,1,35
"30764",10602,"Corner Brook","NL",48.95224,-57.92207,2018-07-06 12:00:00,36,1,37
"30765",10602,"Corner Brook","NL",48.95224,-57.92207,2018-07-06 13:00:00,36,2,38
"30766",10602,"Corner Brook","NL",48.95224,-57.92207,2018-07-06 14:00:00,34,1,35
"30767",10602,"Corner Brook","NL",48.95224,-57.92207,2018-07-06 15:00:00,30,1,31
"30768",10602,"Corner Brook","NL",48.95224,-57.92207,2018-07-06 16:00:00,27,1,28
"30769",10602,"Corner Brook","NL",48.95224,-57.92207,2018-07-06 17:00:00,26,1,27
"30770",10602,"Corner Brook","NL",48.95224,-57.92207,2018-07-06 18:00:00,26,1,27
"30771",10602,"Corner Brook","NL",48.95224,-57.92207,2018-07-06 19:00:00,27,1,28
"30772",10602,"Corner Brook","NL",48.95224,-57.92207,2018-07-06 20:00:00,29,1,30
"30773",10602,"Corner Brook","NL",48.95224,-57.92207,2018-07-06 21:00:00,27,1,28
"30774",10602,"Corner Brook","NL",48.95224,-57.92207,2018-07-06 22:00:00,28,1,29
"30775",10602,"Corner Brook","NL",48.95224,-57.92207,2018-07-06 23:00:00,26,2,28
"30776",10602,"Corner Brook","NL",48.95224,-57.92207,2018-07-07 00:00:00,27,1,28
"30777",10602,"Corner Brook","NL",48.95224,-57.92207,2018-07-07 01:00:00,26,2,28
"30778",10602,"Corner Brook","NL",48.95224,-57.92207,2018-07-07 02:00:00,25,1,26
"30779",10602,"Corner Brook","NL",48.95224,-57.92207,2018-07-07 03:00:00,21,1,22
"30780",10602,"Corner Brook","NL",48.95224,-57.92207,2018-07-07 04:00:00,17,0,17
"30781",10602,"Corner Brook","NL",48.95224,-57.92207,2018-07-07 05:00:00,14,0,14
"30782",10602,"Corner Brook","NL",48.95224,-57.92207,2018-07-07 06:00:00,13,1,14
"30783",10602,"Corner Brook","NL",48.95224,-57.92207,2018-07-07 07:00:00,14,1,15
"30784",10602,"Corner Brook","NL",48.95224,-57.92207,2018-07-07 08:00:00,15,1,16
"30785",10602,"Corner Brook","NL",48.95224,-57.92207,2018-07-07 09:00:00,16,3,19
"30786",10602,"Corner Brook","NL",48.95224,-57.92207,2018-07-07 10:00:00,18,6,24
"30787",10602,"Corner Brook","NL",48.95224,-57.92207,2018-07-07 11:00:00,21,6,27
"30788",10602,"Corner Brook","NL",48.95224,-57.92207,2018-07-07 12:00:00,26,2,28
"30789",10602,"Corner Brook","NL",48.95224,-57.92207,2018-07-07 13:00:00,25,2,27
"30790",10602,"Corner Brook","NL",48.95224,-57.92207,2018-07-07 14:00:00,26,2,28
"30791",10602,"Corner Brook","NL",48.95224,-57.92207,2018-07-07 15:00:00,25,3,28
"30792",10602,"Corner Brook","NL",48.95224,-57.92207,2018-07-07 16:00:00,26,3,29
"30793",10602,"Corner Brook","NL",48.95224,-57.92207,2018-07-07 17:00:00,27,1,28
"30794",10602,"Corner Brook","NL",48.95224,-57.92207,2018-07-07 18:00:00,28,1,29
"30795",10602,"Corner Brook","NL",48.95224,-57.92207,2018-07-07 19:00:00,27,2,29
"30796",10602,"Corner Brook","NL",48.95224,-57.92207,2018-07-07 20:00:00,25,2,27
"30797",10602,"Corner Brook","NL",48.95224,-57.92207,2018-07-07 21:00:00,24,1,25
"30798",10602,"Corner Brook","NL",48.95224,-57.92207,2018-07-07 22:00:00,25,1,26
"30799",10602,"Corner Brook","NL",48.95224,-57.92207,2018-07-07 23:00:00,25,1,26
"30800",10602,"Corner Brook","NL",48.95224,-57.92207,2018-07-08 00:00:00,23,1,24
"30801",10602,"Corner Brook","NL",48.95224,-57.92207,2018-07-08 01:00:00,22,1,23
"30802",10602,"Corner Brook","NL",48.95224,-57.92207,2018-07-08 02:00:00,22,1,23
"30803",10602,"Corner Brook","NL",48.95224,-57.92207,2018-07-08 03:00:00,22,2,24
"30804",10602,"Corner Brook","NL",48.95224,-57.92207,2018-07-08 04:00:00,22,1,23
"30805",10602,"Corner Brook","NL",48.95224,-57.92207,2018-07-08 05:00:00,22,1,23
"30806",10602,"Corner Brook","NL",48.95224,-57.92207,2018-07-08 06:00:00,22,2,24
"30807",10602,"Corner Brook","NL",48.95224,-57.92207,2018-07-08 07:00:00,22,2,24
"30808",10602,"Corner Brook","NL",48.95224,-57.92207,2018-07-08 08:00:00,23,1,24
"30809",10602,"Corner Brook","NL",48.95224,-57.92207,2018-07-08 09:00:00,24,0,24
"30810",10602,"Corner Brook","NL",48.95224,-57.92207,2018-07-08 10:00:00,24,1,25
"30811",10602,"Corner Brook","NL",48.95224,-57.92207,2018-07-08 11:00:00,26,1,27
"30812",10602,"Corner Brook","NL",48.95224,-57.92207,2018-07-08 12:00:00,26,1,27
"30813",10602,"Corner Brook","NL",48.95224,-57.92207,2018-07-08 13:00:00,25,1,26
"30814",10602,"Corner Brook","NL",48.95224,-57.92207,2018-07-08 14:00:00,25,1,26
"30815",10602,"Corner Brook","NL",48.95224,-57.92207,2018-07-08 15:00:00,27,1,28
"30816",10602,"Corner Brook","NL",48.95224,-57.92207,2018-07-08 16:00:00,27,1,28
"30817",10602,"Corner Brook","NL",48.95224,-57.92207,2018-07-08 17:00:00,27,1,28
"30818",10602,"Corner Brook","NL",48.95224,-57.92207,2018-07-08 18:00:00,29,1,30
"30819",10602,"Corner Brook","NL",48.95224,-57.92207,2018-07-08 19:00:00,29,1,30
"30820",10602,"Corner Brook","NL",48.95224,-57.92207,2018-07-08 20:00:00,27,2,29
"30821",10602,"Corner Brook","NL",48.95224,-57.92207,2018-07-08 21:00:00,27,1,28
"30822",10602,"Corner Brook","NL",48.95224,-57.92207,2018-07-08 22:00:00,25,1,26
"30823",10602,"Corner Brook","NL",48.95224,-57.92207,2018-07-08 23:00:00,24,1,25
"30824",10602,"Corner Brook","NL",48.95224,-57.92207,2018-07-09 00:00:00,25,1,26
"30825",10602,"Corner Brook","NL",48.95224,-57.92207,2018-07-09 01:00:00,26,1,27
"30826",10602,"Corner Brook","NL",48.95224,-57.92207,2018-07-09 02:00:00,27,1,28
"30827",10602,"Corner Brook","NL",48.95224,-57.92207,2018-07-09 03:00:00,27,1,28
"30828",10602,"Corner Brook","NL",48.95224,-57.92207,2018-07-09 04:00:00,29,0,29
"30829",10602,"Corner Brook","NL",48.95224,-57.92207,2018-07-09 05:00:00,28,1,29
"30830",10602,"Corner Brook","NL",48.95224,-57.92207,2018-07-09 06:00:00,30,1,31
"30831",10602,"Corner Brook","NL",48.95224,-57.92207,2018-07-09 07:00:00,29,1,30
"30832",10602,"Corner Brook","NL",48.95224,-57.92207,2018-07-09 08:00:00,29,1,30
"30833",10602,"Corner Brook","NL",48.95224,-57.92207,2018-07-09 09:00:00,29,1,30
"30834",10602,"Corner Brook","NL",48.95224,-57.92207,2018-07-09 10:00:00,29,1,30
"30835",10602,"Corner Brook","NL",48.95224,-57.92207,2018-07-09 11:00:00,30,1,31
"30836",10602,"Corner Brook","NL",48.95224,-57.92207,2018-07-09 12:00:00,32,1,33
"30837",10602,"Corner Brook","NL",48.95224,-57.92207,2018-07-09 13:00:00,33,1,34
"30838",10602,"Corner Brook","NL",48.95224,-57.92207,2018-07-09 14:00:00,34,1,35
"30839",10602,"Corner Brook","NL",48.95224,-57.92207,2018-07-09 15:00:00,35,1,36
"30840",10602,"Corner Brook","NL",48.95224,-57.92207,2018-07-09 16:00:00,36,1,37
"30841",10602,"Corner Brook","NL",48.95224,-57.92207,2018-07-09 17:00:00,36,1,37
"30842",10602,"Corner Brook","NL",48.95224,-57.92207,2018-07-09 18:00:00,37,1,38
"30843",10602,"Corner Brook","NL",48.95224,-57.92207,2018-07-09 19:00:00,37,1,38
"30844",10602,"Corner Brook","NL",48.95224,-57.92207,2018-07-09 20:00:00,35,1,36
"30845",10602,"Corner Brook","NL",48.95224,-57.92207,2018-07-09 21:00:00,36,1,37
"30846",10602,"Corner Brook","NL",48.95224,-57.92207,2018-07-09 22:00:00,36,1,37
"30847",10602,"Corner Brook","NL",48.95224,-57.92207,2018-07-09 23:00:00,35,1,36
"30848",10602,"Corner Brook","NL",48.95224,-57.92207,2018-07-10 00:00:00,34,1,35
"30849",10602,"Corner Brook","NL",48.95224,-57.92207,2018-07-10 01:00:00,34,1,35
"30850",10602,"Corner Brook","NL",48.95224,-57.92207,2018-07-10 02:00:00,33,1,34
"30851",10602,"Corner Brook","NL",48.95224,-57.92207,2018-07-10 03:00:00,30,3,33
"30852",10602,"Corner Brook","NL",48.95224,-57.92207,2018-07-10 04:00:00,30,1,31
"30853",10602,"Corner Brook","NL",48.95224,-57.92207,2018-07-10 05:00:00,28,2,30
"30854",10602,"Corner Brook","NL",48.95224,-57.92207,2018-07-10 06:00:00,27,2,29
"30855",10602,"Corner Brook","NL",48.95224,-57.92207,2018-07-10 07:00:00,23,4,27
"30856",10602,"Corner Brook","NL",48.95224,-57.92207,2018-07-10 08:00:00,26,2,28
"30857",10602,"Corner Brook","NL",48.95224,-57.92207,2018-07-10 09:00:00,31,1,32
"30858",10602,"Corner Brook","NL",48.95224,-57.92207,2018-07-10 10:00:00,31,1,32
"30859",10602,"Corner Brook","NL",48.95224,-57.92207,2018-07-10 11:00:00,30,1,31
"30860",10602,"Corner Brook","NL",48.95224,-57.92207,2018-07-10 12:00:00,31,1,32
"30861",10602,"Corner Brook","NL",48.95224,-57.92207,2018-07-10 13:00:00,33,1,34
"30862",10602,"Corner Brook","NL",48.95224,-57.92207,2018-07-10 14:00:00,36,1,37
"30863",10602,"Corner Brook","NL",48.95224,-57.92207,2018-07-10 15:00:00,39,1,40
"30864",10602,"Corner Brook","NL",48.95224,-57.92207,2018-07-10 16:00:00,39,1,40
"30865",10602,"Corner Brook","NL",48.95224,-57.92207,2018-07-10 17:00:00,38,1,39
"30866",10602,"Corner Brook","NL",48.95224,-57.92207,2018-07-10 18:00:00,39,1,40
"30867",10602,"Corner Brook","NL",48.95224,-57.92207,2018-07-10 19:00:00,38,2,40
"30868",10602,"Corner Brook","NL",48.95224,-57.92207,2018-07-10 20:00:00,39,1,40
"30869",10602,"Corner Brook","NL",48.95224,-57.92207,2018-07-10 21:00:00,41,2,43
"30870",10602,"Corner Brook","NL",48.95224,-57.92207,2018-07-10 22:00:00,42,3,45
"30871",10602,"Corner Brook","NL",48.95224,-57.92207,2018-07-10 23:00:00,41,2,43
"30872",10602,"Corner Brook","NL",48.95224,-57.92207,2018-07-11 00:00:00,39,2,41
"30873",10602,"Corner Brook","NL",48.95224,-57.92207,2018-07-11 01:00:00,34,1,35
"30874",10602,"Corner Brook","NL",48.95224,-57.92207,2018-07-11 02:00:00,33,2,35
"30875",10602,"Corner Brook","NL",48.95224,-57.92207,2018-07-11 03:00:00,33,2,35
"30876",10602,"Corner Brook","NL",48.95224,-57.92207,2018-07-11 04:00:00,32,2,34
"30877",10602,"Corner Brook","NL",48.95224,-57.92207,2018-07-11 05:00:00,27,3,30
"30878",10602,"Corner Brook","NL",48.95224,-57.92207,2018-07-11 06:00:00,27,3,30
"30879",10602,"Corner Brook","NL",48.95224,-57.92207,2018-07-11 07:00:00,29,3,32
"30880",10602,"Corner Brook","NL",48.95224,-57.92207,2018-07-11 08:00:00,30,3,33
"30881",10602,"Corner Brook","NL",48.95224,-57.92207,2018-07-11 09:00:00,29,3,32
"30882",10602,"Corner Brook","NL",48.95224,-57.92207,2018-07-11 10:00:00,28,3,31
"30883",10602,"Corner Brook","NL",48.95224,-57.92207,2018-07-11 11:00:00,28,2,30
"30884",10602,"Corner Brook","NL",48.95224,-57.92207,2018-07-11 12:00:00,28,2,30
"30885",10602,"Corner Brook","NL",48.95224,-57.92207,2018-07-11 13:00:00,28,4,32
"30886",10602,"Corner Brook","NL",48.95224,-57.92207,2018-07-11 14:00:00,24,9,33
"30887",10602,"Corner Brook","NL",48.95224,-57.92207,2018-07-11 15:00:00,23,9,32
"30888",10602,"Corner Brook","NL",48.95224,-57.92207,2018-07-11 16:00:00,20,10,30
"30889",10602,"Corner Brook","NL",48.95224,-57.92207,2018-07-11 17:00:00,18,12,30
"30890",10602,"Corner Brook","NL",48.95224,-57.92207,2018-07-11 18:00:00,12,14,26
"30891",10602,"Corner Brook","NL",48.95224,-57.92207,2018-07-11 19:00:00,12,12,24
"30892",10602,"Corner Brook","NL",48.95224,-57.92207,2018-07-11 20:00:00,18,5,23
"30893",10602,"Corner Brook","NL",48.95224,-57.92207,2018-07-11 21:00:00,18,5,23
"30894",10602,"Corner Brook","NL",48.95224,-57.92207,2018-07-11 22:00:00,12,8,20
"30895",10602,"Corner Brook","NL",48.95224,-57.92207,2018-07-11 23:00:00,14,4,18
"30896",10602,"Corner Brook","NL",48.95224,-57.92207,2018-07-12 00:00:00,15,3,18
"30897",10602,"Corner Brook","NL",48.95224,-57.92207,2018-07-12 01:00:00,14,4,18
"30898",10602,"Corner Brook","NL",48.95224,-57.92207,2018-07-12 02:00:00,14,6,20
"30899",10602,"Corner Brook","NL",48.95224,-57.92207,2018-07-12 03:00:00,15,2,17
"30900",10602,"Corner Brook","NL",48.95224,-57.92207,2018-07-12 04:00:00,10,2,12
"30901",10602,"Corner Brook","NL",48.95224,-57.92207,2018-07-12 05:00:00,6,3,9
"30902",10602,"Corner Brook","NL",48.95224,-57.92207,2018-07-12 06:00:00,7,3,10
"30903",10602,"Corner Brook","NL",48.95224,-57.92207,2018-07-12 07:00:00,8,5,13
"30904",10602,"Corner Brook","NL",48.95224,-57.92207,2018-07-12 08:00:00,10,8,18
"30905",10602,"Corner Brook","NL",48.95224,-57.92207,2018-07-12 09:00:00,14,5,19
"30906",10602,"Corner Brook","NL",48.95224,-57.92207,2018-07-12 10:00:00,17,3,20
"30907",10602,"Corner Brook","NL",48.95224,-57.92207,2018-07-12 11:00:00,15,7,22
"30908",10602,"Corner Brook","NL",48.95224,-57.92207,2018-07-12 12:00:00,15,8,23
"30909",10602,"Corner Brook","NL",48.95224,-57.92207,2018-07-12 13:00:00,13,10,23
"30910",10602,"Corner Brook","NL",48.95224,-57.92207,2018-07-12 14:00:00,15,7,22
"30911",10602,"Corner Brook","NL",48.95224,-57.92207,2018-07-12 15:00:00,10,9,19
"30912",10602,"Corner Brook","NL",48.95224,-57.92207,2018-07-12 16:00:00,10,9,19
"30913",10602,"Corner Brook","NL",48.95224,-57.92207,2018-07-12 17:00:00,10,9,19
"30914",10602,"Corner Brook","NL",48.95224,-57.92207,2018-07-12 18:00:00,12,6,18
"30915",10602,"Corner Brook","NL",48.95224,-57.92207,2018-07-12 19:00:00,12,5,17
"30916",10602,"Corner Brook","NL",48.95224,-57.92207,2018-07-12 20:00:00,13,4,17
"30917",10602,"Corner Brook","NL",48.95224,-57.92207,2018-07-12 21:00:00,12,5,17
"30918",10602,"Corner Brook","NL",48.95224,-57.92207,2018-07-12 22:00:00,11,4,15
"30919",10602,"Corner Brook","NL",48.95224,-57.92207,2018-07-12 23:00:00,6,7,13
"30920",10602,"Corner Brook","NL",48.95224,-57.92207,2018-07-13 00:00:00,5,5,10
"30921",10602,"Corner Brook","NL",48.95224,-57.92207,2018-07-13 01:00:00,4,4,8
"30922",10602,"Corner Brook","NL",48.95224,-57.92207,2018-07-13 02:00:00,4,3,7
"30923",10602,"Corner Brook","NL",48.95224,-57.92207,2018-07-13 03:00:00,5,3,8
"30924",10602,"Corner Brook","NL",48.95224,-57.92207,2018-07-13 04:00:00,3,3,6
"30925",10602,"Corner Brook","NL",48.95224,-57.92207,2018-07-13 05:00:00,4,3,7
"30926",10602,"Corner Brook","NL",48.95224,-57.92207,2018-07-13 06:00:00,4,3,7
"30927",10602,"Corner Brook","NL",48.95224,-57.92207,2018-07-13 07:00:00,4,3,7
"30928",10602,"Corner Brook","NL",48.95224,-57.92207,2018-07-13 08:00:00,5,4,9
"30929",10602,"Corner Brook","NL",48.95224,-57.92207,2018-07-13 09:00:00,5,5,10
"30930",10602,"Corner Brook","NL",48.95224,-57.92207,2018-07-13 10:00:00,12,5,17
"30931",10602,"Corner Brook","NL",48.95224,-57.92207,2018-07-13 11:00:00,14,5,19
"30932",10602,"Corner Brook","NL",48.95224,-57.92207,2018-07-13 12:00:00,17,4,21
"30933",10602,"Corner Brook","NL",48.95224,-57.92207,2018-07-13 13:00:00,18,2,20
"30934",10602,"Corner Brook","NL",48.95224,-57.92207,2018-07-13 14:00:00,11,8,19
"30935",10602,"Corner Brook","NL",48.95224,-57.92207,2018-07-13 15:00:00,9,12,21
"30936",10602,"Corner Brook","NL",48.95224,-57.92207,2018-07-13 16:00:00,9,10,19
"30937",10602,"Corner Brook","NL",48.95224,-57.92207,2018-07-13 17:00:00,8,12,20
"30938",10602,"Corner Brook","NL",48.95224,-57.92207,2018-07-13 18:00:00,10,8,18
"30939",10602,"Corner Brook","NL",48.95224,-57.92207,2018-07-13 19:00:00,6,13,19
"30940",10602,"Corner Brook","NL",48.95224,-57.92207,2018-07-13 20:00:00,15,4,19
"30941",10602,"Corner Brook","NL",48.95224,-57.92207,2018-07-13 21:00:00,15,4,19
"30942",10602,"Corner Brook","NL",48.95224,-57.92207,2018-07-13 22:00:00,12,5,17
"30943",10602,"Corner Brook","NL",48.95224,-57.92207,2018-07-13 23:00:00,12,4,16
"30944",10602,"Corner Brook","NL",48.95224,-57.92207,2018-07-14 00:00:00,12,3,15
"30945",10602,"Corner Brook","NL",48.95224,-57.92207,2018-07-14 01:00:00,11,2,13
"30946",10602,"Corner Brook","NL",48.95224,-57.92207,2018-07-14 02:00:00,12,2,14
"30947",10602,"Corner Brook","NL",48.95224,-57.92207,2018-07-14 03:00:00,14,2,16
"30948",10602,"Corner Brook","NL",48.95224,-57.92207,2018-07-14 04:00:00,10,2,12
"30949",10602,"Corner Brook","NL",48.95224,-57.92207,2018-07-14 05:00:00,7,3,10
"30950",10602,"Corner Brook","NL",48.95224,-57.92207,2018-07-14 06:00:00,7,3,10
"30951",10602,"Corner Brook","NL",48.95224,-57.92207,2018-07-14 07:00:00,7,4,11
"30952",10602,"Corner Brook","NL",48.95224,-57.92207,2018-07-14 08:00:00,9,3,12
"30953",10602,"Corner Brook","NL",48.95224,-57.92207,2018-07-14 09:00:00,13,3,16
"30954",10602,"Corner Brook","NL",48.95224,-57.92207,2018-07-14 10:00:00,18,2,20
"30955",10602,"Corner Brook","NL",48.95224,-57.92207,2018-07-14 11:00:00,21,2,23
"30956",10602,"Corner Brook","NL",48.95224,-57.92207,2018-07-14 12:00:00,23,1,24
"30957",10602,"Corner Brook","NL",48.95224,-57.92207,2018-07-14 13:00:00,21,3,24
"30958",10602,"Corner Brook","NL",48.95224,-57.92207,2018-07-14 14:00:00,18,4,22
"30959",10602,"Corner Brook","NL",48.95224,-57.92207,2018-07-14 15:00:00,14,8,22
"30960",10602,"Corner Brook","NL",48.95224,-57.92207,2018-07-14 16:00:00,15,9,24
"30961",10602,"Corner Brook","NL",48.95224,-57.92207,2018-07-14 17:00:00,12,11,23
"30962",10602,"Corner Brook","NL",48.95224,-57.92207,2018-07-14 18:00:00,14,9,23
"30963",10602,"Corner Brook","NL",48.95224,-57.92207,2018-07-14 19:00:00,14,7,21
"30964",10602,"Corner Brook","NL",48.95224,-57.92207,2018-07-14 20:00:00,12,8,20
"30965",10602,"Corner Brook","NL",48.95224,-57.92207,2018-07-14 21:00:00,7,13,20
"30966",10602,"Corner Brook","NL",48.95224,-57.92207,2018-07-14 22:00:00,9,9,18
"30967",10602,"Corner Brook","NL",48.95224,-57.92207,2018-07-14 23:00:00,11,6,17
"30968",10602,"Corner Brook","NL",48.95224,-57.92207,2018-07-15 00:00:00,6,9,15
"30969",10602,"Corner Brook","NL",48.95224,-57.92207,2018-07-15 01:00:00,5,7,12
"30970",10602,"Corner Brook","NL",48.95224,-57.92207,2018-07-15 02:00:00,5,5,10
"30971",10602,"Corner Brook","NL",48.95224,-57.92207,2018-07-15 03:00:00,7,3,10
"30972",10602,"Corner Brook","NL",48.95224,-57.92207,2018-07-15 04:00:00,5,4,9
"30973",10602,"Corner Brook","NL",48.95224,-57.92207,2018-07-15 05:00:00,5,5,10
"30974",10602,"Corner Brook","NL",48.95224,-57.92207,2018-07-15 06:00:00,10,3,13
"30975",10602,"Corner Brook","NL",48.95224,-57.92207,2018-07-15 07:00:00,7,3,10
"30976",10602,"Corner Brook","NL",48.95224,-57.92207,2018-07-15 08:00:00,10,4,14
"30977",10602,"Corner Brook","NL",48.95224,-57.92207,2018-07-15 09:00:00,10,4,14
"30978",10602,"Corner Brook","NL",48.95224,-57.92207,2018-07-15 10:00:00,21,2,23
"30979",10602,"Corner Brook","NL",48.95224,-57.92207,2018-07-15 11:00:00,22,2,24
"30980",10602,"Corner Brook","NL",48.95224,-57.92207,2018-07-15 12:00:00,21,2,23
"30981",10602,"Corner Brook","NL",48.95224,-57.92207,2018-07-15 13:00:00,20,2,22
"30982",10602,"Corner Brook","NL",48.95224,-57.92207,2018-07-15 14:00:00,19,2,21
"30983",10602,"Corner Brook","NL",48.95224,-57.92207,2018-07-15 15:00:00,21,2,23
"30984",10602,"Corner Brook","NL",48.95224,-57.92207,2018-07-15 16:00:00,20,4,24
"30985",10602,"Corner Brook","NL",48.95224,-57.92207,2018-07-15 17:00:00,13,11,24
"30986",10602,"Corner Brook","NL",48.95224,-57.92207,2018-07-15 18:00:00,13,11,24
"30987",10602,"Corner Brook","NL",48.95224,-57.92207,2018-07-15 19:00:00,12,11,23
"30988",10602,"Corner Brook","NL",48.95224,-57.92207,2018-07-15 20:00:00,19,4,23
"30989",10602,"Corner Brook","NL",48.95224,-57.92207,2018-07-15 21:00:00,17,6,23
"30990",10602,"Corner Brook","NL",48.95224,-57.92207,2018-07-15 22:00:00,19,3,22
"30991",10602,"Corner Brook","NL",48.95224,-57.92207,2018-07-15 23:00:00,15,6,21
"30992",10602,"Corner Brook","NL",48.95224,-57.92207,2018-07-16 00:00:00,15,5,20
"30993",10602,"Corner Brook","NL",48.95224,-57.92207,2018-07-16 01:00:00,12,6,18
"30994",10602,"Corner Brook","NL",48.95224,-57.92207,2018-07-16 02:00:00,11,4,15
"30995",10602,"Corner Brook","NL",48.95224,-57.92207,2018-07-16 03:00:00,7,4,11
"30996",10602,"Corner Brook","NL",48.95224,-57.92207,2018-07-16 04:00:00,8,6,14
"30997",10602,"Corner Brook","NL",48.95224,-57.92207,2018-07-16 05:00:00,13,2,15
"30998",10602,"Corner Brook","NL",48.95224,-57.92207,2018-07-16 06:00:00,12,2,14
"30999",10602,"Corner Brook","NL",48.95224,-57.92207,2018-07-16 07:00:00,13,2,15
"31000",10602,"Corner Brook","NL",48.95224,-57.92207,2018-07-16 08:00:00,13,3,16
"31001",10602,"Corner Brook","NL",48.95224,-57.92207,2018-07-16 09:00:00,16,3,19
"31002",10602,"Corner Brook","NL",48.95224,-57.92207,2018-07-16 10:00:00,15,4,19
"31003",10602,"Corner Brook","NL",48.95224,-57.92207,2018-07-16 11:00:00,12,6,18
"31004",10602,"Corner Brook","NL",48.95224,-57.92207,2018-07-16 12:00:00,16,2,18
"31005",10602,"Corner Brook","NL",48.95224,-57.92207,2018-07-16 13:00:00,20,2,22
"31006",10602,"Corner Brook","NL",48.95224,-57.92207,2018-07-16 14:00:00,22,2,24
"31007",10602,"Corner Brook","NL",48.95224,-57.92207,2018-07-16 15:00:00,21,2,23
"31008",10602,"Corner Brook","NL",48.95224,-57.92207,2018-07-16 16:00:00,15,10,25
"31009",10602,"Corner Brook","NL",48.95224,-57.92207,2018-07-16 17:00:00,17,8,25
"31010",10602,"Corner Brook","NL",48.95224,-57.92207,2018-07-16 18:00:00,20,4,24
"31011",10602,"Corner Brook","NL",48.95224,-57.92207,2018-07-16 19:00:00,17,6,23
"31012",10602,"Corner Brook","NL",48.95224,-57.92207,2018-07-16 20:00:00,20,3,23
"31013",10602,"Corner Brook","NL",48.95224,-57.92207,2018-07-16 21:00:00,19,3,22
"31014",10602,"Corner Brook","NL",48.95224,-57.92207,2018-07-16 22:00:00,12,7,19
"31015",10602,"Corner Brook","NL",48.95224,-57.92207,2018-07-16 23:00:00,13,5,18
"31016",10602,"Corner Brook","NL",48.95224,-57.92207,2018-07-17 00:00:00,6,8,14
"31017",10602,"Corner Brook","NL",48.95224,-57.92207,2018-07-17 01:00:00,4,9,13
"31018",10602,"Corner Brook","NL",48.95224,-57.92207,2018-07-17 02:00:00,2,9,11
"31019",10602,"Corner Brook","NL",48.95224,-57.92207,2018-07-17 03:00:00,1,9,10
"31020",10602,"Corner Brook","NL",48.95224,-57.92207,2018-07-17 04:00:00,1,9,10
"31021",10602,"Corner Brook","NL",48.95224,-57.92207,2018-07-17 05:00:00,4,5,9
"31022",10602,"Corner Brook","NL",48.95224,-57.92207,2018-07-17 06:00:00,3,6,9
"31023",10602,"Corner Brook","NL",48.95224,-57.92207,2018-07-17 07:00:00,4,7,11
"31024",10602,"Corner Brook","NL",48.95224,-57.92207,2018-07-17 08:00:00,6,6,12
"31025",10602,"Corner Brook","NL",48.95224,-57.92207,2018-07-17 09:00:00,6,11,17
"31026",10602,"Corner Brook","NL",48.95224,-57.92207,2018-07-17 10:00:00,8,10,18
"31027",10602,"Corner Brook","NL",48.95224,-57.92207,2018-07-17 11:00:00,12,8,20
"31028",10602,"Corner Brook","NL",48.95224,-57.92207,2018-07-17 12:00:00,14,11,25
"31029",10602,"Corner Brook","NL",48.95224,-57.92207,2018-07-17 13:00:00,15,9,24
"31030",10602,"Corner Brook","NL",48.95224,-57.92207,2018-07-17 14:00:00,14,10,24
"31031",10602,"Corner Brook","NL",48.95224,-57.92207,2018-07-17 15:00:00,17,7,24
"31032",10602,"Corner Brook","NL",48.95224,-57.92207,2018-07-17 16:00:00,15,10,25
"31033",10602,"Corner Brook","NL",48.95224,-57.92207,2018-07-17 17:00:00,14,9,23
"31034",10602,"Corner Brook","NL",48.95224,-57.92207,2018-07-17 18:00:00,14,10,24
"31035",10602,"Corner Brook","NL",48.95224,-57.92207,2018-07-17 19:00:00,18,5,23
"31036",10602,"Corner Brook","NL",48.95224,-57.92207,2018-07-17 20:00:00,20,2,22
"31037",10602,"Corner Brook","NL",48.95224,-57.92207,2018-07-17 21:00:00,13,9,22
"31038",10602,"Corner Brook","NL",48.95224,-57.92207,2018-07-17 22:00:00,25,2,27
"31039",10602,"Corner Brook","NL",48.95224,-57.92207,2018-07-17 23:00:00,25,2,27
"31040",10602,"Corner Brook","NL",48.95224,-57.92207,2018-07-18 00:00:00,25,2,27
"31041",10602,"Corner Brook","NL",48.95224,-57.92207,2018-07-18 01:00:00,20,2,22
"31042",10602,"Corner Brook","NL",48.95224,-57.92207,2018-07-18 02:00:00,21,2,23
"31043",10602,"Corner Brook","NL",48.95224,-57.92207,2018-07-18 03:00:00,16,3,19
"31044",10602,"Corner Brook","NL",48.95224,-57.92207,2018-07-18 04:00:00,18,2,20
"31045",10602,"Corner Brook","NL",48.95224,-57.92207,2018-07-18 05:00:00,27,1,28
"31046",10602,"Corner Brook","NL",48.95224,-57.92207,2018-07-18 06:00:00,30,1,31
"31047",10602,"Corner Brook","NL",48.95224,-57.92207,2018-07-18 07:00:00,29,3,32
"31048",10602,"Corner Brook","NL",48.95224,-57.92207,2018-07-18 08:00:00,31,2,33
"31049",10602,"Corner Brook","NL",48.95224,-57.92207,2018-07-18 09:00:00,30,1,31
"31050",10602,"Corner Brook","NL",48.95224,-57.92207,2018-07-18 10:00:00,29,1,30
"31051",10602,"Corner Brook","NL",48.95224,-57.92207,2018-07-18 11:00:00,30,1,31
"31052",10602,"Corner Brook","NL",48.95224,-57.92207,2018-07-18 12:00:00,25,1,26
"31053",10602,"Corner Brook","NL",48.95224,-57.92207,2018-07-18 13:00:00,24,1,25
"31054",10602,"Corner Brook","NL",48.95224,-57.92207,2018-07-18 14:00:00,23,1,24
"31055",10602,"Corner Brook","NL",48.95224,-57.92207,2018-07-18 15:00:00,27,1,28
"31056",10602,"Corner Brook","NL",48.95224,-57.92207,2018-07-18 16:00:00,24,1,25
"31057",10602,"Corner Brook","NL",48.95224,-57.92207,2018-07-18 17:00:00,22,1,23
"31058",10602,"Corner Brook","NL",48.95224,-57.92207,2018-07-18 18:00:00,23,1,24
"31059",10602,"Corner Brook","NL",48.95224,-57.92207,2018-07-18 19:00:00,23,1,24
"31060",10602,"Corner Brook","NL",48.95224,-57.92207,2018-07-18 20:00:00,20,1,21
"31061",10602,"Corner Brook","NL",48.95224,-57.92207,2018-07-18 21:00:00,20,1,21
"31062",10602,"Corner Brook","NL",48.95224,-57.92207,2018-07-18 22:00:00,22,1,23
"31063",10602,"Corner Brook","NL",48.95224,-57.92207,2018-07-18 23:00:00,20,1,21
"31064",10602,"Corner Brook","NL",48.95224,-57.92207,2018-07-19 00:00:00,19,1,20
"31065",10602,"Corner Brook","NL",48.95224,-57.92207,2018-07-19 01:00:00,18,1,19
"31066",10602,"Corner Brook","NL",48.95224,-57.92207,2018-07-19 02:00:00,18,1,19
"31067",10602,"Corner Brook","NL",48.95224,-57.92207,2018-07-19 03:00:00,17,1,18
"31068",10602,"Corner Brook","NL",48.95224,-57.92207,2018-07-19 04:00:00,17,2,19
"31069",10602,"Corner Brook","NL",48.95224,-57.92207,2018-07-19 05:00:00,16,4,20
"31070",10602,"Corner Brook","NL",48.95224,-57.92207,2018-07-19 06:00:00,19,1,20
"31071",10602,"Corner Brook","NL",48.95224,-57.92207,2018-07-19 07:00:00,19,1,20
"31072",10602,"Corner Brook","NL",48.95224,-57.92207,2018-07-19 08:00:00,13,1,14
"31073",10602,"Corner Brook","NL",48.95224,-57.92207,2018-07-19 09:00:00,12,1,13
"31074",10602,"Corner Brook","NL",48.95224,-57.92207,2018-07-19 10:00:00,13,2,15
"31075",10602,"Corner Brook","NL",48.95224,-57.92207,2018-07-19 11:00:00,15,1,16
"31076",10602,"Corner Brook","NL",48.95224,-57.92207,2018-07-19 12:00:00,16,1,17
"31077",10602,"Corner Brook","NL",48.95224,-57.92207,2018-07-19 13:00:00,19,1,20
"31078",10602,"Corner Brook","NL",48.95224,-57.92207,2018-07-19 14:00:00,18,1,19
"31079",10602,"Corner Brook","NL",48.95224,-57.92207,2018-07-19 15:00:00,17,1,18
"31080",10602,"Corner Brook","NL",48.95224,-57.92207,2018-07-19 16:00:00,19,1,20
"31081",10602,"Corner Brook","NL",48.95224,-57.92207,2018-07-19 17:00:00,18,1,19
"31082",10602,"Corner Brook","NL",48.95224,-57.92207,2018-07-19 18:00:00,17,2,19
"31083",10602,"Corner Brook","NL",48.95224,-57.92207,2018-07-19 19:00:00,14,3,17
"31084",10602,"Corner Brook","NL",48.95224,-57.92207,2018-07-19 20:00:00,6,11,17
"31085",10602,"Corner Brook","NL",48.95224,-57.92207,2018-07-19 21:00:00,12,3,15
"31086",10602,"Corner Brook","NL",48.95224,-57.92207,2018-07-19 22:00:00,12,3,15
"31087",10602,"Corner Brook","NL",48.95224,-57.92207,2018-07-19 23:00:00,12,2,14
"31088",10602,"Corner Brook","NL",48.95224,-57.92207,2018-07-20 00:00:00,9,2,11
"31089",10602,"Corner Brook","NL",48.95224,-57.92207,2018-07-20 01:00:00,10,1,11
"31090",10602,"Corner Brook","NL",48.95224,-57.92207,2018-07-20 02:00:00,12,1,13
"31091",10602,"Corner Brook","NL",48.95224,-57.92207,2018-07-20 03:00:00,11,1,12
"31092",10602,"Corner Brook","NL",48.95224,-57.92207,2018-07-20 04:00:00,11,1,12
"31093",10602,"Corner Brook","NL",48.95224,-57.92207,2018-07-20 05:00:00,12,1,13
"31094",10602,"Corner Brook","NL",48.95224,-57.92207,2018-07-20 06:00:00,13,1,14
"31095",10602,"Corner Brook","NL",48.95224,-57.92207,2018-07-20 07:00:00,13,2,15
"31096",10602,"Corner Brook","NL",48.95224,-57.92207,2018-07-20 08:00:00,16,2,18
"31097",10602,"Corner Brook","NL",48.95224,-57.92207,2018-07-20 09:00:00,20,1,21
"31098",10602,"Corner Brook","NL",48.95224,-57.92207,2018-07-20 10:00:00,21,1,22
"31099",10602,"Corner Brook","NL",48.95224,-57.92207,2018-07-20 11:00:00,22,1,23
"31100",10602,"Corner Brook","NL",48.95224,-57.92207,2018-07-20 12:00:00,23,1,24
"31101",10602,"Corner Brook","NL",48.95224,-57.92207,2018-07-20 13:00:00,25,1,26
"31102",10602,"Corner Brook","NL",48.95224,-57.92207,2018-07-20 14:00:00,25,1,26
"31103",10602,"Corner Brook","NL",48.95224,-57.92207,2018-07-20 15:00:00,26,1,27
"31104",10602,"Corner Brook","NL",48.95224,-57.92207,2018-07-20 16:00:00,27,1,28
"31105",10602,"Corner Brook","NL",48.95224,-57.92207,2018-07-20 17:00:00,28,1,29
"31106",10602,"Corner Brook","NL",48.95224,-57.92207,2018-07-20 18:00:00,29,1,30
"31107",10602,"Corner Brook","NL",48.95224,-57.92207,2018-07-20 19:00:00,28,1,29
"31108",10602,"Corner Brook","NL",48.95224,-57.92207,2018-07-20 20:00:00,25,1,26
"31109",10602,"Corner Brook","NL",48.95224,-57.92207,2018-07-20 21:00:00,23,2,25
"31110",10602,"Corner Brook","NL",48.95224,-57.92207,2018-07-20 22:00:00,23,1,24
"31111",10602,"Corner Brook","NL",48.95224,-57.92207,2018-07-20 23:00:00,22,1,23
"31112",10602,"Corner Brook","NL",48.95224,-57.92207,2018-07-21 00:00:00,21,1,22
"31113",10602,"Corner Brook","NL",48.95224,-57.92207,2018-07-21 01:00:00,22,1,23
"31114",10602,"Corner Brook","NL",48.95224,-57.92207,2018-07-21 02:00:00,21,1,22
"31115",10602,"Corner Brook","NL",48.95224,-57.92207,2018-07-21 03:00:00,21,2,23
"31116",10602,"Corner Brook","NL",48.95224,-57.92207,2018-07-21 04:00:00,24,1,25
"31117",10602,"Corner Brook","NL",48.95224,-57.92207,2018-07-21 05:00:00,24,1,25
"31118",10602,"Corner Brook","NL",48.95224,-57.92207,2018-07-21 06:00:00,23,1,24
"31119",10602,"Corner Brook","NL",48.95224,-57.92207,2018-07-21 07:00:00,22,1,23
"31120",10602,"Corner Brook","NL",48.95224,-57.92207,2018-07-21 08:00:00,22,1,23
"31121",10602,"Corner Brook","NL",48.95224,-57.92207,2018-07-21 09:00:00,22,1,23
"31122",10602,"Corner Brook","NL",48.95224,-57.92207,2018-07-21 10:00:00,21,1,22
"31123",10602,"Corner Brook","NL",48.95224,-57.92207,2018-07-21 11:00:00,22,1,23
"31124",10602,"Corner Brook","NL",48.95224,-57.92207,2018-07-21 12:00:00,22,1,23
"31125",10602,"Corner Brook","NL",48.95224,-57.92207,2018-07-21 13:00:00,22,1,23
"31126",10602,"Corner Brook","NL",48.95224,-57.92207,2018-07-21 14:00:00,23,1,24
"31127",10602,"Corner Brook","NL",48.95224,-57.92207,2018-07-21 15:00:00,22,2,24
"31128",10602,"Corner Brook","NL",48.95224,-57.92207,2018-07-21 16:00:00,21,2,23
"31129",10602,"Corner Brook","NL",48.95224,-57.92207,2018-07-21 17:00:00,23,2,25
"31130",10602,"Corner Brook","NL",48.95224,-57.92207,2018-07-21 18:00:00,23,2,25
"31131",10602,"Corner Brook","NL",48.95224,-57.92207,2018-07-21 19:00:00,24,3,27
"31132",10602,"Corner Brook","NL",48.95224,-57.92207,2018-07-21 20:00:00,31,1,32
"31133",10602,"Corner Brook","NL",48.95224,-57.92207,2018-07-21 21:00:00,27,2,29
"31134",10602,"Corner Brook","NL",48.95224,-57.92207,2018-07-21 22:00:00,25,3,28
"31135",10602,"Corner Brook","NL",48.95224,-57.92207,2018-07-21 23:00:00,26,3,29
"31136",10602,"Corner Brook","NL",48.95224,-57.92207,2018-07-22 00:00:00,30,1,31
"31137",10602,"Corner Brook","NL",48.95224,-57.92207,2018-07-22 01:00:00,30,2,32
"31138",10602,"Corner Brook","NL",48.95224,-57.92207,2018-07-22 02:00:00,29,2,31
"31139",10602,"Corner Brook","NL",48.95224,-57.92207,2018-07-22 03:00:00,27,1,28
"31140",10602,"Corner Brook","NL",48.95224,-57.92207,2018-07-22 04:00:00,21,2,23
"31141",10602,"Corner Brook","NL",48.95224,-57.92207,2018-07-22 05:00:00,17,2,19
"31142",10602,"Corner Brook","NL",48.95224,-57.92207,2018-07-22 06:00:00,15,2,17
"31143",10602,"Corner Brook","NL",48.95224,-57.92207,2018-07-22 07:00:00,14,2,16
"31144",10602,"Corner Brook","NL",48.95224,-57.92207,2018-07-22 08:00:00,15,2,17
"31145",10602,"Corner Brook","NL",48.95224,-57.92207,2018-07-22 09:00:00,15,2,17
"31146",10602,"Corner Brook","NL",48.95224,-57.92207,2018-07-22 10:00:00,17,2,19
"31147",10602,"Corner Brook","NL",48.95224,-57.92207,2018-07-22 11:00:00,23,3,26
"31148",10602,"Corner Brook","NL",48.95224,-57.92207,2018-07-22 12:00:00,25,2,27
"31149",10602,"Corner Brook","NL",48.95224,-57.92207,2018-07-22 13:00:00,21,2,23
"31150",10602,"Corner Brook","NL",48.95224,-57.92207,2018-07-22 14:00:00,20,6,26
"31151",10602,"Corner Brook","NL",48.95224,-57.92207,2018-07-22 15:00:00,23,4,27
"31152",10602,"Corner Brook","NL",48.95224,-57.92207,2018-07-22 16:00:00,18,9,27
"31153",10602,"Corner Brook","NL",48.95224,-57.92207,2018-07-22 17:00:00,22,3,25
"31154",10602,"Corner Brook","NL",48.95224,-57.92207,2018-07-22 18:00:00,16,7,23
"31155",10602,"Corner Brook","NL",48.95224,-57.92207,2018-07-22 19:00:00,15,9,24
"31156",10602,"Corner Brook","NL",48.95224,-57.92207,2018-07-22 20:00:00,17,7,24
"31157",10602,"Corner Brook","NL",48.95224,-57.92207,2018-07-22 21:00:00,17,5,22
"31158",10602,"Corner Brook","NL",48.95224,-57.92207,2018-07-22 22:00:00,18,1,19
"31159",10602,"Corner Brook","NL",48.95224,-57.92207,2018-07-22 23:00:00,17,1,18
"31160",10602,"Corner Brook","NL",48.95224,-57.92207,2018-07-23 00:00:00,16,1,17
"31161",10602,"Corner Brook","NL",48.95224,-57.92207,2018-07-23 01:00:00,16,1,17
"31162",10602,"Corner Brook","NL",48.95224,-57.92207,2018-07-23 02:00:00,17,1,18
"31163",10602,"Corner Brook","NL",48.95224,-57.92207,2018-07-23 03:00:00,18,1,19
"31164",10602,"Corner Brook","NL",48.95224,-57.92207,2018-07-23 04:00:00,17,1,18
"31165",10602,"Corner Brook","NL",48.95224,-57.92207,2018-07-23 05:00:00,16,1,17
"31166",10602,"Corner Brook","NL",48.95224,-57.92207,2018-07-23 06:00:00,14,1,15
"31167",10602,"Corner Brook","NL",48.95224,-57.92207,2018-07-23 07:00:00,11,1,12
"31168",10602,"Corner Brook","NL",48.95224,-57.92207,2018-07-23 08:00:00,9,1,10
"31169",10602,"Corner Brook","NL",48.95224,-57.92207,2018-07-23 09:00:00,8,2,10
"31170",10602,"Corner Brook","NL",48.95224,-57.92207,2018-07-23 10:00:00,10,1,11
"31171",10602,"Corner Brook","NL",48.95224,-57.92207,2018-07-23 11:00:00,11,2,13
"31172",10602,"Corner Brook","NL",48.95224,-57.92207,2018-07-23 12:00:00,12,1,13
"31173",10602,"Corner Brook","NL",48.95224,-57.92207,2018-07-23 13:00:00,13,1,14
"31174",10602,"Corner Brook","NL",48.95224,-57.92207,2018-07-23 14:00:00,11,5,16
"31175",10602,"Corner Brook","NL",48.95224,-57.92207,2018-07-23 15:00:00,13,4,17
"31176",10602,"Corner Brook","NL",48.95224,-57.92207,2018-07-23 16:00:00,18,2,20
"31177",10602,"Corner Brook","NL",48.95224,-57.92207,2018-07-23 17:00:00,17,3,20
"31178",10602,"Corner Brook","NL",48.95224,-57.92207,2018-07-23 18:00:00,20,3,23
"31179",10602,"Corner Brook","NL",48.95224,-57.92207,2018-07-23 19:00:00,18,4,22
"31180",10602,"Corner Brook","NL",48.95224,-57.92207,2018-07-23 20:00:00,18,3,21
"31181",10602,"Corner Brook","NL",48.95224,-57.92207,2018-07-23 21:00:00,19,3,22
"31182",10602,"Corner Brook","NL",48.95224,-57.92207,2018-07-23 22:00:00,13,4,17
"31183",10602,"Corner Brook","NL",48.95224,-57.92207,2018-07-23 23:00:00,13,2,15
"31184",10602,"Corner Brook","NL",48.95224,-57.92207,2018-07-24 00:00:00,14,2,16
"31185",10602,"Corner Brook","NL",48.95224,-57.92207,2018-07-24 01:00:00,14,1,15
"31186",10602,"Corner Brook","NL",48.95224,-57.92207,2018-07-24 02:00:00,11,2,13
"31187",10602,"Corner Brook","NL",48.95224,-57.92207,2018-07-24 03:00:00,11,1,12
"31188",10602,"Corner Brook","NL",48.95224,-57.92207,2018-07-24 04:00:00,11,1,12
"31189",10602,"Corner Brook","NL",48.95224,-57.92207,2018-07-24 05:00:00,11,1,12
"31190",10602,"Corner Brook","NL",48.95224,-57.92207,2018-07-24 06:00:00,11,2,13
"31191",10602,"Corner Brook","NL",48.95224,-57.92207,2018-07-24 07:00:00,8,3,11
"31192",10602,"Corner Brook","NL",48.95224,-57.92207,2018-07-24 08:00:00,6,5,11
"31193",10602,"Corner Brook","NL",48.95224,-57.92207,2018-07-24 09:00:00,5,5,10
"31194",10602,"Corner Brook","NL",48.95224,-57.92207,2018-07-24 10:00:00,4,6,10
"31195",10602,"Corner Brook","NL",48.95224,-57.92207,2018-07-24 11:00:00,4,5,9
"31196",10602,"Corner Brook","NL",48.95224,-57.92207,2018-07-24 12:00:00,4,5,9
"31197",10602,"Corner Brook","NL",48.95224,-57.92207,2018-07-24 13:00:00,9,3,12
"31198",10602,"Corner Brook","NL",48.95224,-57.92207,2018-07-24 14:00:00,9,1,10
"31199",10602,"Corner Brook","NL",48.95224,-57.92207,2018-07-24 15:00:00,9,1,10
"31200",10602,"Corner Brook","NL",48.95224,-57.92207,2018-07-24 16:00:00,8,1,9
"31201",10602,"Corner Brook","NL",48.95224,-57.92207,2018-07-24 17:00:00,9,1,10
"31202",10602,"Corner Brook","NL",48.95224,-57.92207,2018-07-24 18:00:00,10,1,11
"31203",10602,"Corner Brook","NL",48.95224,-57.92207,2018-07-24 19:00:00,11,1,12
"31204",10602,"Corner Brook","NL",48.95224,-57.92207,2018-07-24 20:00:00,12,1,13
"31205",10602,"Corner Brook","NL",48.95224,-57.92207,2018-07-24 21:00:00,12,1,13
"31206",10602,"Corner Brook","NL",48.95224,-57.92207,2018-07-24 22:00:00,12,1,13
"31207",10602,"Corner Brook","NL",48.95224,-57.92207,2018-07-24 23:00:00,12,1,13
"31208",10602,"Corner Brook","NL",48.95224,-57.92207,2018-07-25 00:00:00,14,1,15
"31209",10602,"Corner Brook","NL",48.95224,-57.92207,2018-07-25 01:00:00,16,1,17
"31210",10602,"Corner Brook","NL",48.95224,-57.92207,2018-07-25 02:00:00,16,1,17
"31211",10602,"Corner Brook","NL",48.95224,-57.92207,2018-07-25 03:00:00,16,0,16
"31212",10602,"Corner Brook","NL",48.95224,-57.92207,2018-07-25 04:00:00,14,1,15
"31213",10602,"Corner Brook","NL",48.95224,-57.92207,2018-07-25 05:00:00,14,1,15
"31214",10602,"Corner Brook","NL",48.95224,-57.92207,2018-07-25 06:00:00,14,1,15
"31215",10602,"Corner Brook","NL",48.95224,-57.92207,2018-07-25 07:00:00,15,1,16
"31216",10602,"Corner Brook","NL",48.95224,-57.92207,2018-07-25 08:00:00,14,2,16
"31217",10602,"Corner Brook","NL",48.95224,-57.92207,2018-07-25 09:00:00,14,2,16
"31218",10602,"Corner Brook","NL",48.95224,-57.92207,2018-07-25 10:00:00,15,1,16
"31219",10602,"Corner Brook","NL",48.95224,-57.92207,2018-07-25 11:00:00,15,1,16
"31220",10602,"Corner Brook","NL",48.95224,-57.92207,2018-07-25 12:00:00,15,2,17
"31221",10602,"Corner Brook","NL",48.95224,-57.92207,2018-07-25 13:00:00,15,1,16
"31222",10602,"Corner Brook","NL",48.95224,-57.92207,2018-07-25 14:00:00,12,1,13
"31223",10602,"Corner Brook","NL",48.95224,-57.92207,2018-07-25 15:00:00,14,1,15
"31224",10602,"Corner Brook","NL",48.95224,-57.92207,2018-07-25 16:00:00,16,1,17
"31225",10602,"Corner Brook","NL",48.95224,-57.92207,2018-07-25 17:00:00,15,1,16
"31226",10602,"Corner Brook","NL",48.95224,-57.92207,2018-07-25 18:00:00,14,1,15
"31227",10602,"Corner Brook","NL",48.95224,-57.92207,2018-07-25 19:00:00,15,1,16
"31228",10602,"Corner Brook","NL",48.95224,-57.92207,2018-07-25 20:00:00,15,1,16
"31229",10602,"Corner Brook","NL",48.95224,-57.92207,2018-07-25 21:00:00,16,1,17
"31230",10602,"Corner Brook","NL",48.95224,-57.92207,2018-07-25 22:00:00,15,2,17
"31231",10602,"Corner Brook","NL",48.95224,-57.92207,2018-07-25 23:00:00,15,1,16
"31232",10602,"Corner Brook","NL",48.95224,-57.92207,2018-07-26 00:00:00,16,1,17
"31233",10602,"Corner Brook","NL",48.95224,-57.92207,2018-07-26 01:00:00,18,1,19
"31234",10602,"Corner Brook","NL",48.95224,-57.92207,2018-07-26 02:00:00,18,1,19
"31235",10602,"Corner Brook","NL",48.95224,-57.92207,2018-07-26 03:00:00,16,1,17
"31236",10602,"Corner Brook","NL",48.95224,-57.92207,2018-07-26 04:00:00,15,1,16
"31237",10602,"Corner Brook","NL",48.95224,-57.92207,2018-07-26 05:00:00,15,1,16
"31238",10602,"Corner Brook","NL",48.95224,-57.92207,2018-07-26 06:00:00,14,1,15
"31239",10602,"Corner Brook","NL",48.95224,-57.92207,2018-07-26 07:00:00,15,1,16
"31240",10602,"Corner Brook","NL",48.95224,-57.92207,2018-07-26 08:00:00,18,1,19
"31241",10602,"Corner Brook","NL",48.95224,-57.92207,2018-07-26 09:00:00,20,1,21
"31242",10602,"Corner Brook","NL",48.95224,-57.92207,2018-07-26 10:00:00,20,1,21
"31243",10602,"Corner Brook","NL",48.95224,-57.92207,2018-07-26 11:00:00,20,1,21
"31244",10602,"Corner Brook","NL",48.95224,-57.92207,2018-07-26 12:00:00,21,1,22
"31245",10602,"Corner Brook","NL",48.95224,-57.92207,2018-07-26 13:00:00,21,1,22
"31246",10602,"Corner Brook","NL",48.95224,-57.92207,2018-07-26 14:00:00,20,1,21
"31247",10602,"Corner Brook","NL",48.95224,-57.92207,2018-07-26 15:00:00,21,1,22
"31248",10602,"Corner Brook","NL",48.95224,-57.92207,2018-07-26 16:00:00,21,1,22
"31249",10602,"Corner Brook","NL",48.95224,-57.92207,2018-07-26 17:00:00,20,1,21
"31250",10602,"Corner Brook","NL",48.95224,-57.92207,2018-07-26 18:00:00,20,1,21
"31251",10602,"Corner Brook","NL",48.95224,-57.92207,2018-07-26 19:00:00,21,1,22
"31252",10602,"Corner Brook","NL",48.95224,-57.92207,2018-07-26 20:00:00,21,1,22
"31253",10602,"Corner Brook","NL",48.95224,-57.92207,2018-07-26 21:00:00,18,1,19
"31254",10602,"Corner Brook","NL",48.95224,-57.92207,2018-07-26 22:00:00,16,1,17
"31255",10602,"Corner Brook","NL",48.95224,-57.92207,2018-07-26 23:00:00,15,1,16
"31256",10602,"Corner Brook","NL",48.95224,-57.92207,2018-07-27 00:00:00,14,1,15
"31257",10602,"Corner Brook","NL",48.95224,-57.92207,2018-07-27 01:00:00,14,1,15
"31258",10602,"Corner Brook","NL",48.95224,-57.92207,2018-07-27 02:00:00,15,1,16
"31259",10602,"Corner Brook","NL",48.95224,-57.92207,2018-07-27 03:00:00,14,1,15
"31260",10602,"Corner Brook","NL",48.95224,-57.92207,2018-07-27 04:00:00,13,1,14
"31261",10602,"Corner Brook","NL",48.95224,-57.92207,2018-07-27 05:00:00,14,1,15
"31262",10602,"Corner Brook","NL",48.95224,-57.92207,2018-07-27 06:00:00,15,1,16
"31263",10602,"Corner Brook","NL",48.95224,-57.92207,2018-07-27 07:00:00,17,1,18
"31264",10602,"Corner Brook","NL",48.95224,-57.92207,2018-07-27 08:00:00,18,1,19
"31265",10602,"Corner Brook","NL",48.95224,-57.92207,2018-07-27 09:00:00,23,1,24
"31266",10602,"Corner Brook","NL",48.95224,-57.92207,2018-07-27 10:00:00,23,1,24
"31267",10602,"Corner Brook","NL",48.95224,-57.92207,2018-07-27 11:00:00,26,1,27
"31268",10602,"Corner Brook","NL",48.95224,-57.92207,2018-07-27 12:00:00,27,1,28
"31269",10602,"Corner Brook","NL",48.95224,-57.92207,2018-07-27 13:00:00,26,1,27
"31270",10602,"Corner Brook","NL",48.95224,-57.92207,2018-07-27 14:00:00,22,2,24
"31271",10602,"Corner Brook","NL",48.95224,-57.92207,2018-07-27 15:00:00,19,1,20
"31272",10602,"Corner Brook","NL",48.95224,-57.92207,2018-07-27 16:00:00,19,2,21
"31273",10602,"Corner Brook","NL",48.95224,-57.92207,2018-07-27 17:00:00,16,3,19
"31274",10602,"Corner Brook","NL",48.95224,-57.92207,2018-07-27 18:00:00,19,1,20
"31275",10602,"Corner Brook","NL",48.95224,-57.92207,2018-07-27 19:00:00,18,3,21
"31276",10602,"Corner Brook","NL",48.95224,-57.92207,2018-07-27 20:00:00,16,3,19
"31277",10602,"Corner Brook","NL",48.95224,-57.92207,2018-07-27 21:00:00,13,3,16
"31278",10602,"Corner Brook","NL",48.95224,-57.92207,2018-07-27 22:00:00,12,2,14
"31279",10602,"Corner Brook","NL",48.95224,-57.92207,2018-07-27 23:00:00,12,1,13
"31280",10602,"Corner Brook","NL",48.95224,-57.92207,2018-07-28 00:00:00,10,1,11
"31281",10602,"Corner Brook","NL",48.95224,-57.92207,2018-07-28 01:00:00,9,1,10
"31282",10602,"Corner Brook","NL",48.95224,-57.92207,2018-07-28 02:00:00,8,1,9
"31283",10602,"Corner Brook","NL",48.95224,-57.92207,2018-07-28 03:00:00,9,1,10
"31284",10602,"Corner Brook","NL",48.95224,-57.92207,2018-07-28 04:00:00,10,1,11
"31285",10602,"Corner Brook","NL",48.95224,-57.92207,2018-07-28 05:00:00,11,1,12
"31286",10602,"Corner Brook","NL",48.95224,-57.92207,2018-07-28 06:00:00,11,1,12
"31287",10602,"Corner Brook","NL",48.95224,-57.92207,2018-07-28 07:00:00,11,1,12
"31288",10602,"Corner Brook","NL",48.95224,-57.92207,2018-07-28 08:00:00,11,1,12
"31289",10602,"Corner Brook","NL",48.95224,-57.92207,2018-07-28 09:00:00,10,1,11
"31290",10602,"Corner Brook","NL",48.95224,-57.92207,2018-07-28 10:00:00,11,1,12
"31291",10602,"Corner Brook","NL",48.95224,-57.92207,2018-07-28 11:00:00,12,2,14
"31292",10602,"Corner Brook","NL",48.95224,-57.92207,2018-07-28 12:00:00,9,5,14
"31293",10602,"Corner Brook","NL",48.95224,-57.92207,2018-07-28 13:00:00,17,2,19
"31294",10602,"Corner Brook","NL",48.95224,-57.92207,2018-07-28 14:00:00,25,1,26
"31295",10602,"Corner Brook","NL",48.95224,-57.92207,2018-07-28 15:00:00,27,1,28
"31296",10602,"Corner Brook","NL",48.95224,-57.92207,2018-07-28 16:00:00,22,3,25
"31297",10602,"Corner Brook","NL",48.95224,-57.92207,2018-07-28 17:00:00,26,3,29
"31298",10602,"Corner Brook","NL",48.95224,-57.92207,2018-07-28 18:00:00,22,10,32
"31299",10602,"Corner Brook","NL",48.95224,-57.92207,2018-07-28 19:00:00,26,5,31
"31300",10602,"Corner Brook","NL",48.95224,-57.92207,2018-07-28 20:00:00,27,2,29
"31301",10602,"Corner Brook","NL",48.95224,-57.92207,2018-07-28 21:00:00,22,4,26
"31302",10602,"Corner Brook","NL",48.95224,-57.92207,2018-07-28 22:00:00,24,3,27
"31303",10602,"Corner Brook","NL",48.95224,-57.92207,2018-07-28 23:00:00,33,2,35
"31304",10602,"Corner Brook","NL",48.95224,-57.92207,2018-07-29 00:00:00,30,2,32
"31305",10602,"Corner Brook","NL",48.95224,-57.92207,2018-07-29 01:00:00,22,3,25
"31306",10602,"Corner Brook","NL",48.95224,-57.92207,2018-07-29 02:00:00,20,3,23
"31307",10602,"Corner Brook","NL",48.95224,-57.92207,2018-07-29 03:00:00,13,5,18
"31308",10602,"Corner Brook","NL",48.95224,-57.92207,2018-07-29 04:00:00,17,4,21
"31309",10602,"Corner Brook","NL",48.95224,-57.92207,2018-07-29 05:00:00,20,1,21
"31310",10602,"Corner Brook","NL",48.95224,-57.92207,2018-07-29 06:00:00,18,1,19
"31311",10602,"Corner Brook","NL",48.95224,-57.92207,2018-07-29 07:00:00,17,2,19
"31312",10602,"Corner Brook","NL",48.95224,-57.92207,2018-07-29 08:00:00,14,2,16
"31313",10602,"Corner Brook","NL",48.95224,-57.92207,2018-07-29 09:00:00,24,1,25
"31314",10602,"Corner Brook","NL",48.95224,-57.92207,2018-07-29 10:00:00,24,1,25
"31315",10602,"Corner Brook","NL",48.95224,-57.92207,2018-07-29 11:00:00,22,1,23
"31316",10602,"Corner Brook","NL",48.95224,-57.92207,2018-07-29 12:00:00,23,1,24
"31317",10602,"Corner Brook","NL",48.95224,-57.92207,2018-07-29 13:00:00,25,1,26
"31318",10602,"Corner Brook","NL",48.95224,-57.92207,2018-07-29 14:00:00,24,2,26
"31319",10602,"Corner Brook","NL",48.95224,-57.92207,2018-07-29 15:00:00,23,1,24
"31320",10602,"Corner Brook","NL",48.95224,-57.92207,2018-07-29 16:00:00,20,5,25
"31321",10602,"Corner Brook","NL",48.95224,-57.92207,2018-07-29 17:00:00,23,3,26
"31322",10602,"Corner Brook","NL",48.95224,-57.92207,2018-07-29 18:00:00,21,4,25
"31323",10602,"Corner Brook","NL",48.95224,-57.92207,2018-07-29 19:00:00,17,5,22
"31324",10602,"Corner Brook","NL",48.95224,-57.92207,2018-07-29 20:00:00,21,3,24
"31325",10602,"Corner Brook","NL",48.95224,-57.92207,2018-07-29 21:00:00,15,4,19
"31326",10602,"Corner Brook","NL",48.95224,-57.92207,2018-07-29 22:00:00,15,3,18
"31327",10602,"Corner Brook","NL",48.95224,-57.92207,2018-07-29 23:00:00,14,4,18
"31328",10602,"Corner Brook","NL",48.95224,-57.92207,2018-07-30 00:00:00,19,4,23
"31329",10602,"Corner Brook","NL",48.95224,-57.92207,2018-07-30 01:00:00,18,3,21
"31330",10602,"Corner Brook","NL",48.95224,-57.92207,2018-07-30 02:00:00,15,3,18
"31331",10602,"Corner Brook","NL",48.95224,-57.92207,2018-07-30 03:00:00,16,3,19
"31332",10602,"Corner Brook","NL",48.95224,-57.92207,2018-07-30 04:00:00,17,2,19
"31333",10602,"Corner Brook","NL",48.95224,-57.92207,2018-07-30 05:00:00,23,1,24
"31334",10602,"Corner Brook","NL",48.95224,-57.92207,2018-07-30 06:00:00,28,1,29
"31335",10602,"Corner Brook","NL",48.95224,-57.92207,2018-07-30 07:00:00,29,2,31
"31336",10602,"Corner Brook","NL",48.95224,-57.92207,2018-07-30 08:00:00,30,1,31
"31337",10602,"Corner Brook","NL",48.95224,-57.92207,2018-07-30 09:00:00,32,2,34
"31338",10602,"Corner Brook","NL",48.95224,-57.92207,2018-07-30 10:00:00,36,1,37
"31339",10602,"Corner Brook","NL",48.95224,-57.92207,2018-07-30 11:00:00,38,1,39
"31340",10602,"Corner Brook","NL",48.95224,-57.92207,2018-07-30 12:00:00,38,2,40
"31341",10602,"Corner Brook","NL",48.95224,-57.92207,2018-07-30 13:00:00,37,1,38
"31342",10602,"Corner Brook","NL",48.95224,-57.92207,2018-07-30 14:00:00,28,1,29
"31343",10602,"Corner Brook","NL",48.95224,-57.92207,2018-07-30 15:00:00,26,1,27
"31344",10602,"Corner Brook","NL",48.95224,-57.92207,2018-07-30 16:00:00,22,1,23
"31345",10602,"Corner Brook","NL",48.95224,-57.92207,2018-07-30 17:00:00,22,1,23
"31346",10602,"Corner Brook","NL",48.95224,-57.92207,2018-07-30 18:00:00,20,1,21
"31347",10602,"Corner Brook","NL",48.95224,-57.92207,2018-07-30 19:00:00,20,1,21
"31348",10602,"Corner Brook","NL",48.95224,-57.92207,2018-07-30 20:00:00,20,1,21
"31349",10602,"Corner Brook","NL",48.95224,-57.92207,2018-07-30 21:00:00,19,2,21
"31350",10602,"Corner Brook","NL",48.95224,-57.92207,2018-07-30 22:00:00,19,1,20
"31351",10602,"Corner Brook","NL",48.95224,-57.92207,2018-07-30 23:00:00,19,1,20
"31352",10602,"Corner Brook","NL",48.95224,-57.92207,2018-07-31 00:00:00,18,1,19
"31353",10602,"Corner Brook","NL",48.95224,-57.92207,2018-07-31 01:00:00,18,1,19
"31354",10602,"Corner Brook","NL",48.95224,-57.92207,2018-07-31 02:00:00,16,1,17
"31355",10602,"Corner Brook","NL",48.95224,-57.92207,2018-07-31 03:00:00,15,1,16
"31356",10602,"Corner Brook","NL",48.95224,-57.92207,2018-07-31 04:00:00,16,1,17
"31357",10602,"Corner Brook","NL",48.95224,-57.92207,2018-07-31 05:00:00,15,1,16
"31358",10602,"Corner Brook","NL",48.95224,-57.92207,2018-07-31 06:00:00,15,1,16
"31359",10602,"Corner Brook","NL",48.95224,-57.92207,2018-07-31 07:00:00,15,2,17
"31360",10602,"Corner Brook","NL",48.95224,-57.92207,2018-07-31 08:00:00,16,1,17
"31361",10602,"Corner Brook","NL",48.95224,-57.92207,2018-07-31 09:00:00,19,1,20
"31362",10602,"Corner Brook","NL",48.95224,-57.92207,2018-07-31 10:00:00,21,2,23
"31363",10602,"Corner Brook","NL",48.95224,-57.92207,2018-07-31 11:00:00,19,4,23
"31364",10602,"Corner Brook","NL",48.95224,-57.92207,2018-07-31 12:00:00,23,5,28
"31365",10602,"Corner Brook","NL",48.95224,-57.92207,2018-07-31 13:00:00,23,8,31
"31366",10602,"Corner Brook","NL",48.95224,-57.92207,2018-07-31 14:00:00,23,5,28
"31367",10602,"Corner Brook","NL",48.95224,-57.92207,2018-07-31 15:00:00,19,9,28
"31368",10602,"Corner Brook","NL",48.95224,-57.92207,2018-07-31 16:00:00,19,9,28
"31369",10602,"Corner Brook","NL",48.95224,-57.92207,2018-07-31 17:00:00,21,8,29
"31370",10602,"Corner Brook","NL",48.95224,-57.92207,2018-07-31 18:00:00,27,2,29
"31371",10602,"Corner Brook","NL",48.95224,-57.92207,2018-07-31 19:00:00,26,1,27
"31372",10602,"Corner Brook","NL",48.95224,-57.92207,2018-07-31 20:00:00,23,3,26
"31373",10602,"Corner Brook","NL",48.95224,-57.92207,2018-07-31 21:00:00,22,1,23
"31374",10602,"Corner Brook","NL",48.95224,-57.92207,2018-07-31 22:00:00,22,2,24
"31375",10602,"Corner Brook","NL",48.95224,-57.92207,2018-07-31 23:00:00,21,1,22
"31376",10602,"Corner Brook","NL",48.95224,-57.92207,2018-08-01 00:00:00,20,1,21
"31377",10602,"Corner Brook","NL",48.95224,-57.92207,2018-08-01 01:00:00,19,1,20
"31378",10602,"Corner Brook","NL",48.95224,-57.92207,2018-08-01 02:00:00,20,1,21
"31379",10602,"Corner Brook","NL",48.95224,-57.92207,2018-08-01 03:00:00,20,1,21
"31380",10602,"Corner Brook","NL",48.95224,-57.92207,2018-08-01 04:00:00,20,1,21
"31381",10602,"Corner Brook","NL",48.95224,-57.92207,2018-08-01 05:00:00,19,1,20
"31382",10602,"Corner Brook","NL",48.95224,-57.92207,2018-08-01 06:00:00,18,1,19
"31383",10602,"Corner Brook","NL",48.95224,-57.92207,2018-08-01 07:00:00,17,1,18
"31384",10602,"Corner Brook","NL",48.95224,-57.92207,2018-08-01 08:00:00,17,2,19
"31385",10602,"Corner Brook","NL",48.95224,-57.92207,2018-08-01 09:00:00,18,1,19
"31386",10602,"Corner Brook","NL",48.95224,-57.92207,2018-08-01 10:00:00,20,1,21
"31387",10602,"Corner Brook","NL",48.95224,-57.92207,2018-08-01 11:00:00,21,3,24
"31388",10602,"Corner Brook","NL",48.95224,-57.92207,2018-08-01 12:00:00,21,4,25
"31389",10602,"Corner Brook","NL",48.95224,-57.92207,2018-08-01 13:00:00,23,6,29
"31390",10602,"Corner Brook","NL",48.95224,-57.92207,2018-08-01 14:00:00,26,3,29
"31391",10602,"Corner Brook","NL",48.95224,-57.92207,2018-08-01 15:00:00,27,5,32
"31392",10602,"Corner Brook","NL",48.95224,-57.92207,2018-08-01 16:00:00,23,9,32
"31393",10602,"Corner Brook","NL",48.95224,-57.92207,2018-08-01 17:00:00,23,8,31
"31394",10602,"Corner Brook","NL",48.95224,-57.92207,2018-08-01 18:00:00,22,7,29
"31395",10602,"Corner Brook","NL",48.95224,-57.92207,2018-08-01 19:00:00,20,7,27
"31396",10602,"Corner Brook","NL",48.95224,-57.92207,2018-08-01 20:00:00,24,2,26
"31397",10602,"Corner Brook","NL",48.95224,-57.92207,2018-08-01 21:00:00,24,2,26
"31398",10602,"Corner Brook","NL",48.95224,-57.92207,2018-08-01 22:00:00,25,2,27
"31399",10602,"Corner Brook","NL",48.95224,-57.92207,2018-08-01 23:00:00,25,2,27
"31400",10602,"Corner Brook","NL",48.95224,-57.92207,2018-08-02 00:00:00,25,1,26
"31401",10602,"Corner Brook","NL",48.95224,-57.92207,2018-08-02 01:00:00,23,2,25
"31402",10602,"Corner Brook","NL",48.95224,-57.92207,2018-08-02 02:00:00,22,1,23
"31403",10602,"Corner Brook","NL",48.95224,-57.92207,2018-08-02 03:00:00,21,1,22
"31404",10602,"Corner Brook","NL",48.95224,-57.92207,2018-08-02 04:00:00,21,1,22
"31405",10602,"Corner Brook","NL",48.95224,-57.92207,2018-08-02 05:00:00,18,2,20
"31406",10602,"Corner Brook","NL",48.95224,-57.92207,2018-08-02 06:00:00,16,3,19
"31407",10602,"Corner Brook","NL",48.95224,-57.92207,2018-08-02 07:00:00,8,8,16
"31408",10602,"Corner Brook","NL",48.95224,-57.92207,2018-08-02 08:00:00,12,8,20
"31409",10602,"Corner Brook","NL",48.95224,-57.92207,2018-08-02 09:00:00,23,1,24
"31410",10602,"Corner Brook","NL",48.95224,-57.92207,2018-08-02 10:00:00,25,1,26
"31411",10602,"Corner Brook","NL",48.95224,-57.92207,2018-08-02 11:00:00,26,1,27
"31412",10602,"Corner Brook","NL",48.95224,-57.92207,2018-08-02 12:00:00,25,1,26
"31413",10602,"Corner Brook","NL",48.95224,-57.92207,2018-08-02 13:00:00,26,1,27
"31414",10602,"Corner Brook","NL",48.95224,-57.92207,2018-08-02 14:00:00,28,1,29
"31415",10602,"Corner Brook","NL",48.95224,-57.92207,2018-08-02 15:00:00,29,1,30
"31416",10602,"Corner Brook","NL",48.95224,-57.92207,2018-08-02 16:00:00,30,1,31
"31417",10602,"Corner Brook","NL",48.95224,-57.92207,2018-08-02 17:00:00,28,1,29
"31418",10602,"Corner Brook","NL",48.95224,-57.92207,2018-08-02 18:00:00,25,1,26
"31419",10602,"Corner Brook","NL",48.95224,-57.92207,2018-08-02 19:00:00,23,1,24
"31420",10602,"Corner Brook","NL",48.95224,-57.92207,2018-08-02 20:00:00,20,3,23
"31421",10602,"Corner Brook","NL",48.95224,-57.92207,2018-08-02 21:00:00,19,2,21
"31422",10602,"Corner Brook","NL",48.95224,-57.92207,2018-08-02 22:00:00,19,1,20
"31423",10602,"Corner Brook","NL",48.95224,-57.92207,2018-08-02 23:00:00,18,1,19
"31424",10602,"Corner Brook","NL",48.95224,-57.92207,2018-08-03 00:00:00,21,1,22
"31425",10602,"Corner Brook","NL",48.95224,-57.92207,2018-08-03 01:00:00,21,1,22
"31426",10602,"Corner Brook","NL",48.95224,-57.92207,2018-08-03 02:00:00,21,1,22
"31427",10602,"Corner Brook","NL",48.95224,-57.92207,2018-08-03 03:00:00,20,1,21
"31428",10602,"Corner Brook","NL",48.95224,-57.92207,2018-08-03 04:00:00,18,1,19
"31429",10602,"Corner Brook","NL",48.95224,-57.92207,2018-08-03 05:00:00,14,2,16
"31430",10602,"Corner Brook","NL",48.95224,-57.92207,2018-08-03 06:00:00,13,2,15
"31431",10602,"Corner Brook","NL",48.95224,-57.92207,2018-08-03 07:00:00,9,6,15
"31432",10602,"Corner Brook","NL",48.95224,-57.92207,2018-08-03 08:00:00,11,5,16
"31433",10602,"Corner Brook","NL",48.95224,-57.92207,2018-08-03 09:00:00,14,7,21
"31434",10602,"Corner Brook","NL",48.95224,-57.92207,2018-08-03 10:00:00,16,7,23
"31435",10602,"Corner Brook","NL",48.95224,-57.92207,2018-08-03 11:00:00,22,5,27
"31436",10602,"Corner Brook","NL",48.95224,-57.92207,2018-08-03 12:00:00,21,4,25
"31437",10602,"Corner Brook","NL",48.95224,-57.92207,2018-08-03 13:00:00,19,8,27
"31438",10602,"Corner Brook","NL",48.95224,-57.92207,2018-08-03 14:00:00,21,6,27
"31439",10602,"Corner Brook","NL",48.95224,-57.92207,2018-08-03 15:00:00,20,7,27
"31440",10602,"Corner Brook","NL",48.95224,-57.92207,2018-08-03 16:00:00,16,12,28
"31441",10602,"Corner Brook","NL",48.95224,-57.92207,2018-08-03 17:00:00,14,12,26
"31442",10602,"Corner Brook","NL",48.95224,-57.92207,2018-08-03 18:00:00,18,7,25
"31443",10602,"Corner Brook","NL",48.95224,-57.92207,2018-08-03 19:00:00,14,9,23
"31444",10602,"Corner Brook","NL",48.95224,-57.92207,2018-08-03 20:00:00,18,5,23
"31445",10602,"Corner Brook","NL",48.95224,-57.92207,2018-08-03 21:00:00,11,11,22
"31446",10602,"Corner Brook","NL",48.95224,-57.92207,2018-08-03 22:00:00,7,10,17
"31447",10602,"Corner Brook","NL",48.95224,-57.92207,2018-08-03 23:00:00,7,6,13
"31448",10602,"Corner Brook","NL",48.95224,-57.92207,2018-08-04 00:00:00,16,1,17
"31449",10602,"Corner Brook","NL",48.95224,-57.92207,2018-08-04 01:00:00,16,1,17
"31450",10602,"Corner Brook","NL",48.95224,-57.92207,2018-08-04 02:00:00,16,1,17
"31451",10602,"Corner Brook","NL",48.95224,-57.92207,2018-08-04 03:00:00,17,1,18
"31452",10602,"Corner Brook","NL",48.95224,-57.92207,2018-08-04 04:00:00,14,2,16
"31453",10602,"Corner Brook","NL",48.95224,-57.92207,2018-08-04 05:00:00,10,2,12
"31454",10602,"Corner Brook","NL",48.95224,-57.92207,2018-08-04 06:00:00,7,3,10
"31455",10602,"Corner Brook","NL",48.95224,-57.92207,2018-08-04 07:00:00,8,3,11
"31456",10602,"Corner Brook","NL",48.95224,-57.92207,2018-08-04 08:00:00,6,3,9
"31457",10602,"Corner Brook","NL",48.95224,-57.92207,2018-08-04 09:00:00,10,2,12
"31458",10602,"Corner Brook","NL",48.95224,-57.92207,2018-08-04 10:00:00,16,2,18
"31459",10602,"Corner Brook","NL",48.95224,-57.92207,2018-08-04 11:00:00,27,1,28
"31460",10602,"Corner Brook","NL",48.95224,-57.92207,2018-08-04 12:00:00,27,1,28
"31461",10602,"Corner Brook","NL",48.95224,-57.92207,2018-08-04 13:00:00,24,2,26
"31462",10602,"Corner Brook","NL",48.95224,-57.92207,2018-08-04 14:00:00,19,8,27
"31463",10602,"Corner Brook","NL",48.95224,-57.92207,2018-08-04 15:00:00,21,7,28
"31464",10602,"Corner Brook","NL",48.95224,-57.92207,2018-08-04 16:00:00,23,6,29
"31465",10602,"Corner Brook","NL",48.95224,-57.92207,2018-08-04 17:00:00,24,7,31
"31466",10602,"Corner Brook","NL",48.95224,-57.92207,2018-08-04 18:00:00,19,15,34
"31467",10602,"Corner Brook","NL",48.95224,-57.92207,2018-08-04 19:00:00,24,5,29
"31468",10602,"Corner Brook","NL",48.95224,-57.92207,2018-08-04 20:00:00,22,7,29
"31469",10602,"Corner Brook","NL",48.95224,-57.92207,2018-08-04 21:00:00,21,7,28
"31470",10602,"Corner Brook","NL",48.95224,-57.92207,2018-08-04 22:00:00,23,3,26
"31471",10602,"Corner Brook","NL",48.95224,-57.92207,2018-08-04 23:00:00,23,2,25
"31472",10602,"Corner Brook","NL",48.95224,-57.92207,2018-08-05 00:00:00,20,2,22
"31473",10602,"Corner Brook","NL",48.95224,-57.92207,2018-08-05 01:00:00,16,2,18
"31474",10602,"Corner Brook","NL",48.95224,-57.92207,2018-08-05 02:00:00,12,2,14
"31475",10602,"Corner Brook","NL",48.95224,-57.92207,2018-08-05 03:00:00,13,2,15
"31476",10602,"Corner Brook","NL",48.95224,-57.92207,2018-08-05 04:00:00,16,2,18
"31477",10602,"Corner Brook","NL",48.95224,-57.92207,2018-08-05 05:00:00,13,2,15
"31478",10602,"Corner Brook","NL",48.95224,-57.92207,2018-08-05 06:00:00,14,2,16
"31479",10602,"Corner Brook","NL",48.95224,-57.92207,2018-08-05 07:00:00,14,1,15
"31480",10602,"Corner Brook","NL",48.95224,-57.92207,2018-08-05 08:00:00,10,2,12
"31481",10602,"Corner Brook","NL",48.95224,-57.92207,2018-08-05 09:00:00,19,1,20
"31482",10602,"Corner Brook","NL",48.95224,-57.92207,2018-08-05 10:00:00,22,2,24
"31483",10602,"Corner Brook","NL",48.95224,-57.92207,2018-08-05 11:00:00,23,1,24
"31484",10602,"Corner Brook","NL",48.95224,-57.92207,2018-08-05 12:00:00,24,2,26
"31485",10602,"Corner Brook","NL",48.95224,-57.92207,2018-08-05 13:00:00,23,1,24
"31486",10602,"Corner Brook","NL",48.95224,-57.92207,2018-08-05 14:00:00,19,2,21
"31487",10602,"Corner Brook","NL",48.95224,-57.92207,2018-08-05 15:00:00,19,2,21
"31488",10602,"Corner Brook","NL",48.95224,-57.92207,2018-08-05 16:00:00,20,1,21
"31489",10602,"Corner Brook","NL",48.95224,-57.92207,2018-08-05 17:00:00,21,1,22
"31490",10602,"Corner Brook","NL",48.95224,-57.92207,2018-08-05 18:00:00,21,1,22
"31491",10602,"Corner Brook","NL",48.95224,-57.92207,2018-08-05 19:00:00,21,2,23
"31492",10602,"Corner Brook","NL",48.95224,-57.92207,2018-08-05 20:00:00,21,1,22
"31493",10602,"Corner Brook","NL",48.95224,-57.92207,2018-08-05 21:00:00,20,2,22
"31494",10602,"Corner Brook","NL",48.95224,-57.92207,2018-08-05 22:00:00,18,1,19
"31495",10602,"Corner Brook","NL",48.95224,-57.92207,2018-08-05 23:00:00,17,1,18
"31496",10602,"Corner Brook","NL",48.95224,-57.92207,2018-08-06 00:00:00,15,1,16
"31497",10602,"Corner Brook","NL",48.95224,-57.92207,2018-08-06 01:00:00,14,1,15
"31498",10602,"Corner Brook","NL",48.95224,-57.92207,2018-08-06 02:00:00,13,1,14
"31499",10602,"Corner Brook","NL",48.95224,-57.92207,2018-08-06 03:00:00,13,1,14
"31500",10602,"Corner Brook","NL",48.95224,-57.92207,2018-08-06 04:00:00,17,1,18
"31501",10602,"Corner Brook","NL",48.95224,-57.92207,2018-08-06 05:00:00,14,2,16
"31502",10602,"Corner Brook","NL",48.95224,-57.92207,2018-08-06 06:00:00,7,2,9
"31503",10602,"Corner Brook","NL",48.95224,-57.92207,2018-08-06 07:00:00,7,5,12
"31504",10602,"Corner Brook","NL",48.95224,-57.92207,2018-08-06 08:00:00,10,3,13
"31505",10602,"Corner Brook","NL",48.95224,-57.92207,2018-08-06 09:00:00,11,3,14
"31506",10602,"Corner Brook","NL",48.95224,-57.92207,2018-08-06 10:00:00,15,1,16
"31507",10602,"Corner Brook","NL",48.95224,-57.92207,2018-08-06 11:00:00,15,1,16
"31508",10602,"Corner Brook","NL",48.95224,-57.92207,2018-08-06 12:00:00,15,1,16
"31509",10602,"Corner Brook","NL",48.95224,-57.92207,2018-08-06 13:00:00,16,1,17
"31510",10602,"Corner Brook","NL",48.95224,-57.92207,2018-08-06 14:00:00,20,1,21
"31511",10602,"Corner Brook","NL",48.95224,-57.92207,2018-08-06 15:00:00,24,1,25
"31512",10602,"Corner Brook","NL",48.95224,-57.92207,2018-08-06 16:00:00,18,5,23
"31513",10602,"Corner Brook","NL",48.95224,-57.92207,2018-08-06 17:00:00,10,11,21
"31514",10602,"Corner Brook","NL",48.95224,-57.92207,2018-08-06 18:00:00,11,9,20
"31515",10602,"Corner Brook","NL",48.95224,-57.92207,2018-08-06 19:00:00,7,10,17
"31516",10602,"Corner Brook","NL",48.95224,-57.92207,2018-08-06 20:00:00,12,5,17
"31517",10602,"Corner Brook","NL",48.95224,-57.92207,2018-08-06 21:00:00,10,6,16
"31518",10602,"Corner Brook","NL",48.95224,-57.92207,2018-08-06 22:00:00,10,4,14
"31519",10602,"Corner Brook","NL",48.95224,-57.92207,2018-08-06 23:00:00,16,1,17
"31520",10602,"Corner Brook","NL",48.95224,-57.92207,2018-08-07 00:00:00,16,1,17
"31521",10602,"Corner Brook","NL",48.95224,-57.92207,2018-08-07 01:00:00,13,1,14
"31522",10602,"Corner Brook","NL",48.95224,-57.92207,2018-08-07 02:00:00,9,1,10
"31523",10602,"Corner Brook","NL",48.95224,-57.92207,2018-08-07 03:00:00,11,1,12
"31524",10602,"Corner Brook","NL",48.95224,-57.92207,2018-08-07 04:00:00,10,3,13
"31525",10602,"Corner Brook","NL",48.95224,-57.92207,2018-08-07 05:00:00,13,1,14
"31526",10602,"Corner Brook","NL",48.95224,-57.92207,2018-08-07 06:00:00,10,2,12
"31527",10602,"Corner Brook","NL",48.95224,-57.92207,2018-08-07 07:00:00,7,4,11
"31528",10602,"Corner Brook","NL",48.95224,-57.92207,2018-08-07 08:00:00,11,3,14
"31529",10602,"Corner Brook","NL",48.95224,-57.92207,2018-08-07 09:00:00,12,3,15
"31530",10602,"Corner Brook","NL",48.95224,-57.92207,2018-08-07 10:00:00,NA,13,NA
"31531",10602,"Corner Brook","NL",48.95224,-57.92207,2018-08-07 11:00:00,NA,21,NA
"31532",10602,"Corner Brook","NL",48.95224,-57.92207,2018-08-07 12:00:00,13,NA,NA
"31533",10602,"Corner Brook","NL",48.95224,-57.92207,2018-08-07 13:00:00,12,NA,NA
"31534",10602,"Corner Brook","NL",48.95224,-57.92207,2018-08-07 14:00:00,NA,NA,NA
"31535",10602,"Corner Brook","NL",48.95224,-57.92207,2018-08-07 15:00:00,NA,NA,NA
"31536",10602,"Corner Brook","NL",48.95224,-57.92207,2018-08-07 16:00:00,19,2,21
"31537",10602,"Corner Brook","NL",48.95224,-57.92207,2018-08-07 17:00:00,14,5,19
"31538",10602,"Corner Brook","NL",48.95224,-57.92207,2018-08-07 18:00:00,13,4,17
"31539",10602,"Corner Brook","NL",48.95224,-57.92207,2018-08-07 19:00:00,13,3,16
"31540",10602,"Corner Brook","NL",48.95224,-57.92207,2018-08-07 20:00:00,16,2,18
"31541",10602,"Corner Brook","NL",48.95224,-57.92207,2018-08-07 21:00:00,17,2,19
"31542",10602,"Corner Brook","NL",48.95224,-57.92207,2018-08-07 22:00:00,18,1,19
"31543",10602,"Corner Brook","NL",48.95224,-57.92207,2018-08-07 23:00:00,18,1,19
"31544",10602,"Corner Brook","NL",48.95224,-57.92207,2018-08-08 00:00:00,19,1,20
"31545",10602,"Corner Brook","NL",48.95224,-57.92207,2018-08-08 01:00:00,19,1,20
"31546",10602,"Corner Brook","NL",48.95224,-57.92207,2018-08-08 02:00:00,21,1,22
"31547",10602,"Corner Brook","NL",48.95224,-57.92207,2018-08-08 03:00:00,22,1,23
"31548",10602,"Corner Brook","NL",48.95224,-57.92207,2018-08-08 04:00:00,23,1,24
"31549",10602,"Corner Brook","NL",48.95224,-57.92207,2018-08-08 05:00:00,24,1,25
"31550",10602,"Corner Brook","NL",48.95224,-57.92207,2018-08-08 06:00:00,25,1,26
"31551",10602,"Corner Brook","NL",48.95224,-57.92207,2018-08-08 07:00:00,22,2,24
"31552",10602,"Corner Brook","NL",48.95224,-57.92207,2018-08-08 08:00:00,20,4,24
"31553",10602,"Corner Brook","NL",48.95224,-57.92207,2018-08-08 09:00:00,21,3,24
"31554",10602,"Corner Brook","NL",48.95224,-57.92207,2018-08-08 10:00:00,26,1,27
"31555",10602,"Corner Brook","NL",48.95224,-57.92207,2018-08-08 11:00:00,27,1,28
"31556",10602,"Corner Brook","NL",48.95224,-57.92207,2018-08-08 12:00:00,29,1,30
"31557",10602,"Corner Brook","NL",48.95224,-57.92207,2018-08-08 13:00:00,28,2,30
"31558",10602,"Corner Brook","NL",48.95224,-57.92207,2018-08-08 14:00:00,26,2,28
"31559",10602,"Corner Brook","NL",48.95224,-57.92207,2018-08-08 15:00:00,21,1,22
"31560",10602,"Corner Brook","NL",48.95224,-57.92207,2018-08-08 16:00:00,19,2,21
"31561",10602,"Corner Brook","NL",48.95224,-57.92207,2018-08-08 17:00:00,14,4,18
"31562",10602,"Corner Brook","NL",48.95224,-57.92207,2018-08-08 18:00:00,13,3,16
"31563",10602,"Corner Brook","NL",48.95224,-57.92207,2018-08-08 19:00:00,13,1,14
"31564",10602,"Corner Brook","NL",48.95224,-57.92207,2018-08-08 20:00:00,8,7,15
"31565",10602,"Corner Brook","NL",48.95224,-57.92207,2018-08-08 21:00:00,8,5,13
"31566",10602,"Corner Brook","NL",48.95224,-57.92207,2018-08-08 22:00:00,5,3,8
"31567",10602,"Corner Brook","NL",48.95224,-57.92207,2018-08-08 23:00:00,4,4,8
"31568",10602,"Corner Brook","NL",48.95224,-57.92207,2018-08-09 00:00:00,7,2,9
"31569",10602,"Corner Brook","NL",48.95224,-57.92207,2018-08-09 01:00:00,4,2,6
"31570",10602,"Corner Brook","NL",48.95224,-57.92207,2018-08-09 02:00:00,2,2,4
"31571",10602,"Corner Brook","NL",48.95224,-57.92207,2018-08-09 03:00:00,0,3,3
"31572",10602,"Corner Brook","NL",48.95224,-57.92207,2018-08-09 04:00:00,1,3,4
"31573",10602,"Corner Brook","NL",48.95224,-57.92207,2018-08-09 05:00:00,1,2,3
"31574",10602,"Corner Brook","NL",48.95224,-57.92207,2018-08-09 06:00:00,2,3,5
"31575",10602,"Corner Brook","NL",48.95224,-57.92207,2018-08-09 07:00:00,6,2,8
"31576",10602,"Corner Brook","NL",48.95224,-57.92207,2018-08-09 08:00:00,5,4,9
"31577",10602,"Corner Brook","NL",48.95224,-57.92207,2018-08-09 09:00:00,6,4,10
"31578",10602,"Corner Brook","NL",48.95224,-57.92207,2018-08-09 10:00:00,12,3,15
"31579",10602,"Corner Brook","NL",48.95224,-57.92207,2018-08-09 11:00:00,20,3,23
"31580",10602,"Corner Brook","NL",48.95224,-57.92207,2018-08-09 12:00:00,22,3,25
"31581",10602,"Corner Brook","NL",48.95224,-57.92207,2018-08-09 13:00:00,23,3,26
"31582",10602,"Corner Brook","NL",48.95224,-57.92207,2018-08-09 14:00:00,23,2,25
"31583",10602,"Corner Brook","NL",48.95224,-57.92207,2018-08-09 15:00:00,25,2,27
"31584",10602,"Corner Brook","NL",48.95224,-57.92207,2018-08-09 16:00:00,24,2,26
"31585",10602,"Corner Brook","NL",48.95224,-57.92207,2018-08-09 17:00:00,24,3,27
"31586",10602,"Corner Brook","NL",48.95224,-57.92207,2018-08-09 18:00:00,22,2,24
"31587",10602,"Corner Brook","NL",48.95224,-57.92207,2018-08-09 19:00:00,18,2,20
"31588",10602,"Corner Brook","NL",48.95224,-57.92207,2018-08-09 20:00:00,23,2,25
"31589",10602,"Corner Brook","NL",48.95224,-57.92207,2018-08-09 21:00:00,20,2,22
"31590",10602,"Corner Brook","NL",48.95224,-57.92207,2018-08-09 22:00:00,21,2,23
"31591",10602,"Corner Brook","NL",48.95224,-57.92207,2018-08-09 23:00:00,19,1,20
"31592",10602,"Corner Brook","NL",48.95224,-57.92207,2018-08-10 00:00:00,18,1,19
"31593",10602,"Corner Brook","NL",48.95224,-57.92207,2018-08-10 01:00:00,21,1,22
"31594",10602,"Corner Brook","NL",48.95224,-57.92207,2018-08-10 02:00:00,24,1,25
"31595",10602,"Corner Brook","NL",48.95224,-57.92207,2018-08-10 03:00:00,26,1,27
"31596",10602,"Corner Brook","NL",48.95224,-57.92207,2018-08-10 04:00:00,25,1,26
"31597",10602,"Corner Brook","NL",48.95224,-57.92207,2018-08-10 05:00:00,26,1,27
"31598",10602,"Corner Brook","NL",48.95224,-57.92207,2018-08-10 06:00:00,26,1,27
"31599",10602,"Corner Brook","NL",48.95224,-57.92207,2018-08-10 07:00:00,24,1,25
"31600",10602,"Corner Brook","NL",48.95224,-57.92207,2018-08-10 08:00:00,27,1,28
"31601",10602,"Corner Brook","NL",48.95224,-57.92207,2018-08-10 09:00:00,28,1,29
"31602",10602,"Corner Brook","NL",48.95224,-57.92207,2018-08-10 10:00:00,30,1,31
"31603",10602,"Corner Brook","NL",48.95224,-57.92207,2018-08-10 11:00:00,31,1,32
"31604",10602,"Corner Brook","NL",48.95224,-57.92207,2018-08-10 12:00:00,30,2,32
"31605",10602,"Corner Brook","NL",48.95224,-57.92207,2018-08-10 13:00:00,32,2,34
"31606",10602,"Corner Brook","NL",48.95224,-57.92207,2018-08-10 14:00:00,31,1,32
"31607",10602,"Corner Brook","NL",48.95224,-57.92207,2018-08-10 15:00:00,32,1,33
"31608",10602,"Corner Brook","NL",48.95224,-57.92207,2018-08-10 16:00:00,32,1,33
"31609",10602,"Corner Brook","NL",48.95224,-57.92207,2018-08-10 17:00:00,32,1,33
"31610",10602,"Corner Brook","NL",48.95224,-57.92207,2018-08-10 18:00:00,31,1,32
"31611",10602,"Corner Brook","NL",48.95224,-57.92207,2018-08-10 19:00:00,32,2,34
"31612",10602,"Corner Brook","NL",48.95224,-57.92207,2018-08-10 20:00:00,29,1,30
"31613",10602,"Corner Brook","NL",48.95224,-57.92207,2018-08-10 21:00:00,27,3,30
"31614",10602,"Corner Brook","NL",48.95224,-57.92207,2018-08-10 22:00:00,26,1,27
"31615",10602,"Corner Brook","NL",48.95224,-57.92207,2018-08-10 23:00:00,23,1,24
"31616",10602,"Corner Brook","NL",48.95224,-57.92207,2018-08-11 00:00:00,21,1,22
"31617",10602,"Corner Brook","NL",48.95224,-57.92207,2018-08-11 01:00:00,18,2,20
"31618",10602,"Corner Brook","NL",48.95224,-57.92207,2018-08-11 02:00:00,17,2,19
"31619",10602,"Corner Brook","NL",48.95224,-57.92207,2018-08-11 03:00:00,17,1,18
"31620",10602,"Corner Brook","NL",48.95224,-57.92207,2018-08-11 04:00:00,16,1,17
"31621",10602,"Corner Brook","NL",48.95224,-57.92207,2018-08-11 05:00:00,16,1,17
"31622",10602,"Corner Brook","NL",48.95224,-57.92207,2018-08-11 06:00:00,17,1,18
"31623",10602,"Corner Brook","NL",48.95224,-57.92207,2018-08-11 07:00:00,18,1,19
"31624",10602,"Corner Brook","NL",48.95224,-57.92207,2018-08-11 08:00:00,18,1,19
"31625",10602,"Corner Brook","NL",48.95224,-57.92207,2018-08-11 09:00:00,18,1,19
"31626",10602,"Corner Brook","NL",48.95224,-57.92207,2018-08-11 10:00:00,19,1,20
"31627",10602,"Corner Brook","NL",48.95224,-57.92207,2018-08-11 11:00:00,18,1,19
"31628",10602,"Corner Brook","NL",48.95224,-57.92207,2018-08-11 12:00:00,17,1,18
"31629",10602,"Corner Brook","NL",48.95224,-57.92207,2018-08-11 13:00:00,15,1,16
"31630",10602,"Corner Brook","NL",48.95224,-57.92207,2018-08-11 14:00:00,14,1,15
"31631",10602,"Corner Brook","NL",48.95224,-57.92207,2018-08-11 15:00:00,13,1,14
"31632",10602,"Corner Brook","NL",48.95224,-57.92207,2018-08-11 16:00:00,13,1,14
"31633",10602,"Corner Brook","NL",48.95224,-57.92207,2018-08-11 17:00:00,12,1,13
"31634",10602,"Corner Brook","NL",48.95224,-57.92207,2018-08-11 18:00:00,13,1,14
"31635",10602,"Corner Brook","NL",48.95224,-57.92207,2018-08-11 19:00:00,13,1,14
"31636",10602,"Corner Brook","NL",48.95224,-57.92207,2018-08-11 20:00:00,13,1,14
"31637",10602,"Corner Brook","NL",48.95224,-57.92207,2018-08-11 21:00:00,14,1,15
"31638",10602,"Corner Brook","NL",48.95224,-57.92207,2018-08-11 22:00:00,12,1,13
"31639",10602,"Corner Brook","NL",48.95224,-57.92207,2018-08-11 23:00:00,11,1,12
"31640",10602,"Corner Brook","NL",48.95224,-57.92207,2018-08-12 00:00:00,11,1,12
"31641",10602,"Corner Brook","NL",48.95224,-57.92207,2018-08-12 01:00:00,11,1,12
"31642",10602,"Corner Brook","NL",48.95224,-57.92207,2018-08-12 02:00:00,11,1,12
"31643",10602,"Corner Brook","NL",48.95224,-57.92207,2018-08-12 03:00:00,12,0,12
"31644",10602,"Corner Brook","NL",48.95224,-57.92207,2018-08-12 04:00:00,11,1,12
"31645",10602,"Corner Brook","NL",48.95224,-57.92207,2018-08-12 05:00:00,10,1,11
"31646",10602,"Corner Brook","NL",48.95224,-57.92207,2018-08-12 06:00:00,13,1,14
"31647",10602,"Corner Brook","NL",48.95224,-57.92207,2018-08-12 07:00:00,12,1,13
"31648",10602,"Corner Brook","NL",48.95224,-57.92207,2018-08-12 08:00:00,11,1,12
"31649",10602,"Corner Brook","NL",48.95224,-57.92207,2018-08-12 09:00:00,12,1,13
"31650",10602,"Corner Brook","NL",48.95224,-57.92207,2018-08-12 10:00:00,13,2,15
"31651",10602,"Corner Brook","NL",48.95224,-57.92207,2018-08-12 11:00:00,16,1,17
"31652",10602,"Corner Brook","NL",48.95224,-57.92207,2018-08-12 12:00:00,16,1,17
"31653",10602,"Corner Brook","NL",48.95224,-57.92207,2018-08-12 13:00:00,17,1,18
"31654",10602,"Corner Brook","NL",48.95224,-57.92207,2018-08-12 14:00:00,19,1,20
"31655",10602,"Corner Brook","NL",48.95224,-57.92207,2018-08-12 15:00:00,19,2,21
"31656",10602,"Corner Brook","NL",48.95224,-57.92207,2018-08-12 16:00:00,17,5,22
"31657",10602,"Corner Brook","NL",48.95224,-57.92207,2018-08-12 17:00:00,18,5,23
"31658",10602,"Corner Brook","NL",48.95224,-57.92207,2018-08-12 18:00:00,17,5,22
"31659",10602,"Corner Brook","NL",48.95224,-57.92207,2018-08-12 19:00:00,18,4,22
"31660",10602,"Corner Brook","NL",48.95224,-57.92207,2018-08-12 20:00:00,14,4,18
"31661",10602,"Corner Brook","NL",48.95224,-57.92207,2018-08-12 21:00:00,13,3,16
"31662",10602,"Corner Brook","NL",48.95224,-57.92207,2018-08-12 22:00:00,11,3,14
"31663",10602,"Corner Brook","NL",48.95224,-57.92207,2018-08-12 23:00:00,11,1,12
"31664",10602,"Corner Brook","NL",48.95224,-57.92207,2018-08-13 00:00:00,14,1,15
"31665",10602,"Corner Brook","NL",48.95224,-57.92207,2018-08-13 01:00:00,17,1,18
"31666",10602,"Corner Brook","NL",48.95224,-57.92207,2018-08-13 02:00:00,16,1,17
"31667",10602,"Corner Brook","NL",48.95224,-57.92207,2018-08-13 03:00:00,17,1,18
"31668",10602,"Corner Brook","NL",48.95224,-57.92207,2018-08-13 04:00:00,17,1,18
"31669",10602,"Corner Brook","NL",48.95224,-57.92207,2018-08-13 05:00:00,17,1,18
"31670",10602,"Corner Brook","NL",48.95224,-57.92207,2018-08-13 06:00:00,17,1,18
"31671",10602,"Corner Brook","NL",48.95224,-57.92207,2018-08-13 07:00:00,17,1,18
"31672",10602,"Corner Brook","NL",48.95224,-57.92207,2018-08-13 08:00:00,18,1,19
"31673",10602,"Corner Brook","NL",48.95224,-57.92207,2018-08-13 09:00:00,17,2,19
"31674",10602,"Corner Brook","NL",48.95224,-57.92207,2018-08-13 10:00:00,NA,NA,NA
"31675",10602,"Corner Brook","NL",48.95224,-57.92207,2018-08-13 11:00:00,NA,NA,NA
"31676",10602,"Corner Brook","NL",48.95224,-57.92207,2018-08-13 12:00:00,NA,NA,NA
"31677",10602,"Corner Brook","NL",48.95224,-57.92207,2018-08-13 13:00:00,NA,NA,NA
"31678",10602,"Corner Brook","NL",48.95224,-57.92207,2018-08-13 14:00:00,NA,NA,NA
"31679",10602,"Corner Brook","NL",48.95224,-57.92207,2018-08-13 15:00:00,NA,NA,NA
"31680",10602,"Corner Brook","NL",48.95224,-57.92207,2018-08-13 16:00:00,21,1,22
"31681",10602,"Corner Brook","NL",48.95224,-57.92207,2018-08-13 17:00:00,23,1,24
"31682",10602,"Corner Brook","NL",48.95224,-57.92207,2018-08-13 18:00:00,25,1,26
"31683",10602,"Corner Brook","NL",48.95224,-57.92207,2018-08-13 19:00:00,27,1,28
"31684",10602,"Corner Brook","NL",48.95224,-57.92207,2018-08-13 20:00:00,25,3,28
"31685",10602,"Corner Brook","NL",48.95224,-57.92207,2018-08-13 21:00:00,23,2,25
"31686",10602,"Corner Brook","NL",48.95224,-57.92207,2018-08-13 22:00:00,NA,NA,NA
"31687",10602,"Corner Brook","NL",48.95224,-57.92207,2018-08-13 23:00:00,22,1,23
"31688",10602,"Corner Brook","NL",48.95224,-57.92207,2018-08-14 00:00:00,22,1,23
"31689",10602,"Corner Brook","NL",48.95224,-57.92207,2018-08-14 01:00:00,21,1,22
"31690",10602,"Corner Brook","NL",48.95224,-57.92207,2018-08-14 02:00:00,20,1,21
"31691",10602,"Corner Brook","NL",48.95224,-57.92207,2018-08-14 03:00:00,19,1,20
"31692",10602,"Corner Brook","NL",48.95224,-57.92207,2018-08-14 04:00:00,20,1,21
"31693",10602,"Corner Brook","NL",48.95224,-57.92207,2018-08-14 05:00:00,20,1,21
"31694",10602,"Corner Brook","NL",48.95224,-57.92207,2018-08-14 06:00:00,20,2,22
"31695",10602,"Corner Brook","NL",48.95224,-57.92207,2018-08-14 07:00:00,20,2,22
"31696",10602,"Corner Brook","NL",48.95224,-57.92207,2018-08-14 08:00:00,19,2,21
"31697",10602,"Corner Brook","NL",48.95224,-57.92207,2018-08-14 09:00:00,18,3,21
"31698",10602,"Corner Brook","NL",48.95224,-57.92207,2018-08-14 10:00:00,18,1,19
"31699",10602,"Corner Brook","NL",48.95224,-57.92207,2018-08-14 11:00:00,19,1,20
"31700",10602,"Corner Brook","NL",48.95224,-57.92207,2018-08-14 12:00:00,21,1,22
"31701",10602,"Corner Brook","NL",48.95224,-57.92207,2018-08-14 13:00:00,19,NA,NA
"31702",10602,"Corner Brook","NL",48.95224,-57.92207,2018-08-14 14:00:00,18,18,36
"31703",10602,"Corner Brook","NL",48.95224,-57.92207,2018-08-14 15:00:00,20,19,39
"31704",10602,"Corner Brook","NL",48.95224,-57.92207,2018-08-14 16:00:00,26,2,28
"31705",10602,"Corner Brook","NL",48.95224,-57.92207,2018-08-14 17:00:00,27,1,28
"31706",10602,"Corner Brook","NL",48.95224,-57.92207,2018-08-14 18:00:00,25,1,26
"31707",10602,"Corner Brook","NL",48.95224,-57.92207,2018-08-14 19:00:00,26,1,27
"31708",10602,"Corner Brook","NL",48.95224,-57.92207,2018-08-14 20:00:00,29,1,30
"31709",10602,"Corner Brook","NL",48.95224,-57.92207,2018-08-14 21:00:00,25,1,26
"31710",10602,"Corner Brook","NL",48.95224,-57.92207,2018-08-14 22:00:00,24,2,26
"31711",10602,"Corner Brook","NL",48.95224,-57.92207,2018-08-14 23:00:00,20,3,23
"31712",10602,"Corner Brook","NL",48.95224,-57.92207,2018-08-15 00:00:00,18,3,21
"31713",10602,"Corner Brook","NL",48.95224,-57.92207,2018-08-15 01:00:00,19,2,21
"31714",10602,"Corner Brook","NL",48.95224,-57.92207,2018-08-15 02:00:00,15,3,18
"31715",10602,"Corner Brook","NL",48.95224,-57.92207,2018-08-15 03:00:00,18,1,19
"31716",10602,"Corner Brook","NL",48.95224,-57.92207,2018-08-15 04:00:00,16,2,18
"31717",10602,"Corner Brook","NL",48.95224,-57.92207,2018-08-15 05:00:00,15,3,18
"31718",10602,"Corner Brook","NL",48.95224,-57.92207,2018-08-15 06:00:00,22,1,23
"31719",10602,"Corner Brook","NL",48.95224,-57.92207,2018-08-15 07:00:00,24,1,25
"31720",10602,"Corner Brook","NL",48.95224,-57.92207,2018-08-15 08:00:00,24,1,25
"31721",10602,"Corner Brook","NL",48.95224,-57.92207,2018-08-15 09:00:00,23,1,24
"31722",10602,"Corner Brook","NL",48.95224,-57.92207,2018-08-15 10:00:00,22,1,23
"31723",10602,"Corner Brook","NL",48.95224,-57.92207,2018-08-15 11:00:00,20,2,22
"31724",10602,"Corner Brook","NL",48.95224,-57.92207,2018-08-15 12:00:00,20,1,21
"31725",10602,"Corner Brook","NL",48.95224,-57.92207,2018-08-15 13:00:00,19,1,20
"31726",10602,"Corner Brook","NL",48.95224,-57.92207,2018-08-15 14:00:00,20,2,22
"31727",10602,"Corner Brook","NL",48.95224,-57.92207,2018-08-15 15:00:00,23,2,25
"31728",10602,"Corner Brook","NL",48.95224,-57.92207,2018-08-15 16:00:00,24,2,26
"31729",10602,"Corner Brook","NL",48.95224,-57.92207,2018-08-15 17:00:00,25,2,27
"31730",10602,"Corner Brook","NL",48.95224,-57.92207,2018-08-15 18:00:00,28,2,30
"31731",10602,"Corner Brook","NL",48.95224,-57.92207,2018-08-15 19:00:00,27,2,29
"31732",10602,"Corner Brook","NL",48.95224,-57.92207,2018-08-15 20:00:00,24,3,27
"31733",10602,"Corner Brook","NL",48.95224,-57.92207,2018-08-15 21:00:00,25,2,27
"31734",10602,"Corner Brook","NL",48.95224,-57.92207,2018-08-15 22:00:00,26,2,28
"31735",10602,"Corner Brook","NL",48.95224,-57.92207,2018-08-15 23:00:00,23,1,24
"31736",10602,"Corner Brook","NL",48.95224,-57.92207,2018-08-16 00:00:00,22,1,23
"31737",10602,"Corner Brook","NL",48.95224,-57.92207,2018-08-16 01:00:00,20,2,22
"31738",10602,"Corner Brook","NL",48.95224,-57.92207,2018-08-16 02:00:00,17,2,19
"31739",10602,"Corner Brook","NL",48.95224,-57.92207,2018-08-16 03:00:00,15,2,17
"31740",10602,"Corner Brook","NL",48.95224,-57.92207,2018-08-16 04:00:00,12,2,14
"31741",10602,"Corner Brook","NL",48.95224,-57.92207,2018-08-16 05:00:00,18,1,19
"31742",10602,"Corner Brook","NL",48.95224,-57.92207,2018-08-16 06:00:00,22,1,23
"31743",10602,"Corner Brook","NL",48.95224,-57.92207,2018-08-16 07:00:00,21,2,23
"31744",10602,"Corner Brook","NL",48.95224,-57.92207,2018-08-16 08:00:00,18,2,20
"31745",10602,"Corner Brook","NL",48.95224,-57.92207,2018-08-16 09:00:00,18,NA,NA
"31746",10602,"Corner Brook","NL",48.95224,-57.92207,2018-08-16 10:00:00,17,NA,NA
"31747",10602,"Corner Brook","NL",48.95224,-57.92207,2018-08-16 11:00:00,17,NA,NA
"31748",10602,"Corner Brook","NL",48.95224,-57.92207,2018-08-16 12:00:00,17,NA,NA
"31749",10602,"Corner Brook","NL",48.95224,-57.92207,2018-08-16 13:00:00,17,NA,NA
"31750",10602,"Corner Brook","NL",48.95224,-57.92207,2018-08-16 14:00:00,18,NA,NA
"31751",10602,"Corner Brook","NL",48.95224,-57.92207,2018-08-16 15:00:00,18,NA,NA
"31752",10602,"Corner Brook","NL",48.95224,-57.92207,2018-08-16 16:00:00,19,NA,NA
"31753",10602,"Corner Brook","NL",48.95224,-57.92207,2018-08-16 17:00:00,20,NA,NA
"31754",10602,"Corner Brook","NL",48.95224,-57.92207,2018-08-16 18:00:00,20,NA,NA
"31755",10602,"Corner Brook","NL",48.95224,-57.92207,2018-08-16 19:00:00,19,NA,NA
"31756",10602,"Corner Brook","NL",48.95224,-57.92207,2018-08-16 20:00:00,18,NA,NA
"31757",10602,"Corner Brook","NL",48.95224,-57.92207,2018-08-16 21:00:00,18,NA,NA
"31758",10602,"Corner Brook","NL",48.95224,-57.92207,2018-08-16 22:00:00,18,NA,NA
"31759",10602,"Corner Brook","NL",48.95224,-57.92207,2018-08-16 23:00:00,17,NA,NA
"31760",10602,"Corner Brook","NL",48.95224,-57.92207,2018-08-17 00:00:00,17,NA,NA
"31761",10602,"Corner Brook","NL",48.95224,-57.92207,2018-08-17 01:00:00,17,NA,NA
"31762",10602,"Corner Brook","NL",48.95224,-57.92207,2018-08-17 02:00:00,18,NA,NA
"31763",10602,"Corner Brook","NL",48.95224,-57.92207,2018-08-17 03:00:00,18,NA,NA
"31764",10602,"Corner Brook","NL",48.95224,-57.92207,2018-08-17 04:00:00,18,NA,NA
"31765",10602,"Corner Brook","NL",48.95224,-57.92207,2018-08-17 05:00:00,18,NA,NA
"31766",10602,"Corner Brook","NL",48.95224,-57.92207,2018-08-17 06:00:00,18,NA,NA
"31767",10602,"Corner Brook","NL",48.95224,-57.92207,2018-08-17 07:00:00,16,NA,NA
"31768",10602,"Corner Brook","NL",48.95224,-57.92207,2018-08-17 08:00:00,15,NA,NA
"31769",10602,"Corner Brook","NL",48.95224,-57.92207,2018-08-17 09:00:00,15,NA,NA
"31770",10602,"Corner Brook","NL",48.95224,-57.92207,2018-08-17 10:00:00,14,NA,NA
"31771",10602,"Corner Brook","NL",48.95224,-57.92207,2018-08-17 11:00:00,14,NA,NA
"31772",10602,"Corner Brook","NL",48.95224,-57.92207,2018-08-17 12:00:00,14,NA,NA
"31773",10602,"Corner Brook","NL",48.95224,-57.92207,2018-08-17 13:00:00,14,NA,NA
"31774",10602,"Corner Brook","NL",48.95224,-57.92207,2018-08-17 14:00:00,17,NA,NA
"31775",10602,"Corner Brook","NL",48.95224,-57.92207,2018-08-17 15:00:00,19,NA,NA
"31776",10602,"Corner Brook","NL",48.95224,-57.92207,2018-08-17 16:00:00,19,NA,NA
"31777",10602,"Corner Brook","NL",48.95224,-57.92207,2018-08-17 17:00:00,15,NA,NA
"31778",10602,"Corner Brook","NL",48.95224,-57.92207,2018-08-17 18:00:00,9,NA,NA
"31779",10602,"Corner Brook","NL",48.95224,-57.92207,2018-08-17 19:00:00,10,NA,NA
"31780",10602,"Corner Brook","NL",48.95224,-57.92207,2018-08-17 20:00:00,14,NA,NA
"31781",10602,"Corner Brook","NL",48.95224,-57.92207,2018-08-17 21:00:00,11,NA,NA
"31782",10602,"Corner Brook","NL",48.95224,-57.92207,2018-08-17 22:00:00,11,NA,NA
"31783",10602,"Corner Brook","NL",48.95224,-57.92207,2018-08-17 23:00:00,10,NA,NA
"31784",10602,"Corner Brook","NL",48.95224,-57.92207,2018-08-18 00:00:00,11,NA,NA
"31785",10602,"Corner Brook","NL",48.95224,-57.92207,2018-08-18 01:00:00,11,NA,NA
"31786",10602,"Corner Brook","NL",48.95224,-57.92207,2018-08-18 02:00:00,11,NA,NA
"31787",10602,"Corner Brook","NL",48.95224,-57.92207,2018-08-18 03:00:00,14,NA,NA
"31788",10602,"Corner Brook","NL",48.95224,-57.92207,2018-08-18 04:00:00,13,NA,NA
"31789",10602,"Corner Brook","NL",48.95224,-57.92207,2018-08-18 05:00:00,13,NA,NA
"31790",10602,"Corner Brook","NL",48.95224,-57.92207,2018-08-18 06:00:00,11,NA,NA
"31791",10602,"Corner Brook","NL",48.95224,-57.92207,2018-08-18 07:00:00,13,NA,NA
"31792",10602,"Corner Brook","NL",48.95224,-57.92207,2018-08-18 08:00:00,11,NA,NA
"31793",10602,"Corner Brook","NL",48.95224,-57.92207,2018-08-18 09:00:00,7,NA,NA
"31794",10602,"Corner Brook","NL",48.95224,-57.92207,2018-08-18 10:00:00,9,NA,NA
"31795",10602,"Corner Brook","NL",48.95224,-57.92207,2018-08-18 11:00:00,12,NA,NA
"31796",10602,"Corner Brook","NL",48.95224,-57.92207,2018-08-18 12:00:00,14,NA,NA
"31797",10602,"Corner Brook","NL",48.95224,-57.92207,2018-08-18 13:00:00,16,NA,NA
"31798",10602,"Corner Brook","NL",48.95224,-57.92207,2018-08-18 14:00:00,17,NA,NA
"31799",10602,"Corner Brook","NL",48.95224,-57.92207,2018-08-18 15:00:00,15,NA,NA
"31800",10602,"Corner Brook","NL",48.95224,-57.92207,2018-08-18 16:00:00,14,NA,NA
"31801",10602,"Corner Brook","NL",48.95224,-57.92207,2018-08-18 17:00:00,15,NA,NA
"31802",10602,"Corner Brook","NL",48.95224,-57.92207,2018-08-18 18:00:00,13,NA,NA
"31803",10602,"Corner Brook","NL",48.95224,-57.92207,2018-08-18 19:00:00,13,NA,NA
"31804",10602,"Corner Brook","NL",48.95224,-57.92207,2018-08-18 20:00:00,12,NA,NA
"31805",10602,"Corner Brook","NL",48.95224,-57.92207,2018-08-18 21:00:00,8,NA,NA
"31806",10602,"Corner Brook","NL",48.95224,-57.92207,2018-08-18 22:00:00,8,NA,NA
"31807",10602,"Corner Brook","NL",48.95224,-57.92207,2018-08-18 23:00:00,7,NA,NA
"31808",10602,"Corner Brook","NL",48.95224,-57.92207,2018-08-19 00:00:00,5,NA,NA
"31809",10602,"Corner Brook","NL",48.95224,-57.92207,2018-08-19 01:00:00,4,NA,NA
"31810",10602,"Corner Brook","NL",48.95224,-57.92207,2018-08-19 02:00:00,4,NA,NA
"31811",10602,"Corner Brook","NL",48.95224,-57.92207,2018-08-19 03:00:00,4,NA,NA
"31812",10602,"Corner Brook","NL",48.95224,-57.92207,2018-08-19 04:00:00,3,NA,NA
"31813",10602,"Corner Brook","NL",48.95224,-57.92207,2018-08-19 05:00:00,3,NA,NA
"31814",10602,"Corner Brook","NL",48.95224,-57.92207,2018-08-19 06:00:00,1,NA,NA
"31815",10602,"Corner Brook","NL",48.95224,-57.92207,2018-08-19 07:00:00,2,NA,NA
"31816",10602,"Corner Brook","NL",48.95224,-57.92207,2018-08-19 08:00:00,4,NA,NA
"31817",10602,"Corner Brook","NL",48.95224,-57.92207,2018-08-19 09:00:00,10,NA,NA
"31818",10602,"Corner Brook","NL",48.95224,-57.92207,2018-08-19 10:00:00,12,NA,NA
"31819",10602,"Corner Brook","NL",48.95224,-57.92207,2018-08-19 11:00:00,13,NA,NA
"31820",10602,"Corner Brook","NL",48.95224,-57.92207,2018-08-19 12:00:00,15,NA,NA
"31821",10602,"Corner Brook","NL",48.95224,-57.92207,2018-08-19 13:00:00,16,NA,NA
"31822",10602,"Corner Brook","NL",48.95224,-57.92207,2018-08-19 14:00:00,20,NA,NA
"31823",10602,"Corner Brook","NL",48.95224,-57.92207,2018-08-19 15:00:00,19,NA,NA
"31824",10602,"Corner Brook","NL",48.95224,-57.92207,2018-08-19 16:00:00,18,NA,NA
"31825",10602,"Corner Brook","NL",48.95224,-57.92207,2018-08-19 17:00:00,15,NA,NA
"31826",10602,"Corner Brook","NL",48.95224,-57.92207,2018-08-19 18:00:00,13,NA,NA
"31827",10602,"Corner Brook","NL",48.95224,-57.92207,2018-08-19 19:00:00,16,NA,NA
"31828",10602,"Corner Brook","NL",48.95224,-57.92207,2018-08-19 20:00:00,16,NA,NA
"31829",10602,"Corner Brook","NL",48.95224,-57.92207,2018-08-19 21:00:00,14,NA,NA
"31830",10602,"Corner Brook","NL",48.95224,-57.92207,2018-08-19 22:00:00,10,NA,NA
"31831",10602,"Corner Brook","NL",48.95224,-57.92207,2018-08-19 23:00:00,9,NA,NA
"31832",10602,"Corner Brook","NL",48.95224,-57.92207,2018-08-20 00:00:00,8,NA,NA
"31833",10602,"Corner Brook","NL",48.95224,-57.92207,2018-08-20 01:00:00,9,NA,NA
"31834",10602,"Corner Brook","NL",48.95224,-57.92207,2018-08-20 02:00:00,8,NA,NA
"31835",10602,"Corner Brook","NL",48.95224,-57.92207,2018-08-20 03:00:00,7,NA,NA
"31836",10602,"Corner Brook","NL",48.95224,-57.92207,2018-08-20 04:00:00,7,NA,NA
"31837",10602,"Corner Brook","NL",48.95224,-57.92207,2018-08-20 05:00:00,8,NA,NA
"31838",10602,"Corner Brook","NL",48.95224,-57.92207,2018-08-20 06:00:00,7,NA,NA
"31839",10602,"Corner Brook","NL",48.95224,-57.92207,2018-08-20 07:00:00,6,NA,NA
"31840",10602,"Corner Brook","NL",48.95224,-57.92207,2018-08-20 08:00:00,6,NA,NA
"31841",10602,"Corner Brook","NL",48.95224,-57.92207,2018-08-20 09:00:00,7,NA,NA
"31842",10602,"Corner Brook","NL",48.95224,-57.92207,2018-08-20 10:00:00,9,NA,NA
"31843",10602,"Corner Brook","NL",48.95224,-57.92207,2018-08-20 11:00:00,17,NA,NA
"31844",10602,"Corner Brook","NL",48.95224,-57.92207,2018-08-20 12:00:00,21,1,22
"31845",10602,"Corner Brook","NL",48.95224,-57.92207,2018-08-20 13:00:00,20,2,22
"31846",10602,"Corner Brook","NL",48.95224,-57.92207,2018-08-20 14:00:00,14,7,21
"31847",10602,"Corner Brook","NL",48.95224,-57.92207,2018-08-20 15:00:00,15,5,20
"31848",10602,"Corner Brook","NL",48.95224,-57.92207,2018-08-20 16:00:00,17,3,20
"31849",10602,"Corner Brook","NL",48.95224,-57.92207,2018-08-20 17:00:00,18,1,19
"31850",10602,"Corner Brook","NL",48.95224,-57.92207,2018-08-20 18:00:00,18,1,19
"31851",10602,"Corner Brook","NL",48.95224,-57.92207,2018-08-20 19:00:00,17,3,20
"31852",10602,"Corner Brook","NL",48.95224,-57.92207,2018-08-20 20:00:00,17,2,19
"31853",10602,"Corner Brook","NL",48.95224,-57.92207,2018-08-20 21:00:00,13,4,17
"31854",10602,"Corner Brook","NL",48.95224,-57.92207,2018-08-20 22:00:00,15,3,18
"31855",10602,"Corner Brook","NL",48.95224,-57.92207,2018-08-20 23:00:00,15,2,17
"31856",10602,"Corner Brook","NL",48.95224,-57.92207,2018-08-21 00:00:00,15,2,17
"31857",10602,"Corner Brook","NL",48.95224,-57.92207,2018-08-21 01:00:00,17,2,19
"31858",10602,"Corner Brook","NL",48.95224,-57.92207,2018-08-21 02:00:00,18,2,20
"31859",10602,"Corner Brook","NL",48.95224,-57.92207,2018-08-21 03:00:00,16,1,17
"31860",10602,"Corner Brook","NL",48.95224,-57.92207,2018-08-21 04:00:00,15,1,16
"31861",10602,"Corner Brook","NL",48.95224,-57.92207,2018-08-21 05:00:00,14,2,16
"31862",10602,"Corner Brook","NL",48.95224,-57.92207,2018-08-21 06:00:00,12,2,14
"31863",10602,"Corner Brook","NL",48.95224,-57.92207,2018-08-21 07:00:00,12,3,15
"31864",10602,"Corner Brook","NL",48.95224,-57.92207,2018-08-21 08:00:00,10,4,14
"31865",10602,"Corner Brook","NL",48.95224,-57.92207,2018-08-21 09:00:00,12,4,16
"31866",10602,"Corner Brook","NL",48.95224,-57.92207,2018-08-21 10:00:00,13,6,19
"31867",10602,"Corner Brook","NL",48.95224,-57.92207,2018-08-21 11:00:00,19,3,22
"31868",10602,"Corner Brook","NL",48.95224,-57.92207,2018-08-21 12:00:00,23,3,26
"31869",10602,"Corner Brook","NL",48.95224,-57.92207,2018-08-21 13:00:00,23,2,25
"31870",10602,"Corner Brook","NL",48.95224,-57.92207,2018-08-21 14:00:00,25,2,27
"31871",10602,"Corner Brook","NL",48.95224,-57.92207,2018-08-21 15:00:00,18,5,23
"31872",10602,"Corner Brook","NL",48.95224,-57.92207,2018-08-21 16:00:00,16,9,25
"31873",10602,"Corner Brook","NL",48.95224,-57.92207,2018-08-21 17:00:00,15,10,25
"31874",10602,"Corner Brook","NL",48.95224,-57.92207,2018-08-21 18:00:00,13,12,25
"31875",10602,"Corner Brook","NL",48.95224,-57.92207,2018-08-21 19:00:00,15,10,25
"31876",10602,"Corner Brook","NL",48.95224,-57.92207,2018-08-21 20:00:00,15,9,24
"31877",10602,"Corner Brook","NL",48.95224,-57.92207,2018-08-21 21:00:00,17,4,21
"31878",10602,"Corner Brook","NL",48.95224,-57.92207,2018-08-21 22:00:00,15,5,20
"31879",10602,"Corner Brook","NL",48.95224,-57.92207,2018-08-21 23:00:00,13,5,18
"31880",10602,"Corner Brook","NL",48.95224,-57.92207,2018-08-22 00:00:00,8,6,14
"31881",10602,"Corner Brook","NL",48.95224,-57.92207,2018-08-22 01:00:00,6,6,12
"31882",10602,"Corner Brook","NL",48.95224,-57.92207,2018-08-22 02:00:00,5,5,10
"31883",10602,"Corner Brook","NL",48.95224,-57.92207,2018-08-22 03:00:00,4,4,8
"31884",10602,"Corner Brook","NL",48.95224,-57.92207,2018-08-22 04:00:00,3,5,8
"31885",10602,"Corner Brook","NL",48.95224,-57.92207,2018-08-22 05:00:00,3,4,7
"31886",10602,"Corner Brook","NL",48.95224,-57.92207,2018-08-22 06:00:00,3,4,7
"31887",10602,"Corner Brook","NL",48.95224,-57.92207,2018-08-22 07:00:00,5,4,9
"31888",10602,"Corner Brook","NL",48.95224,-57.92207,2018-08-22 08:00:00,6,4,10
"31889",10602,"Corner Brook","NL",48.95224,-57.92207,2018-08-22 09:00:00,10,4,14
"31890",10602,"Corner Brook","NL",48.95224,-57.92207,2018-08-22 10:00:00,10,4,14
"31891",10602,"Corner Brook","NL",48.95224,-57.92207,2018-08-22 11:00:00,10,4,14
"31892",10602,"Corner Brook","NL",48.95224,-57.92207,2018-08-22 12:00:00,10,3,13
"31893",10602,"Corner Brook","NL",48.95224,-57.92207,2018-08-22 13:00:00,12,3,15
"31894",10602,"Corner Brook","NL",48.95224,-57.92207,2018-08-22 14:00:00,16,3,19
"31895",10602,"Corner Brook","NL",48.95224,-57.92207,2018-08-22 15:00:00,17,3,20
"31896",10602,"Corner Brook","NL",48.95224,-57.92207,2018-08-22 16:00:00,21,3,24
"31897",10602,"Corner Brook","NL",48.95224,-57.92207,2018-08-22 17:00:00,22,3,25
"31898",10602,"Corner Brook","NL",48.95224,-57.92207,2018-08-22 18:00:00,20,8,28
"31899",10602,"Corner Brook","NL",48.95224,-57.92207,2018-08-22 19:00:00,23,5,28
"31900",10602,"Corner Brook","NL",48.95224,-57.92207,2018-08-22 20:00:00,21,3,24
"31901",10602,"Corner Brook","NL",48.95224,-57.92207,2018-08-22 21:00:00,16,5,21
"31902",10602,"Corner Brook","NL",48.95224,-57.92207,2018-08-22 22:00:00,12,5,17
"31903",10602,"Corner Brook","NL",48.95224,-57.92207,2018-08-22 23:00:00,9,8,17
"31904",10602,"Corner Brook","NL",48.95224,-57.92207,2018-08-23 00:00:00,19,3,22
"31905",10602,"Corner Brook","NL",48.95224,-57.92207,2018-08-23 01:00:00,18,2,20
"31906",10602,"Corner Brook","NL",48.95224,-57.92207,2018-08-23 02:00:00,22,2,24
"31907",10602,"Corner Brook","NL",48.95224,-57.92207,2018-08-23 03:00:00,18,2,20
"31908",10602,"Corner Brook","NL",48.95224,-57.92207,2018-08-23 04:00:00,15,3,18
"31909",10602,"Corner Brook","NL",48.95224,-57.92207,2018-08-23 05:00:00,14,2,16
"31910",10602,"Corner Brook","NL",48.95224,-57.92207,2018-08-23 06:00:00,16,3,19
"31911",10602,"Corner Brook","NL",48.95224,-57.92207,2018-08-23 07:00:00,22,1,23
"31912",10602,"Corner Brook","NL",48.95224,-57.92207,2018-08-23 08:00:00,25,1,26
"31913",10602,"Corner Brook","NL",48.95224,-57.92207,2018-08-23 09:00:00,27,1,28
"31914",10602,"Corner Brook","NL",48.95224,-57.92207,2018-08-23 10:00:00,28,1,29
"31915",10602,"Corner Brook","NL",48.95224,-57.92207,2018-08-23 11:00:00,29,1,30
"31916",10602,"Corner Brook","NL",48.95224,-57.92207,2018-08-23 12:00:00,27,2,29
"31917",10602,"Corner Brook","NL",48.95224,-57.92207,2018-08-23 13:00:00,27,2,29
"31918",10602,"Corner Brook","NL",48.95224,-57.92207,2018-08-23 14:00:00,29,1,30
"31919",10602,"Corner Brook","NL",48.95224,-57.92207,2018-08-23 15:00:00,27,10,37
"31920",10602,"Corner Brook","NL",48.95224,-57.92207,2018-08-23 16:00:00,27,3,30
"31921",10602,"Corner Brook","NL",48.95224,-57.92207,2018-08-23 17:00:00,25,1,26
"31922",10602,"Corner Brook","NL",48.95224,-57.92207,2018-08-23 18:00:00,25,1,26
"31923",10602,"Corner Brook","NL",48.95224,-57.92207,2018-08-23 19:00:00,26,1,27
"31924",10602,"Corner Brook","NL",48.95224,-57.92207,2018-08-23 20:00:00,26,2,28
"31925",10602,"Corner Brook","NL",48.95224,-57.92207,2018-08-23 21:00:00,26,1,27
"31926",10602,"Corner Brook","NL",48.95224,-57.92207,2018-08-23 22:00:00,26,1,27
"31927",10602,"Corner Brook","NL",48.95224,-57.92207,2018-08-23 23:00:00,26,1,27
"31928",10602,"Corner Brook","NL",48.95224,-57.92207,2018-08-24 00:00:00,24,1,25
"31929",10602,"Corner Brook","NL",48.95224,-57.92207,2018-08-24 01:00:00,23,1,24
"31930",10602,"Corner Brook","NL",48.95224,-57.92207,2018-08-24 02:00:00,23,1,24
"31931",10602,"Corner Brook","NL",48.95224,-57.92207,2018-08-24 03:00:00,23,1,24
"31932",10602,"Corner Brook","NL",48.95224,-57.92207,2018-08-24 04:00:00,23,1,24
"31933",10602,"Corner Brook","NL",48.95224,-57.92207,2018-08-24 05:00:00,23,1,24
"31934",10602,"Corner Brook","NL",48.95224,-57.92207,2018-08-24 06:00:00,22,1,23
"31935",10602,"Corner Brook","NL",48.95224,-57.92207,2018-08-24 07:00:00,22,1,23
"31936",10602,"Corner Brook","NL",48.95224,-57.92207,2018-08-24 08:00:00,23,1,24
"31937",10602,"Corner Brook","NL",48.95224,-57.92207,2018-08-24 09:00:00,23,2,25
"31938",10602,"Corner Brook","NL",48.95224,-57.92207,2018-08-24 10:00:00,24,2,26
"31939",10602,"Corner Brook","NL",48.95224,-57.92207,2018-08-24 11:00:00,25,2,27
"31940",10602,"Corner Brook","NL",48.95224,-57.92207,2018-08-24 12:00:00,25,2,27
"31941",10602,"Corner Brook","NL",48.95224,-57.92207,2018-08-24 13:00:00,25,1,26
"31942",10602,"Corner Brook","NL",48.95224,-57.92207,2018-08-24 14:00:00,26,1,27
"31943",10602,"Corner Brook","NL",48.95224,-57.92207,2018-08-24 15:00:00,27,1,28
"31944",10602,"Corner Brook","NL",48.95224,-57.92207,2018-08-24 16:00:00,26,2,28
"31945",10602,"Corner Brook","NL",48.95224,-57.92207,2018-08-24 17:00:00,27,1,28
"31946",10602,"Corner Brook","NL",48.95224,-57.92207,2018-08-24 18:00:00,27,1,28
"31947",10602,"Corner Brook","NL",48.95224,-57.92207,2018-08-24 19:00:00,23,2,25
"31948",10602,"Corner Brook","NL",48.95224,-57.92207,2018-08-24 20:00:00,22,2,24
"31949",10602,"Corner Brook","NL",48.95224,-57.92207,2018-08-24 21:00:00,22,1,23
"31950",10602,"Corner Brook","NL",48.95224,-57.92207,2018-08-24 22:00:00,22,1,23
"31951",10602,"Corner Brook","NL",48.95224,-57.92207,2018-08-24 23:00:00,22,1,23
"31952",10602,"Corner Brook","NL",48.95224,-57.92207,2018-08-25 00:00:00,21,1,22
"31953",10602,"Corner Brook","NL",48.95224,-57.92207,2018-08-25 01:00:00,21,1,22
"31954",10602,"Corner Brook","NL",48.95224,-57.92207,2018-08-25 02:00:00,20,1,21
"31955",10602,"Corner Brook","NL",48.95224,-57.92207,2018-08-25 03:00:00,19,1,20
"31956",10602,"Corner Brook","NL",48.95224,-57.92207,2018-08-25 04:00:00,20,1,21
"31957",10602,"Corner Brook","NL",48.95224,-57.92207,2018-08-25 05:00:00,19,1,20
"31958",10602,"Corner Brook","NL",48.95224,-57.92207,2018-08-25 06:00:00,21,1,22
"31959",10602,"Corner Brook","NL",48.95224,-57.92207,2018-08-25 07:00:00,20,1,21
"31960",10602,"Corner Brook","NL",48.95224,-57.92207,2018-08-25 08:00:00,17,1,18
"31961",10602,"Corner Brook","NL",48.95224,-57.92207,2018-08-25 09:00:00,17,1,18
"31962",10602,"Corner Brook","NL",48.95224,-57.92207,2018-08-25 10:00:00,18,2,20
"31963",10602,"Corner Brook","NL",48.95224,-57.92207,2018-08-25 11:00:00,20,2,22
"31964",10602,"Corner Brook","NL",48.95224,-57.92207,2018-08-25 12:00:00,20,1,21
"31965",10602,"Corner Brook","NL",48.95224,-57.92207,2018-08-25 13:00:00,23,1,24
"31966",10602,"Corner Brook","NL",48.95224,-57.92207,2018-08-25 14:00:00,27,1,28
"31967",10602,"Corner Brook","NL",48.95224,-57.92207,2018-08-25 15:00:00,25,1,26
"31968",10602,"Corner Brook","NL",48.95224,-57.92207,2018-08-25 16:00:00,30,2,32
"31969",10602,"Corner Brook","NL",48.95224,-57.92207,2018-08-25 17:00:00,34,2,36
"31970",10602,"Corner Brook","NL",48.95224,-57.92207,2018-08-25 18:00:00,35,1,36
"31971",10602,"Corner Brook","NL",48.95224,-57.92207,2018-08-25 19:00:00,36,2,38
"31972",10602,"Corner Brook","NL",48.95224,-57.92207,2018-08-25 20:00:00,37,2,39
"31973",10602,"Corner Brook","NL",48.95224,-57.92207,2018-08-25 21:00:00,36,2,38
"31974",10602,"Corner Brook","NL",48.95224,-57.92207,2018-08-25 22:00:00,38,2,40
"31975",10602,"Corner Brook","NL",48.95224,-57.92207,2018-08-25 23:00:00,34,2,36
"31976",10602,"Corner Brook","NL",48.95224,-57.92207,2018-08-26 00:00:00,30,1,31
"31977",10602,"Corner Brook","NL",48.95224,-57.92207,2018-08-26 01:00:00,28,1,29
"31978",10602,"Corner Brook","NL",48.95224,-57.92207,2018-08-26 02:00:00,28,1,29
"31979",10602,"Corner Brook","NL",48.95224,-57.92207,2018-08-26 03:00:00,28,1,29
"31980",10602,"Corner Brook","NL",48.95224,-57.92207,2018-08-26 04:00:00,29,1,30
"31981",10602,"Corner Brook","NL",48.95224,-57.92207,2018-08-26 05:00:00,28,1,29
"31982",10602,"Corner Brook","NL",48.95224,-57.92207,2018-08-26 06:00:00,27,2,29
"31983",10602,"Corner Brook","NL",48.95224,-57.92207,2018-08-26 07:00:00,29,1,30
"31984",10602,"Corner Brook","NL",48.95224,-57.92207,2018-08-26 08:00:00,29,1,30
"31985",10602,"Corner Brook","NL",48.95224,-57.92207,2018-08-26 09:00:00,29,1,30
"31986",10602,"Corner Brook","NL",48.95224,-57.92207,2018-08-26 10:00:00,29,2,31
"31987",10602,"Corner Brook","NL",48.95224,-57.92207,2018-08-26 11:00:00,30,1,31
"31988",10602,"Corner Brook","NL",48.95224,-57.92207,2018-08-26 12:00:00,31,1,32
"31989",10602,"Corner Brook","NL",48.95224,-57.92207,2018-08-26 13:00:00,31,1,32
"31990",10602,"Corner Brook","NL",48.95224,-57.92207,2018-08-26 14:00:00,31,1,32
"31991",10602,"Corner Brook","NL",48.95224,-57.92207,2018-08-26 15:00:00,29,1,30
"31992",10602,"Corner Brook","NL",48.95224,-57.92207,2018-08-26 16:00:00,30,1,31
"31993",10602,"Corner Brook","NL",48.95224,-57.92207,2018-08-26 17:00:00,33,1,34
"31994",10602,"Corner Brook","NL",48.95224,-57.92207,2018-08-26 18:00:00,32,2,34
"31995",10602,"Corner Brook","NL",48.95224,-57.92207,2018-08-26 19:00:00,32,2,34
"31996",10602,"Corner Brook","NL",48.95224,-57.92207,2018-08-26 20:00:00,30,2,32
"31997",10602,"Corner Brook","NL",48.95224,-57.92207,2018-08-26 21:00:00,27,2,29
"31998",10602,"Corner Brook","NL",48.95224,-57.92207,2018-08-26 22:00:00,29,2,31
"31999",10602,"Corner Brook","NL",48.95224,-57.92207,2018-08-26 23:00:00,31,1,32
"32000",10602,"Corner Brook","NL",48.95224,-57.92207,2018-08-27 00:00:00,29,1,30
"32001",10602,"Corner Brook","NL",48.95224,-57.92207,2018-08-27 01:00:00,27,1,28
"32002",10602,"Corner Brook","NL",48.95224,-57.92207,2018-08-27 02:00:00,23,1,24
"32003",10602,"Corner Brook","NL",48.95224,-57.92207,2018-08-27 03:00:00,16,3,19
"32004",10602,"Corner Brook","NL",48.95224,-57.92207,2018-08-27 04:00:00,19,3,22
"32005",10602,"Corner Brook","NL",48.95224,-57.92207,2018-08-27 05:00:00,18,2,20
"32006",10602,"Corner Brook","NL",48.95224,-57.92207,2018-08-27 06:00:00,17,4,21
"32007",10602,"Corner Brook","NL",48.95224,-57.92207,2018-08-27 07:00:00,13,7,20
"32008",10602,"Corner Brook","NL",48.95224,-57.92207,2018-08-27 08:00:00,17,8,25
"32009",10602,"Corner Brook","NL",48.95224,-57.92207,2018-08-27 09:00:00,14,5,19
"32010",10602,"Corner Brook","NL",48.95224,-57.92207,2018-08-27 10:00:00,18,4,22
"32011",10602,"Corner Brook","NL",48.95224,-57.92207,2018-08-27 11:00:00,24,2,26
"32012",10602,"Corner Brook","NL",48.95224,-57.92207,2018-08-27 12:00:00,27,4,31
"32013",10602,"Corner Brook","NL",48.95224,-57.92207,2018-08-27 13:00:00,32,2,34
"32014",10602,"Corner Brook","NL",48.95224,-57.92207,2018-08-27 14:00:00,31,2,33
"32015",10602,"Corner Brook","NL",48.95224,-57.92207,2018-08-27 15:00:00,19,12,31
"32016",10602,"Corner Brook","NL",48.95224,-57.92207,2018-08-27 16:00:00,24,8,32
"32017",10602,"Corner Brook","NL",48.95224,-57.92207,2018-08-27 17:00:00,27,4,31
"32018",10602,"Corner Brook","NL",48.95224,-57.92207,2018-08-27 18:00:00,27,3,30
"32019",10602,"Corner Brook","NL",48.95224,-57.92207,2018-08-27 19:00:00,25,6,31
"32020",10602,"Corner Brook","NL",48.95224,-57.92207,2018-08-27 20:00:00,27,4,31
"32021",10602,"Corner Brook","NL",48.95224,-57.92207,2018-08-27 21:00:00,27,2,29
"32022",10602,"Corner Brook","NL",48.95224,-57.92207,2018-08-27 22:00:00,28,2,30
"32023",10602,"Corner Brook","NL",48.95224,-57.92207,2018-08-27 23:00:00,31,2,33
"32024",10602,"Corner Brook","NL",48.95224,-57.92207,2018-08-28 00:00:00,33,1,34
"32025",10602,"Corner Brook","NL",48.95224,-57.92207,2018-08-28 01:00:00,33,2,35
"32026",10602,"Corner Brook","NL",48.95224,-57.92207,2018-08-28 02:00:00,32,2,34
"32027",10602,"Corner Brook","NL",48.95224,-57.92207,2018-08-28 03:00:00,31,2,33
"32028",10602,"Corner Brook","NL",48.95224,-57.92207,2018-08-28 04:00:00,27,1,28
"32029",10602,"Corner Brook","NL",48.95224,-57.92207,2018-08-28 05:00:00,25,1,26
"32030",10602,"Corner Brook","NL",48.95224,-57.92207,2018-08-28 06:00:00,22,2,24
"32031",10602,"Corner Brook","NL",48.95224,-57.92207,2018-08-28 07:00:00,22,2,24
"32032",10602,"Corner Brook","NL",48.95224,-57.92207,2018-08-28 08:00:00,23,2,25
"32033",10602,"Corner Brook","NL",48.95224,-57.92207,2018-08-28 09:00:00,23,2,25
"32034",10602,"Corner Brook","NL",48.95224,-57.92207,2018-08-28 10:00:00,24,5,29
"32035",10602,"Corner Brook","NL",48.95224,-57.92207,2018-08-28 11:00:00,30,2,32
"32036",10602,"Corner Brook","NL",48.95224,-57.92207,2018-08-28 12:00:00,30,3,33
"32037",10602,"Corner Brook","NL",48.95224,-57.92207,2018-08-28 13:00:00,30,4,34
"32038",10602,"Corner Brook","NL",48.95224,-57.92207,2018-08-28 14:00:00,30,3,33
"32039",10602,"Corner Brook","NL",48.95224,-57.92207,2018-08-28 15:00:00,30,2,32
"32040",10602,"Corner Brook","NL",48.95224,-57.92207,2018-08-28 16:00:00,30,2,32
"32041",10602,"Corner Brook","NL",48.95224,-57.92207,2018-08-28 17:00:00,31,1,32
"32042",10602,"Corner Brook","NL",48.95224,-57.92207,2018-08-28 18:00:00,32,1,33
"32043",10602,"Corner Brook","NL",48.95224,-57.92207,2018-08-28 19:00:00,33,2,35
"32044",10602,"Corner Brook","NL",48.95224,-57.92207,2018-08-28 20:00:00,33,2,35
"32045",10602,"Corner Brook","NL",48.95224,-57.92207,2018-08-28 21:00:00,32,2,34
"32046",10602,"Corner Brook","NL",48.95224,-57.92207,2018-08-28 22:00:00,32,2,34
"32047",10602,"Corner Brook","NL",48.95224,-57.92207,2018-08-28 23:00:00,35,1,36
"32048",10602,"Corner Brook","NL",48.95224,-57.92207,2018-08-29 00:00:00,35,1,36
"32049",10602,"Corner Brook","NL",48.95224,-57.92207,2018-08-29 01:00:00,33,2,35
"32050",10602,"Corner Brook","NL",48.95224,-57.92207,2018-08-29 02:00:00,33,2,35
"32051",10602,"Corner Brook","NL",48.95224,-57.92207,2018-08-29 03:00:00,33,1,34
"32052",10602,"Corner Brook","NL",48.95224,-57.92207,2018-08-29 04:00:00,32,1,33
"32053",10602,"Corner Brook","NL",48.95224,-57.92207,2018-08-29 05:00:00,33,2,35
"32054",10602,"Corner Brook","NL",48.95224,-57.92207,2018-08-29 06:00:00,31,1,32
"32055",10602,"Corner Brook","NL",48.95224,-57.92207,2018-08-29 07:00:00,30,1,31
"32056",10602,"Corner Brook","NL",48.95224,-57.92207,2018-08-29 08:00:00,32,1,33
"32057",10602,"Corner Brook","NL",48.95224,-57.92207,2018-08-29 09:00:00,30,1,31
"32058",10602,"Corner Brook","NL",48.95224,-57.92207,2018-08-29 10:00:00,29,2,31
"32059",10602,"Corner Brook","NL",48.95224,-57.92207,2018-08-29 11:00:00,27,4,31
"32060",10602,"Corner Brook","NL",48.95224,-57.92207,2018-08-29 12:00:00,33,2,35
"32061",10602,"Corner Brook","NL",48.95224,-57.92207,2018-08-29 13:00:00,23,2,25
"32062",10602,"Corner Brook","NL",48.95224,-57.92207,2018-08-29 14:00:00,17,3,20
"32063",10602,"Corner Brook","NL",48.95224,-57.92207,2018-08-29 15:00:00,20,4,24
"32064",10602,"Corner Brook","NL",48.95224,-57.92207,2018-08-29 16:00:00,21,3,24
"32065",10602,"Corner Brook","NL",48.95224,-57.92207,2018-08-29 17:00:00,18,5,23
"32066",10602,"Corner Brook","NL",48.95224,-57.92207,2018-08-29 18:00:00,18,6,24
"32067",10602,"Corner Brook","NL",48.95224,-57.92207,2018-08-29 19:00:00,19,5,24
"32068",10602,"Corner Brook","NL",48.95224,-57.92207,2018-08-29 20:00:00,17,7,24
"32069",10602,"Corner Brook","NL",48.95224,-57.92207,2018-08-29 21:00:00,14,6,20
"32070",10602,"Corner Brook","NL",48.95224,-57.92207,2018-08-29 22:00:00,10,7,17
"32071",10602,"Corner Brook","NL",48.95224,-57.92207,2018-08-29 23:00:00,13,4,17
"32072",10602,"Corner Brook","NL",48.95224,-57.92207,2018-08-30 00:00:00,12,3,15
"32073",10602,"Corner Brook","NL",48.95224,-57.92207,2018-08-30 01:00:00,10,3,13
"32074",10602,"Corner Brook","NL",48.95224,-57.92207,2018-08-30 02:00:00,10,3,13
"32075",10602,"Corner Brook","NL",48.95224,-57.92207,2018-08-30 03:00:00,11,2,13
"32076",10602,"Corner Brook","NL",48.95224,-57.92207,2018-08-30 04:00:00,10,3,13
"32077",10602,"Corner Brook","NL",48.95224,-57.92207,2018-08-30 05:00:00,14,2,16
"32078",10602,"Corner Brook","NL",48.95224,-57.92207,2018-08-30 06:00:00,13,3,16
"32079",10602,"Corner Brook","NL",48.95224,-57.92207,2018-08-30 07:00:00,11,3,14
"32080",10602,"Corner Brook","NL",48.95224,-57.92207,2018-08-30 08:00:00,9,4,13
"32081",10602,"Corner Brook","NL",48.95224,-57.92207,2018-08-30 09:00:00,8,3,11
"32082",10602,"Corner Brook","NL",48.95224,-57.92207,2018-08-30 10:00:00,11,3,14
"32083",10602,"Corner Brook","NL",48.95224,-57.92207,2018-08-30 11:00:00,11,3,14
"32084",10602,"Corner Brook","NL",48.95224,-57.92207,2018-08-30 12:00:00,11,3,14
"32085",10602,"Corner Brook","NL",48.95224,-57.92207,2018-08-30 13:00:00,10,4,14
"32086",10602,"Corner Brook","NL",48.95224,-57.92207,2018-08-30 14:00:00,11,4,15
"32087",10602,"Corner Brook","NL",48.95224,-57.92207,2018-08-30 15:00:00,11,3,14
"32088",10602,"Corner Brook","NL",48.95224,-57.92207,2018-08-30 16:00:00,9,3,12
"32089",10602,"Corner Brook","NL",48.95224,-57.92207,2018-08-30 17:00:00,8,3,11
"32090",10602,"Corner Brook","NL",48.95224,-57.92207,2018-08-30 18:00:00,9,2,11
"32091",10602,"Corner Brook","NL",48.95224,-57.92207,2018-08-30 19:00:00,8,3,11
"32092",10602,"Corner Brook","NL",48.95224,-57.92207,2018-08-30 20:00:00,8,4,12
"32093",10602,"Corner Brook","NL",48.95224,-57.92207,2018-08-30 21:00:00,13,3,16
"32094",10602,"Corner Brook","NL",48.95224,-57.92207,2018-08-30 22:00:00,15,1,16
"32095",10602,"Corner Brook","NL",48.95224,-57.92207,2018-08-30 23:00:00,14,1,15
"32096",10602,"Corner Brook","NL",48.95224,-57.92207,2018-08-31 00:00:00,14,1,15
"32097",10602,"Corner Brook","NL",48.95224,-57.92207,2018-08-31 01:00:00,15,2,17
"32098",10602,"Corner Brook","NL",48.95224,-57.92207,2018-08-31 02:00:00,12,2,14
"32099",10602,"Corner Brook","NL",48.95224,-57.92207,2018-08-31 03:00:00,14,2,16
"32100",10602,"Corner Brook","NL",48.95224,-57.92207,2018-08-31 04:00:00,17,2,19
"32101",10602,"Corner Brook","NL",48.95224,-57.92207,2018-08-31 05:00:00,16,1,17
"32102",10602,"Corner Brook","NL",48.95224,-57.92207,2018-08-31 06:00:00,16,2,18
"32103",10602,"Corner Brook","NL",48.95224,-57.92207,2018-08-31 07:00:00,16,2,18
"32104",10602,"Corner Brook","NL",48.95224,-57.92207,2018-08-31 08:00:00,14,3,17
"32105",10602,"Corner Brook","NL",48.95224,-57.92207,2018-08-31 09:00:00,14,3,17
"32106",10602,"Corner Brook","NL",48.95224,-57.92207,2018-08-31 10:00:00,16,3,19
"32107",10602,"Corner Brook","NL",48.95224,-57.92207,2018-08-31 11:00:00,16,3,19
"32108",10602,"Corner Brook","NL",48.95224,-57.92207,2018-08-31 12:00:00,17,2,19
"32109",10602,"Corner Brook","NL",48.95224,-57.92207,2018-08-31 13:00:00,16,3,19
"32110",10602,"Corner Brook","NL",48.95224,-57.92207,2018-08-31 14:00:00,17,2,19
"32111",10602,"Corner Brook","NL",48.95224,-57.92207,2018-08-31 15:00:00,18,2,20
"32112",10602,"Corner Brook","NL",48.95224,-57.92207,2018-08-31 16:00:00,15,5,20
"32113",10602,"Corner Brook","NL",48.95224,-57.92207,2018-08-31 17:00:00,14,7,21
"32114",10602,"Corner Brook","NL",48.95224,-57.92207,2018-08-31 18:00:00,16,7,23
"32115",10602,"Corner Brook","NL",48.95224,-57.92207,2018-08-31 19:00:00,14,10,24
"32116",10602,"Corner Brook","NL",48.95224,-57.92207,2018-08-31 20:00:00,19,4,23
"32117",10602,"Corner Brook","NL",48.95224,-57.92207,2018-08-31 21:00:00,12,7,19
"32118",10602,"Corner Brook","NL",48.95224,-57.92207,2018-08-31 22:00:00,10,6,16
"32119",10602,"Corner Brook","NL",48.95224,-57.92207,2018-08-31 23:00:00,9,5,14
"32120",10602,"Corner Brook","NL",48.95224,-57.92207,2018-09-01 00:00:00,8,2,10
"32121",10602,"Corner Brook","NL",48.95224,-57.92207,2018-09-01 01:00:00,6,3,9
"32122",10602,"Corner Brook","NL",48.95224,-57.92207,2018-09-01 02:00:00,4,2,6
"32123",10602,"Corner Brook","NL",48.95224,-57.92207,2018-09-01 03:00:00,3,3,6
"32124",10602,"Corner Brook","NL",48.95224,-57.92207,2018-09-01 04:00:00,3,3,6
"32125",10602,"Corner Brook","NL",48.95224,-57.92207,2018-09-01 05:00:00,3,3,6
"32126",10602,"Corner Brook","NL",48.95224,-57.92207,2018-09-01 06:00:00,6,2,8
"32127",10602,"Corner Brook","NL",48.95224,-57.92207,2018-09-01 07:00:00,4,3,7
"32128",10602,"Corner Brook","NL",48.95224,-57.92207,2018-09-01 08:00:00,7,4,11
"32129",10602,"Corner Brook","NL",48.95224,-57.92207,2018-09-01 09:00:00,12,2,14
"32130",10602,"Corner Brook","NL",48.95224,-57.92207,2018-09-01 10:00:00,17,2,19
"32131",10602,"Corner Brook","NL",48.95224,-57.92207,2018-09-01 11:00:00,20,1,21
"32132",10602,"Corner Brook","NL",48.95224,-57.92207,2018-09-01 12:00:00,22,1,23
"32133",10602,"Corner Brook","NL",48.95224,-57.92207,2018-09-01 13:00:00,23,1,24
"32134",10602,"Corner Brook","NL",48.95224,-57.92207,2018-09-01 14:00:00,24,1,25
"32135",10602,"Corner Brook","NL",48.95224,-57.92207,2018-09-01 15:00:00,24,1,25
"32136",10602,"Corner Brook","NL",48.95224,-57.92207,2018-09-01 16:00:00,23,1,24
"32137",10602,"Corner Brook","NL",48.95224,-57.92207,2018-09-01 17:00:00,24,1,25
"32138",10602,"Corner Brook","NL",48.95224,-57.92207,2018-09-01 18:00:00,24,1,25
"32139",10602,"Corner Brook","NL",48.95224,-57.92207,2018-09-01 19:00:00,23,1,24
"32140",10602,"Corner Brook","NL",48.95224,-57.92207,2018-09-01 20:00:00,21,1,22
"32141",10602,"Corner Brook","NL",48.95224,-57.92207,2018-09-01 21:00:00,21,2,23
"32142",10602,"Corner Brook","NL",48.95224,-57.92207,2018-09-01 22:00:00,19,2,21
"32143",10602,"Corner Brook","NL",48.95224,-57.92207,2018-09-01 23:00:00,19,2,21
"32144",10602,"Corner Brook","NL",48.95224,-57.92207,2018-09-02 00:00:00,18,1,19
"32145",10602,"Corner Brook","NL",48.95224,-57.92207,2018-09-02 01:00:00,19,2,21
"32146",10602,"Corner Brook","NL",48.95224,-57.92207,2018-09-02 02:00:00,20,1,21
"32147",10602,"Corner Brook","NL",48.95224,-57.92207,2018-09-02 03:00:00,17,2,19
"32148",10602,"Corner Brook","NL",48.95224,-57.92207,2018-09-02 04:00:00,17,1,18
"32149",10602,"Corner Brook","NL",48.95224,-57.92207,2018-09-02 05:00:00,15,2,17
"32150",10602,"Corner Brook","NL",48.95224,-57.92207,2018-09-02 06:00:00,19,2,21
"32151",10602,"Corner Brook","NL",48.95224,-57.92207,2018-09-02 07:00:00,20,2,22
"32152",10602,"Corner Brook","NL",48.95224,-57.92207,2018-09-02 08:00:00,21,2,23
"32153",10602,"Corner Brook","NL",48.95224,-57.92207,2018-09-02 09:00:00,24,1,25
"32154",10602,"Corner Brook","NL",48.95224,-57.92207,2018-09-02 10:00:00,24,1,25
"32155",10602,"Corner Brook","NL",48.95224,-57.92207,2018-09-02 11:00:00,25,1,26
"32156",10602,"Corner Brook","NL",48.95224,-57.92207,2018-09-02 12:00:00,26,1,27
"32157",10602,"Corner Brook","NL",48.95224,-57.92207,2018-09-02 13:00:00,27,1,28
"32158",10602,"Corner Brook","NL",48.95224,-57.92207,2018-09-02 14:00:00,27,1,28
"32159",10602,"Corner Brook","NL",48.95224,-57.92207,2018-09-02 15:00:00,27,1,28
"32160",10602,"Corner Brook","NL",48.95224,-57.92207,2018-09-02 16:00:00,27,1,28
"32161",10602,"Corner Brook","NL",48.95224,-57.92207,2018-09-02 17:00:00,30,1,31
"32162",10602,"Corner Brook","NL",48.95224,-57.92207,2018-09-02 18:00:00,28,2,30
"32163",10602,"Corner Brook","NL",48.95224,-57.92207,2018-09-02 19:00:00,29,2,31
"32164",10602,"Corner Brook","NL",48.95224,-57.92207,2018-09-02 20:00:00,28,2,30
"32165",10602,"Corner Brook","NL",48.95224,-57.92207,2018-09-02 21:00:00,26,2,28
"32166",10602,"Corner Brook","NL",48.95224,-57.92207,2018-09-02 22:00:00,27,1,28
"32167",10602,"Corner Brook","NL",48.95224,-57.92207,2018-09-02 23:00:00,26,1,27
"32168",10602,"Corner Brook","NL",48.95224,-57.92207,2018-09-03 00:00:00,24,2,26
"32169",10602,"Corner Brook","NL",48.95224,-57.92207,2018-09-03 01:00:00,25,1,26
"32170",10602,"Corner Brook","NL",48.95224,-57.92207,2018-09-03 02:00:00,24,1,25
"32171",10602,"Corner Brook","NL",48.95224,-57.92207,2018-09-03 03:00:00,25,1,26
"32172",10602,"Corner Brook","NL",48.95224,-57.92207,2018-09-03 04:00:00,23,2,25
"32173",10602,"Corner Brook","NL",48.95224,-57.92207,2018-09-03 05:00:00,23,2,25
"32174",10602,"Corner Brook","NL",48.95224,-57.92207,2018-09-03 06:00:00,23,2,25
"32175",10602,"Corner Brook","NL",48.95224,-57.92207,2018-09-03 07:00:00,23,2,25
"32176",10602,"Corner Brook","NL",48.95224,-57.92207,2018-09-03 08:00:00,22,3,25
"32177",10602,"Corner Brook","NL",48.95224,-57.92207,2018-09-03 09:00:00,24,2,26
"32178",10602,"Corner Brook","NL",48.95224,-57.92207,2018-09-03 10:00:00,25,1,26
"32179",10602,"Corner Brook","NL",48.95224,-57.92207,2018-09-03 11:00:00,26,1,27
"32180",10602,"Corner Brook","NL",48.95224,-57.92207,2018-09-03 12:00:00,27,1,28
"32181",10602,"Corner Brook","NL",48.95224,-57.92207,2018-09-03 13:00:00,28,1,29
"32182",10602,"Corner Brook","NL",48.95224,-57.92207,2018-09-03 14:00:00,28,1,29
"32183",10602,"Corner Brook","NL",48.95224,-57.92207,2018-09-03 15:00:00,29,1,30
"32184",10602,"Corner Brook","NL",48.95224,-57.92207,2018-09-03 16:00:00,29,1,30
"32185",10602,"Corner Brook","NL",48.95224,-57.92207,2018-09-03 17:00:00,28,2,30
"32186",10602,"Corner Brook","NL",48.95224,-57.92207,2018-09-03 18:00:00,25,2,27
"32187",10602,"Corner Brook","NL",48.95224,-57.92207,2018-09-03 19:00:00,25,1,26
"32188",10602,"Corner Brook","NL",48.95224,-57.92207,2018-09-03 20:00:00,25,2,27
"32189",10602,"Corner Brook","NL",48.95224,-57.92207,2018-09-03 21:00:00,26,2,28
"32190",10602,"Corner Brook","NL",48.95224,-57.92207,2018-09-03 22:00:00,23,2,25
"32191",10602,"Corner Brook","NL",48.95224,-57.92207,2018-09-03 23:00:00,26,1,27
"32192",10602,"Corner Brook","NL",48.95224,-57.92207,2018-09-04 00:00:00,28,1,29
"32193",10602,"Corner Brook","NL",48.95224,-57.92207,2018-09-04 01:00:00,28,1,29
"32194",10602,"Corner Brook","NL",48.95224,-57.92207,2018-09-04 02:00:00,25,1,26
"32195",10602,"Corner Brook","NL",48.95224,-57.92207,2018-09-04 03:00:00,26,1,27
"32196",10602,"Corner Brook","NL",48.95224,-57.92207,2018-09-04 04:00:00,25,1,26
"32197",10602,"Corner Brook","NL",48.95224,-57.92207,2018-09-04 05:00:00,24,1,25
"32198",10602,"Corner Brook","NL",48.95224,-57.92207,2018-09-04 06:00:00,24,1,25
"32199",10602,"Corner Brook","NL",48.95224,-57.92207,2018-09-04 07:00:00,22,1,23
"32200",10602,"Corner Brook","NL",48.95224,-57.92207,2018-09-04 08:00:00,22,1,23
"32201",10602,"Corner Brook","NL",48.95224,-57.92207,2018-09-04 09:00:00,22,2,24
"32202",10602,"Corner Brook","NL",48.95224,-57.92207,2018-09-04 10:00:00,22,3,25
"32203",10602,"Corner Brook","NL",48.95224,-57.92207,2018-09-04 11:00:00,21,2,23
"32204",10602,"Corner Brook","NL",48.95224,-57.92207,2018-09-04 12:00:00,28,2,30
"32205",10602,"Corner Brook","NL",48.95224,-57.92207,2018-09-04 13:00:00,31,1,32
"32206",10602,"Corner Brook","NL",48.95224,-57.92207,2018-09-04 14:00:00,29,1,30
"32207",10602,"Corner Brook","NL",48.95224,-57.92207,2018-09-04 15:00:00,23,4,27
"32208",10602,"Corner Brook","NL",48.95224,-57.92207,2018-09-04 16:00:00,24,2,26
"32209",10602,"Corner Brook","NL",48.95224,-57.92207,2018-09-04 17:00:00,22,3,25
"32210",10602,"Corner Brook","NL",48.95224,-57.92207,2018-09-04 18:00:00,22,2,24
"32211",10602,"Corner Brook","NL",48.95224,-57.92207,2018-09-04 19:00:00,19,5,24
"32212",10602,"Corner Brook","NL",48.95224,-57.92207,2018-09-04 20:00:00,17,5,22
"32213",10602,"Corner Brook","NL",48.95224,-57.92207,2018-09-04 21:00:00,19,3,22
"32214",10602,"Corner Brook","NL",48.95224,-57.92207,2018-09-04 22:00:00,17,5,22
"32215",10602,"Corner Brook","NL",48.95224,-57.92207,2018-09-04 23:00:00,20,3,23
"32216",10602,"Corner Brook","NL",48.95224,-57.92207,2018-09-05 00:00:00,22,1,23
"32217",10602,"Corner Brook","NL",48.95224,-57.92207,2018-09-05 01:00:00,19,2,21
"32218",10602,"Corner Brook","NL",48.95224,-57.92207,2018-09-05 02:00:00,15,5,20
"32219",10602,"Corner Brook","NL",48.95224,-57.92207,2018-09-05 03:00:00,17,3,20
"32220",10602,"Corner Brook","NL",48.95224,-57.92207,2018-09-05 04:00:00,17,3,20
"32221",10602,"Corner Brook","NL",48.95224,-57.92207,2018-09-05 05:00:00,19,1,20
"32222",10602,"Corner Brook","NL",48.95224,-57.92207,2018-09-05 06:00:00,17,2,19
"32223",10602,"Corner Brook","NL",48.95224,-57.92207,2018-09-05 07:00:00,11,5,16
"32224",10602,"Corner Brook","NL",48.95224,-57.92207,2018-09-05 08:00:00,12,6,18
"32225",10602,"Corner Brook","NL",48.95224,-57.92207,2018-09-05 09:00:00,20,2,22
"32226",10602,"Corner Brook","NL",48.95224,-57.92207,2018-09-05 10:00:00,21,3,24
"32227",10602,"Corner Brook","NL",48.95224,-57.92207,2018-09-05 11:00:00,21,4,25
"32228",10602,"Corner Brook","NL",48.95224,-57.92207,2018-09-05 12:00:00,24,4,28
"32229",10602,"Corner Brook","NL",48.95224,-57.92207,2018-09-05 13:00:00,23,4,27
"32230",10602,"Corner Brook","NL",48.95224,-57.92207,2018-09-05 14:00:00,22,4,26
"32231",10602,"Corner Brook","NL",48.95224,-57.92207,2018-09-05 15:00:00,21,4,25
"32232",10602,"Corner Brook","NL",48.95224,-57.92207,2018-09-05 16:00:00,20,4,24
"32233",10602,"Corner Brook","NL",48.95224,-57.92207,2018-09-05 17:00:00,21,4,25
"32234",10602,"Corner Brook","NL",48.95224,-57.92207,2018-09-05 18:00:00,22,3,25
"32235",10602,"Corner Brook","NL",48.95224,-57.92207,2018-09-05 19:00:00,16,6,22
"32236",10602,"Corner Brook","NL",48.95224,-57.92207,2018-09-05 20:00:00,13,6,19
"32237",10602,"Corner Brook","NL",48.95224,-57.92207,2018-09-05 21:00:00,14,4,18
"32238",10602,"Corner Brook","NL",48.95224,-57.92207,2018-09-05 22:00:00,16,2,18
"32239",10602,"Corner Brook","NL",48.95224,-57.92207,2018-09-05 23:00:00,15,2,17
"32240",10602,"Corner Brook","NL",48.95224,-57.92207,2018-09-06 00:00:00,14,2,16
"32241",10602,"Corner Brook","NL",48.95224,-57.92207,2018-09-06 01:00:00,13,2,15
"32242",10602,"Corner Brook","NL",48.95224,-57.92207,2018-09-06 02:00:00,15,2,17
"32243",10602,"Corner Brook","NL",48.95224,-57.92207,2018-09-06 03:00:00,16,2,18
"32244",10602,"Corner Brook","NL",48.95224,-57.92207,2018-09-06 04:00:00,14,3,17
"32245",10602,"Corner Brook","NL",48.95224,-57.92207,2018-09-06 05:00:00,15,2,17
"32246",10602,"Corner Brook","NL",48.95224,-57.92207,2018-09-06 06:00:00,16,2,18
"32247",10602,"Corner Brook","NL",48.95224,-57.92207,2018-09-06 07:00:00,12,4,16
"32248",10602,"Corner Brook","NL",48.95224,-57.92207,2018-09-06 08:00:00,10,5,15
"32249",10602,"Corner Brook","NL",48.95224,-57.92207,2018-09-06 09:00:00,13,4,17
"32250",10602,"Corner Brook","NL",48.95224,-57.92207,2018-09-06 10:00:00,21,1,22
"32251",10602,"Corner Brook","NL",48.95224,-57.92207,2018-09-06 11:00:00,22,2,24
"32252",10602,"Corner Brook","NL",48.95224,-57.92207,2018-09-06 12:00:00,25,1,26
"32253",10602,"Corner Brook","NL",48.95224,-57.92207,2018-09-06 13:00:00,28,1,29
"32254",10602,"Corner Brook","NL",48.95224,-57.92207,2018-09-06 14:00:00,27,1,28
"32255",10602,"Corner Brook","NL",48.95224,-57.92207,2018-09-06 15:00:00,23,2,25
"32256",10602,"Corner Brook","NL",48.95224,-57.92207,2018-09-06 16:00:00,18,3,21
"32257",10602,"Corner Brook","NL",48.95224,-57.92207,2018-09-06 17:00:00,15,6,21
"32258",10602,"Corner Brook","NL",48.95224,-57.92207,2018-09-06 18:00:00,13,4,17
"32259",10602,"Corner Brook","NL",48.95224,-57.92207,2018-09-06 19:00:00,12,3,15
"32260",10602,"Corner Brook","NL",48.95224,-57.92207,2018-09-06 20:00:00,10,4,14
"32261",10602,"Corner Brook","NL",48.95224,-57.92207,2018-09-06 21:00:00,9,4,13
"32262",10602,"Corner Brook","NL",48.95224,-57.92207,2018-09-06 22:00:00,10,3,13
"32263",10602,"Corner Brook","NL",48.95224,-57.92207,2018-09-06 23:00:00,15,1,16
"32264",10602,"Corner Brook","NL",48.95224,-57.92207,2018-09-07 00:00:00,17,1,18
"32265",10602,"Corner Brook","NL",48.95224,-57.92207,2018-09-07 01:00:00,13,3,16
"32266",10602,"Corner Brook","NL",48.95224,-57.92207,2018-09-07 02:00:00,14,3,17
"32267",10602,"Corner Brook","NL",48.95224,-57.92207,2018-09-07 03:00:00,13,3,16
"32268",10602,"Corner Brook","NL",48.95224,-57.92207,2018-09-07 04:00:00,13,3,16
"32269",10602,"Corner Brook","NL",48.95224,-57.92207,2018-09-07 05:00:00,13,4,17
"32270",10602,"Corner Brook","NL",48.95224,-57.92207,2018-09-07 06:00:00,12,5,17
"32271",10602,"Corner Brook","NL",48.95224,-57.92207,2018-09-07 07:00:00,9,6,15
"32272",10602,"Corner Brook","NL",48.95224,-57.92207,2018-09-07 08:00:00,10,6,16
"32273",10602,"Corner Brook","NL",48.95224,-57.92207,2018-09-07 09:00:00,17,6,23
"32274",10602,"Corner Brook","NL",48.95224,-57.92207,2018-09-07 10:00:00,20,4,24
"32275",10602,"Corner Brook","NL",48.95224,-57.92207,2018-09-07 11:00:00,23,3,26
"32276",10602,"Corner Brook","NL",48.95224,-57.92207,2018-09-07 12:00:00,23,3,26
"32277",10602,"Corner Brook","NL",48.95224,-57.92207,2018-09-07 13:00:00,22,6,28
"32278",10602,"Corner Brook","NL",48.95224,-57.92207,2018-09-07 14:00:00,23,3,26
"32279",10602,"Corner Brook","NL",48.95224,-57.92207,2018-09-07 15:00:00,24,3,27
"32280",10602,"Corner Brook","NL",48.95224,-57.92207,2018-09-07 16:00:00,24,2,26
"32281",10602,"Corner Brook","NL",48.95224,-57.92207,2018-09-07 17:00:00,23,3,26
"32282",10602,"Corner Brook","NL",48.95224,-57.92207,2018-09-07 18:00:00,23,2,25
"32283",10602,"Corner Brook","NL",48.95224,-57.92207,2018-09-07 19:00:00,23,2,25
"32284",10602,"Corner Brook","NL",48.95224,-57.92207,2018-09-07 20:00:00,19,3,22
"32285",10602,"Corner Brook","NL",48.95224,-57.92207,2018-09-07 21:00:00,18,4,22
"32286",10602,"Corner Brook","NL",48.95224,-57.92207,2018-09-07 22:00:00,20,3,23
"32287",10602,"Corner Brook","NL",48.95224,-57.92207,2018-09-07 23:00:00,19,2,21
"32288",10602,"Corner Brook","NL",48.95224,-57.92207,2018-09-08 00:00:00,19,1,20
"32289",10602,"Corner Brook","NL",48.95224,-57.92207,2018-09-08 01:00:00,19,1,20
"32290",10602,"Corner Brook","NL",48.95224,-57.92207,2018-09-08 02:00:00,17,2,19
"32291",10602,"Corner Brook","NL",48.95224,-57.92207,2018-09-08 03:00:00,15,3,18
"32292",10602,"Corner Brook","NL",48.95224,-57.92207,2018-09-08 04:00:00,18,1,19
"32293",10602,"Corner Brook","NL",48.95224,-57.92207,2018-09-08 05:00:00,18,2,20
"32294",10602,"Corner Brook","NL",48.95224,-57.92207,2018-09-08 06:00:00,17,2,19
"32295",10602,"Corner Brook","NL",48.95224,-57.92207,2018-09-08 07:00:00,18,1,19
"32296",10602,"Corner Brook","NL",48.95224,-57.92207,2018-09-08 08:00:00,19,1,20
"32297",10602,"Corner Brook","NL",48.95224,-57.92207,2018-09-08 09:00:00,25,2,27
"32298",10602,"Corner Brook","NL",48.95224,-57.92207,2018-09-08 10:00:00,28,1,29
"32299",10602,"Corner Brook","NL",48.95224,-57.92207,2018-09-08 11:00:00,27,1,28
"32300",10602,"Corner Brook","NL",48.95224,-57.92207,2018-09-08 12:00:00,26,2,28
"32301",10602,"Corner Brook","NL",48.95224,-57.92207,2018-09-08 13:00:00,26,2,28
"32302",10602,"Corner Brook","NL",48.95224,-57.92207,2018-09-08 14:00:00,25,2,27
"32303",10602,"Corner Brook","NL",48.95224,-57.92207,2018-09-08 15:00:00,24,3,27
"32304",10602,"Corner Brook","NL",48.95224,-57.92207,2018-09-08 16:00:00,23,3,26
"32305",10602,"Corner Brook","NL",48.95224,-57.92207,2018-09-08 17:00:00,22,1,23
"32306",10602,"Corner Brook","NL",48.95224,-57.92207,2018-09-08 18:00:00,21,1,22
"32307",10602,"Corner Brook","NL",48.95224,-57.92207,2018-09-08 19:00:00,19,2,21
"32308",10602,"Corner Brook","NL",48.95224,-57.92207,2018-09-08 20:00:00,14,4,18
"32309",10602,"Corner Brook","NL",48.95224,-57.92207,2018-09-08 21:00:00,14,3,17
"32310",10602,"Corner Brook","NL",48.95224,-57.92207,2018-09-08 22:00:00,13,3,16
"32311",10602,"Corner Brook","NL",48.95224,-57.92207,2018-09-08 23:00:00,14,2,16
"32312",10602,"Corner Brook","NL",48.95224,-57.92207,2018-09-09 00:00:00,14,2,16
"32313",10602,"Corner Brook","NL",48.95224,-57.92207,2018-09-09 01:00:00,14,2,16
"32314",10602,"Corner Brook","NL",48.95224,-57.92207,2018-09-09 02:00:00,15,1,16
"32315",10602,"Corner Brook","NL",48.95224,-57.92207,2018-09-09 03:00:00,15,2,17
"32316",10602,"Corner Brook","NL",48.95224,-57.92207,2018-09-09 04:00:00,12,2,14
"32317",10602,"Corner Brook","NL",48.95224,-57.92207,2018-09-09 05:00:00,12,2,14
"32318",10602,"Corner Brook","NL",48.95224,-57.92207,2018-09-09 06:00:00,10,2,12
"32319",10602,"Corner Brook","NL",48.95224,-57.92207,2018-09-09 07:00:00,9,3,12
"32320",10602,"Corner Brook","NL",48.95224,-57.92207,2018-09-09 08:00:00,7,4,11
"32321",10602,"Corner Brook","NL",48.95224,-57.92207,2018-09-09 09:00:00,16,2,18
"32322",10602,"Corner Brook","NL",48.95224,-57.92207,2018-09-09 10:00:00,18,5,23
"32323",10602,"Corner Brook","NL",48.95224,-57.92207,2018-09-09 11:00:00,23,1,24
"32324",10602,"Corner Brook","NL",48.95224,-57.92207,2018-09-09 12:00:00,24,1,25
"32325",10602,"Corner Brook","NL",48.95224,-57.92207,2018-09-09 13:00:00,23,1,24
"32326",10602,"Corner Brook","NL",48.95224,-57.92207,2018-09-09 14:00:00,23,1,24
"32327",10602,"Corner Brook","NL",48.95224,-57.92207,2018-09-09 15:00:00,24,1,25
"32328",10602,"Corner Brook","NL",48.95224,-57.92207,2018-09-09 16:00:00,23,1,24
"32329",10602,"Corner Brook","NL",48.95224,-57.92207,2018-09-09 17:00:00,21,1,22
"32330",10602,"Corner Brook","NL",48.95224,-57.92207,2018-09-09 18:00:00,20,1,21
"32331",10602,"Corner Brook","NL",48.95224,-57.92207,2018-09-09 19:00:00,19,1,20
"32332",10602,"Corner Brook","NL",48.95224,-57.92207,2018-09-09 20:00:00,16,2,18
"32333",10602,"Corner Brook","NL",48.95224,-57.92207,2018-09-09 21:00:00,11,3,14
"32334",10602,"Corner Brook","NL",48.95224,-57.92207,2018-09-09 22:00:00,9,4,13
"32335",10602,"Corner Brook","NL",48.95224,-57.92207,2018-09-09 23:00:00,10,3,13
"32336",10602,"Corner Brook","NL",48.95224,-57.92207,2018-09-10 00:00:00,11,2,13
"32337",10602,"Corner Brook","NL",48.95224,-57.92207,2018-09-10 01:00:00,11,2,13
"32338",10602,"Corner Brook","NL",48.95224,-57.92207,2018-09-10 02:00:00,14,1,15
"32339",10602,"Corner Brook","NL",48.95224,-57.92207,2018-09-10 03:00:00,14,1,15
"32340",10602,"Corner Brook","NL",48.95224,-57.92207,2018-09-10 04:00:00,13,2,15
"32341",10602,"Corner Brook","NL",48.95224,-57.92207,2018-09-10 05:00:00,12,2,14
"32342",10602,"Corner Brook","NL",48.95224,-57.92207,2018-09-10 06:00:00,11,2,13
"32343",10602,"Corner Brook","NL",48.95224,-57.92207,2018-09-10 07:00:00,11,2,13
"32344",10602,"Corner Brook","NL",48.95224,-57.92207,2018-09-10 08:00:00,7,7,14
"32345",10602,"Corner Brook","NL",48.95224,-57.92207,2018-09-10 09:00:00,11,4,15
"32346",10602,"Corner Brook","NL",48.95224,-57.92207,2018-09-10 10:00:00,15,3,18
"32347",10602,"Corner Brook","NL",48.95224,-57.92207,2018-09-10 11:00:00,19,3,22
"32348",10602,"Corner Brook","NL",48.95224,-57.92207,2018-09-10 12:00:00,23,3,26
"32349",10602,"Corner Brook","NL",48.95224,-57.92207,2018-09-10 13:00:00,24,3,27
"32350",10602,"Corner Brook","NL",48.95224,-57.92207,2018-09-10 14:00:00,24,3,27
"32351",10602,"Corner Brook","NL",48.95224,-57.92207,2018-09-10 15:00:00,24,1,25
"32352",10602,"Corner Brook","NL",48.95224,-57.92207,2018-09-10 16:00:00,24,1,25
"32353",10602,"Corner Brook","NL",48.95224,-57.92207,2018-09-10 17:00:00,23,2,25
"32354",10602,"Corner Brook","NL",48.95224,-57.92207,2018-09-10 18:00:00,23,2,25
"32355",10602,"Corner Brook","NL",48.95224,-57.92207,2018-09-10 19:00:00,19,3,22
"32356",10602,"Corner Brook","NL",48.95224,-57.92207,2018-09-10 20:00:00,20,2,22
"32357",10602,"Corner Brook","NL",48.95224,-57.92207,2018-09-10 21:00:00,21,1,22
"32358",10602,"Corner Brook","NL",48.95224,-57.92207,2018-09-10 22:00:00,21,1,22
"32359",10602,"Corner Brook","NL",48.95224,-57.92207,2018-09-10 23:00:00,19,2,21
"32360",10602,"Corner Brook","NL",48.95224,-57.92207,2018-09-11 00:00:00,18,2,20
"32361",10602,"Corner Brook","NL",48.95224,-57.92207,2018-09-11 01:00:00,17,2,19
"32362",10602,"Corner Brook","NL",48.95224,-57.92207,2018-09-11 02:00:00,17,2,19
"32363",10602,"Corner Brook","NL",48.95224,-57.92207,2018-09-11 03:00:00,21,1,22
"32364",10602,"Corner Brook","NL",48.95224,-57.92207,2018-09-11 04:00:00,21,1,22
"32365",10602,"Corner Brook","NL",48.95224,-57.92207,2018-09-11 05:00:00,21,1,22
"32366",10602,"Corner Brook","NL",48.95224,-57.92207,2018-09-11 06:00:00,20,1,21
"32367",10602,"Corner Brook","NL",48.95224,-57.92207,2018-09-11 07:00:00,20,1,21
"32368",10602,"Corner Brook","NL",48.95224,-57.92207,2018-09-11 08:00:00,20,1,21
"32369",10602,"Corner Brook","NL",48.95224,-57.92207,2018-09-11 09:00:00,20,2,22
"32370",10602,"Corner Brook","NL",48.95224,-57.92207,2018-09-11 10:00:00,20,2,22
"32371",10602,"Corner Brook","NL",48.95224,-57.92207,2018-09-11 11:00:00,21,1,22
"32372",10602,"Corner Brook","NL",48.95224,-57.92207,2018-09-11 12:00:00,23,1,24
"32373",10602,"Corner Brook","NL",48.95224,-57.92207,2018-09-11 13:00:00,26,1,27
"32374",10602,"Corner Brook","NL",48.95224,-57.92207,2018-09-11 14:00:00,28,1,29
"32375",10602,"Corner Brook","NL",48.95224,-57.92207,2018-09-11 15:00:00,28,1,29
"32376",10602,"Corner Brook","NL",48.95224,-57.92207,2018-09-11 16:00:00,28,1,29
"32377",10602,"Corner Brook","NL",48.95224,-57.92207,2018-09-11 17:00:00,27,1,28
"32378",10602,"Corner Brook","NL",48.95224,-57.92207,2018-09-11 18:00:00,27,2,29
"32379",10602,"Corner Brook","NL",48.95224,-57.92207,2018-09-11 19:00:00,27,2,29
"32380",10602,"Corner Brook","NL",48.95224,-57.92207,2018-09-11 20:00:00,27,1,28
"32381",10602,"Corner Brook","NL",48.95224,-57.92207,2018-09-11 21:00:00,25,1,26
"32382",10602,"Corner Brook","NL",48.95224,-57.92207,2018-09-11 22:00:00,23,1,24
"32383",10602,"Corner Brook","NL",48.95224,-57.92207,2018-09-11 23:00:00,20,2,22
"32384",10602,"Corner Brook","NL",48.95224,-57.92207,2018-09-12 00:00:00,23,1,24
"32385",10602,"Corner Brook","NL",48.95224,-57.92207,2018-09-12 01:00:00,24,2,26
"32386",10602,"Corner Brook","NL",48.95224,-57.92207,2018-09-12 02:00:00,20,2,22
"32387",10602,"Corner Brook","NL",48.95224,-57.92207,2018-09-12 03:00:00,20,2,22
"32388",10602,"Corner Brook","NL",48.95224,-57.92207,2018-09-12 04:00:00,19,2,21
"32389",10602,"Corner Brook","NL",48.95224,-57.92207,2018-09-12 05:00:00,18,3,21
"32390",10602,"Corner Brook","NL",48.95224,-57.92207,2018-09-12 06:00:00,21,2,23
"32391",10602,"Corner Brook","NL",48.95224,-57.92207,2018-09-12 07:00:00,14,5,19
"32392",10602,"Corner Brook","NL",48.95224,-57.92207,2018-09-12 08:00:00,12,8,20
"32393",10602,"Corner Brook","NL",48.95224,-57.92207,2018-09-12 09:00:00,16,5,21
"32394",10602,"Corner Brook","NL",48.95224,-57.92207,2018-09-12 10:00:00,15,6,21
"32395",10602,"Corner Brook","NL",48.95224,-57.92207,2018-09-12 11:00:00,20,5,25
"32396",10602,"Corner Brook","NL",48.95224,-57.92207,2018-09-12 12:00:00,26,4,30
"32397",10602,"Corner Brook","NL",48.95224,-57.92207,2018-09-12 13:00:00,25,7,32
"32398",10602,"Corner Brook","NL",48.95224,-57.92207,2018-09-12 14:00:00,25,7,32
"32399",10602,"Corner Brook","NL",48.95224,-57.92207,2018-09-12 15:00:00,28,2,30
"32400",10602,"Corner Brook","NL",48.95224,-57.92207,2018-09-12 16:00:00,23,6,29
"32401",10602,"Corner Brook","NL",48.95224,-57.92207,2018-09-12 17:00:00,28,3,31
"32402",10602,"Corner Brook","NL",48.95224,-57.92207,2018-09-12 18:00:00,29,2,31
"32403",10602,"Corner Brook","NL",48.95224,-57.92207,2018-09-12 19:00:00,29,1,30
"32404",10602,"Corner Brook","NL",48.95224,-57.92207,2018-09-12 20:00:00,24,4,28
"32405",10602,"Corner Brook","NL",48.95224,-57.92207,2018-09-12 21:00:00,24,2,26
"32406",10602,"Corner Brook","NL",48.95224,-57.92207,2018-09-12 22:00:00,17,4,21
"32407",10602,"Corner Brook","NL",48.95224,-57.92207,2018-09-12 23:00:00,14,3,17
"32408",10602,"Corner Brook","NL",48.95224,-57.92207,2018-09-13 00:00:00,14,3,17
"32409",10602,"Corner Brook","NL",48.95224,-57.92207,2018-09-13 01:00:00,15,2,17
"32410",10602,"Corner Brook","NL",48.95224,-57.92207,2018-09-13 02:00:00,16,1,17
"32411",10602,"Corner Brook","NL",48.95224,-57.92207,2018-09-13 03:00:00,9,2,11
"32412",10602,"Corner Brook","NL",48.95224,-57.92207,2018-09-13 04:00:00,6,3,9
"32413",10602,"Corner Brook","NL",48.95224,-57.92207,2018-09-13 05:00:00,5,3,8
"32414",10602,"Corner Brook","NL",48.95224,-57.92207,2018-09-13 06:00:00,4,4,8
"32415",10602,"Corner Brook","NL",48.95224,-57.92207,2018-09-13 07:00:00,3,5,8
"32416",10602,"Corner Brook","NL",48.95224,-57.92207,2018-09-13 08:00:00,2,8,10
"32417",10602,"Corner Brook","NL",48.95224,-57.92207,2018-09-13 09:00:00,8,8,16
"32418",10602,"Corner Brook","NL",48.95224,-57.92207,2018-09-13 10:00:00,10,7,17
"32419",10602,"Corner Brook","NL",48.95224,-57.92207,2018-09-13 11:00:00,14,4,18
"32420",10602,"Corner Brook","NL",48.95224,-57.92207,2018-09-13 12:00:00,19,2,21
"32421",10602,"Corner Brook","NL",48.95224,-57.92207,2018-09-13 13:00:00,22,3,25
"32422",10602,"Corner Brook","NL",48.95224,-57.92207,2018-09-13 14:00:00,21,4,25
"32423",10602,"Corner Brook","NL",48.95224,-57.92207,2018-09-13 15:00:00,21,4,25
"32424",10602,"Corner Brook","NL",48.95224,-57.92207,2018-09-13 16:00:00,22,3,25
"32425",10602,"Corner Brook","NL",48.95224,-57.92207,2018-09-13 17:00:00,25,2,27
"32426",10602,"Corner Brook","NL",48.95224,-57.92207,2018-09-13 18:00:00,26,2,28
"32427",10602,"Corner Brook","NL",48.95224,-57.92207,2018-09-13 19:00:00,21,5,26
"32428",10602,"Corner Brook","NL",48.95224,-57.92207,2018-09-13 20:00:00,17,6,23
"32429",10602,"Corner Brook","NL",48.95224,-57.92207,2018-09-13 21:00:00,18,4,22
"32430",10602,"Corner Brook","NL",48.95224,-57.92207,2018-09-13 22:00:00,14,5,19
"32431",10602,"Corner Brook","NL",48.95224,-57.92207,2018-09-13 23:00:00,18,3,21
"32432",10602,"Corner Brook","NL",48.95224,-57.92207,2018-09-14 00:00:00,22,1,23
"32433",10602,"Corner Brook","NL",48.95224,-57.92207,2018-09-14 01:00:00,24,1,25
"32434",10602,"Corner Brook","NL",48.95224,-57.92207,2018-09-14 02:00:00,23,2,25
"32435",10602,"Corner Brook","NL",48.95224,-57.92207,2018-09-14 03:00:00,21,2,23
"32436",10602,"Corner Brook","NL",48.95224,-57.92207,2018-09-14 04:00:00,25,2,27
"32437",10602,"Corner Brook","NL",48.95224,-57.92207,2018-09-14 05:00:00,25,3,28
"32438",10602,"Corner Brook","NL",48.95224,-57.92207,2018-09-14 06:00:00,21,5,26
"32439",10602,"Corner Brook","NL",48.95224,-57.92207,2018-09-14 07:00:00,22,4,26
"32440",10602,"Corner Brook","NL",48.95224,-57.92207,2018-09-14 08:00:00,22,4,26
"32441",10602,"Corner Brook","NL",48.95224,-57.92207,2018-09-14 09:00:00,23,3,26
"32442",10602,"Corner Brook","NL",48.95224,-57.92207,2018-09-14 10:00:00,22,4,26
"32443",10602,"Corner Brook","NL",48.95224,-57.92207,2018-09-14 11:00:00,22,3,25
"32444",10602,"Corner Brook","NL",48.95224,-57.92207,2018-09-14 12:00:00,21,3,24
"32445",10602,"Corner Brook","NL",48.95224,-57.92207,2018-09-14 13:00:00,22,3,25
"32446",10602,"Corner Brook","NL",48.95224,-57.92207,2018-09-14 14:00:00,21,3,24
"32447",10602,"Corner Brook","NL",48.95224,-57.92207,2018-09-14 15:00:00,22,3,25
"32448",10602,"Corner Brook","NL",48.95224,-57.92207,2018-09-14 16:00:00,21,3,24
"32449",10602,"Corner Brook","NL",48.95224,-57.92207,2018-09-14 17:00:00,13,10,23
"32450",10602,"Corner Brook","NL",48.95224,-57.92207,2018-09-14 18:00:00,18,4,22
"32451",10602,"Corner Brook","NL",48.95224,-57.92207,2018-09-14 19:00:00,15,4,19
"32452",10602,"Corner Brook","NL",48.95224,-57.92207,2018-09-14 20:00:00,13,5,18
"32453",10602,"Corner Brook","NL",48.95224,-57.92207,2018-09-14 21:00:00,17,2,19
"32454",10602,"Corner Brook","NL",48.95224,-57.92207,2018-09-14 22:00:00,16,2,18
"32455",10602,"Corner Brook","NL",48.95224,-57.92207,2018-09-14 23:00:00,15,3,18
"32456",10602,"Corner Brook","NL",48.95224,-57.92207,2018-09-15 00:00:00,16,1,17
"32457",10602,"Corner Brook","NL",48.95224,-57.92207,2018-09-15 01:00:00,15,1,16
"32458",10602,"Corner Brook","NL",48.95224,-57.92207,2018-09-15 02:00:00,17,1,18
"32459",10602,"Corner Brook","NL",48.95224,-57.92207,2018-09-15 03:00:00,17,1,18
"32460",10602,"Corner Brook","NL",48.95224,-57.92207,2018-09-15 04:00:00,17,1,18
"32461",10602,"Corner Brook","NL",48.95224,-57.92207,2018-09-15 05:00:00,18,1,19
"32462",10602,"Corner Brook","NL",48.95224,-57.92207,2018-09-15 06:00:00,18,2,20
"32463",10602,"Corner Brook","NL",48.95224,-57.92207,2018-09-15 07:00:00,20,2,22
"32464",10602,"Corner Brook","NL",48.95224,-57.92207,2018-09-15 08:00:00,19,3,22
"32465",10602,"Corner Brook","NL",48.95224,-57.92207,2018-09-15 09:00:00,19,2,21
"32466",10602,"Corner Brook","NL",48.95224,-57.92207,2018-09-15 10:00:00,19,1,20
"32467",10602,"Corner Brook","NL",48.95224,-57.92207,2018-09-15 11:00:00,20,1,21
"32468",10602,"Corner Brook","NL",48.95224,-57.92207,2018-09-15 12:00:00,21,1,22
"32469",10602,"Corner Brook","NL",48.95224,-57.92207,2018-09-15 13:00:00,22,1,23
"32470",10602,"Corner Brook","NL",48.95224,-57.92207,2018-09-15 14:00:00,24,2,26
"32471",10602,"Corner Brook","NL",48.95224,-57.92207,2018-09-15 15:00:00,26,2,28
"32472",10602,"Corner Brook","NL",48.95224,-57.92207,2018-09-15 16:00:00,24,1,25
"32473",10602,"Corner Brook","NL",48.95224,-57.92207,2018-09-15 17:00:00,23,2,25
"32474",10602,"Corner Brook","NL",48.95224,-57.92207,2018-09-15 18:00:00,23,2,25
"32475",10602,"Corner Brook","NL",48.95224,-57.92207,2018-09-15 19:00:00,21,2,23
"32476",10602,"Corner Brook","NL",48.95224,-57.92207,2018-09-15 20:00:00,22,2,24
"32477",10602,"Corner Brook","NL",48.95224,-57.92207,2018-09-15 21:00:00,24,1,25
"32478",10602,"Corner Brook","NL",48.95224,-57.92207,2018-09-15 22:00:00,23,1,24
"32479",10602,"Corner Brook","NL",48.95224,-57.92207,2018-09-15 23:00:00,21,1,22
"32480",10602,"Corner Brook","NL",48.95224,-57.92207,2018-09-16 00:00:00,20,1,21
"32481",10602,"Corner Brook","NL",48.95224,-57.92207,2018-09-16 01:00:00,18,2,20
"32482",10602,"Corner Brook","NL",48.95224,-57.92207,2018-09-16 02:00:00,17,2,19
"32483",10602,"Corner Brook","NL",48.95224,-57.92207,2018-09-16 03:00:00,16,2,18
"32484",10602,"Corner Brook","NL",48.95224,-57.92207,2018-09-16 04:00:00,11,4,15
"32485",10602,"Corner Brook","NL",48.95224,-57.92207,2018-09-16 05:00:00,12,2,14
"32486",10602,"Corner Brook","NL",48.95224,-57.92207,2018-09-16 06:00:00,12,2,14
"32487",10602,"Corner Brook","NL",48.95224,-57.92207,2018-09-16 07:00:00,9,3,12
"32488",10602,"Corner Brook","NL",48.95224,-57.92207,2018-09-16 08:00:00,7,3,10
"32489",10602,"Corner Brook","NL",48.95224,-57.92207,2018-09-16 09:00:00,9,4,13
"32490",10602,"Corner Brook","NL",48.95224,-57.92207,2018-09-16 10:00:00,10,8,18
"32491",10602,"Corner Brook","NL",48.95224,-57.92207,2018-09-16 11:00:00,21,2,23
"32492",10602,"Corner Brook","NL",48.95224,-57.92207,2018-09-16 12:00:00,20,4,24
"32493",10602,"Corner Brook","NL",48.95224,-57.92207,2018-09-16 13:00:00,21,3,24
"32494",10602,"Corner Brook","NL",48.95224,-57.92207,2018-09-16 14:00:00,21,3,24
"32495",10602,"Corner Brook","NL",48.95224,-57.92207,2018-09-16 15:00:00,21,2,23
"32496",10602,"Corner Brook","NL",48.95224,-57.92207,2018-09-16 16:00:00,19,3,22
"32497",10602,"Corner Brook","NL",48.95224,-57.92207,2018-09-16 17:00:00,18,5,23
"32498",10602,"Corner Brook","NL",48.95224,-57.92207,2018-09-16 18:00:00,18,7,25
"32499",10602,"Corner Brook","NL",48.95224,-57.92207,2018-09-16 19:00:00,16,5,21
"32500",10602,"Corner Brook","NL",48.95224,-57.92207,2018-09-16 20:00:00,12,4,16
"32501",10602,"Corner Brook","NL",48.95224,-57.92207,2018-09-16 21:00:00,13,4,17
"32502",10602,"Corner Brook","NL",48.95224,-57.92207,2018-09-16 22:00:00,13,3,16
"32503",10602,"Corner Brook","NL",48.95224,-57.92207,2018-09-16 23:00:00,15,2,17
"32504",10602,"Corner Brook","NL",48.95224,-57.92207,2018-09-17 00:00:00,15,2,17
"32505",10602,"Corner Brook","NL",48.95224,-57.92207,2018-09-17 01:00:00,15,1,16
"32506",10602,"Corner Brook","NL",48.95224,-57.92207,2018-09-17 02:00:00,14,1,15
"32507",10602,"Corner Brook","NL",48.95224,-57.92207,2018-09-17 03:00:00,12,2,14
"32508",10602,"Corner Brook","NL",48.95224,-57.92207,2018-09-17 04:00:00,14,1,15
"32509",10602,"Corner Brook","NL",48.95224,-57.92207,2018-09-17 05:00:00,13,1,14
"32510",10602,"Corner Brook","NL",48.95224,-57.92207,2018-09-17 06:00:00,13,1,14
"32511",10602,"Corner Brook","NL",48.95224,-57.92207,2018-09-17 07:00:00,14,3,17
"32512",10602,"Corner Brook","NL",48.95224,-57.92207,2018-09-17 08:00:00,19,2,21
"32513",10602,"Corner Brook","NL",48.95224,-57.92207,2018-09-17 09:00:00,20,1,21
"32514",10602,"Corner Brook","NL",48.95224,-57.92207,2018-09-17 10:00:00,20,1,21
"32515",10602,"Corner Brook","NL",48.95224,-57.92207,2018-09-17 11:00:00,20,4,24
"32516",10602,"Corner Brook","NL",48.95224,-57.92207,2018-09-17 12:00:00,18,5,23
"32517",10602,"Corner Brook","NL",48.95224,-57.92207,2018-09-17 13:00:00,17,4,21
"32518",10602,"Corner Brook","NL",48.95224,-57.92207,2018-09-17 14:00:00,15,4,19
"32519",10602,"Corner Brook","NL",48.95224,-57.92207,2018-09-17 15:00:00,18,4,22
"32520",10602,"Corner Brook","NL",48.95224,-57.92207,2018-09-17 16:00:00,18,4,22
"32521",10602,"Corner Brook","NL",48.95224,-57.92207,2018-09-17 17:00:00,20,4,24
"32522",10602,"Corner Brook","NL",48.95224,-57.92207,2018-09-17 18:00:00,19,3,22
"32523",10602,"Corner Brook","NL",48.95224,-57.92207,2018-09-17 19:00:00,19,3,22
"32524",10602,"Corner Brook","NL",48.95224,-57.92207,2018-09-17 20:00:00,21,2,23
"32525",10602,"Corner Brook","NL",48.95224,-57.92207,2018-09-17 21:00:00,27,1,28
"32526",10602,"Corner Brook","NL",48.95224,-57.92207,2018-09-17 22:00:00,26,1,27
"32527",10602,"Corner Brook","NL",48.95224,-57.92207,2018-09-17 23:00:00,24,2,26
"32528",10602,"Corner Brook","NL",48.95224,-57.92207,2018-09-18 00:00:00,25,1,26
"32529",10602,"Corner Brook","NL",48.95224,-57.92207,2018-09-18 01:00:00,24,1,25
"32530",10602,"Corner Brook","NL",48.95224,-57.92207,2018-09-18 02:00:00,21,1,22
"32531",10602,"Corner Brook","NL",48.95224,-57.92207,2018-09-18 03:00:00,21,1,22
"32532",10602,"Corner Brook","NL",48.95224,-57.92207,2018-09-18 04:00:00,21,1,22
"32533",10602,"Corner Brook","NL",48.95224,-57.92207,2018-09-18 05:00:00,22,1,23
"32534",10602,"Corner Brook","NL",48.95224,-57.92207,2018-09-18 06:00:00,22,1,23
"32535",10602,"Corner Brook","NL",48.95224,-57.92207,2018-09-18 07:00:00,22,2,24
"32536",10602,"Corner Brook","NL",48.95224,-57.92207,2018-09-18 08:00:00,21,3,24
"32537",10602,"Corner Brook","NL",48.95224,-57.92207,2018-09-18 09:00:00,21,3,24
"32538",10602,"Corner Brook","NL",48.95224,-57.92207,2018-09-18 10:00:00,21,2,23
"32539",10602,"Corner Brook","NL",48.95224,-57.92207,2018-09-18 11:00:00,20,2,22
"32540",10602,"Corner Brook","NL",48.95224,-57.92207,2018-09-18 12:00:00,20,2,22
"32541",10602,"Corner Brook","NL",48.95224,-57.92207,2018-09-18 13:00:00,22,2,24
"32542",10602,"Corner Brook","NL",48.95224,-57.92207,2018-09-18 14:00:00,23,2,25
"32543",10602,"Corner Brook","NL",48.95224,-57.92207,2018-09-18 15:00:00,23,2,25
"32544",10602,"Corner Brook","NL",48.95224,-57.92207,2018-09-18 16:00:00,22,2,24
"32545",10602,"Corner Brook","NL",48.95224,-57.92207,2018-09-18 17:00:00,22,2,24
"32546",10602,"Corner Brook","NL",48.95224,-57.92207,2018-09-18 18:00:00,23,2,25
"32547",10602,"Corner Brook","NL",48.95224,-57.92207,2018-09-18 19:00:00,22,2,24
"32548",10602,"Corner Brook","NL",48.95224,-57.92207,2018-09-18 20:00:00,22,1,23
"32549",10602,"Corner Brook","NL",48.95224,-57.92207,2018-09-18 21:00:00,19,2,21
"32550",10602,"Corner Brook","NL",48.95224,-57.92207,2018-09-18 22:00:00,18,2,20
"32551",10602,"Corner Brook","NL",48.95224,-57.92207,2018-09-18 23:00:00,14,3,17
"32552",10602,"Corner Brook","NL",48.95224,-57.92207,2018-09-19 00:00:00,12,2,14
"32553",10602,"Corner Brook","NL",48.95224,-57.92207,2018-09-19 01:00:00,11,2,13
"32554",10602,"Corner Brook","NL",48.95224,-57.92207,2018-09-19 02:00:00,8,2,10
"32555",10602,"Corner Brook","NL",48.95224,-57.92207,2018-09-19 03:00:00,8,2,10
"32556",10602,"Corner Brook","NL",48.95224,-57.92207,2018-09-19 04:00:00,8,3,11
"32557",10602,"Corner Brook","NL",48.95224,-57.92207,2018-09-19 05:00:00,8,2,10
"32558",10602,"Corner Brook","NL",48.95224,-57.92207,2018-09-19 06:00:00,6,4,10
"32559",10602,"Corner Brook","NL",48.95224,-57.92207,2018-09-19 07:00:00,4,7,11
"32560",10602,"Corner Brook","NL",48.95224,-57.92207,2018-09-19 08:00:00,11,3,14
"32561",10602,"Corner Brook","NL",48.95224,-57.92207,2018-09-19 09:00:00,15,3,18
"32562",10602,"Corner Brook","NL",48.95224,-57.92207,2018-09-19 10:00:00,20,2,22
"32563",10602,"Corner Brook","NL",48.95224,-57.92207,2018-09-19 11:00:00,24,2,26
"32564",10602,"Corner Brook","NL",48.95224,-57.92207,2018-09-19 12:00:00,24,2,26
"32565",10602,"Corner Brook","NL",48.95224,-57.92207,2018-09-19 13:00:00,23,10,33
"32566",10602,"Corner Brook","NL",48.95224,-57.92207,2018-09-19 14:00:00,25,2,27
"32567",10602,"Corner Brook","NL",48.95224,-57.92207,2018-09-19 15:00:00,25,2,27
"32568",10602,"Corner Brook","NL",48.95224,-57.92207,2018-09-19 16:00:00,26,2,28
"32569",10602,"Corner Brook","NL",48.95224,-57.92207,2018-09-19 17:00:00,26,2,28
"32570",10602,"Corner Brook","NL",48.95224,-57.92207,2018-09-19 18:00:00,26,2,28
"32571",10602,"Corner Brook","NL",48.95224,-57.92207,2018-09-19 19:00:00,24,2,26
"32572",10602,"Corner Brook","NL",48.95224,-57.92207,2018-09-19 20:00:00,23,2,25
"32573",10602,"Corner Brook","NL",48.95224,-57.92207,2018-09-19 21:00:00,23,1,24
"32574",10602,"Corner Brook","NL",48.95224,-57.92207,2018-09-19 22:00:00,23,1,24
"32575",10602,"Corner Brook","NL",48.95224,-57.92207,2018-09-19 23:00:00,20,2,22
"32576",10602,"Corner Brook","NL",48.95224,-57.92207,2018-09-20 00:00:00,19,2,21
"32577",10602,"Corner Brook","NL",48.95224,-57.92207,2018-09-20 01:00:00,19,2,21
"32578",10602,"Corner Brook","NL",48.95224,-57.92207,2018-09-20 02:00:00,19,2,21
"32579",10602,"Corner Brook","NL",48.95224,-57.92207,2018-09-20 03:00:00,19,2,21
"32580",10602,"Corner Brook","NL",48.95224,-57.92207,2018-09-20 04:00:00,20,2,22
"32581",10602,"Corner Brook","NL",48.95224,-57.92207,2018-09-20 05:00:00,18,2,20
"32582",10602,"Corner Brook","NL",48.95224,-57.92207,2018-09-20 06:00:00,18,2,20
"32583",10602,"Corner Brook","NL",48.95224,-57.92207,2018-09-20 07:00:00,17,3,20
"32584",10602,"Corner Brook","NL",48.95224,-57.92207,2018-09-20 08:00:00,16,4,20
"32585",10602,"Corner Brook","NL",48.95224,-57.92207,2018-09-20 09:00:00,19,3,22
"32586",10602,"Corner Brook","NL",48.95224,-57.92207,2018-09-20 10:00:00,23,2,25
"32587",10602,"Corner Brook","NL",48.95224,-57.92207,2018-09-20 11:00:00,25,2,27
"32588",10602,"Corner Brook","NL",48.95224,-57.92207,2018-09-20 12:00:00,25,1,26
"32589",10602,"Corner Brook","NL",48.95224,-57.92207,2018-09-20 13:00:00,24,2,26
"32590",10602,"Corner Brook","NL",48.95224,-57.92207,2018-09-20 14:00:00,25,2,27
"32591",10602,"Corner Brook","NL",48.95224,-57.92207,2018-09-20 15:00:00,25,2,27
"32592",10602,"Corner Brook","NL",48.95224,-57.92207,2018-09-20 16:00:00,25,3,28
"32593",10602,"Corner Brook","NL",48.95224,-57.92207,2018-09-20 17:00:00,25,2,27
"32594",10602,"Corner Brook","NL",48.95224,-57.92207,2018-09-20 18:00:00,25,2,27
"32595",10602,"Corner Brook","NL",48.95224,-57.92207,2018-09-20 19:00:00,23,2,25
"32596",10602,"Corner Brook","NL",48.95224,-57.92207,2018-09-20 20:00:00,14,6,20
"32597",10602,"Corner Brook","NL",48.95224,-57.92207,2018-09-20 21:00:00,11,6,17
"32598",10602,"Corner Brook","NL",48.95224,-57.92207,2018-09-20 22:00:00,11,3,14
"32599",10602,"Corner Brook","NL",48.95224,-57.92207,2018-09-20 23:00:00,9,4,13
"32600",10602,"Corner Brook","NL",48.95224,-57.92207,2018-09-21 00:00:00,7,4,11
"32601",10602,"Corner Brook","NL",48.95224,-57.92207,2018-09-21 01:00:00,7,4,11
"32602",10602,"Corner Brook","NL",48.95224,-57.92207,2018-09-21 02:00:00,7,3,10
"32603",10602,"Corner Brook","NL",48.95224,-57.92207,2018-09-21 03:00:00,6,4,10
"32604",10602,"Corner Brook","NL",48.95224,-57.92207,2018-09-21 04:00:00,7,4,11
"32605",10602,"Corner Brook","NL",48.95224,-57.92207,2018-09-21 05:00:00,7,3,10
"32606",10602,"Corner Brook","NL",48.95224,-57.92207,2018-09-21 06:00:00,4,5,9
"32607",10602,"Corner Brook","NL",48.95224,-57.92207,2018-09-21 07:00:00,5,6,11
"32608",10602,"Corner Brook","NL",48.95224,-57.92207,2018-09-21 08:00:00,5,8,13
"32609",10602,"Corner Brook","NL",48.95224,-57.92207,2018-09-21 09:00:00,8,7,15
"32610",10602,"Corner Brook","NL",48.95224,-57.92207,2018-09-21 10:00:00,16,4,20
"32611",10602,"Corner Brook","NL",48.95224,-57.92207,2018-09-21 11:00:00,23,2,25
"32612",10602,"Corner Brook","NL",48.95224,-57.92207,2018-09-21 12:00:00,22,3,25
"32613",10602,"Corner Brook","NL",48.95224,-57.92207,2018-09-21 13:00:00,23,1,24
"32614",10602,"Corner Brook","NL",48.95224,-57.92207,2018-09-21 14:00:00,23,1,24
"32615",10602,"Corner Brook","NL",48.95224,-57.92207,2018-09-21 15:00:00,23,1,24
"32616",10602,"Corner Brook","NL",48.95224,-57.92207,2018-09-21 16:00:00,23,2,25
"32617",10602,"Corner Brook","NL",48.95224,-57.92207,2018-09-21 17:00:00,24,1,25
"32618",10602,"Corner Brook","NL",48.95224,-57.92207,2018-09-21 18:00:00,23,1,24
"32619",10602,"Corner Brook","NL",48.95224,-57.92207,2018-09-21 19:00:00,23,2,25
"32620",10602,"Corner Brook","NL",48.95224,-57.92207,2018-09-21 20:00:00,20,2,22
"32621",10602,"Corner Brook","NL",48.95224,-57.92207,2018-09-21 21:00:00,21,2,23
"32622",10602,"Corner Brook","NL",48.95224,-57.92207,2018-09-21 22:00:00,21,2,23
"32623",10602,"Corner Brook","NL",48.95224,-57.92207,2018-09-21 23:00:00,21,1,22
"32624",10602,"Corner Brook","NL",48.95224,-57.92207,2018-09-22 00:00:00,23,1,24
"32625",10602,"Corner Brook","NL",48.95224,-57.92207,2018-09-22 01:00:00,25,1,26
"32626",10602,"Corner Brook","NL",48.95224,-57.92207,2018-09-22 02:00:00,25,1,26
"32627",10602,"Corner Brook","NL",48.95224,-57.92207,2018-09-22 03:00:00,27,1,28
"32628",10602,"Corner Brook","NL",48.95224,-57.92207,2018-09-22 04:00:00,27,1,28
"32629",10602,"Corner Brook","NL",48.95224,-57.92207,2018-09-22 05:00:00,29,1,30
"32630",10602,"Corner Brook","NL",48.95224,-57.92207,2018-09-22 06:00:00,30,1,31
"32631",10602,"Corner Brook","NL",48.95224,-57.92207,2018-09-22 07:00:00,30,1,31
"32632",10602,"Corner Brook","NL",48.95224,-57.92207,2018-09-22 08:00:00,30,1,31
"32633",10602,"Corner Brook","NL",48.95224,-57.92207,2018-09-22 09:00:00,30,1,31
"32634",10602,"Corner Brook","NL",48.95224,-57.92207,2018-09-22 10:00:00,31,1,32
"32635",10602,"Corner Brook","NL",48.95224,-57.92207,2018-09-22 11:00:00,31,1,32
"32636",10602,"Corner Brook","NL",48.95224,-57.92207,2018-09-22 12:00:00,31,1,32
"32637",10602,"Corner Brook","NL",48.95224,-57.92207,2018-09-22 13:00:00,28,1,29
"32638",10602,"Corner Brook","NL",48.95224,-57.92207,2018-09-22 14:00:00,21,1,22
"32639",10602,"Corner Brook","NL",48.95224,-57.92207,2018-09-22 15:00:00,20,2,22
"32640",10602,"Corner Brook","NL",48.95224,-57.92207,2018-09-22 16:00:00,20,3,23
"32641",10602,"Corner Brook","NL",48.95224,-57.92207,2018-09-22 17:00:00,22,2,24
"32642",10602,"Corner Brook","NL",48.95224,-57.92207,2018-09-22 18:00:00,23,3,26
"32643",10602,"Corner Brook","NL",48.95224,-57.92207,2018-09-22 19:00:00,28,1,29
"32644",10602,"Corner Brook","NL",48.95224,-57.92207,2018-09-22 20:00:00,29,1,30
"32645",10602,"Corner Brook","NL",48.95224,-57.92207,2018-09-22 21:00:00,28,2,30
"32646",10602,"Corner Brook","NL",48.95224,-57.92207,2018-09-22 22:00:00,28,1,29
"32647",10602,"Corner Brook","NL",48.95224,-57.92207,2018-09-22 23:00:00,27,1,28
"32648",10602,"Corner Brook","NL",48.95224,-57.92207,2018-09-23 00:00:00,26,4,30
"32649",10602,"Corner Brook","NL",48.95224,-57.92207,2018-09-23 01:00:00,27,4,31
"32650",10602,"Corner Brook","NL",48.95224,-57.92207,2018-09-23 02:00:00,27,3,30
"32651",10602,"Corner Brook","NL",48.95224,-57.92207,2018-09-23 03:00:00,25,4,29
"32652",10602,"Corner Brook","NL",48.95224,-57.92207,2018-09-23 04:00:00,24,3,27
"32653",10602,"Corner Brook","NL",48.95224,-57.92207,2018-09-23 05:00:00,23,3,26
"32654",10602,"Corner Brook","NL",48.95224,-57.92207,2018-09-23 06:00:00,24,2,26
"32655",10602,"Corner Brook","NL",48.95224,-57.92207,2018-09-23 07:00:00,20,4,24
"32656",10602,"Corner Brook","NL",48.95224,-57.92207,2018-09-23 08:00:00,21,2,23
"32657",10602,"Corner Brook","NL",48.95224,-57.92207,2018-09-23 09:00:00,24,1,25
"32658",10602,"Corner Brook","NL",48.95224,-57.92207,2018-09-23 10:00:00,27,1,28
"32659",10602,"Corner Brook","NL",48.95224,-57.92207,2018-09-23 11:00:00,27,1,28
"32660",10602,"Corner Brook","NL",48.95224,-57.92207,2018-09-23 12:00:00,28,1,29
"32661",10602,"Corner Brook","NL",48.95224,-57.92207,2018-09-23 13:00:00,29,1,30
"32662",10602,"Corner Brook","NL",48.95224,-57.92207,2018-09-23 14:00:00,29,1,30
"32663",10602,"Corner Brook","NL",48.95224,-57.92207,2018-09-23 15:00:00,28,1,29
"32664",10602,"Corner Brook","NL",48.95224,-57.92207,2018-09-23 16:00:00,26,1,27
"32665",10602,"Corner Brook","NL",48.95224,-57.92207,2018-09-23 17:00:00,22,3,25
"32666",10602,"Corner Brook","NL",48.95224,-57.92207,2018-09-23 18:00:00,23,3,26
"32667",10602,"Corner Brook","NL",48.95224,-57.92207,2018-09-23 19:00:00,25,1,26
"32668",10602,"Corner Brook","NL",48.95224,-57.92207,2018-09-23 20:00:00,23,2,25
"32669",10602,"Corner Brook","NL",48.95224,-57.92207,2018-09-23 21:00:00,22,2,24
"32670",10602,"Corner Brook","NL",48.95224,-57.92207,2018-09-23 22:00:00,20,5,25
"32671",10602,"Corner Brook","NL",48.95224,-57.92207,2018-09-23 23:00:00,18,8,26
"32672",10602,"Corner Brook","NL",48.95224,-57.92207,2018-09-24 00:00:00,20,4,24
"32673",10602,"Corner Brook","NL",48.95224,-57.92207,2018-09-24 01:00:00,18,4,22
"32674",10602,"Corner Brook","NL",48.95224,-57.92207,2018-09-24 02:00:00,17,3,20
"32675",10602,"Corner Brook","NL",48.95224,-57.92207,2018-09-24 03:00:00,18,2,20
"32676",10602,"Corner Brook","NL",48.95224,-57.92207,2018-09-24 04:00:00,19,5,24
"32677",10602,"Corner Brook","NL",48.95224,-57.92207,2018-09-24 05:00:00,19,3,22
"32678",10602,"Corner Brook","NL",48.95224,-57.92207,2018-09-24 06:00:00,18,4,22
"32679",10602,"Corner Brook","NL",48.95224,-57.92207,2018-09-24 07:00:00,16,5,21
"32680",10602,"Corner Brook","NL",48.95224,-57.92207,2018-09-24 08:00:00,18,5,23
"32681",10602,"Corner Brook","NL",48.95224,-57.92207,2018-09-24 09:00:00,23,2,25
"32682",10602,"Corner Brook","NL",48.95224,-57.92207,2018-09-24 10:00:00,24,1,25
"32683",10602,"Corner Brook","NL",48.95224,-57.92207,2018-09-24 11:00:00,24,1,25
"32684",10602,"Corner Brook","NL",48.95224,-57.92207,2018-09-24 12:00:00,25,1,26
"32685",10602,"Corner Brook","NL",48.95224,-57.92207,2018-09-24 13:00:00,25,1,26
"32686",10602,"Corner Brook","NL",48.95224,-57.92207,2018-09-24 14:00:00,25,1,26
"32687",10602,"Corner Brook","NL",48.95224,-57.92207,2018-09-24 15:00:00,25,1,26
"32688",10602,"Corner Brook","NL",48.95224,-57.92207,2018-09-24 16:00:00,26,1,27
"32689",10602,"Corner Brook","NL",48.95224,-57.92207,2018-09-24 17:00:00,24,1,25
"32690",10602,"Corner Brook","NL",48.95224,-57.92207,2018-09-24 18:00:00,24,2,26
"32691",10602,"Corner Brook","NL",48.95224,-57.92207,2018-09-24 19:00:00,22,3,25
"32692",10602,"Corner Brook","NL",48.95224,-57.92207,2018-09-24 20:00:00,20,4,24
"32693",10602,"Corner Brook","NL",48.95224,-57.92207,2018-09-24 21:00:00,17,5,22
"32694",10602,"Corner Brook","NL",48.95224,-57.92207,2018-09-24 22:00:00,22,2,24
"32695",10602,"Corner Brook","NL",48.95224,-57.92207,2018-09-24 23:00:00,25,1,26
"32696",10602,"Corner Brook","NL",48.95224,-57.92207,2018-09-25 00:00:00,23,2,25
"32697",10602,"Corner Brook","NL",48.95224,-57.92207,2018-09-25 01:00:00,22,2,24
"32698",10602,"Corner Brook","NL",48.95224,-57.92207,2018-09-25 02:00:00,22,2,24
"32699",10602,"Corner Brook","NL",48.95224,-57.92207,2018-09-25 03:00:00,18,3,21
"32700",10602,"Corner Brook","NL",48.95224,-57.92207,2018-09-25 04:00:00,14,4,18
"32701",10602,"Corner Brook","NL",48.95224,-57.92207,2018-09-25 05:00:00,15,4,19
"32702",10602,"Corner Brook","NL",48.95224,-57.92207,2018-09-25 06:00:00,19,4,23
"32703",10602,"Corner Brook","NL",48.95224,-57.92207,2018-09-25 07:00:00,12,11,23
"32704",10602,"Corner Brook","NL",48.95224,-57.92207,2018-09-25 08:00:00,17,8,25
"32705",10602,"Corner Brook","NL",48.95224,-57.92207,2018-09-25 09:00:00,22,4,26
"32706",10602,"Corner Brook","NL",48.95224,-57.92207,2018-09-25 10:00:00,26,2,28
"32707",10602,"Corner Brook","NL",48.95224,-57.92207,2018-09-25 11:00:00,26,4,30
"32708",10602,"Corner Brook","NL",48.95224,-57.92207,2018-09-25 12:00:00,28,3,31
"32709",10602,"Corner Brook","NL",48.95224,-57.92207,2018-09-25 13:00:00,27,2,29
"32710",10602,"Corner Brook","NL",48.95224,-57.92207,2018-09-25 14:00:00,26,2,28
"32711",10602,"Corner Brook","NL",48.95224,-57.92207,2018-09-25 15:00:00,26,2,28
"32712",10602,"Corner Brook","NL",48.95224,-57.92207,2018-09-25 16:00:00,26,3,29
"32713",10602,"Corner Brook","NL",48.95224,-57.92207,2018-09-25 17:00:00,25,3,28
"32714",10602,"Corner Brook","NL",48.95224,-57.92207,2018-09-25 18:00:00,23,4,27
"32715",10602,"Corner Brook","NL",48.95224,-57.92207,2018-09-25 19:00:00,19,3,22
"32716",10602,"Corner Brook","NL",48.95224,-57.92207,2018-09-25 20:00:00,16,6,22
"32717",10602,"Corner Brook","NL",48.95224,-57.92207,2018-09-25 21:00:00,20,3,23
"32718",10602,"Corner Brook","NL",48.95224,-57.92207,2018-09-25 22:00:00,22,2,24
"32719",10602,"Corner Brook","NL",48.95224,-57.92207,2018-09-25 23:00:00,22,2,24
"32720",10602,"Corner Brook","NL",48.95224,-57.92207,2018-09-26 00:00:00,21,2,23
"32721",10602,"Corner Brook","NL",48.95224,-57.92207,2018-09-26 01:00:00,23,1,24
"32722",10602,"Corner Brook","NL",48.95224,-57.92207,2018-09-26 02:00:00,21,2,23
"32723",10602,"Corner Brook","NL",48.95224,-57.92207,2018-09-26 03:00:00,22,2,24
"32724",10602,"Corner Brook","NL",48.95224,-57.92207,2018-09-26 04:00:00,19,3,22
"32725",10602,"Corner Brook","NL",48.95224,-57.92207,2018-09-26 05:00:00,22,2,24
"32726",10602,"Corner Brook","NL",48.95224,-57.92207,2018-09-26 06:00:00,23,2,25
"32727",10602,"Corner Brook","NL",48.95224,-57.92207,2018-09-26 07:00:00,22,2,24
"32728",10602,"Corner Brook","NL",48.95224,-57.92207,2018-09-26 08:00:00,23,3,26
"32729",10602,"Corner Brook","NL",48.95224,-57.92207,2018-09-26 09:00:00,26,2,28
"32730",10602,"Corner Brook","NL",48.95224,-57.92207,2018-09-26 10:00:00,28,1,29
"32731",10602,"Corner Brook","NL",48.95224,-57.92207,2018-09-26 11:00:00,29,1,30
"32732",10602,"Corner Brook","NL",48.95224,-57.92207,2018-09-26 12:00:00,33,1,34
"32733",10602,"Corner Brook","NL",48.95224,-57.92207,2018-09-26 13:00:00,35,1,36
"32734",10602,"Corner Brook","NL",48.95224,-57.92207,2018-09-26 14:00:00,33,1,34
"32735",10602,"Corner Brook","NL",48.95224,-57.92207,2018-09-26 15:00:00,32,1,33
"32736",10602,"Corner Brook","NL",48.95224,-57.92207,2018-09-26 16:00:00,31,1,32
"32737",10602,"Corner Brook","NL",48.95224,-57.92207,2018-09-26 17:00:00,32,2,34
"32738",10602,"Corner Brook","NL",48.95224,-57.92207,2018-09-26 18:00:00,32,2,34
"32739",10602,"Corner Brook","NL",48.95224,-57.92207,2018-09-26 19:00:00,31,2,33
"32740",10602,"Corner Brook","NL",48.95224,-57.92207,2018-09-26 20:00:00,32,1,33
"32741",10602,"Corner Brook","NL",48.95224,-57.92207,2018-09-26 21:00:00,32,1,33
"32742",10602,"Corner Brook","NL",48.95224,-57.92207,2018-09-26 22:00:00,33,1,34
"32743",10602,"Corner Brook","NL",48.95224,-57.92207,2018-09-26 23:00:00,33,1,34
"32744",10602,"Corner Brook","NL",48.95224,-57.92207,2018-09-27 00:00:00,34,1,35
"32745",10602,"Corner Brook","NL",48.95224,-57.92207,2018-09-27 01:00:00,34,1,35
"32746",10602,"Corner Brook","NL",48.95224,-57.92207,2018-09-27 02:00:00,34,1,35
"32747",10602,"Corner Brook","NL",48.95224,-57.92207,2018-09-27 03:00:00,34,1,35
"32748",10602,"Corner Brook","NL",48.95224,-57.92207,2018-09-27 04:00:00,33,1,34
"32749",10602,"Corner Brook","NL",48.95224,-57.92207,2018-09-27 05:00:00,31,1,32
"32750",10602,"Corner Brook","NL",48.95224,-57.92207,2018-09-27 06:00:00,30,1,31
"32751",10602,"Corner Brook","NL",48.95224,-57.92207,2018-09-27 07:00:00,29,1,30
"32752",10602,"Corner Brook","NL",48.95224,-57.92207,2018-09-27 08:00:00,29,1,30
"32753",10602,"Corner Brook","NL",48.95224,-57.92207,2018-09-27 09:00:00,29,2,31
"32754",10602,"Corner Brook","NL",48.95224,-57.92207,2018-09-27 10:00:00,28,4,32
"32755",10602,"Corner Brook","NL",48.95224,-57.92207,2018-09-27 11:00:00,26,2,28
"32756",10602,"Corner Brook","NL",48.95224,-57.92207,2018-09-27 12:00:00,25,2,27
"32757",10602,"Corner Brook","NL",48.95224,-57.92207,2018-09-27 13:00:00,24,2,26
"32758",10602,"Corner Brook","NL",48.95224,-57.92207,2018-09-27 14:00:00,19,6,25
"32759",10602,"Corner Brook","NL",48.95224,-57.92207,2018-09-27 15:00:00,21,7,28
"32760",10602,"Corner Brook","NL",48.95224,-57.92207,2018-09-27 16:00:00,17,13,30
"32761",10602,"Corner Brook","NL",48.95224,-57.92207,2018-09-27 17:00:00,23,2,25
"32762",10602,"Corner Brook","NL",48.95224,-57.92207,2018-09-27 18:00:00,22,3,25
"32763",10602,"Corner Brook","NL",48.95224,-57.92207,2018-09-27 19:00:00,18,4,22
"32764",10602,"Corner Brook","NL",48.95224,-57.92207,2018-09-27 20:00:00,18,4,22
"32765",10602,"Corner Brook","NL",48.95224,-57.92207,2018-09-27 21:00:00,15,4,19
"32766",10602,"Corner Brook","NL",48.95224,-57.92207,2018-09-27 22:00:00,10,4,14
"32767",10602,"Corner Brook","NL",48.95224,-57.92207,2018-09-27 23:00:00,7,5,12
"32768",10602,"Corner Brook","NL",48.95224,-57.92207,2018-09-28 00:00:00,5,5,10
"32769",10602,"Corner Brook","NL",48.95224,-57.92207,2018-09-28 01:00:00,6,4,10
"32770",10602,"Corner Brook","NL",48.95224,-57.92207,2018-09-28 02:00:00,5,4,9
"32771",10602,"Corner Brook","NL",48.95224,-57.92207,2018-09-28 03:00:00,5,4,9
"32772",10602,"Corner Brook","NL",48.95224,-57.92207,2018-09-28 04:00:00,4,4,8
"32773",10602,"Corner Brook","NL",48.95224,-57.92207,2018-09-28 05:00:00,3,4,7
"32774",10602,"Corner Brook","NL",48.95224,-57.92207,2018-09-28 06:00:00,3,5,8
"32775",10602,"Corner Brook","NL",48.95224,-57.92207,2018-09-28 07:00:00,3,6,9
"32776",10602,"Corner Brook","NL",48.95224,-57.92207,2018-09-28 08:00:00,7,5,12
"32777",10602,"Corner Brook","NL",48.95224,-57.92207,2018-09-28 09:00:00,9,6,15
"32778",10602,"Corner Brook","NL",48.95224,-57.92207,2018-09-28 10:00:00,12,4,16
"32779",10602,"Corner Brook","NL",48.95224,-57.92207,2018-09-28 11:00:00,11,4,15
"32780",10602,"Corner Brook","NL",48.95224,-57.92207,2018-09-28 12:00:00,13,3,16
"32781",10602,"Corner Brook","NL",48.95224,-57.92207,2018-09-28 13:00:00,15,3,18
"32782",10602,"Corner Brook","NL",48.95224,-57.92207,2018-09-28 14:00:00,16,4,20
"32783",10602,"Corner Brook","NL",48.95224,-57.92207,2018-09-28 15:00:00,17,4,21
"32784",10602,"Corner Brook","NL",48.95224,-57.92207,2018-09-28 16:00:00,17,4,21
"32785",10602,"Corner Brook","NL",48.95224,-57.92207,2018-09-28 17:00:00,18,2,20
"32786",10602,"Corner Brook","NL",48.95224,-57.92207,2018-09-28 18:00:00,17,3,20
"32787",10602,"Corner Brook","NL",48.95224,-57.92207,2018-09-28 19:00:00,18,2,20
"32788",10602,"Corner Brook","NL",48.95224,-57.92207,2018-09-28 20:00:00,18,1,19
"32789",10602,"Corner Brook","NL",48.95224,-57.92207,2018-09-28 21:00:00,19,1,20
"32790",10602,"Corner Brook","NL",48.95224,-57.92207,2018-09-28 22:00:00,20,1,21
"32791",10602,"Corner Brook","NL",48.95224,-57.92207,2018-09-28 23:00:00,19,1,20
"32792",10602,"Corner Brook","NL",48.95224,-57.92207,2018-09-29 00:00:00,19,1,20
"32793",10602,"Corner Brook","NL",48.95224,-57.92207,2018-09-29 01:00:00,19,1,20
"32794",10602,"Corner Brook","NL",48.95224,-57.92207,2018-09-29 02:00:00,18,1,19
"32795",10602,"Corner Brook","NL",48.95224,-57.92207,2018-09-29 03:00:00,19,1,20
"32796",10602,"Corner Brook","NL",48.95224,-57.92207,2018-09-29 04:00:00,19,2,21
"32797",10602,"Corner Brook","NL",48.95224,-57.92207,2018-09-29 05:00:00,22,2,24
"32798",10602,"Corner Brook","NL",48.95224,-57.92207,2018-09-29 06:00:00,20,2,22
"32799",10602,"Corner Brook","NL",48.95224,-57.92207,2018-09-29 07:00:00,22,2,24
"32800",10602,"Corner Brook","NL",48.95224,-57.92207,2018-09-29 08:00:00,23,1,24
"32801",10602,"Corner Brook","NL",48.95224,-57.92207,2018-09-29 09:00:00,22,1,23
"32802",10602,"Corner Brook","NL",48.95224,-57.92207,2018-09-29 10:00:00,21,1,22
"32803",10602,"Corner Brook","NL",48.95224,-57.92207,2018-09-29 11:00:00,21,1,22
"32804",10602,"Corner Brook","NL",48.95224,-57.92207,2018-09-29 12:00:00,21,1,22
"32805",10602,"Corner Brook","NL",48.95224,-57.92207,2018-09-29 13:00:00,21,1,22
"32806",10602,"Corner Brook","NL",48.95224,-57.92207,2018-09-29 14:00:00,21,1,22
"32807",10602,"Corner Brook","NL",48.95224,-57.92207,2018-09-29 15:00:00,19,2,21
"32808",10602,"Corner Brook","NL",48.95224,-57.92207,2018-09-29 16:00:00,20,2,22
"32809",10602,"Corner Brook","NL",48.95224,-57.92207,2018-09-29 17:00:00,22,2,24
"32810",10602,"Corner Brook","NL",48.95224,-57.92207,2018-09-29 18:00:00,21,2,23
"32811",10602,"Corner Brook","NL",48.95224,-57.92207,2018-09-29 19:00:00,23,2,25
"32812",10602,"Corner Brook","NL",48.95224,-57.92207,2018-09-29 20:00:00,26,2,28
"32813",10602,"Corner Brook","NL",48.95224,-57.92207,2018-09-29 21:00:00,23,2,25
"32814",10602,"Corner Brook","NL",48.95224,-57.92207,2018-09-29 22:00:00,19,6,25
"32815",10602,"Corner Brook","NL",48.95224,-57.92207,2018-09-29 23:00:00,18,3,21
"32816",10602,"Corner Brook","NL",48.95224,-57.92207,2018-09-30 00:00:00,18,3,21
"32817",10602,"Corner Brook","NL",48.95224,-57.92207,2018-09-30 01:00:00,18,2,20
"32818",10602,"Corner Brook","NL",48.95224,-57.92207,2018-09-30 02:00:00,19,2,21
"32819",10602,"Corner Brook","NL",48.95224,-57.92207,2018-09-30 03:00:00,23,2,25
"32820",10602,"Corner Brook","NL",48.95224,-57.92207,2018-09-30 04:00:00,20,3,23
"32821",10602,"Corner Brook","NL",48.95224,-57.92207,2018-09-30 05:00:00,20,2,22
"32822",10602,"Corner Brook","NL",48.95224,-57.92207,2018-09-30 06:00:00,17,3,20
"32823",10602,"Corner Brook","NL",48.95224,-57.92207,2018-09-30 07:00:00,12,7,19
"32824",10602,"Corner Brook","NL",48.95224,-57.92207,2018-09-30 08:00:00,18,4,22
"32825",10602,"Corner Brook","NL",48.95224,-57.92207,2018-09-30 09:00:00,19,2,21
"32826",10602,"Corner Brook","NL",48.95224,-57.92207,2018-09-30 10:00:00,21,3,24
"32827",10602,"Corner Brook","NL",48.95224,-57.92207,2018-09-30 11:00:00,21,5,26
"32828",10602,"Corner Brook","NL",48.95224,-57.92207,2018-09-30 12:00:00,23,5,28
"32829",10602,"Corner Brook","NL",48.95224,-57.92207,2018-09-30 13:00:00,24,5,29
"32830",10602,"Corner Brook","NL",48.95224,-57.92207,2018-09-30 14:00:00,26,3,29
"32831",10602,"Corner Brook","NL",48.95224,-57.92207,2018-09-30 15:00:00,23,7,30
"32832",10602,"Corner Brook","NL",48.95224,-57.92207,2018-09-30 16:00:00,20,10,30
"32833",10602,"Corner Brook","NL",48.95224,-57.92207,2018-09-30 17:00:00,25,5,30
"32834",10602,"Corner Brook","NL",48.95224,-57.92207,2018-09-30 18:00:00,25,2,27
"32835",10602,"Corner Brook","NL",48.95224,-57.92207,2018-09-30 19:00:00,20,4,24
"32836",10602,"Corner Brook","NL",48.95224,-57.92207,2018-09-30 20:00:00,13,6,19
"32837",10602,"Corner Brook","NL",48.95224,-57.92207,2018-09-30 21:00:00,9,6,15
"32838",10602,"Corner Brook","NL",48.95224,-57.92207,2018-09-30 22:00:00,9,5,14
"32839",10602,"Corner Brook","NL",48.95224,-57.92207,2018-09-30 23:00:00,7,5,12
"32840",10602,"Corner Brook","NL",48.95224,-57.92207,2018-10-01 00:00:00,8,4,12
"32841",10602,"Corner Brook","NL",48.95224,-57.92207,2018-10-01 01:00:00,5,4,9
"32842",10602,"Corner Brook","NL",48.95224,-57.92207,2018-10-01 02:00:00,5,5,10
"32843",10602,"Corner Brook","NL",48.95224,-57.92207,2018-10-01 03:00:00,5,5,10
"32844",10602,"Corner Brook","NL",48.95224,-57.92207,2018-10-01 04:00:00,5,5,10
"32845",10602,"Corner Brook","NL",48.95224,-57.92207,2018-10-01 05:00:00,5,4,9
"32846",10602,"Corner Brook","NL",48.95224,-57.92207,2018-10-01 06:00:00,5,5,10
"32847",10602,"Corner Brook","NL",48.95224,-57.92207,2018-10-01 07:00:00,5,6,11
"32848",10602,"Corner Brook","NL",48.95224,-57.92207,2018-10-01 08:00:00,6,7,13
"32849",10602,"Corner Brook","NL",48.95224,-57.92207,2018-10-01 09:00:00,6,8,14
"32850",10602,"Corner Brook","NL",48.95224,-57.92207,2018-10-01 10:00:00,20,2,22
"32851",10602,"Corner Brook","NL",48.95224,-57.92207,2018-10-01 11:00:00,20,2,22
"32852",10602,"Corner Brook","NL",48.95224,-57.92207,2018-10-01 12:00:00,23,1,24
"32853",10602,"Corner Brook","NL",48.95224,-57.92207,2018-10-01 13:00:00,NA,11,NA
"32854",10602,"Corner Brook","NL",48.95224,-57.92207,2018-10-01 14:00:00,17,20,37
"32855",10602,"Corner Brook","NL",48.95224,-57.92207,2018-10-01 15:00:00,24,7,31
"32856",10602,"Corner Brook","NL",48.95224,-57.92207,2018-10-01 16:00:00,26,1,27
"32857",10602,"Corner Brook","NL",48.95224,-57.92207,2018-10-01 17:00:00,25,1,26
"32858",10602,"Corner Brook","NL",48.95224,-57.92207,2018-10-01 18:00:00,22,4,26
"32859",10602,"Corner Brook","NL",48.95224,-57.92207,2018-10-01 19:00:00,22,3,25
"32860",10602,"Corner Brook","NL",48.95224,-57.92207,2018-10-01 20:00:00,19,2,21
"32861",10602,"Corner Brook","NL",48.95224,-57.92207,2018-10-01 21:00:00,18,2,20
"32862",10602,"Corner Brook","NL",48.95224,-57.92207,2018-10-01 22:00:00,16,3,19
"32863",10602,"Corner Brook","NL",48.95224,-57.92207,2018-10-01 23:00:00,15,4,19
"32864",10602,"Corner Brook","NL",48.95224,-57.92207,2018-10-02 00:00:00,16,3,19
"32865",10602,"Corner Brook","NL",48.95224,-57.92207,2018-10-02 01:00:00,17,3,20
"32866",10602,"Corner Brook","NL",48.95224,-57.92207,2018-10-02 02:00:00,18,2,20
"32867",10602,"Corner Brook","NL",48.95224,-57.92207,2018-10-02 03:00:00,20,2,22
"32868",10602,"Corner Brook","NL",48.95224,-57.92207,2018-10-02 04:00:00,16,2,18
"32869",10602,"Corner Brook","NL",48.95224,-57.92207,2018-10-02 05:00:00,18,2,20
"32870",10602,"Corner Brook","NL",48.95224,-57.92207,2018-10-02 06:00:00,15,3,18
"32871",10602,"Corner Brook","NL",48.95224,-57.92207,2018-10-02 07:00:00,6,11,17
"32872",10602,"Corner Brook","NL",48.95224,-57.92207,2018-10-02 08:00:00,5,12,17
"32873",10602,"Corner Brook","NL",48.95224,-57.92207,2018-10-02 09:00:00,13,10,23
"32874",10602,"Corner Brook","NL",48.95224,-57.92207,2018-10-02 10:00:00,21,4,25
"32875",10602,"Corner Brook","NL",48.95224,-57.92207,2018-10-02 11:00:00,25,3,28
"32876",10602,"Corner Brook","NL",48.95224,-57.92207,2018-10-02 12:00:00,27,3,30
"32877",10602,"Corner Brook","NL",48.95224,-57.92207,2018-10-02 13:00:00,26,3,29
"32878",10602,"Corner Brook","NL",48.95224,-57.92207,2018-10-02 14:00:00,25,4,29
"32879",10602,"Corner Brook","NL",48.95224,-57.92207,2018-10-02 15:00:00,26,2,28
"32880",10602,"Corner Brook","NL",48.95224,-57.92207,2018-10-02 16:00:00,26,2,28
"32881",10602,"Corner Brook","NL",48.95224,-57.92207,2018-10-02 17:00:00,25,2,27
"32882",10602,"Corner Brook","NL",48.95224,-57.92207,2018-10-02 18:00:00,25,2,27
"32883",10602,"Corner Brook","NL",48.95224,-57.92207,2018-10-02 19:00:00,19,5,24
"32884",10602,"Corner Brook","NL",48.95224,-57.92207,2018-10-02 20:00:00,14,6,20
"32885",10602,"Corner Brook","NL",48.95224,-57.92207,2018-10-02 21:00:00,11,6,17
"32886",10602,"Corner Brook","NL",48.95224,-57.92207,2018-10-02 22:00:00,10,5,15
"32887",10602,"Corner Brook","NL",48.95224,-57.92207,2018-10-02 23:00:00,9,5,14
"32888",10602,"Corner Brook","NL",48.95224,-57.92207,2018-10-03 00:00:00,9,4,13
"32889",10602,"Corner Brook","NL",48.95224,-57.92207,2018-10-03 01:00:00,9,4,13
"32890",10602,"Corner Brook","NL",48.95224,-57.92207,2018-10-03 02:00:00,7,5,12
"32891",10602,"Corner Brook","NL",48.95224,-57.92207,2018-10-03 03:00:00,5,5,10
"32892",10602,"Corner Brook","NL",48.95224,-57.92207,2018-10-03 04:00:00,6,4,10
"32893",10602,"Corner Brook","NL",48.95224,-57.92207,2018-10-03 05:00:00,6,4,10
"32894",10602,"Corner Brook","NL",48.95224,-57.92207,2018-10-03 06:00:00,4,5,9
"32895",10602,"Corner Brook","NL",48.95224,-57.92207,2018-10-03 07:00:00,2,9,11
"32896",10602,"Corner Brook","NL",48.95224,-57.92207,2018-10-03 08:00:00,2,8,10
"32897",10602,"Corner Brook","NL",48.95224,-57.92207,2018-10-03 09:00:00,4,9,13
"32898",10602,"Corner Brook","NL",48.95224,-57.92207,2018-10-03 10:00:00,6,9,15
"32899",10602,"Corner Brook","NL",48.95224,-57.92207,2018-10-03 11:00:00,8,7,15
"32900",10602,"Corner Brook","NL",48.95224,-57.92207,2018-10-03 12:00:00,20,3,23
"32901",10602,"Corner Brook","NL",48.95224,-57.92207,2018-10-03 13:00:00,24,1,25
"32902",10602,"Corner Brook","NL",48.95224,-57.92207,2018-10-03 14:00:00,24,2,26
"32903",10602,"Corner Brook","NL",48.95224,-57.92207,2018-10-03 15:00:00,27,2,29
"32904",10602,"Corner Brook","NL",48.95224,-57.92207,2018-10-03 16:00:00,26,2,28
"32905",10602,"Corner Brook","NL",48.95224,-57.92207,2018-10-03 17:00:00,26,2,28
"32906",10602,"Corner Brook","NL",48.95224,-57.92207,2018-10-03 18:00:00,26,2,28
"32907",10602,"Corner Brook","NL",48.95224,-57.92207,2018-10-03 19:00:00,26,2,28
"32908",10602,"Corner Brook","NL",48.95224,-57.92207,2018-10-03 20:00:00,26,2,28
"32909",10602,"Corner Brook","NL",48.95224,-57.92207,2018-10-03 21:00:00,27,2,29
"32910",10602,"Corner Brook","NL",48.95224,-57.92207,2018-10-03 22:00:00,25,2,27
"32911",10602,"Corner Brook","NL",48.95224,-57.92207,2018-10-03 23:00:00,25,1,26
"32912",10602,"Corner Brook","NL",48.95224,-57.92207,2018-10-04 00:00:00,26,1,27
"32913",10602,"Corner Brook","NL",48.95224,-57.92207,2018-10-04 01:00:00,26,1,27
"32914",10602,"Corner Brook","NL",48.95224,-57.92207,2018-10-04 02:00:00,27,1,28
"32915",10602,"Corner Brook","NL",48.95224,-57.92207,2018-10-04 03:00:00,28,1,29
"32916",10602,"Corner Brook","NL",48.95224,-57.92207,2018-10-04 04:00:00,27,1,28
"32917",10602,"Corner Brook","NL",48.95224,-57.92207,2018-10-04 05:00:00,26,1,27
"32918",10602,"Corner Brook","NL",48.95224,-57.92207,2018-10-04 06:00:00,26,2,28
"32919",10602,"Corner Brook","NL",48.95224,-57.92207,2018-10-04 07:00:00,26,2,28
"32920",10602,"Corner Brook","NL",48.95224,-57.92207,2018-10-04 08:00:00,25,3,28
"32921",10602,"Corner Brook","NL",48.95224,-57.92207,2018-10-04 09:00:00,25,2,27
"32922",10602,"Corner Brook","NL",48.95224,-57.92207,2018-10-04 10:00:00,27,1,28
"32923",10602,"Corner Brook","NL",48.95224,-57.92207,2018-10-04 11:00:00,29,1,30
"32924",10602,"Corner Brook","NL",48.95224,-57.92207,2018-10-04 12:00:00,30,1,31
"32925",10602,"Corner Brook","NL",48.95224,-57.92207,2018-10-04 13:00:00,32,1,33
"32926",10602,"Corner Brook","NL",48.95224,-57.92207,2018-10-04 14:00:00,35,1,36
"32927",10602,"Corner Brook","NL",48.95224,-57.92207,2018-10-04 15:00:00,35,1,36
"32928",10602,"Corner Brook","NL",48.95224,-57.92207,2018-10-04 16:00:00,32,1,33
"32929",10602,"Corner Brook","NL",48.95224,-57.92207,2018-10-04 17:00:00,30,2,32
"32930",10602,"Corner Brook","NL",48.95224,-57.92207,2018-10-04 18:00:00,30,1,31
"32931",10602,"Corner Brook","NL",48.95224,-57.92207,2018-10-04 19:00:00,30,1,31
"32932",10602,"Corner Brook","NL",48.95224,-57.92207,2018-10-04 20:00:00,29,1,30
"32933",10602,"Corner Brook","NL",48.95224,-57.92207,2018-10-04 21:00:00,31,1,32
"32934",10602,"Corner Brook","NL",48.95224,-57.92207,2018-10-04 22:00:00,31,1,32
"32935",10602,"Corner Brook","NL",48.95224,-57.92207,2018-10-04 23:00:00,31,1,32
"32936",10602,"Corner Brook","NL",48.95224,-57.92207,2018-10-05 00:00:00,32,1,33
"32937",10602,"Corner Brook","NL",48.95224,-57.92207,2018-10-05 01:00:00,32,1,33
"32938",10602,"Corner Brook","NL",48.95224,-57.92207,2018-10-05 02:00:00,31,1,32
"32939",10602,"Corner Brook","NL",48.95224,-57.92207,2018-10-05 03:00:00,27,1,28
"32940",10602,"Corner Brook","NL",48.95224,-57.92207,2018-10-05 04:00:00,21,1,22
"32941",10602,"Corner Brook","NL",48.95224,-57.92207,2018-10-05 05:00:00,17,3,20
"32942",10602,"Corner Brook","NL",48.95224,-57.92207,2018-10-05 06:00:00,25,2,27
"32943",10602,"Corner Brook","NL",48.95224,-57.92207,2018-10-05 07:00:00,20,3,23
"32944",10602,"Corner Brook","NL",48.95224,-57.92207,2018-10-05 08:00:00,22,4,26
"32945",10602,"Corner Brook","NL",48.95224,-57.92207,2018-10-05 09:00:00,25,2,27
"32946",10602,"Corner Brook","NL",48.95224,-57.92207,2018-10-05 10:00:00,26,2,28
"32947",10602,"Corner Brook","NL",48.95224,-57.92207,2018-10-05 11:00:00,25,1,26
"32948",10602,"Corner Brook","NL",48.95224,-57.92207,2018-10-05 12:00:00,26,1,27
"32949",10602,"Corner Brook","NL",48.95224,-57.92207,2018-10-05 13:00:00,21,NA,NA
"32950",10602,"Corner Brook","NL",48.95224,-57.92207,2018-10-05 14:00:00,26,NA,NA
"32951",10602,"Corner Brook","NL",48.95224,-57.92207,2018-10-05 15:00:00,26,1,27
"32952",10602,"Corner Brook","NL",48.95224,-57.92207,2018-10-05 16:00:00,25,1,26
"32953",10602,"Corner Brook","NL",48.95224,-57.92207,2018-10-05 17:00:00,25,2,27
"32954",10602,"Corner Brook","NL",48.95224,-57.92207,2018-10-05 18:00:00,23,3,26
"32955",10602,"Corner Brook","NL",48.95224,-57.92207,2018-10-05 19:00:00,19,4,23
"32956",10602,"Corner Brook","NL",48.95224,-57.92207,2018-10-05 20:00:00,20,3,23
"32957",10602,"Corner Brook","NL",48.95224,-57.92207,2018-10-05 21:00:00,20,3,23
"32958",10602,"Corner Brook","NL",48.95224,-57.92207,2018-10-05 22:00:00,21,4,25
"32959",10602,"Corner Brook","NL",48.95224,-57.92207,2018-10-05 23:00:00,23,2,25
"32960",10602,"Corner Brook","NL",48.95224,-57.92207,2018-10-06 00:00:00,21,1,22
"32961",10602,"Corner Brook","NL",48.95224,-57.92207,2018-10-06 01:00:00,20,3,23
"32962",10602,"Corner Brook","NL",48.95224,-57.92207,2018-10-06 02:00:00,24,2,26
"32963",10602,"Corner Brook","NL",48.95224,-57.92207,2018-10-06 03:00:00,22,3,25
"32964",10602,"Corner Brook","NL",48.95224,-57.92207,2018-10-06 04:00:00,21,3,24
"32965",10602,"Corner Brook","NL",48.95224,-57.92207,2018-10-06 05:00:00,19,2,21
"32966",10602,"Corner Brook","NL",48.95224,-57.92207,2018-10-06 06:00:00,20,2,22
"32967",10602,"Corner Brook","NL",48.95224,-57.92207,2018-10-06 07:00:00,19,3,22
"32968",10602,"Corner Brook","NL",48.95224,-57.92207,2018-10-06 08:00:00,18,3,21
"32969",10602,"Corner Brook","NL",48.95224,-57.92207,2018-10-06 09:00:00,21,3,24
"32970",10602,"Corner Brook","NL",48.95224,-57.92207,2018-10-06 10:00:00,25,1,26
"32971",10602,"Corner Brook","NL",48.95224,-57.92207,2018-10-06 11:00:00,25,1,26
"32972",10602,"Corner Brook","NL",48.95224,-57.92207,2018-10-06 12:00:00,25,1,26
"32973",10602,"Corner Brook","NL",48.95224,-57.92207,2018-10-06 13:00:00,24,1,25
"32974",10602,"Corner Brook","NL",48.95224,-57.92207,2018-10-06 14:00:00,26,1,27
"32975",10602,"Corner Brook","NL",48.95224,-57.92207,2018-10-06 15:00:00,27,1,28
"32976",10602,"Corner Brook","NL",48.95224,-57.92207,2018-10-06 16:00:00,28,1,29
"32977",10602,"Corner Brook","NL",48.95224,-57.92207,2018-10-06 17:00:00,29,1,30
"32978",10602,"Corner Brook","NL",48.95224,-57.92207,2018-10-06 18:00:00,29,1,30
"32979",10602,"Corner Brook","NL",48.95224,-57.92207,2018-10-06 19:00:00,24,3,27
"32980",10602,"Corner Brook","NL",48.95224,-57.92207,2018-10-06 20:00:00,22,4,26
"32981",10602,"Corner Brook","NL",48.95224,-57.92207,2018-10-06 21:00:00,20,3,23
"32982",10602,"Corner Brook","NL",48.95224,-57.92207,2018-10-06 22:00:00,19,4,23
"32983",10602,"Corner Brook","NL",48.95224,-57.92207,2018-10-06 23:00:00,19,3,22
"32984",10602,"Corner Brook","NL",48.95224,-57.92207,2018-10-07 00:00:00,20,2,22
"32985",10602,"Corner Brook","NL",48.95224,-57.92207,2018-10-07 01:00:00,15,3,18
"32986",10602,"Corner Brook","NL",48.95224,-57.92207,2018-10-07 02:00:00,14,3,17
"32987",10602,"Corner Brook","NL",48.95224,-57.92207,2018-10-07 03:00:00,15,3,18
"32988",10602,"Corner Brook","NL",48.95224,-57.92207,2018-10-07 04:00:00,17,2,19
"32989",10602,"Corner Brook","NL",48.95224,-57.92207,2018-10-07 05:00:00,17,2,19
"32990",10602,"Corner Brook","NL",48.95224,-57.92207,2018-10-07 06:00:00,16,2,18
"32991",10602,"Corner Brook","NL",48.95224,-57.92207,2018-10-07 07:00:00,15,2,17
"32992",10602,"Corner Brook","NL",48.95224,-57.92207,2018-10-07 08:00:00,15,4,19
"32993",10602,"Corner Brook","NL",48.95224,-57.92207,2018-10-07 09:00:00,17,5,22
"32994",10602,"Corner Brook","NL",48.95224,-57.92207,2018-10-07 10:00:00,21,3,24
"32995",10602,"Corner Brook","NL",48.95224,-57.92207,2018-10-07 11:00:00,24,3,27
"32996",10602,"Corner Brook","NL",48.95224,-57.92207,2018-10-07 12:00:00,28,2,30
"32997",10602,"Corner Brook","NL",48.95224,-57.92207,2018-10-07 13:00:00,29,1,30
"32998",10602,"Corner Brook","NL",48.95224,-57.92207,2018-10-07 14:00:00,27,2,29
"32999",10602,"Corner Brook","NL",48.95224,-57.92207,2018-10-07 15:00:00,28,2,30
"33000",10602,"Corner Brook","NL",48.95224,-57.92207,2018-10-07 16:00:00,26,2,28
"33001",10602,"Corner Brook","NL",48.95224,-57.92207,2018-10-07 17:00:00,26,2,28
"33002",10602,"Corner Brook","NL",48.95224,-57.92207,2018-10-07 18:00:00,26,2,28
"33003",10602,"Corner Brook","NL",48.95224,-57.92207,2018-10-07 19:00:00,25,2,27
"33004",10602,"Corner Brook","NL",48.95224,-57.92207,2018-10-07 20:00:00,23,3,26
"33005",10602,"Corner Brook","NL",48.95224,-57.92207,2018-10-07 21:00:00,20,3,23
"33006",10602,"Corner Brook","NL",48.95224,-57.92207,2018-10-07 22:00:00,23,3,26
"33007",10602,"Corner Brook","NL",48.95224,-57.92207,2018-10-07 23:00:00,19,4,23
"33008",10602,"Corner Brook","NL",48.95224,-57.92207,2018-10-08 00:00:00,15,4,19
"33009",10602,"Corner Brook","NL",48.95224,-57.92207,2018-10-08 01:00:00,15,3,18
"33010",10602,"Corner Brook","NL",48.95224,-57.92207,2018-10-08 02:00:00,15,3,18
"33011",10602,"Corner Brook","NL",48.95224,-57.92207,2018-10-08 03:00:00,16,3,19
"33012",10602,"Corner Brook","NL",48.95224,-57.92207,2018-10-08 04:00:00,15,4,19
"33013",10602,"Corner Brook","NL",48.95224,-57.92207,2018-10-08 05:00:00,14,3,17
"33014",10602,"Corner Brook","NL",48.95224,-57.92207,2018-10-08 06:00:00,12,5,17
"33015",10602,"Corner Brook","NL",48.95224,-57.92207,2018-10-08 07:00:00,10,7,17
"33016",10602,"Corner Brook","NL",48.95224,-57.92207,2018-10-08 08:00:00,8,10,18
"33017",10602,"Corner Brook","NL",48.95224,-57.92207,2018-10-08 09:00:00,17,6,23
"33018",10602,"Corner Brook","NL",48.95224,-57.92207,2018-10-08 10:00:00,21,5,26
"33019",10602,"Corner Brook","NL",48.95224,-57.92207,2018-10-08 11:00:00,27,1,28
"33020",10602,"Corner Brook","NL",48.95224,-57.92207,2018-10-08 12:00:00,27,1,28
"33021",10602,"Corner Brook","NL",48.95224,-57.92207,2018-10-08 13:00:00,28,1,29
"33022",10602,"Corner Brook","NL",48.95224,-57.92207,2018-10-08 14:00:00,28,1,29
"33023",10602,"Corner Brook","NL",48.95224,-57.92207,2018-10-08 15:00:00,28,1,29
"33024",10602,"Corner Brook","NL",48.95224,-57.92207,2018-10-08 16:00:00,28,1,29
"33025",10602,"Corner Brook","NL",48.95224,-57.92207,2018-10-08 17:00:00,29,1,30
"33026",10602,"Corner Brook","NL",48.95224,-57.92207,2018-10-08 18:00:00,28,2,30
"33027",10602,"Corner Brook","NL",48.95224,-57.92207,2018-10-08 19:00:00,26,3,29
"33028",10602,"Corner Brook","NL",48.95224,-57.92207,2018-10-08 20:00:00,25,3,28
"33029",10602,"Corner Brook","NL",48.95224,-57.92207,2018-10-08 21:00:00,24,3,27
"33030",10602,"Corner Brook","NL",48.95224,-57.92207,2018-10-08 22:00:00,24,3,27
"33031",10602,"Corner Brook","NL",48.95224,-57.92207,2018-10-08 23:00:00,24,3,27
"33032",10602,"Corner Brook","NL",48.95224,-57.92207,2018-10-09 00:00:00,22,3,25
"33033",10602,"Corner Brook","NL",48.95224,-57.92207,2018-10-09 01:00:00,23,2,25
"33034",10602,"Corner Brook","NL",48.95224,-57.92207,2018-10-09 02:00:00,21,2,23
"33035",10602,"Corner Brook","NL",48.95224,-57.92207,2018-10-09 03:00:00,19,3,22
"33036",10602,"Corner Brook","NL",48.95224,-57.92207,2018-10-09 04:00:00,20,3,23
"33037",10602,"Corner Brook","NL",48.95224,-57.92207,2018-10-09 05:00:00,20,3,23
"33038",10602,"Corner Brook","NL",48.95224,-57.92207,2018-10-09 06:00:00,20,2,22
"33039",10602,"Corner Brook","NL",48.95224,-57.92207,2018-10-09 07:00:00,19,2,21
"33040",10602,"Corner Brook","NL",48.95224,-57.92207,2018-10-09 08:00:00,19,3,22
"33041",10602,"Corner Brook","NL",48.95224,-57.92207,2018-10-09 09:00:00,18,4,22
"33042",10602,"Corner Brook","NL",48.95224,-57.92207,2018-10-09 10:00:00,20,2,22
"33043",10602,"Corner Brook","NL",48.95224,-57.92207,2018-10-09 11:00:00,23,1,24
"33044",10602,"Corner Brook","NL",48.95224,-57.92207,2018-10-09 12:00:00,22,2,24
"33045",10602,"Corner Brook","NL",48.95224,-57.92207,2018-10-09 13:00:00,22,2,24
"33046",10602,"Corner Brook","NL",48.95224,-57.92207,2018-10-09 14:00:00,21,2,23
"33047",10602,"Corner Brook","NL",48.95224,-57.92207,2018-10-09 15:00:00,20,3,23
"33048",10602,"Corner Brook","NL",48.95224,-57.92207,2018-10-09 16:00:00,18,4,22
"33049",10602,"Corner Brook","NL",48.95224,-57.92207,2018-10-09 17:00:00,18,4,22
"33050",10602,"Corner Brook","NL",48.95224,-57.92207,2018-10-09 18:00:00,17,4,21
"33051",10602,"Corner Brook","NL",48.95224,-57.92207,2018-10-09 19:00:00,17,4,21
"33052",10602,"Corner Brook","NL",48.95224,-57.92207,2018-10-09 20:00:00,18,3,21
"33053",10602,"Corner Brook","NL",48.95224,-57.92207,2018-10-09 21:00:00,19,2,21
"33054",10602,"Corner Brook","NL",48.95224,-57.92207,2018-10-09 22:00:00,16,3,19
"33055",10602,"Corner Brook","NL",48.95224,-57.92207,2018-10-09 23:00:00,16,3,19
"33056",10602,"Corner Brook","NL",48.95224,-57.92207,2018-10-10 00:00:00,15,2,17
"33057",10602,"Corner Brook","NL",48.95224,-57.92207,2018-10-10 01:00:00,15,3,18
"33058",10602,"Corner Brook","NL",48.95224,-57.92207,2018-10-10 02:00:00,15,2,17
"33059",10602,"Corner Brook","NL",48.95224,-57.92207,2018-10-10 03:00:00,14,3,17
"33060",10602,"Corner Brook","NL",48.95224,-57.92207,2018-10-10 04:00:00,15,3,18
"33061",10602,"Corner Brook","NL",48.95224,-57.92207,2018-10-10 05:00:00,15,2,17
"33062",10602,"Corner Brook","NL",48.95224,-57.92207,2018-10-10 06:00:00,15,3,18
"33063",10602,"Corner Brook","NL",48.95224,-57.92207,2018-10-10 07:00:00,21,3,24
"33064",10602,"Corner Brook","NL",48.95224,-57.92207,2018-10-10 08:00:00,20,6,26
"33065",10602,"Corner Brook","NL",48.95224,-57.92207,2018-10-10 09:00:00,25,3,28
"33066",10602,"Corner Brook","NL",48.95224,-57.92207,2018-10-10 10:00:00,26,2,28
"33067",10602,"Corner Brook","NL",48.95224,-57.92207,2018-10-10 11:00:00,29,2,31
"33068",10602,"Corner Brook","NL",48.95224,-57.92207,2018-10-10 12:00:00,26,2,28
"33069",10602,"Corner Brook","NL",48.95224,-57.92207,2018-10-10 13:00:00,23,2,25
"33070",10602,"Corner Brook","NL",48.95224,-57.92207,2018-10-10 14:00:00,22,2,24
"33071",10602,"Corner Brook","NL",48.95224,-57.92207,2018-10-10 15:00:00,21,2,23
"33072",10602,"Corner Brook","NL",48.95224,-57.92207,2018-10-10 16:00:00,20,2,22
"33073",10602,"Corner Brook","NL",48.95224,-57.92207,2018-10-10 17:00:00,22,2,24
"33074",10602,"Corner Brook","NL",48.95224,-57.92207,2018-10-10 18:00:00,21,4,25
"33075",10602,"Corner Brook","NL",48.95224,-57.92207,2018-10-10 19:00:00,26,3,29
"33076",10602,"Corner Brook","NL",48.95224,-57.92207,2018-10-10 20:00:00,28,3,31
"33077",10602,"Corner Brook","NL",48.95224,-57.92207,2018-10-10 21:00:00,27,2,29
"33078",10602,"Corner Brook","NL",48.95224,-57.92207,2018-10-10 22:00:00,27,2,29
"33079",10602,"Corner Brook","NL",48.95224,-57.92207,2018-10-10 23:00:00,27,3,30
"33080",10602,"Corner Brook","NL",48.95224,-57.92207,2018-10-11 00:00:00,28,3,31
"33081",10602,"Corner Brook","NL",48.95224,-57.92207,2018-10-11 01:00:00,26,3,29
"33082",10602,"Corner Brook","NL",48.95224,-57.92207,2018-10-11 02:00:00,26,2,28
"33083",10602,"Corner Brook","NL",48.95224,-57.92207,2018-10-11 03:00:00,22,3,25
"33084",10602,"Corner Brook","NL",48.95224,-57.92207,2018-10-11 04:00:00,23,3,26
"33085",10602,"Corner Brook","NL",48.95224,-57.92207,2018-10-11 05:00:00,26,3,29
"33086",10602,"Corner Brook","NL",48.95224,-57.92207,2018-10-11 06:00:00,26,3,29
"33087",10602,"Corner Brook","NL",48.95224,-57.92207,2018-10-11 07:00:00,26,4,30
"33088",10602,"Corner Brook","NL",48.95224,-57.92207,2018-10-11 08:00:00,25,6,31
"33089",10602,"Corner Brook","NL",48.95224,-57.92207,2018-10-11 09:00:00,29,4,33
"33090",10602,"Corner Brook","NL",48.95224,-57.92207,2018-10-11 10:00:00,30,2,32
"33091",10602,"Corner Brook","NL",48.95224,-57.92207,2018-10-11 11:00:00,30,2,32
"33092",10602,"Corner Brook","NL",48.95224,-57.92207,2018-10-11 12:00:00,30,3,33
"33093",10602,"Corner Brook","NL",48.95224,-57.92207,2018-10-11 13:00:00,29,3,32
"33094",10602,"Corner Brook","NL",48.95224,-57.92207,2018-10-11 14:00:00,31,2,33
"33095",10602,"Corner Brook","NL",48.95224,-57.92207,2018-10-11 15:00:00,30,3,33
"33096",10602,"Corner Brook","NL",48.95224,-57.92207,2018-10-11 16:00:00,29,3,32
"33097",10602,"Corner Brook","NL",48.95224,-57.92207,2018-10-11 17:00:00,28,3,31
"33098",10602,"Corner Brook","NL",48.95224,-57.92207,2018-10-11 18:00:00,25,4,29
"33099",10602,"Corner Brook","NL",48.95224,-57.92207,2018-10-11 19:00:00,22,5,27
"33100",10602,"Corner Brook","NL",48.95224,-57.92207,2018-10-11 20:00:00,22,4,26
"33101",10602,"Corner Brook","NL",48.95224,-57.92207,2018-10-11 21:00:00,17,7,24
"33102",10602,"Corner Brook","NL",48.95224,-57.92207,2018-10-11 22:00:00,13,7,20
"33103",10602,"Corner Brook","NL",48.95224,-57.92207,2018-10-11 23:00:00,24,3,27
"33104",10602,"Corner Brook","NL",48.95224,-57.92207,2018-10-12 00:00:00,25,2,27
"33105",10602,"Corner Brook","NL",48.95224,-57.92207,2018-10-12 01:00:00,23,2,25
"33106",10602,"Corner Brook","NL",48.95224,-57.92207,2018-10-12 02:00:00,24,1,25
"33107",10602,"Corner Brook","NL",48.95224,-57.92207,2018-10-12 03:00:00,24,1,25
"33108",10602,"Corner Brook","NL",48.95224,-57.92207,2018-10-12 04:00:00,22,4,26
"33109",10602,"Corner Brook","NL",48.95224,-57.92207,2018-10-12 05:00:00,23,2,25
"33110",10602,"Corner Brook","NL",48.95224,-57.92207,2018-10-12 06:00:00,22,3,25
"33111",10602,"Corner Brook","NL",48.95224,-57.92207,2018-10-12 07:00:00,21,3,24
"33112",10602,"Corner Brook","NL",48.95224,-57.92207,2018-10-12 08:00:00,22,2,24
"33113",10602,"Corner Brook","NL",48.95224,-57.92207,2018-10-12 09:00:00,23,4,27
"33114",10602,"Corner Brook","NL",48.95224,-57.92207,2018-10-12 10:00:00,28,2,30
"33115",10602,"Corner Brook","NL",48.95224,-57.92207,2018-10-12 11:00:00,29,2,31
"33116",10602,"Corner Brook","NL",48.95224,-57.92207,2018-10-12 12:00:00,28,2,30
"33117",10602,"Corner Brook","NL",48.95224,-57.92207,2018-10-12 13:00:00,28,2,30
"33118",10602,"Corner Brook","NL",48.95224,-57.92207,2018-10-12 14:00:00,27,3,30
"33119",10602,"Corner Brook","NL",48.95224,-57.92207,2018-10-12 15:00:00,24,4,28
"33120",10602,"Corner Brook","NL",48.95224,-57.92207,2018-10-12 16:00:00,24,3,27
"33121",10602,"Corner Brook","NL",48.95224,-57.92207,2018-10-12 17:00:00,25,2,27
"33122",10602,"Corner Brook","NL",48.95224,-57.92207,2018-10-12 18:00:00,23,3,26
"33123",10602,"Corner Brook","NL",48.95224,-57.92207,2018-10-12 19:00:00,23,2,25
"33124",10602,"Corner Brook","NL",48.95224,-57.92207,2018-10-12 20:00:00,23,2,25
"33125",10602,"Corner Brook","NL",48.95224,-57.92207,2018-10-12 21:00:00,24,2,26
"33126",10602,"Corner Brook","NL",48.95224,-57.92207,2018-10-12 22:00:00,23,2,25
"33127",10602,"Corner Brook","NL",48.95224,-57.92207,2018-10-12 23:00:00,23,2,25
"33128",10602,"Corner Brook","NL",48.95224,-57.92207,2018-10-13 00:00:00,23,2,25
"33129",10602,"Corner Brook","NL",48.95224,-57.92207,2018-10-13 01:00:00,22,2,24
"33130",10602,"Corner Brook","NL",48.95224,-57.92207,2018-10-13 02:00:00,21,1,22
"33131",10602,"Corner Brook","NL",48.95224,-57.92207,2018-10-13 03:00:00,22,1,23
"33132",10602,"Corner Brook","NL",48.95224,-57.92207,2018-10-13 04:00:00,20,2,22
"33133",10602,"Corner Brook","NL",48.95224,-57.92207,2018-10-13 05:00:00,22,2,24
"33134",10602,"Corner Brook","NL",48.95224,-57.92207,2018-10-13 06:00:00,21,2,23
"33135",10602,"Corner Brook","NL",48.95224,-57.92207,2018-10-13 07:00:00,21,2,23
"33136",10602,"Corner Brook","NL",48.95224,-57.92207,2018-10-13 08:00:00,18,4,22
"33137",10602,"Corner Brook","NL",48.95224,-57.92207,2018-10-13 09:00:00,21,3,24
"33138",10602,"Corner Brook","NL",48.95224,-57.92207,2018-10-13 10:00:00,23,3,26
"33139",10602,"Corner Brook","NL",48.95224,-57.92207,2018-10-13 11:00:00,23,3,26
"33140",10602,"Corner Brook","NL",48.95224,-57.92207,2018-10-13 12:00:00,24,3,27
"33141",10602,"Corner Brook","NL",48.95224,-57.92207,2018-10-13 13:00:00,27,2,29
"33142",10602,"Corner Brook","NL",48.95224,-57.92207,2018-10-13 14:00:00,27,2,29
"33143",10602,"Corner Brook","NL",48.95224,-57.92207,2018-10-13 15:00:00,25,2,27
"33144",10602,"Corner Brook","NL",48.95224,-57.92207,2018-10-13 16:00:00,24,2,26
"33145",10602,"Corner Brook","NL",48.95224,-57.92207,2018-10-13 17:00:00,22,2,24
"33146",10602,"Corner Brook","NL",48.95224,-57.92207,2018-10-13 18:00:00,18,2,20
"33147",10602,"Corner Brook","NL",48.95224,-57.92207,2018-10-13 19:00:00,17,2,19
"33148",10602,"Corner Brook","NL",48.95224,-57.92207,2018-10-13 20:00:00,19,2,21
"33149",10602,"Corner Brook","NL",48.95224,-57.92207,2018-10-13 21:00:00,18,2,20
"33150",10602,"Corner Brook","NL",48.95224,-57.92207,2018-10-13 22:00:00,16,2,18
"33151",10602,"Corner Brook","NL",48.95224,-57.92207,2018-10-13 23:00:00,15,1,16
"33152",10602,"Corner Brook","NL",48.95224,-57.92207,2018-10-14 00:00:00,17,1,18
"33153",10602,"Corner Brook","NL",48.95224,-57.92207,2018-10-14 01:00:00,16,1,17
"33154",10602,"Corner Brook","NL",48.95224,-57.92207,2018-10-14 02:00:00,16,2,18
"33155",10602,"Corner Brook","NL",48.95224,-57.92207,2018-10-14 03:00:00,24,2,26
"33156",10602,"Corner Brook","NL",48.95224,-57.92207,2018-10-14 04:00:00,24,1,25
"33157",10602,"Corner Brook","NL",48.95224,-57.92207,2018-10-14 05:00:00,23,1,24
"33158",10602,"Corner Brook","NL",48.95224,-57.92207,2018-10-14 06:00:00,22,1,23
"33159",10602,"Corner Brook","NL",48.95224,-57.92207,2018-10-14 07:00:00,22,1,23
"33160",10602,"Corner Brook","NL",48.95224,-57.92207,2018-10-14 08:00:00,22,2,24
"33161",10602,"Corner Brook","NL",48.95224,-57.92207,2018-10-14 09:00:00,26,2,28
"33162",10602,"Corner Brook","NL",48.95224,-57.92207,2018-10-14 10:00:00,25,2,27
"33163",10602,"Corner Brook","NL",48.95224,-57.92207,2018-10-14 11:00:00,21,1,22
"33164",10602,"Corner Brook","NL",48.95224,-57.92207,2018-10-14 12:00:00,18,3,21
"33165",10602,"Corner Brook","NL",48.95224,-57.92207,2018-10-14 13:00:00,16,3,19
"33166",10602,"Corner Brook","NL",48.95224,-57.92207,2018-10-14 14:00:00,13,4,17
"33167",10602,"Corner Brook","NL",48.95224,-57.92207,2018-10-14 15:00:00,17,5,22
"33168",10602,"Corner Brook","NL",48.95224,-57.92207,2018-10-14 16:00:00,19,3,22
"33169",10602,"Corner Brook","NL",48.95224,-57.92207,2018-10-14 17:00:00,22,2,24
"33170",10602,"Corner Brook","NL",48.95224,-57.92207,2018-10-14 18:00:00,22,2,24
"33171",10602,"Corner Brook","NL",48.95224,-57.92207,2018-10-14 19:00:00,22,2,24
"33172",10602,"Corner Brook","NL",48.95224,-57.92207,2018-10-14 20:00:00,22,3,25
"33173",10602,"Corner Brook","NL",48.95224,-57.92207,2018-10-14 21:00:00,21,2,23
"33174",10602,"Corner Brook","NL",48.95224,-57.92207,2018-10-14 22:00:00,19,2,21
"33175",10602,"Corner Brook","NL",48.95224,-57.92207,2018-10-14 23:00:00,19,2,21
"33176",10602,"Corner Brook","NL",48.95224,-57.92207,2018-10-15 00:00:00,18,2,20
"33177",10602,"Corner Brook","NL",48.95224,-57.92207,2018-10-15 01:00:00,19,2,21
"33178",10602,"Corner Brook","NL",48.95224,-57.92207,2018-10-15 02:00:00,19,3,22
"33179",10602,"Corner Brook","NL",48.95224,-57.92207,2018-10-15 03:00:00,23,1,24
"33180",10602,"Corner Brook","NL",48.95224,-57.92207,2018-10-15 04:00:00,21,2,23
"33181",10602,"Corner Brook","NL",48.95224,-57.92207,2018-10-15 05:00:00,20,2,22
"33182",10602,"Corner Brook","NL",48.95224,-57.92207,2018-10-15 06:00:00,19,2,21
"33183",10602,"Corner Brook","NL",48.95224,-57.92207,2018-10-15 07:00:00,17,4,21
"33184",10602,"Corner Brook","NL",48.95224,-57.92207,2018-10-15 08:00:00,18,3,21
"33185",10602,"Corner Brook","NL",48.95224,-57.92207,2018-10-15 09:00:00,19,3,22
"33186",10602,"Corner Brook","NL",48.95224,-57.92207,2018-10-15 10:00:00,21,2,23
"33187",10602,"Corner Brook","NL",48.95224,-57.92207,2018-10-15 11:00:00,20,3,23
"33188",10602,"Corner Brook","NL",48.95224,-57.92207,2018-10-15 12:00:00,22,2,24
"33189",10602,"Corner Brook","NL",48.95224,-57.92207,2018-10-15 13:00:00,22,2,24
"33190",10602,"Corner Brook","NL",48.95224,-57.92207,2018-10-15 14:00:00,21,3,24
"33191",10602,"Corner Brook","NL",48.95224,-57.92207,2018-10-15 15:00:00,22,2,24
"33192",10602,"Corner Brook","NL",48.95224,-57.92207,2018-10-15 16:00:00,23,2,25
"33193",10602,"Corner Brook","NL",48.95224,-57.92207,2018-10-15 17:00:00,25,2,27
"33194",10602,"Corner Brook","NL",48.95224,-57.92207,2018-10-15 18:00:00,28,2,30
"33195",10602,"Corner Brook","NL",48.95224,-57.92207,2018-10-15 19:00:00,29,2,31
"33196",10602,"Corner Brook","NL",48.95224,-57.92207,2018-10-15 20:00:00,30,1,31
"33197",10602,"Corner Brook","NL",48.95224,-57.92207,2018-10-15 21:00:00,28,2,30
"33198",10602,"Corner Brook","NL",48.95224,-57.92207,2018-10-15 22:00:00,25,2,27
"33199",10602,"Corner Brook","NL",48.95224,-57.92207,2018-10-15 23:00:00,22,3,25
"33200",10602,"Corner Brook","NL",48.95224,-57.92207,2018-10-16 00:00:00,22,3,25
"33201",10602,"Corner Brook","NL",48.95224,-57.92207,2018-10-16 01:00:00,21,3,24
"33202",10602,"Corner Brook","NL",48.95224,-57.92207,2018-10-16 02:00:00,23,2,25
"33203",10602,"Corner Brook","NL",48.95224,-57.92207,2018-10-16 03:00:00,27,1,28
"33204",10602,"Corner Brook","NL",48.95224,-57.92207,2018-10-16 04:00:00,30,1,31
"33205",10602,"Corner Brook","NL",48.95224,-57.92207,2018-10-16 05:00:00,33,1,34
"33206",10602,"Corner Brook","NL",48.95224,-57.92207,2018-10-16 06:00:00,35,1,36
"33207",10602,"Corner Brook","NL",48.95224,-57.92207,2018-10-16 07:00:00,36,1,37
"33208",10602,"Corner Brook","NL",48.95224,-57.92207,2018-10-16 08:00:00,36,1,37
"33209",10602,"Corner Brook","NL",48.95224,-57.92207,2018-10-16 09:00:00,35,3,38
"33210",10602,"Corner Brook","NL",48.95224,-57.92207,2018-10-16 10:00:00,28,18,46
"33211",10602,"Corner Brook","NL",48.95224,-57.92207,2018-10-16 11:00:00,28,NA,NA
"33212",10602,"Corner Brook","NL",48.95224,-57.92207,2018-10-16 12:00:00,27,NA,NA
"33213",10602,"Corner Brook","NL",48.95224,-57.92207,2018-10-16 13:00:00,NA,NA,NA
"33214",10602,"Corner Brook","NL",48.95224,-57.92207,2018-10-16 14:00:00,NA,21,NA
"33215",10602,"Corner Brook","NL",48.95224,-57.92207,2018-10-16 15:00:00,26,1,27
"33216",10602,"Corner Brook","NL",48.95224,-57.92207,2018-10-16 16:00:00,24,1,25
"33217",10602,"Corner Brook","NL",48.95224,-57.92207,2018-10-16 17:00:00,25,1,26
"33218",10602,"Corner Brook","NL",48.95224,-57.92207,2018-10-16 18:00:00,26,1,27
"33219",10602,"Corner Brook","NL",48.95224,-57.92207,2018-10-16 19:00:00,24,1,25
"33220",10602,"Corner Brook","NL",48.95224,-57.92207,2018-10-16 20:00:00,23,1,24
"33221",10602,"Corner Brook","NL",48.95224,-57.92207,2018-10-16 21:00:00,23,1,24
"33222",10602,"Corner Brook","NL",48.95224,-57.92207,2018-10-16 22:00:00,21,1,22
"33223",10602,"Corner Brook","NL",48.95224,-57.92207,2018-10-16 23:00:00,20,1,21
"33224",10602,"Corner Brook","NL",48.95224,-57.92207,2018-10-17 00:00:00,20,1,21
"33225",10602,"Corner Brook","NL",48.95224,-57.92207,2018-10-17 01:00:00,20,2,22
"33226",10602,"Corner Brook","NL",48.95224,-57.92207,2018-10-17 02:00:00,21,1,22
"33227",10602,"Corner Brook","NL",48.95224,-57.92207,2018-10-17 03:00:00,21,1,22
"33228",10602,"Corner Brook","NL",48.95224,-57.92207,2018-10-17 04:00:00,22,1,23
"33229",10602,"Corner Brook","NL",48.95224,-57.92207,2018-10-17 05:00:00,21,2,23
"33230",10602,"Corner Brook","NL",48.95224,-57.92207,2018-10-17 06:00:00,21,2,23
"33231",10602,"Corner Brook","NL",48.95224,-57.92207,2018-10-17 07:00:00,22,2,24
"33232",10602,"Corner Brook","NL",48.95224,-57.92207,2018-10-17 08:00:00,22,3,25
"33233",10602,"Corner Brook","NL",48.95224,-57.92207,2018-10-17 09:00:00,22,2,24
"33234",10602,"Corner Brook","NL",48.95224,-57.92207,2018-10-17 10:00:00,22,3,25
"33235",10602,"Corner Brook","NL",48.95224,-57.92207,2018-10-17 11:00:00,25,2,27
"33236",10602,"Corner Brook","NL",48.95224,-57.92207,2018-10-17 12:00:00,24,2,26
"33237",10602,"Corner Brook","NL",48.95224,-57.92207,2018-10-17 13:00:00,24,4,28
"33238",10602,"Corner Brook","NL",48.95224,-57.92207,2018-10-17 14:00:00,27,2,29
"33239",10602,"Corner Brook","NL",48.95224,-57.92207,2018-10-17 15:00:00,28,3,31
"33240",10602,"Corner Brook","NL",48.95224,-57.92207,2018-10-17 16:00:00,31,2,33
"33241",10602,"Corner Brook","NL",48.95224,-57.92207,2018-10-17 17:00:00,29,3,32
"33242",10602,"Corner Brook","NL",48.95224,-57.92207,2018-10-17 18:00:00,27,2,29
"33243",10602,"Corner Brook","NL",48.95224,-57.92207,2018-10-17 19:00:00,26,2,28
"33244",10602,"Corner Brook","NL",48.95224,-57.92207,2018-10-17 20:00:00,23,3,26
"33245",10602,"Corner Brook","NL",48.95224,-57.92207,2018-10-17 21:00:00,22,3,25
"33246",10602,"Corner Brook","NL",48.95224,-57.92207,2018-10-17 22:00:00,22,2,24
"33247",10602,"Corner Brook","NL",48.95224,-57.92207,2018-10-17 23:00:00,24,2,26
"33248",10602,"Corner Brook","NL",48.95224,-57.92207,2018-10-18 00:00:00,24,2,26
"33249",10602,"Corner Brook","NL",48.95224,-57.92207,2018-10-18 01:00:00,25,2,27
"33250",10602,"Corner Brook","NL",48.95224,-57.92207,2018-10-18 02:00:00,28,1,29
"33251",10602,"Corner Brook","NL",48.95224,-57.92207,2018-10-18 03:00:00,29,2,31
"33252",10602,"Corner Brook","NL",48.95224,-57.92207,2018-10-18 04:00:00,25,3,28
"33253",10602,"Corner Brook","NL",48.95224,-57.92207,2018-10-18 05:00:00,28,4,32
"33254",10602,"Corner Brook","NL",48.95224,-57.92207,2018-10-18 06:00:00,28,2,30
"33255",10602,"Corner Brook","NL",48.95224,-57.92207,2018-10-18 07:00:00,19,6,25
"33256",10602,"Corner Brook","NL",48.95224,-57.92207,2018-10-18 08:00:00,16,11,27
"33257",10602,"Corner Brook","NL",48.95224,-57.92207,2018-10-18 09:00:00,22,5,27
"33258",10602,"Corner Brook","NL",48.95224,-57.92207,2018-10-18 10:00:00,18,6,24
"33259",10602,"Corner Brook","NL",48.95224,-57.92207,2018-10-18 11:00:00,21,6,27
"33260",10602,"Corner Brook","NL",48.95224,-57.92207,2018-10-18 12:00:00,22,4,26
"33261",10602,"Corner Brook","NL",48.95224,-57.92207,2018-10-18 13:00:00,21,3,24
"33262",10602,"Corner Brook","NL",48.95224,-57.92207,2018-10-18 14:00:00,21,3,24
"33263",10602,"Corner Brook","NL",48.95224,-57.92207,2018-10-18 15:00:00,19,5,24
"33264",10602,"Corner Brook","NL",48.95224,-57.92207,2018-10-18 16:00:00,21,4,25
"33265",10602,"Corner Brook","NL",48.95224,-57.92207,2018-10-18 17:00:00,23,5,28
"33266",10602,"Corner Brook","NL",48.95224,-57.92207,2018-10-18 18:00:00,26,4,30
"33267",10602,"Corner Brook","NL",48.95224,-57.92207,2018-10-18 19:00:00,22,4,26
"33268",10602,"Corner Brook","NL",48.95224,-57.92207,2018-10-18 20:00:00,21,4,25
"33269",10602,"Corner Brook","NL",48.95224,-57.92207,2018-10-18 21:00:00,24,3,27
"33270",10602,"Corner Brook","NL",48.95224,-57.92207,2018-10-18 22:00:00,22,3,25
"33271",10602,"Corner Brook","NL",48.95224,-57.92207,2018-10-18 23:00:00,20,4,24
"33272",10602,"Corner Brook","NL",48.95224,-57.92207,2018-10-19 00:00:00,20,4,24
"33273",10602,"Corner Brook","NL",48.95224,-57.92207,2018-10-19 01:00:00,16,5,21
"33274",10602,"Corner Brook","NL",48.95224,-57.92207,2018-10-19 02:00:00,16,5,21
"33275",10602,"Corner Brook","NL",48.95224,-57.92207,2018-10-19 03:00:00,19,3,22
"33276",10602,"Corner Brook","NL",48.95224,-57.92207,2018-10-19 04:00:00,19,4,23
"33277",10602,"Corner Brook","NL",48.95224,-57.92207,2018-10-19 05:00:00,15,4,19
"33278",10602,"Corner Brook","NL",48.95224,-57.92207,2018-10-19 06:00:00,10,7,17
"33279",10602,"Corner Brook","NL",48.95224,-57.92207,2018-10-19 07:00:00,7,12,19
"33280",10602,"Corner Brook","NL",48.95224,-57.92207,2018-10-19 08:00:00,4,13,17
"33281",10602,"Corner Brook","NL",48.95224,-57.92207,2018-10-19 09:00:00,8,12,20
"33282",10602,"Corner Brook","NL",48.95224,-57.92207,2018-10-19 10:00:00,19,5,24
"33283",10602,"Corner Brook","NL",48.95224,-57.92207,2018-10-19 11:00:00,24,4,28
"33284",10602,"Corner Brook","NL",48.95224,-57.92207,2018-10-19 12:00:00,27,3,30
"33285",10602,"Corner Brook","NL",48.95224,-57.92207,2018-10-19 13:00:00,28,2,30
"33286",10602,"Corner Brook","NL",48.95224,-57.92207,2018-10-19 14:00:00,28,2,30
"33287",10602,"Corner Brook","NL",48.95224,-57.92207,2018-10-19 15:00:00,26,3,29
"33288",10602,"Corner Brook","NL",48.95224,-57.92207,2018-10-19 16:00:00,27,2,29
"33289",10602,"Corner Brook","NL",48.95224,-57.92207,2018-10-19 17:00:00,25,3,28
"33290",10602,"Corner Brook","NL",48.95224,-57.92207,2018-10-19 18:00:00,20,4,24
"33291",10602,"Corner Brook","NL",48.95224,-57.92207,2018-10-19 19:00:00,19,2,21
"33292",10602,"Corner Brook","NL",48.95224,-57.92207,2018-10-19 20:00:00,21,1,22
"33293",10602,"Corner Brook","NL",48.95224,-57.92207,2018-10-19 21:00:00,24,1,25
"33294",10602,"Corner Brook","NL",48.95224,-57.92207,2018-10-19 22:00:00,24,1,25
"33295",10602,"Corner Brook","NL",48.95224,-57.92207,2018-10-19 23:00:00,25,1,26
"33296",10602,"Corner Brook","NL",48.95224,-57.92207,2018-10-20 00:00:00,25,1,26
"33297",10602,"Corner Brook","NL",48.95224,-57.92207,2018-10-20 01:00:00,25,1,26
"33298",10602,"Corner Brook","NL",48.95224,-57.92207,2018-10-20 02:00:00,27,1,28
"33299",10602,"Corner Brook","NL",48.95224,-57.92207,2018-10-20 03:00:00,28,1,29
"33300",10602,"Corner Brook","NL",48.95224,-57.92207,2018-10-20 04:00:00,26,1,27
"33301",10602,"Corner Brook","NL",48.95224,-57.92207,2018-10-20 05:00:00,26,2,28
"33302",10602,"Corner Brook","NL",48.95224,-57.92207,2018-10-20 06:00:00,27,2,29
"33303",10602,"Corner Brook","NL",48.95224,-57.92207,2018-10-20 07:00:00,27,2,29
"33304",10602,"Corner Brook","NL",48.95224,-57.92207,2018-10-20 08:00:00,27,2,29
"33305",10602,"Corner Brook","NL",48.95224,-57.92207,2018-10-20 09:00:00,26,2,28
"33306",10602,"Corner Brook","NL",48.95224,-57.92207,2018-10-20 10:00:00,27,2,29
"33307",10602,"Corner Brook","NL",48.95224,-57.92207,2018-10-20 11:00:00,29,1,30
"33308",10602,"Corner Brook","NL",48.95224,-57.92207,2018-10-20 12:00:00,30,1,31
"33309",10602,"Corner Brook","NL",48.95224,-57.92207,2018-10-20 13:00:00,31,1,32
"33310",10602,"Corner Brook","NL",48.95224,-57.92207,2018-10-20 14:00:00,32,1,33
"33311",10602,"Corner Brook","NL",48.95224,-57.92207,2018-10-20 15:00:00,34,1,35
"33312",10602,"Corner Brook","NL",48.95224,-57.92207,2018-10-20 16:00:00,33,1,34
"33313",10602,"Corner Brook","NL",48.95224,-57.92207,2018-10-20 17:00:00,35,1,36
"33314",10602,"Corner Brook","NL",48.95224,-57.92207,2018-10-20 18:00:00,36,1,37
"33315",10602,"Corner Brook","NL",48.95224,-57.92207,2018-10-20 19:00:00,37,1,38
"33316",10602,"Corner Brook","NL",48.95224,-57.92207,2018-10-20 20:00:00,37,1,38
"33317",10602,"Corner Brook","NL",48.95224,-57.92207,2018-10-20 21:00:00,38,1,39
"33318",10602,"Corner Brook","NL",48.95224,-57.92207,2018-10-20 22:00:00,39,1,40
"33319",10602,"Corner Brook","NL",48.95224,-57.92207,2018-10-20 23:00:00,39,1,40
"33320",10602,"Corner Brook","NL",48.95224,-57.92207,2018-10-21 00:00:00,37,1,38
"33321",10602,"Corner Brook","NL",48.95224,-57.92207,2018-10-21 01:00:00,38,1,39
"33322",10602,"Corner Brook","NL",48.95224,-57.92207,2018-10-21 02:00:00,39,1,40
"33323",10602,"Corner Brook","NL",48.95224,-57.92207,2018-10-21 03:00:00,39,1,40
"33324",10602,"Corner Brook","NL",48.95224,-57.92207,2018-10-21 04:00:00,39,1,40
"33325",10602,"Corner Brook","NL",48.95224,-57.92207,2018-10-21 05:00:00,38,1,39
"33326",10602,"Corner Brook","NL",48.95224,-57.92207,2018-10-21 06:00:00,37,1,38
"33327",10602,"Corner Brook","NL",48.95224,-57.92207,2018-10-21 07:00:00,35,2,37
"33328",10602,"Corner Brook","NL",48.95224,-57.92207,2018-10-21 08:00:00,29,3,32
"33329",10602,"Corner Brook","NL",48.95224,-57.92207,2018-10-21 09:00:00,34,1,35
"33330",10602,"Corner Brook","NL",48.95224,-57.92207,2018-10-21 10:00:00,34,2,36
"33331",10602,"Corner Brook","NL",48.95224,-57.92207,2018-10-21 11:00:00,34,2,36
"33332",10602,"Corner Brook","NL",48.95224,-57.92207,2018-10-21 12:00:00,34,2,36
"33333",10602,"Corner Brook","NL",48.95224,-57.92207,2018-10-21 13:00:00,34,2,36
"33334",10602,"Corner Brook","NL",48.95224,-57.92207,2018-10-21 14:00:00,29,3,32
"33335",10602,"Corner Brook","NL",48.95224,-57.92207,2018-10-21 15:00:00,24,3,27
"33336",10602,"Corner Brook","NL",48.95224,-57.92207,2018-10-21 16:00:00,23,3,26
"33337",10602,"Corner Brook","NL",48.95224,-57.92207,2018-10-21 17:00:00,20,4,24
"33338",10602,"Corner Brook","NL",48.95224,-57.92207,2018-10-21 18:00:00,17,5,22
"33339",10602,"Corner Brook","NL",48.95224,-57.92207,2018-10-21 19:00:00,17,5,22
"33340",10602,"Corner Brook","NL",48.95224,-57.92207,2018-10-21 20:00:00,16,3,19
"33341",10602,"Corner Brook","NL",48.95224,-57.92207,2018-10-21 21:00:00,17,3,20
"33342",10602,"Corner Brook","NL",48.95224,-57.92207,2018-10-21 22:00:00,18,2,20
"33343",10602,"Corner Brook","NL",48.95224,-57.92207,2018-10-21 23:00:00,20,3,23
"33344",10602,"Corner Brook","NL",48.95224,-57.92207,2018-10-22 00:00:00,19,1,20
"33345",10602,"Corner Brook","NL",48.95224,-57.92207,2018-10-22 01:00:00,18,2,20
"33346",10602,"Corner Brook","NL",48.95224,-57.92207,2018-10-22 02:00:00,20,1,21
"33347",10602,"Corner Brook","NL",48.95224,-57.92207,2018-10-22 03:00:00,22,1,23
"33348",10602,"Corner Brook","NL",48.95224,-57.92207,2018-10-22 04:00:00,24,1,25
"33349",10602,"Corner Brook","NL",48.95224,-57.92207,2018-10-22 05:00:00,25,1,26
"33350",10602,"Corner Brook","NL",48.95224,-57.92207,2018-10-22 06:00:00,25,1,26
"33351",10602,"Corner Brook","NL",48.95224,-57.92207,2018-10-22 07:00:00,21,4,25
"33352",10602,"Corner Brook","NL",48.95224,-57.92207,2018-10-22 08:00:00,23,4,27
"33353",10602,"Corner Brook","NL",48.95224,-57.92207,2018-10-22 09:00:00,23,3,26
"33354",10602,"Corner Brook","NL",48.95224,-57.92207,2018-10-22 10:00:00,25,2,27
"33355",10602,"Corner Brook","NL",48.95224,-57.92207,2018-10-22 11:00:00,26,2,28
"33356",10602,"Corner Brook","NL",48.95224,-57.92207,2018-10-22 12:00:00,25,3,28
"33357",10602,"Corner Brook","NL",48.95224,-57.92207,2018-10-22 13:00:00,26,2,28
"33358",10602,"Corner Brook","NL",48.95224,-57.92207,2018-10-22 14:00:00,25,3,28
"33359",10602,"Corner Brook","NL",48.95224,-57.92207,2018-10-22 15:00:00,25,3,28
"33360",10602,"Corner Brook","NL",48.95224,-57.92207,2018-10-22 16:00:00,24,2,26
"33361",10602,"Corner Brook","NL",48.95224,-57.92207,2018-10-22 17:00:00,22,3,25
"33362",10602,"Corner Brook","NL",48.95224,-57.92207,2018-10-22 18:00:00,25,2,27
"33363",10602,"Corner Brook","NL",48.95224,-57.92207,2018-10-22 19:00:00,27,1,28
"33364",10602,"Corner Brook","NL",48.95224,-57.92207,2018-10-22 20:00:00,27,1,28
"33365",10602,"Corner Brook","NL",48.95224,-57.92207,2018-10-22 21:00:00,28,1,29
"33366",10602,"Corner Brook","NL",48.95224,-57.92207,2018-10-22 22:00:00,27,1,28
"33367",10602,"Corner Brook","NL",48.95224,-57.92207,2018-10-22 23:00:00,27,1,28
"33368",10602,"Corner Brook","NL",48.95224,-57.92207,2018-10-23 00:00:00,27,1,28
"33369",10602,"Corner Brook","NL",48.95224,-57.92207,2018-10-23 01:00:00,27,1,28
"33370",10602,"Corner Brook","NL",48.95224,-57.92207,2018-10-23 02:00:00,25,1,26
"33371",10602,"Corner Brook","NL",48.95224,-57.92207,2018-10-23 03:00:00,24,2,26
"33372",10602,"Corner Brook","NL",48.95224,-57.92207,2018-10-23 04:00:00,23,2,25
"33373",10602,"Corner Brook","NL",48.95224,-57.92207,2018-10-23 05:00:00,26,2,28
"33374",10602,"Corner Brook","NL",48.95224,-57.92207,2018-10-23 06:00:00,26,1,27
"33375",10602,"Corner Brook","NL",48.95224,-57.92207,2018-10-23 07:00:00,24,3,27
"33376",10602,"Corner Brook","NL",48.95224,-57.92207,2018-10-23 08:00:00,24,3,27
"33377",10602,"Corner Brook","NL",48.95224,-57.92207,2018-10-23 09:00:00,24,2,26
"33378",10602,"Corner Brook","NL",48.95224,-57.92207,2018-10-23 10:00:00,24,2,26
"33379",10602,"Corner Brook","NL",48.95224,-57.92207,2018-10-23 11:00:00,25,1,26
"33380",10602,"Corner Brook","NL",48.95224,-57.92207,2018-10-23 12:00:00,25,1,26
"33381",10602,"Corner Brook","NL",48.95224,-57.92207,2018-10-23 13:00:00,25,1,26
"33382",10602,"Corner Brook","NL",48.95224,-57.92207,2018-10-23 14:00:00,24,1,25
"33383",10602,"Corner Brook","NL",48.95224,-57.92207,2018-10-23 15:00:00,24,2,26
"33384",10602,"Corner Brook","NL",48.95224,-57.92207,2018-10-23 16:00:00,23,2,25
"33385",10602,"Corner Brook","NL",48.95224,-57.92207,2018-10-23 17:00:00,23,2,25
"33386",10602,"Corner Brook","NL",48.95224,-57.92207,2018-10-23 18:00:00,23,2,25
"33387",10602,"Corner Brook","NL",48.95224,-57.92207,2018-10-23 19:00:00,21,2,23
"33388",10602,"Corner Brook","NL",48.95224,-57.92207,2018-10-23 20:00:00,20,2,22
"33389",10602,"Corner Brook","NL",48.95224,-57.92207,2018-10-23 21:00:00,21,2,23
"33390",10602,"Corner Brook","NL",48.95224,-57.92207,2018-10-23 22:00:00,20,2,22
"33391",10602,"Corner Brook","NL",48.95224,-57.92207,2018-10-23 23:00:00,21,2,23
"33392",10602,"Corner Brook","NL",48.95224,-57.92207,2018-10-24 00:00:00,22,2,24
"33393",10602,"Corner Brook","NL",48.95224,-57.92207,2018-10-24 01:00:00,22,2,24
"33394",10602,"Corner Brook","NL",48.95224,-57.92207,2018-10-24 02:00:00,22,2,24
"33395",10602,"Corner Brook","NL",48.95224,-57.92207,2018-10-24 03:00:00,22,2,24
"33396",10602,"Corner Brook","NL",48.95224,-57.92207,2018-10-24 04:00:00,16,3,19
"33397",10602,"Corner Brook","NL",48.95224,-57.92207,2018-10-24 05:00:00,11,3,14
"33398",10602,"Corner Brook","NL",48.95224,-57.92207,2018-10-24 06:00:00,9,6,15
"33399",10602,"Corner Brook","NL",48.95224,-57.92207,2018-10-24 07:00:00,8,8,16
"33400",10602,"Corner Brook","NL",48.95224,-57.92207,2018-10-24 08:00:00,10,8,18
"33401",10602,"Corner Brook","NL",48.95224,-57.92207,2018-10-24 09:00:00,13,5,18
"33402",10602,"Corner Brook","NL",48.95224,-57.92207,2018-10-24 10:00:00,13,4,17
"33403",10602,"Corner Brook","NL",48.95224,-57.92207,2018-10-24 11:00:00,17,4,21
"33404",10602,"Corner Brook","NL",48.95224,-57.92207,2018-10-24 12:00:00,16,3,19
"33405",10602,"Corner Brook","NL",48.95224,-57.92207,2018-10-24 13:00:00,20,3,23
"33406",10602,"Corner Brook","NL",48.95224,-57.92207,2018-10-24 14:00:00,24,3,27
"33407",10602,"Corner Brook","NL",48.95224,-57.92207,2018-10-24 15:00:00,24,2,26
"33408",10602,"Corner Brook","NL",48.95224,-57.92207,2018-10-24 16:00:00,24,3,27
"33409",10602,"Corner Brook","NL",48.95224,-57.92207,2018-10-24 17:00:00,23,2,25
"33410",10602,"Corner Brook","NL",48.95224,-57.92207,2018-10-24 18:00:00,23,2,25
"33411",10602,"Corner Brook","NL",48.95224,-57.92207,2018-10-24 19:00:00,24,2,26
"33412",10602,"Corner Brook","NL",48.95224,-57.92207,2018-10-24 20:00:00,26,1,27
"33413",10602,"Corner Brook","NL",48.95224,-57.92207,2018-10-24 21:00:00,27,1,28
"33414",10602,"Corner Brook","NL",48.95224,-57.92207,2018-10-24 22:00:00,29,1,30
"33415",10602,"Corner Brook","NL",48.95224,-57.92207,2018-10-24 23:00:00,30,1,31
"33416",10602,"Corner Brook","NL",48.95224,-57.92207,2018-10-25 00:00:00,30,1,31
"33417",10602,"Corner Brook","NL",48.95224,-57.92207,2018-10-25 01:00:00,29,1,30
"33418",10602,"Corner Brook","NL",48.95224,-57.92207,2018-10-25 02:00:00,29,1,30
"33419",10602,"Corner Brook","NL",48.95224,-57.92207,2018-10-25 03:00:00,29,1,30
"33420",10602,"Corner Brook","NL",48.95224,-57.92207,2018-10-25 04:00:00,33,1,34
"33421",10602,"Corner Brook","NL",48.95224,-57.92207,2018-10-25 05:00:00,33,1,34
"33422",10602,"Corner Brook","NL",48.95224,-57.92207,2018-10-25 06:00:00,33,1,34
"33423",10602,"Corner Brook","NL",48.95224,-57.92207,2018-10-25 07:00:00,34,1,35
"33424",10602,"Corner Brook","NL",48.95224,-57.92207,2018-10-25 08:00:00,32,2,34
"33425",10602,"Corner Brook","NL",48.95224,-57.92207,2018-10-25 09:00:00,31,2,33
"33426",10602,"Corner Brook","NL",48.95224,-57.92207,2018-10-25 10:00:00,28,4,32
"33427",10602,"Corner Brook","NL",48.95224,-57.92207,2018-10-25 11:00:00,26,4,30
"33428",10602,"Corner Brook","NL",48.95224,-57.92207,2018-10-25 12:00:00,23,5,28
"33429",10602,"Corner Brook","NL",48.95224,-57.92207,2018-10-25 13:00:00,24,3,27
"33430",10602,"Corner Brook","NL",48.95224,-57.92207,2018-10-25 14:00:00,27,2,29
"33431",10602,"Corner Brook","NL",48.95224,-57.92207,2018-10-25 15:00:00,35,2,37
"33432",10602,"Corner Brook","NL",48.95224,-57.92207,2018-10-25 16:00:00,33,3,36
"33433",10602,"Corner Brook","NL",48.95224,-57.92207,2018-10-25 17:00:00,30,4,34
"33434",10602,"Corner Brook","NL",48.95224,-57.92207,2018-10-25 18:00:00,25,5,30
"33435",10602,"Corner Brook","NL",48.95224,-57.92207,2018-10-25 19:00:00,21,5,26
"33436",10602,"Corner Brook","NL",48.95224,-57.92207,2018-10-25 20:00:00,23,2,25
"33437",10602,"Corner Brook","NL",48.95224,-57.92207,2018-10-25 21:00:00,22,1,23
"33438",10602,"Corner Brook","NL",48.95224,-57.92207,2018-10-25 22:00:00,21,1,22
"33439",10602,"Corner Brook","NL",48.95224,-57.92207,2018-10-25 23:00:00,23,1,24
"33440",10602,"Corner Brook","NL",48.95224,-57.92207,2018-10-26 00:00:00,22,1,23
"33441",10602,"Corner Brook","NL",48.95224,-57.92207,2018-10-26 01:00:00,20,1,21
"33442",10602,"Corner Brook","NL",48.95224,-57.92207,2018-10-26 02:00:00,20,1,21
"33443",10602,"Corner Brook","NL",48.95224,-57.92207,2018-10-26 03:00:00,21,1,22
"33444",10602,"Corner Brook","NL",48.95224,-57.92207,2018-10-26 04:00:00,21,1,22
"33445",10602,"Corner Brook","NL",48.95224,-57.92207,2018-10-26 05:00:00,21,1,22
"33446",10602,"Corner Brook","NL",48.95224,-57.92207,2018-10-26 06:00:00,24,1,25
"33447",10602,"Corner Brook","NL",48.95224,-57.92207,2018-10-26 07:00:00,25,1,26
"33448",10602,"Corner Brook","NL",48.95224,-57.92207,2018-10-26 08:00:00,25,2,27
"33449",10602,"Corner Brook","NL",48.95224,-57.92207,2018-10-26 09:00:00,26,1,27
"33450",10602,"Corner Brook","NL",48.95224,-57.92207,2018-10-26 10:00:00,27,1,28
"33451",10602,"Corner Brook","NL",48.95224,-57.92207,2018-10-26 11:00:00,28,1,29
"33452",10602,"Corner Brook","NL",48.95224,-57.92207,2018-10-26 12:00:00,28,1,29
"33453",10602,"Corner Brook","NL",48.95224,-57.92207,2018-10-26 13:00:00,29,1,30
"33454",10602,"Corner Brook","NL",48.95224,-57.92207,2018-10-26 14:00:00,29,1,30
"33455",10602,"Corner Brook","NL",48.95224,-57.92207,2018-10-26 15:00:00,29,1,30
"33456",10602,"Corner Brook","NL",48.95224,-57.92207,2018-10-26 16:00:00,29,1,30
"33457",10602,"Corner Brook","NL",48.95224,-57.92207,2018-10-26 17:00:00,30,1,31
"33458",10602,"Corner Brook","NL",48.95224,-57.92207,2018-10-26 18:00:00,29,1,30
"33459",10602,"Corner Brook","NL",48.95224,-57.92207,2018-10-26 19:00:00,30,1,31
"33460",10602,"Corner Brook","NL",48.95224,-57.92207,2018-10-26 20:00:00,31,2,33
"33461",10602,"Corner Brook","NL",48.95224,-57.92207,2018-10-26 21:00:00,31,1,32
"33462",10602,"Corner Brook","NL",48.95224,-57.92207,2018-10-26 22:00:00,32,1,33
"33463",10602,"Corner Brook","NL",48.95224,-57.92207,2018-10-26 23:00:00,32,1,33
"33464",10602,"Corner Brook","NL",48.95224,-57.92207,2018-10-27 00:00:00,32,1,33
"33465",10602,"Corner Brook","NL",48.95224,-57.92207,2018-10-27 01:00:00,32,1,33
"33466",10602,"Corner Brook","NL",48.95224,-57.92207,2018-10-27 02:00:00,32,1,33
"33467",10602,"Corner Brook","NL",48.95224,-57.92207,2018-10-27 03:00:00,32,1,33
"33468",10602,"Corner Brook","NL",48.95224,-57.92207,2018-10-27 04:00:00,31,1,32
"33469",10602,"Corner Brook","NL",48.95224,-57.92207,2018-10-27 05:00:00,31,1,32
"33470",10602,"Corner Brook","NL",48.95224,-57.92207,2018-10-27 06:00:00,30,2,32
"33471",10602,"Corner Brook","NL",48.95224,-57.92207,2018-10-27 07:00:00,32,1,33
"33472",10602,"Corner Brook","NL",48.95224,-57.92207,2018-10-27 08:00:00,31,2,33
"33473",10602,"Corner Brook","NL",48.95224,-57.92207,2018-10-27 09:00:00,31,3,34
"33474",10602,"Corner Brook","NL",48.95224,-57.92207,2018-10-27 10:00:00,32,2,34
"33475",10602,"Corner Brook","NL",48.95224,-57.92207,2018-10-27 11:00:00,31,3,34
"33476",10602,"Corner Brook","NL",48.95224,-57.92207,2018-10-27 12:00:00,32,2,34
"33477",10602,"Corner Brook","NL",48.95224,-57.92207,2018-10-27 13:00:00,32,2,34
"33478",10602,"Corner Brook","NL",48.95224,-57.92207,2018-10-27 14:00:00,32,2,34
"33479",10602,"Corner Brook","NL",48.95224,-57.92207,2018-10-27 15:00:00,32,2,34
"33480",10602,"Corner Brook","NL",48.95224,-57.92207,2018-10-27 16:00:00,33,2,35
"33481",10602,"Corner Brook","NL",48.95224,-57.92207,2018-10-27 17:00:00,32,3,35
"33482",10602,"Corner Brook","NL",48.95224,-57.92207,2018-10-27 18:00:00,32,3,35
"33483",10602,"Corner Brook","NL",48.95224,-57.92207,2018-10-27 19:00:00,31,3,34
"33484",10602,"Corner Brook","NL",48.95224,-57.92207,2018-10-27 20:00:00,28,4,32
"33485",10602,"Corner Brook","NL",48.95224,-57.92207,2018-10-27 21:00:00,28,3,31
"33486",10602,"Corner Brook","NL",48.95224,-57.92207,2018-10-27 22:00:00,27,4,31
"33487",10602,"Corner Brook","NL",48.95224,-57.92207,2018-10-27 23:00:00,26,4,30
"33488",10602,"Corner Brook","NL",48.95224,-57.92207,2018-10-28 00:00:00,24,3,27
"33489",10602,"Corner Brook","NL",48.95224,-57.92207,2018-10-28 01:00:00,18,4,22
"33490",10602,"Corner Brook","NL",48.95224,-57.92207,2018-10-28 02:00:00,15,5,20
"33491",10602,"Corner Brook","NL",48.95224,-57.92207,2018-10-28 03:00:00,19,4,23
"33492",10602,"Corner Brook","NL",48.95224,-57.92207,2018-10-28 04:00:00,20,3,23
"33493",10602,"Corner Brook","NL",48.95224,-57.92207,2018-10-28 05:00:00,22,2,24
"33494",10602,"Corner Brook","NL",48.95224,-57.92207,2018-10-28 06:00:00,26,1,27
"33495",10602,"Corner Brook","NL",48.95224,-57.92207,2018-10-28 07:00:00,25,2,27
"33496",10602,"Corner Brook","NL",48.95224,-57.92207,2018-10-28 08:00:00,25,3,28
"33497",10602,"Corner Brook","NL",48.95224,-57.92207,2018-10-28 09:00:00,24,2,26
"33498",10602,"Corner Brook","NL",48.95224,-57.92207,2018-10-28 10:00:00,23,2,25
"33499",10602,"Corner Brook","NL",48.95224,-57.92207,2018-10-28 11:00:00,24,2,26
"33500",10602,"Corner Brook","NL",48.95224,-57.92207,2018-10-28 12:00:00,26,2,28
"33501",10602,"Corner Brook","NL",48.95224,-57.92207,2018-10-28 13:00:00,28,2,30
"33502",10602,"Corner Brook","NL",48.95224,-57.92207,2018-10-28 14:00:00,30,1,31
"33503",10602,"Corner Brook","NL",48.95224,-57.92207,2018-10-28 15:00:00,28,2,30
"33504",10602,"Corner Brook","NL",48.95224,-57.92207,2018-10-28 16:00:00,31,2,33
"33505",10602,"Corner Brook","NL",48.95224,-57.92207,2018-10-28 17:00:00,32,2,34
"33506",10602,"Corner Brook","NL",48.95224,-57.92207,2018-10-28 18:00:00,33,2,35
"33507",10602,"Corner Brook","NL",48.95224,-57.92207,2018-10-28 19:00:00,30,2,32
"33508",10602,"Corner Brook","NL",48.95224,-57.92207,2018-10-28 20:00:00,30,2,32
"33509",10602,"Corner Brook","NL",48.95224,-57.92207,2018-10-28 21:00:00,28,1,29
"33510",10602,"Corner Brook","NL",48.95224,-57.92207,2018-10-28 22:00:00,28,1,29
"33511",10602,"Corner Brook","NL",48.95224,-57.92207,2018-10-28 23:00:00,27,1,28
"33512",10602,"Corner Brook","NL",48.95224,-57.92207,2018-10-29 00:00:00,28,1,29
"33513",10602,"Corner Brook","NL",48.95224,-57.92207,2018-10-29 01:00:00,28,1,29
"33514",10602,"Corner Brook","NL",48.95224,-57.92207,2018-10-29 02:00:00,27,2,29
"33515",10602,"Corner Brook","NL",48.95224,-57.92207,2018-10-29 03:00:00,25,2,27
"33516",10602,"Corner Brook","NL",48.95224,-57.92207,2018-10-29 04:00:00,25,3,28
"33517",10602,"Corner Brook","NL",48.95224,-57.92207,2018-10-29 05:00:00,23,3,26
"33518",10602,"Corner Brook","NL",48.95224,-57.92207,2018-10-29 06:00:00,22,4,26
"33519",10602,"Corner Brook","NL",48.95224,-57.92207,2018-10-29 07:00:00,19,6,25
"33520",10602,"Corner Brook","NL",48.95224,-57.92207,2018-10-29 08:00:00,18,7,25
"33521",10602,"Corner Brook","NL",48.95224,-57.92207,2018-10-29 09:00:00,13,11,24
"33522",10602,"Corner Brook","NL",48.95224,-57.92207,2018-10-29 10:00:00,14,10,24
"33523",10602,"Corner Brook","NL",48.95224,-57.92207,2018-10-29 11:00:00,13,9,22
"33524",10602,"Corner Brook","NL",48.95224,-57.92207,2018-10-29 12:00:00,20,5,25
"33525",10602,"Corner Brook","NL",48.95224,-57.92207,2018-10-29 13:00:00,27,2,29
"33526",10602,"Corner Brook","NL",48.95224,-57.92207,2018-10-29 14:00:00,22,6,28
"33527",10602,"Corner Brook","NL",48.95224,-57.92207,2018-10-29 15:00:00,21,8,29
"33528",10602,"Corner Brook","NL",48.95224,-57.92207,2018-10-29 16:00:00,22,7,29
"33529",10602,"Corner Brook","NL",48.95224,-57.92207,2018-10-29 17:00:00,23,5,28
"33530",10602,"Corner Brook","NL",48.95224,-57.92207,2018-10-29 18:00:00,20,5,25
"33531",10602,"Corner Brook","NL",48.95224,-57.92207,2018-10-29 19:00:00,18,4,22
"33532",10602,"Corner Brook","NL",48.95224,-57.92207,2018-10-29 20:00:00,15,5,20
"33533",10602,"Corner Brook","NL",48.95224,-57.92207,2018-10-29 21:00:00,12,6,18
"33534",10602,"Corner Brook","NL",48.95224,-57.92207,2018-10-29 22:00:00,12,6,18
"33535",10602,"Corner Brook","NL",48.95224,-57.92207,2018-10-29 23:00:00,14,6,20
"33536",10602,"Corner Brook","NL",48.95224,-57.92207,2018-10-30 00:00:00,9,6,15
"33537",10602,"Corner Brook","NL",48.95224,-57.92207,2018-10-30 01:00:00,9,4,13
"33538",10602,"Corner Brook","NL",48.95224,-57.92207,2018-10-30 02:00:00,10,3,13
"33539",10602,"Corner Brook","NL",48.95224,-57.92207,2018-10-30 03:00:00,9,3,12
"33540",10602,"Corner Brook","NL",48.95224,-57.92207,2018-10-30 04:00:00,7,3,10
"33541",10602,"Corner Brook","NL",48.95224,-57.92207,2018-10-30 05:00:00,7,4,11
"33542",10602,"Corner Brook","NL",48.95224,-57.92207,2018-10-30 06:00:00,5,5,10
"33543",10602,"Corner Brook","NL",48.95224,-57.92207,2018-10-30 07:00:00,2,8,10
"33544",10602,"Corner Brook","NL",48.95224,-57.92207,2018-10-30 08:00:00,1,10,11
"33545",10602,"Corner Brook","NL",48.95224,-57.92207,2018-10-30 09:00:00,5,8,13
"33546",10602,"Corner Brook","NL",48.95224,-57.92207,2018-10-30 10:00:00,6,9,15
"33547",10602,"Corner Brook","NL",48.95224,-57.92207,2018-10-30 11:00:00,8,9,17
"33548",10602,"Corner Brook","NL",48.95224,-57.92207,2018-10-30 12:00:00,10,8,18
"33549",10602,"Corner Brook","NL",48.95224,-57.92207,2018-10-30 13:00:00,13,5,18
"33550",10602,"Corner Brook","NL",48.95224,-57.92207,2018-10-30 14:00:00,13,4,17
"33551",10602,"Corner Brook","NL",48.95224,-57.92207,2018-10-30 15:00:00,14,7,21
"33552",10602,"Corner Brook","NL",48.95224,-57.92207,2018-10-30 16:00:00,19,3,22
"33553",10602,"Corner Brook","NL",48.95224,-57.92207,2018-10-30 17:00:00,20,4,24
"33554",10602,"Corner Brook","NL",48.95224,-57.92207,2018-10-30 18:00:00,17,6,23
"33555",10602,"Corner Brook","NL",48.95224,-57.92207,2018-10-30 19:00:00,19,4,23
"33556",10602,"Corner Brook","NL",48.95224,-57.92207,2018-10-30 20:00:00,18,5,23
"33557",10602,"Corner Brook","NL",48.95224,-57.92207,2018-10-30 21:00:00,18,4,22
"33558",10602,"Corner Brook","NL",48.95224,-57.92207,2018-10-30 22:00:00,18,4,22
"33559",10602,"Corner Brook","NL",48.95224,-57.92207,2018-10-30 23:00:00,16,5,21
"33560",10602,"Corner Brook","NL",48.95224,-57.92207,2018-10-31 00:00:00,15,6,21
"33561",10602,"Corner Brook","NL",48.95224,-57.92207,2018-10-31 01:00:00,17,5,22
"33562",10602,"Corner Brook","NL",48.95224,-57.92207,2018-10-31 02:00:00,18,4,22
"33563",10602,"Corner Brook","NL",48.95224,-57.92207,2018-10-31 03:00:00,20,3,23
"33564",10602,"Corner Brook","NL",48.95224,-57.92207,2018-10-31 04:00:00,17,6,23
"33565",10602,"Corner Brook","NL",48.95224,-57.92207,2018-10-31 05:00:00,20,3,23
"33566",10602,"Corner Brook","NL",48.95224,-57.92207,2018-10-31 06:00:00,15,6,21
"33567",10602,"Corner Brook","NL",48.95224,-57.92207,2018-10-31 07:00:00,12,9,21
"33568",10602,"Corner Brook","NL",48.95224,-57.92207,2018-10-31 08:00:00,16,6,22
"33569",10602,"Corner Brook","NL",48.95224,-57.92207,2018-10-31 09:00:00,11,11,22
"33570",10602,"Corner Brook","NL",48.95224,-57.92207,2018-10-31 10:00:00,14,7,21
"33571",10602,"Corner Brook","NL",48.95224,-57.92207,2018-10-31 11:00:00,16,7,23
"33572",10602,"Corner Brook","NL",48.95224,-57.92207,2018-10-31 12:00:00,17,7,24
"33573",10602,"Corner Brook","NL",48.95224,-57.92207,2018-10-31 13:00:00,19,7,26
"33574",10602,"Corner Brook","NL",48.95224,-57.92207,2018-10-31 14:00:00,17,9,26
"33575",10602,"Corner Brook","NL",48.95224,-57.92207,2018-10-31 15:00:00,20,5,25
"33576",10602,"Corner Brook","NL",48.95224,-57.92207,2018-10-31 16:00:00,20,5,25
"33577",10602,"Corner Brook","NL",48.95224,-57.92207,2018-10-31 17:00:00,21,6,27
"33578",10602,"Corner Brook","NL",48.95224,-57.92207,2018-10-31 18:00:00,20,6,26
"33579",10602,"Corner Brook","NL",48.95224,-57.92207,2018-10-31 19:00:00,24,3,27
"33580",10602,"Corner Brook","NL",48.95224,-57.92207,2018-10-31 20:00:00,31,2,33
"33581",10602,"Corner Brook","NL",48.95224,-57.92207,2018-10-31 21:00:00,30,2,32
"33582",10602,"Corner Brook","NL",48.95224,-57.92207,2018-10-31 22:00:00,30,2,32
"33583",10602,"Corner Brook","NL",48.95224,-57.92207,2018-10-31 23:00:00,30,2,32
"33584",10602,"Corner Brook","NL",48.95224,-57.92207,2018-11-01 00:00:00,31,1,32
"33585",10602,"Corner Brook","NL",48.95224,-57.92207,2018-11-01 01:00:00,32,1,33
"33586",10602,"Corner Brook","NL",48.95224,-57.92207,2018-11-01 02:00:00,31,1,32
"33587",10602,"Corner Brook","NL",48.95224,-57.92207,2018-11-01 03:00:00,32,1,33
"33588",10602,"Corner Brook","NL",48.95224,-57.92207,2018-11-01 04:00:00,31,2,33
"33589",10602,"Corner Brook","NL",48.95224,-57.92207,2018-11-01 05:00:00,31,2,33
"33590",10602,"Corner Brook","NL",48.95224,-57.92207,2018-11-01 06:00:00,30,2,32
"33591",10602,"Corner Brook","NL",48.95224,-57.92207,2018-11-01 07:00:00,29,3,32
"33592",10602,"Corner Brook","NL",48.95224,-57.92207,2018-11-01 08:00:00,24,7,31
"33593",10602,"Corner Brook","NL",48.95224,-57.92207,2018-11-01 09:00:00,27,3,30
"33594",10602,"Corner Brook","NL",48.95224,-57.92207,2018-11-01 10:00:00,26,3,29
"33595",10602,"Corner Brook","NL",48.95224,-57.92207,2018-11-01 11:00:00,25,4,29
"33596",10602,"Corner Brook","NL",48.95224,-57.92207,2018-11-01 12:00:00,27,3,30
"33597",10602,"Corner Brook","NL",48.95224,-57.92207,2018-11-01 13:00:00,25,3,28
"33598",10602,"Corner Brook","NL",48.95224,-57.92207,2018-11-01 14:00:00,24,2,26
"33599",10602,"Corner Brook","NL",48.95224,-57.92207,2018-11-01 15:00:00,21,2,23
"33600",10602,"Corner Brook","NL",48.95224,-57.92207,2018-11-01 16:00:00,18,2,20
"33601",10602,"Corner Brook","NL",48.95224,-57.92207,2018-11-01 17:00:00,20,2,22
"33602",10602,"Corner Brook","NL",48.95224,-57.92207,2018-11-01 18:00:00,17,3,20
"33603",10602,"Corner Brook","NL",48.95224,-57.92207,2018-11-01 19:00:00,16,2,18
"33604",10602,"Corner Brook","NL",48.95224,-57.92207,2018-11-01 20:00:00,15,2,17
"33605",10602,"Corner Brook","NL",48.95224,-57.92207,2018-11-01 21:00:00,15,1,16
"33606",10602,"Corner Brook","NL",48.95224,-57.92207,2018-11-01 22:00:00,17,1,18
"33607",10602,"Corner Brook","NL",48.95224,-57.92207,2018-11-01 23:00:00,23,1,24
"33608",10602,"Corner Brook","NL",48.95224,-57.92207,2018-11-02 00:00:00,22,2,24
"33609",10602,"Corner Brook","NL",48.95224,-57.92207,2018-11-02 01:00:00,22,2,24
"33610",10602,"Corner Brook","NL",48.95224,-57.92207,2018-11-02 02:00:00,23,2,25
"33611",10602,"Corner Brook","NL",48.95224,-57.92207,2018-11-02 03:00:00,21,1,22
"33612",10602,"Corner Brook","NL",48.95224,-57.92207,2018-11-02 04:00:00,20,2,22
"33613",10602,"Corner Brook","NL",48.95224,-57.92207,2018-11-02 05:00:00,19,1,20
"33614",10602,"Corner Brook","NL",48.95224,-57.92207,2018-11-02 06:00:00,18,1,19
"33615",10602,"Corner Brook","NL",48.95224,-57.92207,2018-11-02 07:00:00,17,2,19
"33616",10602,"Corner Brook","NL",48.95224,-57.92207,2018-11-02 08:00:00,15,3,18
"33617",10602,"Corner Brook","NL",48.95224,-57.92207,2018-11-02 09:00:00,15,2,17
"33618",10602,"Corner Brook","NL",48.95224,-57.92207,2018-11-02 10:00:00,17,2,19
"33619",10602,"Corner Brook","NL",48.95224,-57.92207,2018-11-02 11:00:00,18,4,22
"33620",10602,"Corner Brook","NL",48.95224,-57.92207,2018-11-02 12:00:00,21,3,24
"33621",10602,"Corner Brook","NL",48.95224,-57.92207,2018-11-02 13:00:00,22,2,24
"33622",10602,"Corner Brook","NL",48.95224,-57.92207,2018-11-02 14:00:00,23,2,25
"33623",10602,"Corner Brook","NL",48.95224,-57.92207,2018-11-02 15:00:00,23,2,25
"33624",10602,"Corner Brook","NL",48.95224,-57.92207,2018-11-02 16:00:00,21,2,23
"33625",10602,"Corner Brook","NL",48.95224,-57.92207,2018-11-02 17:00:00,17,4,21
"33626",10602,"Corner Brook","NL",48.95224,-57.92207,2018-11-02 18:00:00,14,4,18
"33627",10602,"Corner Brook","NL",48.95224,-57.92207,2018-11-02 19:00:00,15,3,18
"33628",10602,"Corner Brook","NL",48.95224,-57.92207,2018-11-02 20:00:00,17,3,20
"33629",10602,"Corner Brook","NL",48.95224,-57.92207,2018-11-02 21:00:00,18,3,21
"33630",10602,"Corner Brook","NL",48.95224,-57.92207,2018-11-02 22:00:00,14,4,18
"33631",10602,"Corner Brook","NL",48.95224,-57.92207,2018-11-02 23:00:00,18,2,20
"33632",10602,"Corner Brook","NL",48.95224,-57.92207,2018-11-03 00:00:00,17,3,20
"33633",10602,"Corner Brook","NL",48.95224,-57.92207,2018-11-03 01:00:00,16,3,19
"33634",10602,"Corner Brook","NL",48.95224,-57.92207,2018-11-03 02:00:00,11,3,14
"33635",10602,"Corner Brook","NL",48.95224,-57.92207,2018-11-03 03:00:00,13,3,16
"33636",10602,"Corner Brook","NL",48.95224,-57.92207,2018-11-03 04:00:00,15,2,17
"33637",10602,"Corner Brook","NL",48.95224,-57.92207,2018-11-03 05:00:00,17,1,18
"33638",10602,"Corner Brook","NL",48.95224,-57.92207,2018-11-03 06:00:00,16,2,18
"33639",10602,"Corner Brook","NL",48.95224,-57.92207,2018-11-03 07:00:00,15,2,17
"33640",10602,"Corner Brook","NL",48.95224,-57.92207,2018-11-03 08:00:00,19,2,21
"33641",10602,"Corner Brook","NL",48.95224,-57.92207,2018-11-03 09:00:00,18,2,20
"33642",10602,"Corner Brook","NL",48.95224,-57.92207,2018-11-03 10:00:00,17,2,19
"33643",10602,"Corner Brook","NL",48.95224,-57.92207,2018-11-03 11:00:00,19,2,21
"33644",10602,"Corner Brook","NL",48.95224,-57.92207,2018-11-03 12:00:00,23,1,24
"33645",10602,"Corner Brook","NL",48.95224,-57.92207,2018-11-03 13:00:00,23,1,24
"33646",10602,"Corner Brook","NL",48.95224,-57.92207,2018-11-03 14:00:00,22,1,23
"33647",10602,"Corner Brook","NL",48.95224,-57.92207,2018-11-03 15:00:00,19,2,21
"33648",10602,"Corner Brook","NL",48.95224,-57.92207,2018-11-03 16:00:00,18,1,19
"33649",10602,"Corner Brook","NL",48.95224,-57.92207,2018-11-03 17:00:00,17,2,19
"33650",10602,"Corner Brook","NL",48.95224,-57.92207,2018-11-03 18:00:00,17,1,18
"33651",10602,"Corner Brook","NL",48.95224,-57.92207,2018-11-03 19:00:00,18,1,19
"33652",10602,"Corner Brook","NL",48.95224,-57.92207,2018-11-03 20:00:00,17,2,19
"33653",10602,"Corner Brook","NL",48.95224,-57.92207,2018-11-03 21:00:00,10,7,17
"33654",10602,"Corner Brook","NL",48.95224,-57.92207,2018-11-03 22:00:00,9,7,16
"33655",10602,"Corner Brook","NL",48.95224,-57.92207,2018-11-03 23:00:00,13,6,19
"33656",10602,"Corner Brook","NL",48.95224,-57.92207,2018-11-04 00:00:00,23,4,27
"33657",10602,"Corner Brook","NL",48.95224,-57.92207,2018-11-04 01:00:00,34,1,35
"33658",10602,"Corner Brook","NL",48.95224,-57.92207,2018-11-04 02:00:00,39,1,40
"33659",10602,"Corner Brook","NL",48.95224,-57.92207,2018-11-04 03:00:00,37,1,38
"33660",10602,"Corner Brook","NL",48.95224,-57.92207,2018-11-04 04:00:00,30,1,31
"33661",10602,"Corner Brook","NL",48.95224,-57.92207,2018-11-04 05:00:00,21,1,22
"33662",10602,"Corner Brook","NL",48.95224,-57.92207,2018-11-04 06:00:00,14,1,15
"33663",10602,"Corner Brook","NL",48.95224,-57.92207,2018-11-04 07:00:00,13,1,14
"33664",10602,"Corner Brook","NL",48.95224,-57.92207,2018-11-04 08:00:00,13,1,14
"33665",10602,"Corner Brook","NL",48.95224,-57.92207,2018-11-04 09:00:00,13,1,14
"33666",10602,"Corner Brook","NL",48.95224,-57.92207,2018-11-04 10:00:00,14,1,15
"33667",10602,"Corner Brook","NL",48.95224,-57.92207,2018-11-04 11:00:00,16,1,17
"33668",10602,"Corner Brook","NL",48.95224,-57.92207,2018-11-04 12:00:00,18,1,19
"33669",10602,"Corner Brook","NL",48.95224,-57.92207,2018-11-04 13:00:00,21,1,22
"33670",10602,"Corner Brook","NL",48.95224,-57.92207,2018-11-04 14:00:00,23,1,24
"33671",10602,"Corner Brook","NL",48.95224,-57.92207,2018-11-04 15:00:00,24,1,25
"33672",10602,"Corner Brook","NL",48.95224,-57.92207,2018-11-04 16:00:00,26,1,27
"33673",10602,"Corner Brook","NL",48.95224,-57.92207,2018-11-04 17:00:00,27,1,28
"33674",10602,"Corner Brook","NL",48.95224,-57.92207,2018-11-04 18:00:00,27,1,28
"33675",10602,"Corner Brook","NL",48.95224,-57.92207,2018-11-04 19:00:00,26,2,28
"33676",10602,"Corner Brook","NL",48.95224,-57.92207,2018-11-04 20:00:00,27,2,29
"33677",10602,"Corner Brook","NL",48.95224,-57.92207,2018-11-04 21:00:00,29,1,30
"33678",10602,"Corner Brook","NL",48.95224,-57.92207,2018-11-04 22:00:00,32,1,33
"33679",10602,"Corner Brook","NL",48.95224,-57.92207,2018-11-04 23:00:00,33,1,34
"33680",10602,"Corner Brook","NL",48.95224,-57.92207,2018-11-05 00:00:00,34,1,35
"33681",10602,"Corner Brook","NL",48.95224,-57.92207,2018-11-05 01:00:00,35,1,36
"33682",10602,"Corner Brook","NL",48.95224,-57.92207,2018-11-05 02:00:00,35,1,36
"33683",10602,"Corner Brook","NL",48.95224,-57.92207,2018-11-05 03:00:00,35,1,36
"33684",10602,"Corner Brook","NL",48.95224,-57.92207,2018-11-05 04:00:00,35,1,36
"33685",10602,"Corner Brook","NL",48.95224,-57.92207,2018-11-05 05:00:00,34,1,35
"33686",10602,"Corner Brook","NL",48.95224,-57.92207,2018-11-05 06:00:00,33,1,34
"33687",10602,"Corner Brook","NL",48.95224,-57.92207,2018-11-05 07:00:00,33,2,35
"33688",10602,"Corner Brook","NL",48.95224,-57.92207,2018-11-05 08:00:00,31,2,33
"33689",10602,"Corner Brook","NL",48.95224,-57.92207,2018-11-05 09:00:00,31,2,33
"33690",10602,"Corner Brook","NL",48.95224,-57.92207,2018-11-05 10:00:00,32,2,34
"33691",10602,"Corner Brook","NL",48.95224,-57.92207,2018-11-05 11:00:00,32,1,33
"33692",10602,"Corner Brook","NL",48.95224,-57.92207,2018-11-05 12:00:00,31,1,32
"33693",10602,"Corner Brook","NL",48.95224,-57.92207,2018-11-05 13:00:00,31,1,32
"33694",10602,"Corner Brook","NL",48.95224,-57.92207,2018-11-05 14:00:00,32,1,33
"33695",10602,"Corner Brook","NL",48.95224,-57.92207,2018-11-05 15:00:00,32,2,34
"33696",10602,"Corner Brook","NL",48.95224,-57.92207,2018-11-05 16:00:00,33,1,34
"33697",10602,"Corner Brook","NL",48.95224,-57.92207,2018-11-05 17:00:00,30,2,32
"33698",10602,"Corner Brook","NL",48.95224,-57.92207,2018-11-05 18:00:00,25,6,31
"33699",10602,"Corner Brook","NL",48.95224,-57.92207,2018-11-05 19:00:00,26,5,31
"33700",10602,"Corner Brook","NL",48.95224,-57.92207,2018-11-05 20:00:00,26,5,31
"33701",10602,"Corner Brook","NL",48.95224,-57.92207,2018-11-05 21:00:00,24,4,28
"33702",10602,"Corner Brook","NL",48.95224,-57.92207,2018-11-05 22:00:00,24,3,27
"33703",10602,"Corner Brook","NL",48.95224,-57.92207,2018-11-05 23:00:00,23,3,26
"33704",10602,"Corner Brook","NL",48.95224,-57.92207,2018-11-06 00:00:00,24,3,27
"33705",10602,"Corner Brook","NL",48.95224,-57.92207,2018-11-06 01:00:00,23,3,26
"33706",10602,"Corner Brook","NL",48.95224,-57.92207,2018-11-06 02:00:00,22,2,24
"33707",10602,"Corner Brook","NL",48.95224,-57.92207,2018-11-06 03:00:00,20,2,22
"33708",10602,"Corner Brook","NL",48.95224,-57.92207,2018-11-06 04:00:00,19,2,21
"33709",10602,"Corner Brook","NL",48.95224,-57.92207,2018-11-06 05:00:00,20,2,22
"33710",10602,"Corner Brook","NL",48.95224,-57.92207,2018-11-06 06:00:00,20,2,22
"33711",10602,"Corner Brook","NL",48.95224,-57.92207,2018-11-06 07:00:00,23,3,26
"33712",10602,"Corner Brook","NL",48.95224,-57.92207,2018-11-06 08:00:00,21,4,25
"33713",10602,"Corner Brook","NL",48.95224,-57.92207,2018-11-06 09:00:00,17,6,23
"33714",10602,"Corner Brook","NL",48.95224,-57.92207,2018-11-06 10:00:00,18,6,24
"33715",10602,"Corner Brook","NL",48.95224,-57.92207,2018-11-06 11:00:00,19,5,24
"33716",10602,"Corner Brook","NL",48.95224,-57.92207,2018-11-06 12:00:00,22,4,26
"33717",10602,"Corner Brook","NL",48.95224,-57.92207,2018-11-06 13:00:00,24,3,27
"33718",10602,"Corner Brook","NL",48.95224,-57.92207,2018-11-06 14:00:00,23,2,25
"33719",10602,"Corner Brook","NL",48.95224,-57.92207,2018-11-06 15:00:00,21,4,25
"33720",10602,"Corner Brook","NL",48.95224,-57.92207,2018-11-06 16:00:00,22,3,25
"33721",10602,"Corner Brook","NL",48.95224,-57.92207,2018-11-06 17:00:00,21,4,25
"33722",10602,"Corner Brook","NL",48.95224,-57.92207,2018-11-06 18:00:00,20,2,22
"33723",10602,"Corner Brook","NL",48.95224,-57.92207,2018-11-06 19:00:00,20,2,22
"33724",10602,"Corner Brook","NL",48.95224,-57.92207,2018-11-06 20:00:00,18,3,21
"33725",10602,"Corner Brook","NL",48.95224,-57.92207,2018-11-06 21:00:00,22,2,24
"33726",10602,"Corner Brook","NL",48.95224,-57.92207,2018-11-06 22:00:00,23,2,25
"33727",10602,"Corner Brook","NL",48.95224,-57.92207,2018-11-06 23:00:00,24,2,26
"33728",10602,"Corner Brook","NL",48.95224,-57.92207,2018-11-07 00:00:00,24,2,26
"33729",10602,"Corner Brook","NL",48.95224,-57.92207,2018-11-07 01:00:00,29,1,30
"33730",10602,"Corner Brook","NL",48.95224,-57.92207,2018-11-07 02:00:00,28,2,30
"33731",10602,"Corner Brook","NL",48.95224,-57.92207,2018-11-07 03:00:00,36,1,37
"33732",10602,"Corner Brook","NL",48.95224,-57.92207,2018-11-07 04:00:00,34,1,35
"33733",10602,"Corner Brook","NL",48.95224,-57.92207,2018-11-07 05:00:00,33,1,34
"33734",10602,"Corner Brook","NL",48.95224,-57.92207,2018-11-07 06:00:00,33,1,34
"33735",10602,"Corner Brook","NL",48.95224,-57.92207,2018-11-07 07:00:00,31,1,32
"33736",10602,"Corner Brook","NL",48.95224,-57.92207,2018-11-07 08:00:00,28,3,31
"33737",10602,"Corner Brook","NL",48.95224,-57.92207,2018-11-07 09:00:00,22,5,27
"33738",10602,"Corner Brook","NL",48.95224,-57.92207,2018-11-07 10:00:00,18,9,27
"33739",10602,"Corner Brook","NL",48.95224,-57.92207,2018-11-07 11:00:00,28,1,29
"33740",10602,"Corner Brook","NL",48.95224,-57.92207,2018-11-07 12:00:00,29,1,30
"33741",10602,"Corner Brook","NL",48.95224,-57.92207,2018-11-07 13:00:00,28,1,29
"33742",10602,"Corner Brook","NL",48.95224,-57.92207,2018-11-07 14:00:00,28,1,29
"33743",10602,"Corner Brook","NL",48.95224,-57.92207,2018-11-07 15:00:00,27,1,28
"33744",10602,"Corner Brook","NL",48.95224,-57.92207,2018-11-07 16:00:00,25,1,26
"33745",10602,"Corner Brook","NL",48.95224,-57.92207,2018-11-07 17:00:00,24,2,26
"33746",10602,"Corner Brook","NL",48.95224,-57.92207,2018-11-07 18:00:00,24,2,26
"33747",10602,"Corner Brook","NL",48.95224,-57.92207,2018-11-07 19:00:00,25,2,27
"33748",10602,"Corner Brook","NL",48.95224,-57.92207,2018-11-07 20:00:00,26,1,27
"33749",10602,"Corner Brook","NL",48.95224,-57.92207,2018-11-07 21:00:00,25,1,26
"33750",10602,"Corner Brook","NL",48.95224,-57.92207,2018-11-07 22:00:00,24,1,25
"33751",10602,"Corner Brook","NL",48.95224,-57.92207,2018-11-07 23:00:00,24,1,25
"33752",10602,"Corner Brook","NL",48.95224,-57.92207,2018-11-08 00:00:00,23,1,24
"33753",10602,"Corner Brook","NL",48.95224,-57.92207,2018-11-08 01:00:00,22,2,24
"33754",10602,"Corner Brook","NL",48.95224,-57.92207,2018-11-08 02:00:00,22,2,24
"33755",10602,"Corner Brook","NL",48.95224,-57.92207,2018-11-08 03:00:00,22,2,24
"33756",10602,"Corner Brook","NL",48.95224,-57.92207,2018-11-08 04:00:00,24,1,25
"33757",10602,"Corner Brook","NL",48.95224,-57.92207,2018-11-08 05:00:00,24,1,25
"33758",10602,"Corner Brook","NL",48.95224,-57.92207,2018-11-08 06:00:00,22,1,23
"33759",10602,"Corner Brook","NL",48.95224,-57.92207,2018-11-08 07:00:00,21,2,23
"33760",10602,"Corner Brook","NL",48.95224,-57.92207,2018-11-08 08:00:00,17,5,22
"33761",10602,"Corner Brook","NL",48.95224,-57.92207,2018-11-08 09:00:00,18,2,20
"33762",10602,"Corner Brook","NL",48.95224,-57.92207,2018-11-08 10:00:00,15,2,17
"33763",10602,"Corner Brook","NL",48.95224,-57.92207,2018-11-08 11:00:00,15,1,16
"33764",10602,"Corner Brook","NL",48.95224,-57.92207,2018-11-08 12:00:00,15,1,16
"33765",10602,"Corner Brook","NL",48.95224,-57.92207,2018-11-08 13:00:00,15,1,16
"33766",10602,"Corner Brook","NL",48.95224,-57.92207,2018-11-08 14:00:00,15,1,16
"33767",10602,"Corner Brook","NL",48.95224,-57.92207,2018-11-08 15:00:00,15,1,16
"33768",10602,"Corner Brook","NL",48.95224,-57.92207,2018-11-08 16:00:00,13,12,25
"33769",10602,"Corner Brook","NL",48.95224,-57.92207,2018-11-08 17:00:00,14,6,20
"33770",10602,"Corner Brook","NL",48.95224,-57.92207,2018-11-08 18:00:00,15,2,17
"33771",10602,"Corner Brook","NL",48.95224,-57.92207,2018-11-08 19:00:00,16,1,17
"33772",10602,"Corner Brook","NL",48.95224,-57.92207,2018-11-08 20:00:00,17,1,18
"33773",10602,"Corner Brook","NL",48.95224,-57.92207,2018-11-08 21:00:00,17,2,19
"33774",10602,"Corner Brook","NL",48.95224,-57.92207,2018-11-08 22:00:00,17,2,19
"33775",10602,"Corner Brook","NL",48.95224,-57.92207,2018-11-08 23:00:00,19,2,21
"33776",10602,"Corner Brook","NL",48.95224,-57.92207,2018-11-09 00:00:00,18,1,19
"33777",10602,"Corner Brook","NL",48.95224,-57.92207,2018-11-09 01:00:00,19,1,20
"33778",10602,"Corner Brook","NL",48.95224,-57.92207,2018-11-09 02:00:00,19,1,20
"33779",10602,"Corner Brook","NL",48.95224,-57.92207,2018-11-09 03:00:00,19,1,20
"33780",10602,"Corner Brook","NL",48.95224,-57.92207,2018-11-09 04:00:00,19,1,20
"33781",10602,"Corner Brook","NL",48.95224,-57.92207,2018-11-09 05:00:00,20,1,21
"33782",10602,"Corner Brook","NL",48.95224,-57.92207,2018-11-09 06:00:00,22,1,23
"33783",10602,"Corner Brook","NL",48.95224,-57.92207,2018-11-09 07:00:00,23,2,25
"33784",10602,"Corner Brook","NL",48.95224,-57.92207,2018-11-09 08:00:00,21,3,24
"33785",10602,"Corner Brook","NL",48.95224,-57.92207,2018-11-09 09:00:00,21,3,24
"33786",10602,"Corner Brook","NL",48.95224,-57.92207,2018-11-09 10:00:00,21,3,24
"33787",10602,"Corner Brook","NL",48.95224,-57.92207,2018-11-09 11:00:00,24,2,26
"33788",10602,"Corner Brook","NL",48.95224,-57.92207,2018-11-09 12:00:00,25,1,26
"33789",10602,"Corner Brook","NL",48.95224,-57.92207,2018-11-09 13:00:00,25,2,27
"33790",10602,"Corner Brook","NL",48.95224,-57.92207,2018-11-09 14:00:00,24,2,26
"33791",10602,"Corner Brook","NL",48.95224,-57.92207,2018-11-09 15:00:00,32,1,33
"33792",10602,"Corner Brook","NL",48.95224,-57.92207,2018-11-09 16:00:00,35,1,36
"33793",10602,"Corner Brook","NL",48.95224,-57.92207,2018-11-09 17:00:00,34,1,35
"33794",10602,"Corner Brook","NL",48.95224,-57.92207,2018-11-09 18:00:00,35,1,36
"33795",10602,"Corner Brook","NL",48.95224,-57.92207,2018-11-09 19:00:00,33,2,35
"33796",10602,"Corner Brook","NL",48.95224,-57.92207,2018-11-09 20:00:00,31,2,33
"33797",10602,"Corner Brook","NL",48.95224,-57.92207,2018-11-09 21:00:00,30,3,33
"33798",10602,"Corner Brook","NL",48.95224,-57.92207,2018-11-09 22:00:00,30,3,33
"33799",10602,"Corner Brook","NL",48.95224,-57.92207,2018-11-09 23:00:00,31,2,33
"33800",10602,"Corner Brook","NL",48.95224,-57.92207,2018-11-10 00:00:00,30,3,33
"33801",10602,"Corner Brook","NL",48.95224,-57.92207,2018-11-10 01:00:00,28,3,31
"33802",10602,"Corner Brook","NL",48.95224,-57.92207,2018-11-10 02:00:00,27,4,31
"33803",10602,"Corner Brook","NL",48.95224,-57.92207,2018-11-10 03:00:00,29,3,32
"33804",10602,"Corner Brook","NL",48.95224,-57.92207,2018-11-10 04:00:00,29,3,32
"33805",10602,"Corner Brook","NL",48.95224,-57.92207,2018-11-10 05:00:00,26,3,29
"33806",10602,"Corner Brook","NL",48.95224,-57.92207,2018-11-10 06:00:00,28,3,31
"33807",10602,"Corner Brook","NL",48.95224,-57.92207,2018-11-10 07:00:00,21,5,26
"33808",10602,"Corner Brook","NL",48.95224,-57.92207,2018-11-10 08:00:00,20,5,25
"33809",10602,"Corner Brook","NL",48.95224,-57.92207,2018-11-10 09:00:00,22,3,25
"33810",10602,"Corner Brook","NL",48.95224,-57.92207,2018-11-10 10:00:00,25,2,27
"33811",10602,"Corner Brook","NL",48.95224,-57.92207,2018-11-10 11:00:00,20,5,25
"33812",10602,"Corner Brook","NL",48.95224,-57.92207,2018-11-10 12:00:00,23,5,28
"33813",10602,"Corner Brook","NL",48.95224,-57.92207,2018-11-10 13:00:00,25,3,28
"33814",10602,"Corner Brook","NL",48.95224,-57.92207,2018-11-10 14:00:00,24,3,27
"33815",10602,"Corner Brook","NL",48.95224,-57.92207,2018-11-10 15:00:00,25,3,28
"33816",10602,"Corner Brook","NL",48.95224,-57.92207,2018-11-10 16:00:00,28,1,29
"33817",10602,"Corner Brook","NL",48.95224,-57.92207,2018-11-10 17:00:00,28,2,30
"33818",10602,"Corner Brook","NL",48.95224,-57.92207,2018-11-10 18:00:00,27,2,29
"33819",10602,"Corner Brook","NL",48.95224,-57.92207,2018-11-10 19:00:00,26,2,28
"33820",10602,"Corner Brook","NL",48.95224,-57.92207,2018-11-10 20:00:00,28,1,29
"33821",10602,"Corner Brook","NL",48.95224,-57.92207,2018-11-10 21:00:00,32,1,33
"33822",10602,"Corner Brook","NL",48.95224,-57.92207,2018-11-10 22:00:00,33,1,34
"33823",10602,"Corner Brook","NL",48.95224,-57.92207,2018-11-10 23:00:00,32,1,33
"33824",10602,"Corner Brook","NL",48.95224,-57.92207,2018-11-11 00:00:00,31,1,32
"33825",10602,"Corner Brook","NL",48.95224,-57.92207,2018-11-11 01:00:00,30,1,31
"33826",10602,"Corner Brook","NL",48.95224,-57.92207,2018-11-11 02:00:00,30,1,31
"33827",10602,"Corner Brook","NL",48.95224,-57.92207,2018-11-11 03:00:00,29,1,30
"33828",10602,"Corner Brook","NL",48.95224,-57.92207,2018-11-11 04:00:00,29,1,30
"33829",10602,"Corner Brook","NL",48.95224,-57.92207,2018-11-11 05:00:00,29,1,30
"33830",10602,"Corner Brook","NL",48.95224,-57.92207,2018-11-11 06:00:00,31,1,32
"33831",10602,"Corner Brook","NL",48.95224,-57.92207,2018-11-11 07:00:00,29,1,30
"33832",10602,"Corner Brook","NL",48.95224,-57.92207,2018-11-11 08:00:00,25,1,26
"33833",10602,"Corner Brook","NL",48.95224,-57.92207,2018-11-11 09:00:00,24,1,25
"33834",10602,"Corner Brook","NL",48.95224,-57.92207,2018-11-11 10:00:00,24,1,25
"33835",10602,"Corner Brook","NL",48.95224,-57.92207,2018-11-11 11:00:00,25,1,26
"33836",10602,"Corner Brook","NL",48.95224,-57.92207,2018-11-11 12:00:00,25,1,26
"33837",10602,"Corner Brook","NL",48.95224,-57.92207,2018-11-11 13:00:00,26,1,27
"33838",10602,"Corner Brook","NL",48.95224,-57.92207,2018-11-11 14:00:00,27,1,28
"33839",10602,"Corner Brook","NL",48.95224,-57.92207,2018-11-11 15:00:00,28,1,29
"33840",10602,"Corner Brook","NL",48.95224,-57.92207,2018-11-11 16:00:00,29,1,30
"33841",10602,"Corner Brook","NL",48.95224,-57.92207,2018-11-11 17:00:00,29,1,30
"33842",10602,"Corner Brook","NL",48.95224,-57.92207,2018-11-11 18:00:00,29,1,30
"33843",10602,"Corner Brook","NL",48.95224,-57.92207,2018-11-11 19:00:00,30,1,31
"33844",10602,"Corner Brook","NL",48.95224,-57.92207,2018-11-11 20:00:00,31,1,32
"33845",10602,"Corner Brook","NL",48.95224,-57.92207,2018-11-11 21:00:00,31,1,32
"33846",10602,"Corner Brook","NL",48.95224,-57.92207,2018-11-11 22:00:00,32,1,33
"33847",10602,"Corner Brook","NL",48.95224,-57.92207,2018-11-11 23:00:00,33,1,34
"33848",10602,"Corner Brook","NL",48.95224,-57.92207,2018-11-12 00:00:00,33,1,34
"33849",10602,"Corner Brook","NL",48.95224,-57.92207,2018-11-12 01:00:00,33,1,34
"33850",10602,"Corner Brook","NL",48.95224,-57.92207,2018-11-12 02:00:00,32,2,34
"33851",10602,"Corner Brook","NL",48.95224,-57.92207,2018-11-12 03:00:00,31,2,33
"33852",10602,"Corner Brook","NL",48.95224,-57.92207,2018-11-12 04:00:00,32,1,33
"33853",10602,"Corner Brook","NL",48.95224,-57.92207,2018-11-12 05:00:00,33,1,34
"33854",10602,"Corner Brook","NL",48.95224,-57.92207,2018-11-12 06:00:00,34,2,36
"33855",10602,"Corner Brook","NL",48.95224,-57.92207,2018-11-12 07:00:00,33,3,36
"33856",10602,"Corner Brook","NL",48.95224,-57.92207,2018-11-12 08:00:00,33,3,36
"33857",10602,"Corner Brook","NL",48.95224,-57.92207,2018-11-12 09:00:00,33,3,36
"33858",10602,"Corner Brook","NL",48.95224,-57.92207,2018-11-12 10:00:00,34,2,36
"33859",10602,"Corner Brook","NL",48.95224,-57.92207,2018-11-12 11:00:00,35,2,37
"33860",10602,"Corner Brook","NL",48.95224,-57.92207,2018-11-12 12:00:00,33,3,36
"33861",10602,"Corner Brook","NL",48.95224,-57.92207,2018-11-12 13:00:00,33,3,36
"33862",10602,"Corner Brook","NL",48.95224,-57.92207,2018-11-12 14:00:00,33,2,35
"33863",10602,"Corner Brook","NL",48.95224,-57.92207,2018-11-12 15:00:00,32,4,36
"33864",10602,"Corner Brook","NL",48.95224,-57.92207,2018-11-12 16:00:00,33,3,36
"33865",10602,"Corner Brook","NL",48.95224,-57.92207,2018-11-12 17:00:00,33,3,36
"33866",10602,"Corner Brook","NL",48.95224,-57.92207,2018-11-12 18:00:00,33,3,36
"33867",10602,"Corner Brook","NL",48.95224,-57.92207,2018-11-12 19:00:00,33,2,35
"33868",10602,"Corner Brook","NL",48.95224,-57.92207,2018-11-12 20:00:00,34,2,36
"33869",10602,"Corner Brook","NL",48.95224,-57.92207,2018-11-12 21:00:00,34,1,35
"33870",10602,"Corner Brook","NL",48.95224,-57.92207,2018-11-12 22:00:00,33,2,35
"33871",10602,"Corner Brook","NL",48.95224,-57.92207,2018-11-12 23:00:00,33,2,35
"33872",10602,"Corner Brook","NL",48.95224,-57.92207,2018-11-13 00:00:00,33,2,35
"33873",10602,"Corner Brook","NL",48.95224,-57.92207,2018-11-13 01:00:00,31,4,35
"33874",10602,"Corner Brook","NL",48.95224,-57.92207,2018-11-13 02:00:00,32,3,35
"33875",10602,"Corner Brook","NL",48.95224,-57.92207,2018-11-13 03:00:00,31,3,34
"33876",10602,"Corner Brook","NL",48.95224,-57.92207,2018-11-13 04:00:00,31,4,35
"33877",10602,"Corner Brook","NL",48.95224,-57.92207,2018-11-13 05:00:00,30,3,33
"33878",10602,"Corner Brook","NL",48.95224,-57.92207,2018-11-13 06:00:00,32,2,34
"33879",10602,"Corner Brook","NL",48.95224,-57.92207,2018-11-13 07:00:00,31,3,34
"33880",10602,"Corner Brook","NL",48.95224,-57.92207,2018-11-13 08:00:00,31,4,35
"33881",10602,"Corner Brook","NL",48.95224,-57.92207,2018-11-13 09:00:00,30,6,36
"33882",10602,"Corner Brook","NL",48.95224,-57.92207,2018-11-13 10:00:00,31,4,35
"33883",10602,"Corner Brook","NL",48.95224,-57.92207,2018-11-13 11:00:00,30,5,35
"33884",10602,"Corner Brook","NL",48.95224,-57.92207,2018-11-13 12:00:00,29,7,36
"33885",10602,"Corner Brook","NL",48.95224,-57.92207,2018-11-13 13:00:00,30,5,35
"33886",10602,"Corner Brook","NL",48.95224,-57.92207,2018-11-13 14:00:00,32,3,35
"33887",10602,"Corner Brook","NL",48.95224,-57.92207,2018-11-13 15:00:00,32,2,34
"33888",10602,"Corner Brook","NL",48.95224,-57.92207,2018-11-13 16:00:00,32,2,34
"33889",10602,"Corner Brook","NL",48.95224,-57.92207,2018-11-13 17:00:00,32,3,35
"33890",10602,"Corner Brook","NL",48.95224,-57.92207,2018-11-13 18:00:00,32,2,34
"33891",10602,"Corner Brook","NL",48.95224,-57.92207,2018-11-13 19:00:00,33,2,35
"33892",10602,"Corner Brook","NL",48.95224,-57.92207,2018-11-13 20:00:00,32,2,34
"33893",10602,"Corner Brook","NL",48.95224,-57.92207,2018-11-13 21:00:00,31,2,33
"33894",10602,"Corner Brook","NL",48.95224,-57.92207,2018-11-13 22:00:00,31,2,33
"33895",10602,"Corner Brook","NL",48.95224,-57.92207,2018-11-13 23:00:00,32,2,34
"33896",10602,"Corner Brook","NL",48.95224,-57.92207,2018-11-14 00:00:00,32,2,34
"33897",10602,"Corner Brook","NL",48.95224,-57.92207,2018-11-14 01:00:00,33,2,35
"33898",10602,"Corner Brook","NL",48.95224,-57.92207,2018-11-14 02:00:00,30,3,33
"33899",10602,"Corner Brook","NL",48.95224,-57.92207,2018-11-14 03:00:00,33,2,35
"33900",10602,"Corner Brook","NL",48.95224,-57.92207,2018-11-14 04:00:00,32,2,34
"33901",10602,"Corner Brook","NL",48.95224,-57.92207,2018-11-14 05:00:00,32,2,34
"33902",10602,"Corner Brook","NL",48.95224,-57.92207,2018-11-14 06:00:00,33,2,35
"33903",10602,"Corner Brook","NL",48.95224,-57.92207,2018-11-14 07:00:00,32,2,34
"33904",10602,"Corner Brook","NL",48.95224,-57.92207,2018-11-14 08:00:00,30,5,35
"33905",10602,"Corner Brook","NL",48.95224,-57.92207,2018-11-14 09:00:00,29,6,35
"33906",10602,"Corner Brook","NL",48.95224,-57.92207,2018-11-14 10:00:00,34,1,35
"33907",10602,"Corner Brook","NL",48.95224,-57.92207,2018-11-14 11:00:00,34,1,35
"33908",10602,"Corner Brook","NL",48.95224,-57.92207,2018-11-14 12:00:00,33,1,34
"33909",10602,"Corner Brook","NL",48.95224,-57.92207,2018-11-14 13:00:00,34,1,35
"33910",10602,"Corner Brook","NL",48.95224,-57.92207,2018-11-14 14:00:00,33,1,34
"33911",10602,"Corner Brook","NL",48.95224,-57.92207,2018-11-14 15:00:00,34,1,35
"33912",10602,"Corner Brook","NL",48.95224,-57.92207,2018-11-14 16:00:00,34,1,35
"33913",10602,"Corner Brook","NL",48.95224,-57.92207,2018-11-14 17:00:00,34,1,35
"33914",10602,"Corner Brook","NL",48.95224,-57.92207,2018-11-14 18:00:00,32,2,34
"33915",10602,"Corner Brook","NL",48.95224,-57.92207,2018-11-14 19:00:00,33,1,34
"33916",10602,"Corner Brook","NL",48.95224,-57.92207,2018-11-14 20:00:00,31,3,34
"33917",10602,"Corner Brook","NL",48.95224,-57.92207,2018-11-14 21:00:00,34,2,36
"33918",10602,"Corner Brook","NL",48.95224,-57.92207,2018-11-14 22:00:00,37,1,38
"33919",10602,"Corner Brook","NL",48.95224,-57.92207,2018-11-14 23:00:00,37,0,37
"33920",10602,"Corner Brook","NL",48.95224,-57.92207,2018-11-15 00:00:00,37,0,37
"33921",10602,"Corner Brook","NL",48.95224,-57.92207,2018-11-15 01:00:00,37,0,37
"33922",10602,"Corner Brook","NL",48.95224,-57.92207,2018-11-15 02:00:00,37,0,37
"33923",10602,"Corner Brook","NL",48.95224,-57.92207,2018-11-15 03:00:00,37,0,37
"33924",10602,"Corner Brook","NL",48.95224,-57.92207,2018-11-15 04:00:00,35,1,36
"33925",10602,"Corner Brook","NL",48.95224,-57.92207,2018-11-15 05:00:00,35,1,36
"33926",10602,"Corner Brook","NL",48.95224,-57.92207,2018-11-15 06:00:00,35,1,36
"33927",10602,"Corner Brook","NL",48.95224,-57.92207,2018-11-15 07:00:00,36,1,37
"33928",10602,"Corner Brook","NL",48.95224,-57.92207,2018-11-15 08:00:00,36,1,37
"33929",10602,"Corner Brook","NL",48.95224,-57.92207,2018-11-15 09:00:00,36,1,37
"33930",10602,"Corner Brook","NL",48.95224,-57.92207,2018-11-15 10:00:00,37,1,38
"33931",10602,"Corner Brook","NL",48.95224,-57.92207,2018-11-15 11:00:00,37,1,38
"33932",10602,"Corner Brook","NL",48.95224,-57.92207,2018-11-15 12:00:00,36,1,37
"33933",10602,"Corner Brook","NL",48.95224,-57.92207,2018-11-15 13:00:00,36,1,37
"33934",10602,"Corner Brook","NL",48.95224,-57.92207,2018-11-15 14:00:00,36,1,37
"33935",10602,"Corner Brook","NL",48.95224,-57.92207,2018-11-15 15:00:00,37,1,38
"33936",10602,"Corner Brook","NL",48.95224,-57.92207,2018-11-15 16:00:00,37,1,38
"33937",10602,"Corner Brook","NL",48.95224,-57.92207,2018-11-15 17:00:00,37,1,38
"33938",10602,"Corner Brook","NL",48.95224,-57.92207,2018-11-15 18:00:00,37,1,38
"33939",10602,"Corner Brook","NL",48.95224,-57.92207,2018-11-15 19:00:00,38,1,39
"33940",10602,"Corner Brook","NL",48.95224,-57.92207,2018-11-15 20:00:00,38,1,39
"33941",10602,"Corner Brook","NL",48.95224,-57.92207,2018-11-15 21:00:00,38,1,39
"33942",10602,"Corner Brook","NL",48.95224,-57.92207,2018-11-15 22:00:00,37,1,38
"33943",10602,"Corner Brook","NL",48.95224,-57.92207,2018-11-15 23:00:00,38,1,39
"33944",10602,"Corner Brook","NL",48.95224,-57.92207,2018-11-16 00:00:00,37,1,38
"33945",10602,"Corner Brook","NL",48.95224,-57.92207,2018-11-16 01:00:00,37,1,38
"33946",10602,"Corner Brook","NL",48.95224,-57.92207,2018-11-16 02:00:00,37,1,38
"33947",10602,"Corner Brook","NL",48.95224,-57.92207,2018-11-16 03:00:00,37,1,38
"33948",10602,"Corner Brook","NL",48.95224,-57.92207,2018-11-16 04:00:00,38,1,39
"33949",10602,"Corner Brook","NL",48.95224,-57.92207,2018-11-16 05:00:00,37,1,38
"33950",10602,"Corner Brook","NL",48.95224,-57.92207,2018-11-16 06:00:00,37,1,38
"33951",10602,"Corner Brook","NL",48.95224,-57.92207,2018-11-16 07:00:00,35,2,37
"33952",10602,"Corner Brook","NL",48.95224,-57.92207,2018-11-16 08:00:00,28,7,35
"33953",10602,"Corner Brook","NL",48.95224,-57.92207,2018-11-16 09:00:00,32,4,36
"33954",10602,"Corner Brook","NL",48.95224,-57.92207,2018-11-16 10:00:00,34,3,37
"33955",10602,"Corner Brook","NL",48.95224,-57.92207,2018-11-16 11:00:00,35,3,38
"33956",10602,"Corner Brook","NL",48.95224,-57.92207,2018-11-16 12:00:00,35,2,37
"33957",10602,"Corner Brook","NL",48.95224,-57.92207,2018-11-16 13:00:00,35,2,37
"33958",10602,"Corner Brook","NL",48.95224,-57.92207,2018-11-16 14:00:00,35,19,54
"33959",10602,"Corner Brook","NL",48.95224,-57.92207,2018-11-16 15:00:00,33,6,39
"33960",10602,"Corner Brook","NL",48.95224,-57.92207,2018-11-16 16:00:00,33,5,38
"33961",10602,"Corner Brook","NL",48.95224,-57.92207,2018-11-16 17:00:00,31,6,37
"33962",10602,"Corner Brook","NL",48.95224,-57.92207,2018-11-16 18:00:00,32,5,37
"33963",10602,"Corner Brook","NL",48.95224,-57.92207,2018-11-16 19:00:00,36,2,38
"33964",10602,"Corner Brook","NL",48.95224,-57.92207,2018-11-16 20:00:00,36,2,38
"33965",10602,"Corner Brook","NL",48.95224,-57.92207,2018-11-16 21:00:00,35,3,38
"33966",10602,"Corner Brook","NL",48.95224,-57.92207,2018-11-16 22:00:00,36,1,37
"33967",10602,"Corner Brook","NL",48.95224,-57.92207,2018-11-16 23:00:00,36,1,37
"33968",10602,"Corner Brook","NL",48.95224,-57.92207,2018-11-17 00:00:00,36,1,37
"33969",10602,"Corner Brook","NL",48.95224,-57.92207,2018-11-17 01:00:00,36,1,37
"33970",10602,"Corner Brook","NL",48.95224,-57.92207,2018-11-17 02:00:00,36,1,37
"33971",10602,"Corner Brook","NL",48.95224,-57.92207,2018-11-17 03:00:00,35,1,36
"33972",10602,"Corner Brook","NL",48.95224,-57.92207,2018-11-17 04:00:00,36,1,37
"33973",10602,"Corner Brook","NL",48.95224,-57.92207,2018-11-17 05:00:00,36,1,37
"33974",10602,"Corner Brook","NL",48.95224,-57.92207,2018-11-17 06:00:00,36,1,37
"33975",10602,"Corner Brook","NL",48.95224,-57.92207,2018-11-17 07:00:00,36,1,37
"33976",10602,"Corner Brook","NL",48.95224,-57.92207,2018-11-17 08:00:00,37,2,39
"33977",10602,"Corner Brook","NL",48.95224,-57.92207,2018-11-17 09:00:00,38,2,40
"33978",10602,"Corner Brook","NL",48.95224,-57.92207,2018-11-17 10:00:00,38,3,41
"33979",10602,"Corner Brook","NL",48.95224,-57.92207,2018-11-17 11:00:00,39,2,41
"33980",10602,"Corner Brook","NL",48.95224,-57.92207,2018-11-17 12:00:00,39,2,41
"33981",10602,"Corner Brook","NL",48.95224,-57.92207,2018-11-17 13:00:00,38,2,40
"33982",10602,"Corner Brook","NL",48.95224,-57.92207,2018-11-17 14:00:00,39,2,41
"33983",10602,"Corner Brook","NL",48.95224,-57.92207,2018-11-17 15:00:00,33,7,40
"33984",10602,"Corner Brook","NL",48.95224,-57.92207,2018-11-17 16:00:00,36,3,39
"33985",10602,"Corner Brook","NL",48.95224,-57.92207,2018-11-17 17:00:00,35,3,38
"33986",10602,"Corner Brook","NL",48.95224,-57.92207,2018-11-17 18:00:00,34,4,38
"33987",10602,"Corner Brook","NL",48.95224,-57.92207,2018-11-17 19:00:00,32,4,36
"33988",10602,"Corner Brook","NL",48.95224,-57.92207,2018-11-17 20:00:00,32,3,35
"33989",10602,"Corner Brook","NL",48.95224,-57.92207,2018-11-17 21:00:00,30,6,36
"33990",10602,"Corner Brook","NL",48.95224,-57.92207,2018-11-17 22:00:00,33,3,36
"33991",10602,"Corner Brook","NL",48.95224,-57.92207,2018-11-17 23:00:00,32,2,34
"33992",10602,"Corner Brook","NL",48.95224,-57.92207,2018-11-18 00:00:00,34,3,37
"33993",10602,"Corner Brook","NL",48.95224,-57.92207,2018-11-18 01:00:00,36,2,38
"33994",10602,"Corner Brook","NL",48.95224,-57.92207,2018-11-18 02:00:00,35,2,37
"33995",10602,"Corner Brook","NL",48.95224,-57.92207,2018-11-18 03:00:00,35,2,37
"33996",10602,"Corner Brook","NL",48.95224,-57.92207,2018-11-18 04:00:00,33,3,36
"33997",10602,"Corner Brook","NL",48.95224,-57.92207,2018-11-18 05:00:00,34,1,35
"33998",10602,"Corner Brook","NL",48.95224,-57.92207,2018-11-18 06:00:00,33,1,34
"33999",10602,"Corner Brook","NL",48.95224,-57.92207,2018-11-18 07:00:00,30,4,34
"34000",10602,"Corner Brook","NL",48.95224,-57.92207,2018-11-18 08:00:00,28,3,31
"34001",10602,"Corner Brook","NL",48.95224,-57.92207,2018-11-18 09:00:00,28,3,31
"34002",10602,"Corner Brook","NL",48.95224,-57.92207,2018-11-18 10:00:00,28,2,30
"34003",10602,"Corner Brook","NL",48.95224,-57.92207,2018-11-18 11:00:00,28,3,31
"34004",10602,"Corner Brook","NL",48.95224,-57.92207,2018-11-18 12:00:00,27,4,31
"34005",10602,"Corner Brook","NL",48.95224,-57.92207,2018-11-18 13:00:00,29,2,31
"34006",10602,"Corner Brook","NL",48.95224,-57.92207,2018-11-18 14:00:00,28,2,30
"34007",10602,"Corner Brook","NL",48.95224,-57.92207,2018-11-18 15:00:00,29,2,31
"34008",10602,"Corner Brook","NL",48.95224,-57.92207,2018-11-18 16:00:00,30,2,32
"34009",10602,"Corner Brook","NL",48.95224,-57.92207,2018-11-18 17:00:00,31,2,33
"34010",10602,"Corner Brook","NL",48.95224,-57.92207,2018-11-18 18:00:00,35,2,37
"34011",10602,"Corner Brook","NL",48.95224,-57.92207,2018-11-18 19:00:00,35,2,37
"34012",10602,"Corner Brook","NL",48.95224,-57.92207,2018-11-18 20:00:00,35,2,37
"34013",10602,"Corner Brook","NL",48.95224,-57.92207,2018-11-18 21:00:00,36,2,38
"34014",10602,"Corner Brook","NL",48.95224,-57.92207,2018-11-18 22:00:00,36,3,39
"34015",10602,"Corner Brook","NL",48.95224,-57.92207,2018-11-18 23:00:00,37,2,39
"34016",10602,"Corner Brook","NL",48.95224,-57.92207,2018-11-19 00:00:00,37,2,39
"34017",10602,"Corner Brook","NL",48.95224,-57.92207,2018-11-19 01:00:00,34,3,37
"34018",10602,"Corner Brook","NL",48.95224,-57.92207,2018-11-19 02:00:00,34,3,37
"34019",10602,"Corner Brook","NL",48.95224,-57.92207,2018-11-19 03:00:00,34,2,36
"34020",10602,"Corner Brook","NL",48.95224,-57.92207,2018-11-19 04:00:00,35,1,36
"34021",10602,"Corner Brook","NL",48.95224,-57.92207,2018-11-19 05:00:00,35,1,36
"34022",10602,"Corner Brook","NL",48.95224,-57.92207,2018-11-19 06:00:00,37,1,38
"34023",10602,"Corner Brook","NL",48.95224,-57.92207,2018-11-19 07:00:00,37,1,38
"34024",10602,"Corner Brook","NL",48.95224,-57.92207,2018-11-19 08:00:00,37,2,39
"34025",10602,"Corner Brook","NL",48.95224,-57.92207,2018-11-19 09:00:00,37,2,39
"34026",10602,"Corner Brook","NL",48.95224,-57.92207,2018-11-19 10:00:00,36,2,38
"34027",10602,"Corner Brook","NL",48.95224,-57.92207,2018-11-19 11:00:00,36,1,37
"34028",10602,"Corner Brook","NL",48.95224,-57.92207,2018-11-19 12:00:00,35,1,36
"34029",10602,"Corner Brook","NL",48.95224,-57.92207,2018-11-19 13:00:00,34,1,35
"34030",10602,"Corner Brook","NL",48.95224,-57.92207,2018-11-19 14:00:00,35,1,36
"34031",10602,"Corner Brook","NL",48.95224,-57.92207,2018-11-19 15:00:00,34,2,36
"34032",10602,"Corner Brook","NL",48.95224,-57.92207,2018-11-19 16:00:00,34,2,36
"34033",10602,"Corner Brook","NL",48.95224,-57.92207,2018-11-19 17:00:00,34,3,37
"34034",10602,"Corner Brook","NL",48.95224,-57.92207,2018-11-19 18:00:00,34,3,37
"34035",10602,"Corner Brook","NL",48.95224,-57.92207,2018-11-19 19:00:00,35,1,36
"34036",10602,"Corner Brook","NL",48.95224,-57.92207,2018-11-19 20:00:00,35,2,37
"34037",10602,"Corner Brook","NL",48.95224,-57.92207,2018-11-19 21:00:00,34,3,37
"34038",10602,"Corner Brook","NL",48.95224,-57.92207,2018-11-19 22:00:00,34,2,36
"34039",10602,"Corner Brook","NL",48.95224,-57.92207,2018-11-19 23:00:00,33,2,35
"34040",10602,"Corner Brook","NL",48.95224,-57.92207,2018-11-20 00:00:00,33,3,36
"34041",10602,"Corner Brook","NL",48.95224,-57.92207,2018-11-20 01:00:00,34,2,36
"34042",10602,"Corner Brook","NL",48.95224,-57.92207,2018-11-20 02:00:00,30,3,33
"34043",10602,"Corner Brook","NL",48.95224,-57.92207,2018-11-20 03:00:00,29,3,32
"34044",10602,"Corner Brook","NL",48.95224,-57.92207,2018-11-20 04:00:00,25,6,31
"34045",10602,"Corner Brook","NL",48.95224,-57.92207,2018-11-20 05:00:00,24,7,31
"34046",10602,"Corner Brook","NL",48.95224,-57.92207,2018-11-20 06:00:00,26,6,32
"34047",10602,"Corner Brook","NL",48.95224,-57.92207,2018-11-20 07:00:00,26,6,32
"34048",10602,"Corner Brook","NL",48.95224,-57.92207,2018-11-20 08:00:00,22,8,30
"34049",10602,"Corner Brook","NL",48.95224,-57.92207,2018-11-20 09:00:00,15,14,29
"34050",10602,"Corner Brook","NL",48.95224,-57.92207,2018-11-20 10:00:00,19,12,31
"34051",10602,"Corner Brook","NL",48.95224,-57.92207,2018-11-20 11:00:00,26,5,31
"34052",10602,"Corner Brook","NL",48.95224,-57.92207,2018-11-20 12:00:00,25,9,34
"34053",10602,"Corner Brook","NL",48.95224,-57.92207,2018-11-20 13:00:00,27,7,34
"34054",10602,"Corner Brook","NL",48.95224,-57.92207,2018-11-20 14:00:00,23,10,33
"34055",10602,"Corner Brook","NL",48.95224,-57.92207,2018-11-20 15:00:00,25,8,33
"34056",10602,"Corner Brook","NL",48.95224,-57.92207,2018-11-20 16:00:00,27,6,33
"34057",10602,"Corner Brook","NL",48.95224,-57.92207,2018-11-20 17:00:00,28,6,34
"34058",10602,"Corner Brook","NL",48.95224,-57.92207,2018-11-20 18:00:00,29,4,33
"34059",10602,"Corner Brook","NL",48.95224,-57.92207,2018-11-20 19:00:00,30,3,33
"34060",10602,"Corner Brook","NL",48.95224,-57.92207,2018-11-20 20:00:00,31,2,33
"34061",10602,"Corner Brook","NL",48.95224,-57.92207,2018-11-20 21:00:00,31,2,33
"34062",10602,"Corner Brook","NL",48.95224,-57.92207,2018-11-20 22:00:00,31,2,33
"34063",10602,"Corner Brook","NL",48.95224,-57.92207,2018-11-20 23:00:00,32,2,34
"34064",10602,"Corner Brook","NL",48.95224,-57.92207,2018-11-21 00:00:00,33,1,34
"34065",10602,"Corner Brook","NL",48.95224,-57.92207,2018-11-21 01:00:00,33,1,34
"34066",10602,"Corner Brook","NL",48.95224,-57.92207,2018-11-21 02:00:00,33,1,34
"34067",10602,"Corner Brook","NL",48.95224,-57.92207,2018-11-21 03:00:00,33,1,34
"34068",10602,"Corner Brook","NL",48.95224,-57.92207,2018-11-21 04:00:00,32,1,33
"34069",10602,"Corner Brook","NL",48.95224,-57.92207,2018-11-21 05:00:00,33,1,34
"34070",10602,"Corner Brook","NL",48.95224,-57.92207,2018-11-21 06:00:00,33,1,34
"34071",10602,"Corner Brook","NL",48.95224,-57.92207,2018-11-21 07:00:00,33,2,35
"34072",10602,"Corner Brook","NL",48.95224,-57.92207,2018-11-21 08:00:00,33,2,35
"34073",10602,"Corner Brook","NL",48.95224,-57.92207,2018-11-21 09:00:00,31,3,34
"34074",10602,"Corner Brook","NL",48.95224,-57.92207,2018-11-21 10:00:00,31,3,34
"34075",10602,"Corner Brook","NL",48.95224,-57.92207,2018-11-21 11:00:00,30,3,33
"34076",10602,"Corner Brook","NL",48.95224,-57.92207,2018-11-21 12:00:00,29,4,33
"34077",10602,"Corner Brook","NL",48.95224,-57.92207,2018-11-21 13:00:00,30,3,33
"34078",10602,"Corner Brook","NL",48.95224,-57.92207,2018-11-21 14:00:00,32,2,34
"34079",10602,"Corner Brook","NL",48.95224,-57.92207,2018-11-21 15:00:00,31,3,34
"34080",10602,"Corner Brook","NL",48.95224,-57.92207,2018-11-21 16:00:00,30,4,34
"34081",10602,"Corner Brook","NL",48.95224,-57.92207,2018-11-21 17:00:00,32,2,34
"34082",10602,"Corner Brook","NL",48.95224,-57.92207,2018-11-21 18:00:00,32,1,33
"34083",10602,"Corner Brook","NL",48.95224,-57.92207,2018-11-21 19:00:00,32,2,34
"34084",10602,"Corner Brook","NL",48.95224,-57.92207,2018-11-21 20:00:00,31,3,34
"34085",10602,"Corner Brook","NL",48.95224,-57.92207,2018-11-21 21:00:00,31,2,33
"34086",10602,"Corner Brook","NL",48.95224,-57.92207,2018-11-21 22:00:00,31,3,34
"34087",10602,"Corner Brook","NL",48.95224,-57.92207,2018-11-21 23:00:00,33,2,35
"34088",10602,"Corner Brook","NL",48.95224,-57.92207,2018-11-22 00:00:00,34,1,35
"34089",10602,"Corner Brook","NL",48.95224,-57.92207,2018-11-22 01:00:00,33,1,34
"34090",10602,"Corner Brook","NL",48.95224,-57.92207,2018-11-22 02:00:00,32,2,34
"34091",10602,"Corner Brook","NL",48.95224,-57.92207,2018-11-22 03:00:00,30,3,33
"34092",10602,"Corner Brook","NL",48.95224,-57.92207,2018-11-22 04:00:00,30,3,33
"34093",10602,"Corner Brook","NL",48.95224,-57.92207,2018-11-22 05:00:00,29,4,33
"34094",10602,"Corner Brook","NL",48.95224,-57.92207,2018-11-22 06:00:00,30,4,34
"34095",10602,"Corner Brook","NL",48.95224,-57.92207,2018-11-22 07:00:00,29,4,33
"34096",10602,"Corner Brook","NL",48.95224,-57.92207,2018-11-22 08:00:00,29,5,34
"34097",10602,"Corner Brook","NL",48.95224,-57.92207,2018-11-22 09:00:00,25,8,33
"34098",10602,"Corner Brook","NL",48.95224,-57.92207,2018-11-22 10:00:00,24,9,33
"34099",10602,"Corner Brook","NL",48.95224,-57.92207,2018-11-22 11:00:00,29,4,33
"34100",10602,"Corner Brook","NL",48.95224,-57.92207,2018-11-22 12:00:00,29,5,34
"34101",10602,"Corner Brook","NL",48.95224,-57.92207,2018-11-22 13:00:00,29,5,34
"34102",10602,"Corner Brook","NL",48.95224,-57.92207,2018-11-22 14:00:00,31,15,46
"34103",10602,"Corner Brook","NL",48.95224,-57.92207,2018-11-22 15:00:00,31,27,58
"34104",10602,"Corner Brook","NL",48.95224,-57.92207,2018-11-22 16:00:00,32,12,44
"34105",10602,"Corner Brook","NL",48.95224,-57.92207,2018-11-22 17:00:00,33,2,35
"34106",10602,"Corner Brook","NL",48.95224,-57.92207,2018-11-22 18:00:00,30,3,33
"34107",10602,"Corner Brook","NL",48.95224,-57.92207,2018-11-22 19:00:00,30,3,33
"34108",10602,"Corner Brook","NL",48.95224,-57.92207,2018-11-22 20:00:00,32,1,33
"34109",10602,"Corner Brook","NL",48.95224,-57.92207,2018-11-22 21:00:00,31,3,34
"34110",10602,"Corner Brook","NL",48.95224,-57.92207,2018-11-22 22:00:00,31,2,33
"34111",10602,"Corner Brook","NL",48.95224,-57.92207,2018-11-22 23:00:00,32,2,34
"34112",10602,"Corner Brook","NL",48.95224,-57.92207,2018-11-23 00:00:00,32,3,35
"34113",10602,"Corner Brook","NL",48.95224,-57.92207,2018-11-23 01:00:00,33,1,34
"34114",10602,"Corner Brook","NL",48.95224,-57.92207,2018-11-23 02:00:00,34,1,35
"34115",10602,"Corner Brook","NL",48.95224,-57.92207,2018-11-23 03:00:00,32,2,34
"34116",10602,"Corner Brook","NL",48.95224,-57.92207,2018-11-23 04:00:00,33,1,34
"34117",10602,"Corner Brook","NL",48.95224,-57.92207,2018-11-23 05:00:00,33,2,35
"34118",10602,"Corner Brook","NL",48.95224,-57.92207,2018-11-23 06:00:00,33,2,35
"34119",10602,"Corner Brook","NL",48.95224,-57.92207,2018-11-23 07:00:00,33,3,36
"34120",10602,"Corner Brook","NL",48.95224,-57.92207,2018-11-23 08:00:00,33,2,35
"34121",10602,"Corner Brook","NL",48.95224,-57.92207,2018-11-23 09:00:00,32,3,35
"34122",10602,"Corner Brook","NL",48.95224,-57.92207,2018-11-23 10:00:00,32,3,35
"34123",10602,"Corner Brook","NL",48.95224,-57.92207,2018-11-23 11:00:00,33,2,35
"34124",10602,"Corner Brook","NL",48.95224,-57.92207,2018-11-23 12:00:00,33,2,35
"34125",10602,"Corner Brook","NL",48.95224,-57.92207,2018-11-23 13:00:00,31,3,34
"34126",10602,"Corner Brook","NL",48.95224,-57.92207,2018-11-23 14:00:00,34,1,35
"34127",10602,"Corner Brook","NL",48.95224,-57.92207,2018-11-23 15:00:00,33,2,35
"34128",10602,"Corner Brook","NL",48.95224,-57.92207,2018-11-23 16:00:00,33,2,35
"34129",10602,"Corner Brook","NL",48.95224,-57.92207,2018-11-23 17:00:00,32,2,34
"34130",10602,"Corner Brook","NL",48.95224,-57.92207,2018-11-23 18:00:00,33,2,35
"34131",10602,"Corner Brook","NL",48.95224,-57.92207,2018-11-23 19:00:00,33,1,34
"34132",10602,"Corner Brook","NL",48.95224,-57.92207,2018-11-23 20:00:00,33,2,35
"34133",10602,"Corner Brook","NL",48.95224,-57.92207,2018-11-23 21:00:00,33,2,35
"34134",10602,"Corner Brook","NL",48.95224,-57.92207,2018-11-23 22:00:00,34,2,36
"34135",10602,"Corner Brook","NL",48.95224,-57.92207,2018-11-23 23:00:00,35,1,36
"34136",10602,"Corner Brook","NL",48.95224,-57.92207,2018-11-24 00:00:00,36,1,37
"34137",10602,"Corner Brook","NL",48.95224,-57.92207,2018-11-24 01:00:00,37,1,38
"34138",10602,"Corner Brook","NL",48.95224,-57.92207,2018-11-24 02:00:00,37,1,38
"34139",10602,"Corner Brook","NL",48.95224,-57.92207,2018-11-24 03:00:00,37,2,39
"34140",10602,"Corner Brook","NL",48.95224,-57.92207,2018-11-24 04:00:00,37,1,38
"34141",10602,"Corner Brook","NL",48.95224,-57.92207,2018-11-24 05:00:00,37,1,38
"34142",10602,"Corner Brook","NL",48.95224,-57.92207,2018-11-24 06:00:00,37,1,38
"34143",10602,"Corner Brook","NL",48.95224,-57.92207,2018-11-24 07:00:00,36,3,39
"34144",10602,"Corner Brook","NL",48.95224,-57.92207,2018-11-24 08:00:00,35,2,37
"34145",10602,"Corner Brook","NL",48.95224,-57.92207,2018-11-24 09:00:00,35,2,37
"34146",10602,"Corner Brook","NL",48.95224,-57.92207,2018-11-24 10:00:00,35,2,37
"34147",10602,"Corner Brook","NL",48.95224,-57.92207,2018-11-24 11:00:00,35,2,37
"34148",10602,"Corner Brook","NL",48.95224,-57.92207,2018-11-24 12:00:00,35,2,37
"34149",10602,"Corner Brook","NL",48.95224,-57.92207,2018-11-24 13:00:00,35,2,37
"34150",10602,"Corner Brook","NL",48.95224,-57.92207,2018-11-24 14:00:00,34,2,36
"34151",10602,"Corner Brook","NL",48.95224,-57.92207,2018-11-24 15:00:00,32,4,36
"34152",10602,"Corner Brook","NL",48.95224,-57.92207,2018-11-24 16:00:00,30,6,36
"34153",10602,"Corner Brook","NL",48.95224,-57.92207,2018-11-24 17:00:00,29,6,35
"34154",10602,"Corner Brook","NL",48.95224,-57.92207,2018-11-24 18:00:00,28,7,35
"34155",10602,"Corner Brook","NL",48.95224,-57.92207,2018-11-24 19:00:00,31,5,36
"34156",10602,"Corner Brook","NL",48.95224,-57.92207,2018-11-24 20:00:00,34,1,35
"34157",10602,"Corner Brook","NL",48.95224,-57.92207,2018-11-24 21:00:00,35,1,36
"34158",10602,"Corner Brook","NL",48.95224,-57.92207,2018-11-24 22:00:00,33,2,35
"34159",10602,"Corner Brook","NL",48.95224,-57.92207,2018-11-24 23:00:00,34,2,36
"34160",10602,"Corner Brook","NL",48.95224,-57.92207,2018-11-25 00:00:00,32,3,35
"34161",10602,"Corner Brook","NL",48.95224,-57.92207,2018-11-25 01:00:00,29,4,33
"34162",10602,"Corner Brook","NL",48.95224,-57.92207,2018-11-25 02:00:00,30,4,34
"34163",10602,"Corner Brook","NL",48.95224,-57.92207,2018-11-25 03:00:00,31,3,34
"34164",10602,"Corner Brook","NL",48.95224,-57.92207,2018-11-25 04:00:00,32,2,34
"34165",10602,"Corner Brook","NL",48.95224,-57.92207,2018-11-25 05:00:00,31,4,35
"34166",10602,"Corner Brook","NL",48.95224,-57.92207,2018-11-25 06:00:00,28,5,33
"34167",10602,"Corner Brook","NL",48.95224,-57.92207,2018-11-25 07:00:00,28,5,33
"34168",10602,"Corner Brook","NL",48.95224,-57.92207,2018-11-25 08:00:00,32,3,35
"34169",10602,"Corner Brook","NL",48.95224,-57.92207,2018-11-25 09:00:00,30,4,34
"34170",10602,"Corner Brook","NL",48.95224,-57.92207,2018-11-25 10:00:00,28,5,33
"34171",10602,"Corner Brook","NL",48.95224,-57.92207,2018-11-25 11:00:00,32,3,35
"34172",10602,"Corner Brook","NL",48.95224,-57.92207,2018-11-25 12:00:00,33,2,35
"34173",10602,"Corner Brook","NL",48.95224,-57.92207,2018-11-25 13:00:00,34,2,36
"34174",10602,"Corner Brook","NL",48.95224,-57.92207,2018-11-25 14:00:00,34,2,36
"34175",10602,"Corner Brook","NL",48.95224,-57.92207,2018-11-25 15:00:00,35,1,36
"34176",10602,"Corner Brook","NL",48.95224,-57.92207,2018-11-25 16:00:00,32,3,35
"34177",10602,"Corner Brook","NL",48.95224,-57.92207,2018-11-25 17:00:00,29,5,34
"34178",10602,"Corner Brook","NL",48.95224,-57.92207,2018-11-25 18:00:00,30,5,35
"34179",10602,"Corner Brook","NL",48.95224,-57.92207,2018-11-25 19:00:00,28,6,34
"34180",10602,"Corner Brook","NL",48.95224,-57.92207,2018-11-25 20:00:00,29,5,34
"34181",10602,"Corner Brook","NL",48.95224,-57.92207,2018-11-25 21:00:00,27,6,33
"34182",10602,"Corner Brook","NL",48.95224,-57.92207,2018-11-25 22:00:00,25,8,33
"34183",10602,"Corner Brook","NL",48.95224,-57.92207,2018-11-25 23:00:00,21,11,32
"34184",10602,"Corner Brook","NL",48.95224,-57.92207,2018-11-26 00:00:00,17,14,31
"34185",10602,"Corner Brook","NL",48.95224,-57.92207,2018-11-26 01:00:00,22,9,31
"34186",10602,"Corner Brook","NL",48.95224,-57.92207,2018-11-26 02:00:00,20,9,29
"34187",10602,"Corner Brook","NL",48.95224,-57.92207,2018-11-26 03:00:00,18,9,27
"34188",10602,"Corner Brook","NL",48.95224,-57.92207,2018-11-26 04:00:00,21,7,28
"34189",10602,"Corner Brook","NL",48.95224,-57.92207,2018-11-26 05:00:00,16,11,27
"34190",10602,"Corner Brook","NL",48.95224,-57.92207,2018-11-26 06:00:00,17,10,27
"34191",10602,"Corner Brook","NL",48.95224,-57.92207,2018-11-26 07:00:00,18,10,28
"34192",10602,"Corner Brook","NL",48.95224,-57.92207,2018-11-26 08:00:00,7,18,25
"34193",10602,"Corner Brook","NL",48.95224,-57.92207,2018-11-26 09:00:00,7,18,25
"34194",10602,"Corner Brook","NL",48.95224,-57.92207,2018-11-26 10:00:00,15,14,29
"34195",10602,"Corner Brook","NL",48.95224,-57.92207,2018-11-26 11:00:00,28,8,36
"34196",10602,"Corner Brook","NL",48.95224,-57.92207,2018-11-26 12:00:00,34,4,38
"34197",10602,"Corner Brook","NL",48.95224,-57.92207,2018-11-26 13:00:00,34,3,37
"34198",10602,"Corner Brook","NL",48.95224,-57.92207,2018-11-26 14:00:00,34,3,37
"34199",10602,"Corner Brook","NL",48.95224,-57.92207,2018-11-26 15:00:00,33,4,37
"34200",10602,"Corner Brook","NL",48.95224,-57.92207,2018-11-26 16:00:00,30,6,36
"34201",10602,"Corner Brook","NL",48.95224,-57.92207,2018-11-26 17:00:00,27,8,35
"34202",10602,"Corner Brook","NL",48.95224,-57.92207,2018-11-26 18:00:00,32,3,35
"34203",10602,"Corner Brook","NL",48.95224,-57.92207,2018-11-26 19:00:00,33,2,35
"34204",10602,"Corner Brook","NL",48.95224,-57.92207,2018-11-26 20:00:00,33,2,35
"34205",10602,"Corner Brook","NL",48.95224,-57.92207,2018-11-26 21:00:00,32,2,34
"34206",10602,"Corner Brook","NL",48.95224,-57.92207,2018-11-26 22:00:00,26,6,32
"34207",10602,"Corner Brook","NL",48.95224,-57.92207,2018-11-26 23:00:00,24,5,29
"34208",10602,"Corner Brook","NL",48.95224,-57.92207,2018-11-27 00:00:00,22,7,29
"34209",10602,"Corner Brook","NL",48.95224,-57.92207,2018-11-27 01:00:00,26,4,30
"34210",10602,"Corner Brook","NL",48.95224,-57.92207,2018-11-27 02:00:00,31,2,33
"34211",10602,"Corner Brook","NL",48.95224,-57.92207,2018-11-27 03:00:00,31,2,33
"34212",10602,"Corner Brook","NL",48.95224,-57.92207,2018-11-27 04:00:00,30,2,32
"34213",10602,"Corner Brook","NL",48.95224,-57.92207,2018-11-27 05:00:00,31,2,33
"34214",10602,"Corner Brook","NL",48.95224,-57.92207,2018-11-27 06:00:00,30,2,32
"34215",10602,"Corner Brook","NL",48.95224,-57.92207,2018-11-27 07:00:00,31,1,32
"34216",10602,"Corner Brook","NL",48.95224,-57.92207,2018-11-27 08:00:00,31,2,33
"34217",10602,"Corner Brook","NL",48.95224,-57.92207,2018-11-27 09:00:00,30,3,33
"34218",10602,"Corner Brook","NL",48.95224,-57.92207,2018-11-27 10:00:00,30,3,33
"34219",10602,"Corner Brook","NL",48.95224,-57.92207,2018-11-27 11:00:00,30,3,33
"34220",10602,"Corner Brook","NL",48.95224,-57.92207,2018-11-27 12:00:00,28,4,32
"34221",10602,"Corner Brook","NL",48.95224,-57.92207,2018-11-27 13:00:00,29,3,32
"34222",10602,"Corner Brook","NL",48.95224,-57.92207,2018-11-27 14:00:00,30,3,33
"34223",10602,"Corner Brook","NL",48.95224,-57.92207,2018-11-27 15:00:00,28,5,33
"34224",10602,"Corner Brook","NL",48.95224,-57.92207,2018-11-27 16:00:00,29,4,33
"34225",10602,"Corner Brook","NL",48.95224,-57.92207,2018-11-27 17:00:00,29,4,33
"34226",10602,"Corner Brook","NL",48.95224,-57.92207,2018-11-27 18:00:00,30,3,33
"34227",10602,"Corner Brook","NL",48.95224,-57.92207,2018-11-27 19:00:00,31,2,33
"34228",10602,"Corner Brook","NL",48.95224,-57.92207,2018-11-27 20:00:00,32,1,33
"34229",10602,"Corner Brook","NL",48.95224,-57.92207,2018-11-27 21:00:00,32,1,33
"34230",10602,"Corner Brook","NL",48.95224,-57.92207,2018-11-27 22:00:00,32,1,33
"34231",10602,"Corner Brook","NL",48.95224,-57.92207,2018-11-27 23:00:00,32,1,33
"34232",10602,"Corner Brook","NL",48.95224,-57.92207,2018-11-28 00:00:00,32,1,33
"34233",10602,"Corner Brook","NL",48.95224,-57.92207,2018-11-28 01:00:00,32,1,33
"34234",10602,"Corner Brook","NL",48.95224,-57.92207,2018-11-28 02:00:00,33,1,34
"34235",10602,"Corner Brook","NL",48.95224,-57.92207,2018-11-28 03:00:00,33,1,34
"34236",10602,"Corner Brook","NL",48.95224,-57.92207,2018-11-28 04:00:00,33,1,34
"34237",10602,"Corner Brook","NL",48.95224,-57.92207,2018-11-28 05:00:00,33,1,34
"34238",10602,"Corner Brook","NL",48.95224,-57.92207,2018-11-28 06:00:00,33,1,34
"34239",10602,"Corner Brook","NL",48.95224,-57.92207,2018-11-28 07:00:00,33,2,35
"34240",10602,"Corner Brook","NL",48.95224,-57.92207,2018-11-28 08:00:00,34,1,35
"34241",10602,"Corner Brook","NL",48.95224,-57.92207,2018-11-28 09:00:00,34,2,36
"34242",10602,"Corner Brook","NL",48.95224,-57.92207,2018-11-28 10:00:00,34,2,36
"34243",10602,"Corner Brook","NL",48.95224,-57.92207,2018-11-28 11:00:00,33,2,35
"34244",10602,"Corner Brook","NL",48.95224,-57.92207,2018-11-28 12:00:00,33,2,35
"34245",10602,"Corner Brook","NL",48.95224,-57.92207,2018-11-28 13:00:00,34,1,35
"34246",10602,"Corner Brook","NL",48.95224,-57.92207,2018-11-28 14:00:00,35,1,36
"34247",10602,"Corner Brook","NL",48.95224,-57.92207,2018-11-28 15:00:00,34,1,35
"34248",10602,"Corner Brook","NL",48.95224,-57.92207,2018-11-28 16:00:00,34,2,36
"34249",10602,"Corner Brook","NL",48.95224,-57.92207,2018-11-28 17:00:00,33,2,35
"34250",10602,"Corner Brook","NL",48.95224,-57.92207,2018-11-28 18:00:00,34,1,35
"34251",10602,"Corner Brook","NL",48.95224,-57.92207,2018-11-28 19:00:00,35,1,36
"34252",10602,"Corner Brook","NL",48.95224,-57.92207,2018-11-28 20:00:00,36,1,37
"34253",10602,"Corner Brook","NL",48.95224,-57.92207,2018-11-28 21:00:00,36,1,37
"34254",10602,"Corner Brook","NL",48.95224,-57.92207,2018-11-28 22:00:00,37,1,38
"34255",10602,"Corner Brook","NL",48.95224,-57.92207,2018-11-28 23:00:00,37,1,38
"34256",10602,"Corner Brook","NL",48.95224,-57.92207,2018-11-29 00:00:00,37,1,38
"34257",10602,"Corner Brook","NL",48.95224,-57.92207,2018-11-29 01:00:00,38,1,39
"34258",10602,"Corner Brook","NL",48.95224,-57.92207,2018-11-29 02:00:00,39,0,39
"34259",10602,"Corner Brook","NL",48.95224,-57.92207,2018-11-29 03:00:00,39,1,40
"34260",10602,"Corner Brook","NL",48.95224,-57.92207,2018-11-29 04:00:00,39,0,39
"34261",10602,"Corner Brook","NL",48.95224,-57.92207,2018-11-29 05:00:00,39,1,40
"34262",10602,"Corner Brook","NL",48.95224,-57.92207,2018-11-29 06:00:00,39,0,39
"34263",10602,"Corner Brook","NL",48.95224,-57.92207,2018-11-29 07:00:00,40,1,41
"34264",10602,"Corner Brook","NL",48.95224,-57.92207,2018-11-29 08:00:00,41,1,42
"34265",10602,"Corner Brook","NL",48.95224,-57.92207,2018-11-29 09:00:00,41,1,42
"34266",10602,"Corner Brook","NL",48.95224,-57.92207,2018-11-29 10:00:00,39,2,41
"34267",10602,"Corner Brook","NL",48.95224,-57.92207,2018-11-29 11:00:00,39,1,40
"34268",10602,"Corner Brook","NL",48.95224,-57.92207,2018-11-29 12:00:00,39,1,40
"34269",10602,"Corner Brook","NL",48.95224,-57.92207,2018-11-29 13:00:00,39,1,40
"34270",10602,"Corner Brook","NL",48.95224,-57.92207,2018-11-29 14:00:00,39,2,41
"34271",10602,"Corner Brook","NL",48.95224,-57.92207,2018-11-29 15:00:00,39,2,41
"34272",10602,"Corner Brook","NL",48.95224,-57.92207,2018-11-29 16:00:00,39,2,41
"34273",10602,"Corner Brook","NL",48.95224,-57.92207,2018-11-29 17:00:00,38,2,40
"34274",10602,"Corner Brook","NL",48.95224,-57.92207,2018-11-29 18:00:00,40,1,41
"34275",10602,"Corner Brook","NL",48.95224,-57.92207,2018-11-29 19:00:00,41,1,42
"34276",10602,"Corner Brook","NL",48.95224,-57.92207,2018-11-29 20:00:00,41,1,42
"34277",10602,"Corner Brook","NL",48.95224,-57.92207,2018-11-29 21:00:00,41,1,42
"34278",10602,"Corner Brook","NL",48.95224,-57.92207,2018-11-29 22:00:00,40,1,41
"34279",10602,"Corner Brook","NL",48.95224,-57.92207,2018-11-29 23:00:00,40,1,41
"34280",10602,"Corner Brook","NL",48.95224,-57.92207,2018-11-30 00:00:00,40,1,41
"34281",10602,"Corner Brook","NL",48.95224,-57.92207,2018-11-30 01:00:00,40,1,41
"34282",10602,"Corner Brook","NL",48.95224,-57.92207,2018-11-30 02:00:00,39,1,40
"34283",10602,"Corner Brook","NL",48.95224,-57.92207,2018-11-30 03:00:00,39,1,40
"34284",10602,"Corner Brook","NL",48.95224,-57.92207,2018-11-30 04:00:00,39,1,40
"34285",10602,"Corner Brook","NL",48.95224,-57.92207,2018-11-30 05:00:00,38,1,39
"34286",10602,"Corner Brook","NL",48.95224,-57.92207,2018-11-30 06:00:00,38,1,39
"34287",10602,"Corner Brook","NL",48.95224,-57.92207,2018-11-30 07:00:00,38,1,39
"34288",10602,"Corner Brook","NL",48.95224,-57.92207,2018-11-30 08:00:00,37,1,38
"34289",10602,"Corner Brook","NL",48.95224,-57.92207,2018-11-30 09:00:00,38,2,40
"34290",10602,"Corner Brook","NL",48.95224,-57.92207,2018-11-30 10:00:00,39,2,41
"34291",10602,"Corner Brook","NL",48.95224,-57.92207,2018-11-30 11:00:00,38,2,40
"34292",10602,"Corner Brook","NL",48.95224,-57.92207,2018-11-30 12:00:00,37,2,39
"34293",10602,"Corner Brook","NL",48.95224,-57.92207,2018-11-30 13:00:00,38,2,40
"34294",10602,"Corner Brook","NL",48.95224,-57.92207,2018-11-30 14:00:00,37,NA,NA
"34295",10602,"Corner Brook","NL",48.95224,-57.92207,2018-11-30 15:00:00,37,NA,NA
"34296",10602,"Corner Brook","NL",48.95224,-57.92207,2018-11-30 16:00:00,37,NA,NA
"34297",10602,"Corner Brook","NL",48.95224,-57.92207,2018-11-30 17:00:00,37,3,40
"34298",10602,"Corner Brook","NL",48.95224,-57.92207,2018-11-30 18:00:00,36,3,39
"34299",10602,"Corner Brook","NL",48.95224,-57.92207,2018-11-30 19:00:00,37,2,39
"34300",10602,"Corner Brook","NL",48.95224,-57.92207,2018-11-30 20:00:00,36,3,39
"34301",10602,"Corner Brook","NL",48.95224,-57.92207,2018-11-30 21:00:00,37,2,39
"34302",10602,"Corner Brook","NL",48.95224,-57.92207,2018-11-30 22:00:00,37,2,39
"34303",10602,"Corner Brook","NL",48.95224,-57.92207,2018-11-30 23:00:00,37,2,39
"34304",10602,"Corner Brook","NL",48.95224,-57.92207,2018-12-01 00:00:00,37,2,39
"34305",10602,"Corner Brook","NL",48.95224,-57.92207,2018-12-01 01:00:00,36,2,38
"34306",10602,"Corner Brook","NL",48.95224,-57.92207,2018-12-01 02:00:00,35,3,38
"34307",10602,"Corner Brook","NL",48.95224,-57.92207,2018-12-01 03:00:00,35,2,37
"34308",10602,"Corner Brook","NL",48.95224,-57.92207,2018-12-01 04:00:00,35,3,38
"34309",10602,"Corner Brook","NL",48.95224,-57.92207,2018-12-01 05:00:00,36,2,38
"34310",10602,"Corner Brook","NL",48.95224,-57.92207,2018-12-01 06:00:00,36,2,38
"34311",10602,"Corner Brook","NL",48.95224,-57.92207,2018-12-01 07:00:00,36,2,38
"34312",10602,"Corner Brook","NL",48.95224,-57.92207,2018-12-01 08:00:00,37,2,39
"34313",10602,"Corner Brook","NL",48.95224,-57.92207,2018-12-01 09:00:00,37,2,39
"34314",10602,"Corner Brook","NL",48.95224,-57.92207,2018-12-01 10:00:00,36,3,39
"34315",10602,"Corner Brook","NL",48.95224,-57.92207,2018-12-01 11:00:00,36,2,38
"34316",10602,"Corner Brook","NL",48.95224,-57.92207,2018-12-01 12:00:00,38,2,40
"34317",10602,"Corner Brook","NL",48.95224,-57.92207,2018-12-01 13:00:00,38,2,40
"34318",10602,"Corner Brook","NL",48.95224,-57.92207,2018-12-01 14:00:00,37,2,39
"34319",10602,"Corner Brook","NL",48.95224,-57.92207,2018-12-01 15:00:00,37,3,40
"34320",10602,"Corner Brook","NL",48.95224,-57.92207,2018-12-01 16:00:00,37,3,40
"34321",10602,"Corner Brook","NL",48.95224,-57.92207,2018-12-01 17:00:00,35,4,39
"34322",10602,"Corner Brook","NL",48.95224,-57.92207,2018-12-01 18:00:00,35,3,38
"34323",10602,"Corner Brook","NL",48.95224,-57.92207,2018-12-01 19:00:00,33,4,37
"34324",10602,"Corner Brook","NL",48.95224,-57.92207,2018-12-01 20:00:00,31,4,35
"34325",10602,"Corner Brook","NL",48.95224,-57.92207,2018-12-01 21:00:00,32,3,35
"34326",10602,"Corner Brook","NL",48.95224,-57.92207,2018-12-01 22:00:00,31,4,35
"34327",10602,"Corner Brook","NL",48.95224,-57.92207,2018-12-01 23:00:00,28,4,32
"34328",10602,"Corner Brook","NL",48.95224,-57.92207,2018-12-02 00:00:00,26,5,31
"34329",10602,"Corner Brook","NL",48.95224,-57.92207,2018-12-02 01:00:00,25,5,30
"34330",10602,"Corner Brook","NL",48.95224,-57.92207,2018-12-02 02:00:00,25,5,30
"34331",10602,"Corner Brook","NL",48.95224,-57.92207,2018-12-02 03:00:00,22,6,28
"34332",10602,"Corner Brook","NL",48.95224,-57.92207,2018-12-02 04:00:00,27,4,31
"34333",10602,"Corner Brook","NL",48.95224,-57.92207,2018-12-02 05:00:00,26,3,29
"34334",10602,"Corner Brook","NL",48.95224,-57.92207,2018-12-02 06:00:00,24,4,28
"34335",10602,"Corner Brook","NL",48.95224,-57.92207,2018-12-02 07:00:00,22,5,27
"34336",10602,"Corner Brook","NL",48.95224,-57.92207,2018-12-02 08:00:00,25,6,31
"34337",10602,"Corner Brook","NL",48.95224,-57.92207,2018-12-02 09:00:00,33,3,36
"34338",10602,"Corner Brook","NL",48.95224,-57.92207,2018-12-02 10:00:00,36,2,38
"34339",10602,"Corner Brook","NL",48.95224,-57.92207,2018-12-02 11:00:00,36,2,38
"34340",10602,"Corner Brook","NL",48.95224,-57.92207,2018-12-02 12:00:00,36,2,38
"34341",10602,"Corner Brook","NL",48.95224,-57.92207,2018-12-02 13:00:00,37,1,38
"34342",10602,"Corner Brook","NL",48.95224,-57.92207,2018-12-02 14:00:00,37,1,38
"34343",10602,"Corner Brook","NL",48.95224,-57.92207,2018-12-02 15:00:00,36,2,38
"34344",10602,"Corner Brook","NL",48.95224,-57.92207,2018-12-02 16:00:00,35,2,37
"34345",10602,"Corner Brook","NL",48.95224,-57.92207,2018-12-02 17:00:00,33,3,36
"34346",10602,"Corner Brook","NL",48.95224,-57.92207,2018-12-02 18:00:00,33,3,36
"34347",10602,"Corner Brook","NL",48.95224,-57.92207,2018-12-02 19:00:00,33,2,35
"34348",10602,"Corner Brook","NL",48.95224,-57.92207,2018-12-02 20:00:00,33,2,35
"34349",10602,"Corner Brook","NL",48.95224,-57.92207,2018-12-02 21:00:00,33,3,36
"34350",10602,"Corner Brook","NL",48.95224,-57.92207,2018-12-02 22:00:00,31,3,34
"34351",10602,"Corner Brook","NL",48.95224,-57.92207,2018-12-02 23:00:00,34,1,35
"34352",10602,"Corner Brook","NL",48.95224,-57.92207,2018-12-03 00:00:00,36,2,38
"34353",10602,"Corner Brook","NL",48.95224,-57.92207,2018-12-03 01:00:00,36,2,38
"34354",10602,"Corner Brook","NL",48.95224,-57.92207,2018-12-03 02:00:00,35,3,38
"34355",10602,"Corner Brook","NL",48.95224,-57.92207,2018-12-03 03:00:00,36,2,38
"34356",10602,"Corner Brook","NL",48.95224,-57.92207,2018-12-03 04:00:00,36,2,38
"34357",10602,"Corner Brook","NL",48.95224,-57.92207,2018-12-03 05:00:00,38,2,40
"34358",10602,"Corner Brook","NL",48.95224,-57.92207,2018-12-03 06:00:00,38,2,40
"34359",10602,"Corner Brook","NL",48.95224,-57.92207,2018-12-03 07:00:00,38,2,40
"34360",10602,"Corner Brook","NL",48.95224,-57.92207,2018-12-03 08:00:00,39,2,41
"34361",10602,"Corner Brook","NL",48.95224,-57.92207,2018-12-03 09:00:00,41,2,43
"34362",10602,"Corner Brook","NL",48.95224,-57.92207,2018-12-03 10:00:00,41,1,42
"34363",10602,"Corner Brook","NL",48.95224,-57.92207,2018-12-03 11:00:00,41,1,42
"34364",10602,"Corner Brook","NL",48.95224,-57.92207,2018-12-03 12:00:00,41,0,41
"34365",10602,"Corner Brook","NL",48.95224,-57.92207,2018-12-03 13:00:00,40,1,41
"34366",10602,"Corner Brook","NL",48.95224,-57.92207,2018-12-03 14:00:00,38,2,40
"34367",10602,"Corner Brook","NL",48.95224,-57.92207,2018-12-03 15:00:00,37,3,40
"34368",10602,"Corner Brook","NL",48.95224,-57.92207,2018-12-03 16:00:00,36,2,38
"34369",10602,"Corner Brook","NL",48.95224,-57.92207,2018-12-03 17:00:00,37,1,38
"34370",10602,"Corner Brook","NL",48.95224,-57.92207,2018-12-03 18:00:00,36,1,37
"34371",10602,"Corner Brook","NL",48.95224,-57.92207,2018-12-03 19:00:00,35,2,37
"34372",10602,"Corner Brook","NL",48.95224,-57.92207,2018-12-03 20:00:00,35,2,37
"34373",10602,"Corner Brook","NL",48.95224,-57.92207,2018-12-03 21:00:00,35,1,36
"34374",10602,"Corner Brook","NL",48.95224,-57.92207,2018-12-03 22:00:00,35,1,36
"34375",10602,"Corner Brook","NL",48.95224,-57.92207,2018-12-03 23:00:00,34,2,36
"34376",10602,"Corner Brook","NL",48.95224,-57.92207,2018-12-04 00:00:00,33,2,35
"34377",10602,"Corner Brook","NL",48.95224,-57.92207,2018-12-04 01:00:00,32,1,33
"34378",10602,"Corner Brook","NL",48.95224,-57.92207,2018-12-04 02:00:00,31,1,32
"34379",10602,"Corner Brook","NL",48.95224,-57.92207,2018-12-04 03:00:00,30,1,31
"34380",10602,"Corner Brook","NL",48.95224,-57.92207,2018-12-04 04:00:00,29,1,30
"34381",10602,"Corner Brook","NL",48.95224,-57.92207,2018-12-04 05:00:00,30,3,33
"34382",10602,"Corner Brook","NL",48.95224,-57.92207,2018-12-04 06:00:00,32,2,34
"34383",10602,"Corner Brook","NL",48.95224,-57.92207,2018-12-04 07:00:00,32,1,33
"34384",10602,"Corner Brook","NL",48.95224,-57.92207,2018-12-04 08:00:00,31,1,32
"34385",10602,"Corner Brook","NL",48.95224,-57.92207,2018-12-04 09:00:00,32,1,33
"34386",10602,"Corner Brook","NL",48.95224,-57.92207,2018-12-04 10:00:00,33,1,34
"34387",10602,"Corner Brook","NL",48.95224,-57.92207,2018-12-04 11:00:00,33,1,34
"34388",10602,"Corner Brook","NL",48.95224,-57.92207,2018-12-04 12:00:00,32,1,33
"34389",10602,"Corner Brook","NL",48.95224,-57.92207,2018-12-04 13:00:00,31,2,33
"34390",10602,"Corner Brook","NL",48.95224,-57.92207,2018-12-04 14:00:00,30,2,32
"34391",10602,"Corner Brook","NL",48.95224,-57.92207,2018-12-04 15:00:00,29,3,32
"34392",10602,"Corner Brook","NL",48.95224,-57.92207,2018-12-04 16:00:00,29,4,33
"34393",10602,"Corner Brook","NL",48.95224,-57.92207,2018-12-04 17:00:00,27,6,33
"34394",10602,"Corner Brook","NL",48.95224,-57.92207,2018-12-04 18:00:00,26,8,34
"34395",10602,"Corner Brook","NL",48.95224,-57.92207,2018-12-04 19:00:00,32,3,35
"34396",10602,"Corner Brook","NL",48.95224,-57.92207,2018-12-04 20:00:00,34,3,37
"34397",10602,"Corner Brook","NL",48.95224,-57.92207,2018-12-04 21:00:00,34,2,36
"34398",10602,"Corner Brook","NL",48.95224,-57.92207,2018-12-04 22:00:00,32,3,35
"34399",10602,"Corner Brook","NL",48.95224,-57.92207,2018-12-04 23:00:00,32,3,35
"34400",10602,"Corner Brook","NL",48.95224,-57.92207,2018-12-05 00:00:00,35,1,36
"34401",10602,"Corner Brook","NL",48.95224,-57.92207,2018-12-05 01:00:00,36,1,37
"34402",10602,"Corner Brook","NL",48.95224,-57.92207,2018-12-05 02:00:00,35,2,37
"34403",10602,"Corner Brook","NL",48.95224,-57.92207,2018-12-05 03:00:00,36,2,38
"34404",10602,"Corner Brook","NL",48.95224,-57.92207,2018-12-05 04:00:00,37,2,39
"34405",10602,"Corner Brook","NL",48.95224,-57.92207,2018-12-05 05:00:00,35,4,39
"34406",10602,"Corner Brook","NL",48.95224,-57.92207,2018-12-05 06:00:00,34,4,38
"34407",10602,"Corner Brook","NL",48.95224,-57.92207,2018-12-05 07:00:00,34,3,37
"34408",10602,"Corner Brook","NL",48.95224,-57.92207,2018-12-05 08:00:00,35,3,38
"34409",10602,"Corner Brook","NL",48.95224,-57.92207,2018-12-05 09:00:00,35,3,38
"34410",10602,"Corner Brook","NL",48.95224,-57.92207,2018-12-05 10:00:00,37,2,39
"34411",10602,"Corner Brook","NL",48.95224,-57.92207,2018-12-05 11:00:00,37,3,40
"34412",10602,"Corner Brook","NL",48.95224,-57.92207,2018-12-05 12:00:00,39,1,40
"34413",10602,"Corner Brook","NL",48.95224,-57.92207,2018-12-05 13:00:00,39,2,41
"34414",10602,"Corner Brook","NL",48.95224,-57.92207,2018-12-05 14:00:00,38,3,41
"34415",10602,"Corner Brook","NL",48.95224,-57.92207,2018-12-05 15:00:00,38,3,41
"34416",10602,"Corner Brook","NL",48.95224,-57.92207,2018-12-05 16:00:00,39,2,41
"34417",10602,"Corner Brook","NL",48.95224,-57.92207,2018-12-05 17:00:00,37,4,41
"34418",10602,"Corner Brook","NL",48.95224,-57.92207,2018-12-05 18:00:00,38,3,41
"34419",10602,"Corner Brook","NL",48.95224,-57.92207,2018-12-05 19:00:00,39,2,41
"34420",10602,"Corner Brook","NL",48.95224,-57.92207,2018-12-05 20:00:00,38,3,41
"34421",10602,"Corner Brook","NL",48.95224,-57.92207,2018-12-05 21:00:00,37,3,40
"34422",10602,"Corner Brook","NL",48.95224,-57.92207,2018-12-05 22:00:00,38,2,40
"34423",10602,"Corner Brook","NL",48.95224,-57.92207,2018-12-05 23:00:00,39,2,41
"34424",10602,"Corner Brook","NL",48.95224,-57.92207,2018-12-06 00:00:00,38,2,40
"34425",10602,"Corner Brook","NL",48.95224,-57.92207,2018-12-06 01:00:00,39,2,41
"34426",10602,"Corner Brook","NL",48.95224,-57.92207,2018-12-06 02:00:00,38,2,40
"34427",10602,"Corner Brook","NL",48.95224,-57.92207,2018-12-06 03:00:00,37,2,39
"34428",10602,"Corner Brook","NL",48.95224,-57.92207,2018-12-06 04:00:00,38,2,40
"34429",10602,"Corner Brook","NL",48.95224,-57.92207,2018-12-06 05:00:00,37,3,40
"34430",10602,"Corner Brook","NL",48.95224,-57.92207,2018-12-06 06:00:00,35,4,39
"34431",10602,"Corner Brook","NL",48.95224,-57.92207,2018-12-06 07:00:00,39,1,40
"34432",10602,"Corner Brook","NL",48.95224,-57.92207,2018-12-06 08:00:00,37,1,38
"34433",10602,"Corner Brook","NL",48.95224,-57.92207,2018-12-06 09:00:00,34,5,39
"34434",10602,"Corner Brook","NL",48.95224,-57.92207,2018-12-06 10:00:00,35,4,39
"34435",10602,"Corner Brook","NL",48.95224,-57.92207,2018-12-06 11:00:00,32,7,39
"34436",10602,"Corner Brook","NL",48.95224,-57.92207,2018-12-06 12:00:00,36,5,41
"34437",10602,"Corner Brook","NL",48.95224,-57.92207,2018-12-06 13:00:00,38,3,41
"34438",10602,"Corner Brook","NL",48.95224,-57.92207,2018-12-06 14:00:00,38,2,40
"34439",10602,"Corner Brook","NL",48.95224,-57.92207,2018-12-06 15:00:00,37,3,40
"34440",10602,"Corner Brook","NL",48.95224,-57.92207,2018-12-06 16:00:00,35,5,40
"34441",10602,"Corner Brook","NL",48.95224,-57.92207,2018-12-06 17:00:00,36,4,40
"34442",10602,"Corner Brook","NL",48.95224,-57.92207,2018-12-06 18:00:00,37,3,40
"34443",10602,"Corner Brook","NL",48.95224,-57.92207,2018-12-06 19:00:00,38,2,40
"34444",10602,"Corner Brook","NL",48.95224,-57.92207,2018-12-06 20:00:00,38,2,40
"34445",10602,"Corner Brook","NL",48.95224,-57.92207,2018-12-06 21:00:00,37,2,39
"34446",10602,"Corner Brook","NL",48.95224,-57.92207,2018-12-06 22:00:00,36,3,39
"34447",10602,"Corner Brook","NL",48.95224,-57.92207,2018-12-06 23:00:00,35,3,38
"34448",10602,"Corner Brook","NL",48.95224,-57.92207,2018-12-07 00:00:00,35,3,38
"34449",10602,"Corner Brook","NL",48.95224,-57.92207,2018-12-07 01:00:00,35,3,38
"34450",10602,"Corner Brook","NL",48.95224,-57.92207,2018-12-07 02:00:00,32,5,37
"34451",10602,"Corner Brook","NL",48.95224,-57.92207,2018-12-07 03:00:00,33,4,37
"34452",10602,"Corner Brook","NL",48.95224,-57.92207,2018-12-07 04:00:00,34,3,37
"34453",10602,"Corner Brook","NL",48.95224,-57.92207,2018-12-07 05:00:00,33,3,36
"34454",10602,"Corner Brook","NL",48.95224,-57.92207,2018-12-07 06:00:00,34,3,37
"34455",10602,"Corner Brook","NL",48.95224,-57.92207,2018-12-07 07:00:00,33,3,36
"34456",10602,"Corner Brook","NL",48.95224,-57.92207,2018-12-07 08:00:00,34,3,37
"34457",10602,"Corner Brook","NL",48.95224,-57.92207,2018-12-07 09:00:00,33,5,38
"34458",10602,"Corner Brook","NL",48.95224,-57.92207,2018-12-07 10:00:00,33,5,38
"34459",10602,"Corner Brook","NL",48.95224,-57.92207,2018-12-07 11:00:00,33,5,38
"34460",10602,"Corner Brook","NL",48.95224,-57.92207,2018-12-07 12:00:00,34,4,38
"34461",10602,"Corner Brook","NL",48.95224,-57.92207,2018-12-07 13:00:00,34,4,38
"34462",10602,"Corner Brook","NL",48.95224,-57.92207,2018-12-07 14:00:00,34,4,38
"34463",10602,"Corner Brook","NL",48.95224,-57.92207,2018-12-07 15:00:00,33,5,38
"34464",10602,"Corner Brook","NL",48.95224,-57.92207,2018-12-07 16:00:00,33,5,38
"34465",10602,"Corner Brook","NL",48.95224,-57.92207,2018-12-07 17:00:00,33,4,37
"34466",10602,"Corner Brook","NL",48.95224,-57.92207,2018-12-07 18:00:00,32,4,36
"34467",10602,"Corner Brook","NL",48.95224,-57.92207,2018-12-07 19:00:00,30,6,36
"34468",10602,"Corner Brook","NL",48.95224,-57.92207,2018-12-07 20:00:00,32,4,36
"34469",10602,"Corner Brook","NL",48.95224,-57.92207,2018-12-07 21:00:00,36,2,38
"34470",10602,"Corner Brook","NL",48.95224,-57.92207,2018-12-07 22:00:00,36,1,37
"34471",10602,"Corner Brook","NL",48.95224,-57.92207,2018-12-07 23:00:00,36,1,37
"34472",10602,"Corner Brook","NL",48.95224,-57.92207,2018-12-08 00:00:00,36,2,38
"34473",10602,"Corner Brook","NL",48.95224,-57.92207,2018-12-08 01:00:00,36,1,37
"34474",10602,"Corner Brook","NL",48.95224,-57.92207,2018-12-08 02:00:00,36,1,37
"34475",10602,"Corner Brook","NL",48.95224,-57.92207,2018-12-08 03:00:00,35,2,37
"34476",10602,"Corner Brook","NL",48.95224,-57.92207,2018-12-08 04:00:00,34,2,36
"34477",10602,"Corner Brook","NL",48.95224,-57.92207,2018-12-08 05:00:00,33,2,35
"34478",10602,"Corner Brook","NL",48.95224,-57.92207,2018-12-08 06:00:00,30,4,34
"34479",10602,"Corner Brook","NL",48.95224,-57.92207,2018-12-08 07:00:00,30,4,34
"34480",10602,"Corner Brook","NL",48.95224,-57.92207,2018-12-08 08:00:00,32,3,35
"34481",10602,"Corner Brook","NL",48.95224,-57.92207,2018-12-08 09:00:00,29,5,34
"34482",10602,"Corner Brook","NL",48.95224,-57.92207,2018-12-08 10:00:00,31,4,35
"34483",10602,"Corner Brook","NL",48.95224,-57.92207,2018-12-08 11:00:00,32,3,35
"34484",10602,"Corner Brook","NL",48.95224,-57.92207,2018-12-08 12:00:00,32,3,35
"34485",10602,"Corner Brook","NL",48.95224,-57.92207,2018-12-08 13:00:00,33,3,36
"34486",10602,"Corner Brook","NL",48.95224,-57.92207,2018-12-08 14:00:00,32,3,35
"34487",10602,"Corner Brook","NL",48.95224,-57.92207,2018-12-08 15:00:00,29,3,32
"34488",10602,"Corner Brook","NL",48.95224,-57.92207,2018-12-08 16:00:00,29,4,33
"34489",10602,"Corner Brook","NL",48.95224,-57.92207,2018-12-08 17:00:00,32,2,34
"34490",10602,"Corner Brook","NL",48.95224,-57.92207,2018-12-08 18:00:00,32,2,34
"34491",10602,"Corner Brook","NL",48.95224,-57.92207,2018-12-08 19:00:00,31,2,33
"34492",10602,"Corner Brook","NL",48.95224,-57.92207,2018-12-08 20:00:00,29,4,33
"34493",10602,"Corner Brook","NL",48.95224,-57.92207,2018-12-08 21:00:00,29,4,33
"34494",10602,"Corner Brook","NL",48.95224,-57.92207,2018-12-08 22:00:00,27,4,31
"34495",10602,"Corner Brook","NL",48.95224,-57.92207,2018-12-08 23:00:00,27,3,30
"34496",10602,"Corner Brook","NL",48.95224,-57.92207,2018-12-09 00:00:00,26,3,29
"34497",10602,"Corner Brook","NL",48.95224,-57.92207,2018-12-09 01:00:00,26,2,28
"34498",10602,"Corner Brook","NL",48.95224,-57.92207,2018-12-09 02:00:00,27,2,29
"34499",10602,"Corner Brook","NL",48.95224,-57.92207,2018-12-09 03:00:00,28,2,30
"34500",10602,"Corner Brook","NL",48.95224,-57.92207,2018-12-09 04:00:00,27,3,30
"34501",10602,"Corner Brook","NL",48.95224,-57.92207,2018-12-09 05:00:00,30,3,33
"34502",10602,"Corner Brook","NL",48.95224,-57.92207,2018-12-09 06:00:00,31,2,33
"34503",10602,"Corner Brook","NL",48.95224,-57.92207,2018-12-09 07:00:00,31,2,33
"34504",10602,"Corner Brook","NL",48.95224,-57.92207,2018-12-09 08:00:00,32,2,34
"34505",10602,"Corner Brook","NL",48.95224,-57.92207,2018-12-09 09:00:00,32,2,34
"34506",10602,"Corner Brook","NL",48.95224,-57.92207,2018-12-09 10:00:00,33,3,36
"34507",10602,"Corner Brook","NL",48.95224,-57.92207,2018-12-09 11:00:00,35,2,37
"34508",10602,"Corner Brook","NL",48.95224,-57.92207,2018-12-09 12:00:00,34,2,36
"34509",10602,"Corner Brook","NL",48.95224,-57.92207,2018-12-09 13:00:00,35,4,39
"34510",10602,"Corner Brook","NL",48.95224,-57.92207,2018-12-09 14:00:00,36,3,39
"34511",10602,"Corner Brook","NL",48.95224,-57.92207,2018-12-09 15:00:00,37,2,39
"34512",10602,"Corner Brook","NL",48.95224,-57.92207,2018-12-09 16:00:00,35,4,39
"34513",10602,"Corner Brook","NL",48.95224,-57.92207,2018-12-09 17:00:00,36,4,40
"34514",10602,"Corner Brook","NL",48.95224,-57.92207,2018-12-09 18:00:00,36,3,39
"34515",10602,"Corner Brook","NL",48.95224,-57.92207,2018-12-09 19:00:00,34,5,39
"34516",10602,"Corner Brook","NL",48.95224,-57.92207,2018-12-09 20:00:00,37,3,40
"34517",10602,"Corner Brook","NL",48.95224,-57.92207,2018-12-09 21:00:00,35,4,39
"34518",10602,"Corner Brook","NL",48.95224,-57.92207,2018-12-09 22:00:00,37,3,40
"34519",10602,"Corner Brook","NL",48.95224,-57.92207,2018-12-09 23:00:00,38,2,40
"34520",10602,"Corner Brook","NL",48.95224,-57.92207,2018-12-10 00:00:00,38,2,40
"34521",10602,"Corner Brook","NL",48.95224,-57.92207,2018-12-10 01:00:00,38,2,40
"34522",10602,"Corner Brook","NL",48.95224,-57.92207,2018-12-10 02:00:00,39,1,40
"34523",10602,"Corner Brook","NL",48.95224,-57.92207,2018-12-10 03:00:00,38,2,40
"34524",10602,"Corner Brook","NL",48.95224,-57.92207,2018-12-10 04:00:00,38,2,40
"34525",10602,"Corner Brook","NL",48.95224,-57.92207,2018-12-10 05:00:00,38,2,40
"34526",10602,"Corner Brook","NL",48.95224,-57.92207,2018-12-10 06:00:00,37,2,39
"34527",10602,"Corner Brook","NL",48.95224,-57.92207,2018-12-10 07:00:00,37,2,39
"34528",10602,"Corner Brook","NL",48.95224,-57.92207,2018-12-10 08:00:00,36,2,38
"34529",10602,"Corner Brook","NL",48.95224,-57.92207,2018-12-10 09:00:00,35,3,38
"34530",10602,"Corner Brook","NL",48.95224,-57.92207,2018-12-10 10:00:00,35,3,38
"34531",10602,"Corner Brook","NL",48.95224,-57.92207,2018-12-10 11:00:00,35,3,38
"34532",10602,"Corner Brook","NL",48.95224,-57.92207,2018-12-10 12:00:00,35,3,38
"34533",10602,"Corner Brook","NL",48.95224,-57.92207,2018-12-10 13:00:00,35,3,38
"34534",10602,"Corner Brook","NL",48.95224,-57.92207,2018-12-10 14:00:00,35,3,38
"34535",10602,"Corner Brook","NL",48.95224,-57.92207,2018-12-10 15:00:00,34,4,38
"34536",10602,"Corner Brook","NL",48.95224,-57.92207,2018-12-10 16:00:00,34,4,38
"34537",10602,"Corner Brook","NL",48.95224,-57.92207,2018-12-10 17:00:00,34,4,38
"34538",10602,"Corner Brook","NL",48.95224,-57.92207,2018-12-10 18:00:00,35,2,37
"34539",10602,"Corner Brook","NL",48.95224,-57.92207,2018-12-10 19:00:00,33,3,36
"34540",10602,"Corner Brook","NL",48.95224,-57.92207,2018-12-10 20:00:00,33,3,36
"34541",10602,"Corner Brook","NL",48.95224,-57.92207,2018-12-10 21:00:00,33,2,35
"34542",10602,"Corner Brook","NL",48.95224,-57.92207,2018-12-10 22:00:00,35,2,37
"34543",10602,"Corner Brook","NL",48.95224,-57.92207,2018-12-10 23:00:00,32,4,36
"34544",10602,"Corner Brook","NL",48.95224,-57.92207,2018-12-11 00:00:00,35,3,38
"34545",10602,"Corner Brook","NL",48.95224,-57.92207,2018-12-11 01:00:00,33,3,36
"34546",10602,"Corner Brook","NL",48.95224,-57.92207,2018-12-11 02:00:00,29,5,34
"34547",10602,"Corner Brook","NL",48.95224,-57.92207,2018-12-11 03:00:00,30,5,35
"34548",10602,"Corner Brook","NL",48.95224,-57.92207,2018-12-11 04:00:00,27,7,34
"34549",10602,"Corner Brook","NL",48.95224,-57.92207,2018-12-11 05:00:00,28,7,35
"34550",10602,"Corner Brook","NL",48.95224,-57.92207,2018-12-11 06:00:00,31,5,36
"34551",10602,"Corner Brook","NL",48.95224,-57.92207,2018-12-11 07:00:00,25,12,37
"34552",10602,"Corner Brook","NL",48.95224,-57.92207,2018-12-11 08:00:00,18,16,34
"34553",10602,"Corner Brook","NL",48.95224,-57.92207,2018-12-11 09:00:00,15,21,36
"34554",10602,"Corner Brook","NL",48.95224,-57.92207,2018-12-11 10:00:00,27,12,39
"34555",10602,"Corner Brook","NL",48.95224,-57.92207,2018-12-11 11:00:00,34,7,41
"34556",10602,"Corner Brook","NL",48.95224,-57.92207,2018-12-11 12:00:00,37,3,40
"34557",10602,"Corner Brook","NL",48.95224,-57.92207,2018-12-11 13:00:00,37,4,41
"34558",10602,"Corner Brook","NL",48.95224,-57.92207,2018-12-11 14:00:00,38,3,41
"34559",10602,"Corner Brook","NL",48.95224,-57.92207,2018-12-11 15:00:00,37,4,41
"34560",10602,"Corner Brook","NL",48.95224,-57.92207,2018-12-11 16:00:00,35,6,41
"34561",10602,"Corner Brook","NL",48.95224,-57.92207,2018-12-11 17:00:00,32,7,39
"34562",10602,"Corner Brook","NL",48.95224,-57.92207,2018-12-11 18:00:00,29,8,37
"34563",10602,"Corner Brook","NL",48.95224,-57.92207,2018-12-11 19:00:00,35,3,38
"34564",10602,"Corner Brook","NL",48.95224,-57.92207,2018-12-11 20:00:00,34,4,38
"34565",10602,"Corner Brook","NL",48.95224,-57.92207,2018-12-11 21:00:00,36,2,38
"34566",10602,"Corner Brook","NL",48.95224,-57.92207,2018-12-11 22:00:00,36,2,38
"34567",10602,"Corner Brook","NL",48.95224,-57.92207,2018-12-11 23:00:00,36,2,38
"34568",10602,"Corner Brook","NL",48.95224,-57.92207,2018-12-12 00:00:00,37,2,39
"34569",10602,"Corner Brook","NL",48.95224,-57.92207,2018-12-12 01:00:00,38,1,39
"34570",10602,"Corner Brook","NL",48.95224,-57.92207,2018-12-12 02:00:00,37,2,39
"34571",10602,"Corner Brook","NL",48.95224,-57.92207,2018-12-12 03:00:00,37,2,39
"34572",10602,"Corner Brook","NL",48.95224,-57.92207,2018-12-12 04:00:00,37,2,39
"34573",10602,"Corner Brook","NL",48.95224,-57.92207,2018-12-12 05:00:00,37,2,39
"34574",10602,"Corner Brook","NL",48.95224,-57.92207,2018-12-12 06:00:00,37,2,39
"34575",10602,"Corner Brook","NL",48.95224,-57.92207,2018-12-12 07:00:00,35,3,38
"34576",10602,"Corner Brook","NL",48.95224,-57.92207,2018-12-12 08:00:00,34,5,39
"34577",10602,"Corner Brook","NL",48.95224,-57.92207,2018-12-12 09:00:00,27,10,37
"34578",10602,"Corner Brook","NL",48.95224,-57.92207,2018-12-12 10:00:00,25,11,36
"34579",10602,"Corner Brook","NL",48.95224,-57.92207,2018-12-12 11:00:00,31,7,38
"34580",10602,"Corner Brook","NL",48.95224,-57.92207,2018-12-12 12:00:00,32,5,37
"34581",10602,"Corner Brook","NL",48.95224,-57.92207,2018-12-12 13:00:00,31,6,37
"34582",10602,"Corner Brook","NL",48.95224,-57.92207,2018-12-12 14:00:00,32,5,37
"34583",10602,"Corner Brook","NL",48.95224,-57.92207,2018-12-12 15:00:00,31,6,37
"34584",10602,"Corner Brook","NL",48.95224,-57.92207,2018-12-12 16:00:00,30,7,37
"34585",10602,"Corner Brook","NL",48.95224,-57.92207,2018-12-12 17:00:00,32,5,37
"34586",10602,"Corner Brook","NL",48.95224,-57.92207,2018-12-12 18:00:00,35,4,39
"34587",10602,"Corner Brook","NL",48.95224,-57.92207,2018-12-12 19:00:00,37,3,40
"34588",10602,"Corner Brook","NL",48.95224,-57.92207,2018-12-12 20:00:00,37,3,40
"34589",10602,"Corner Brook","NL",48.95224,-57.92207,2018-12-12 21:00:00,36,3,39
"34590",10602,"Corner Brook","NL",48.95224,-57.92207,2018-12-12 22:00:00,35,4,39
"34591",10602,"Corner Brook","NL",48.95224,-57.92207,2018-12-12 23:00:00,36,3,39
"34592",10602,"Corner Brook","NL",48.95224,-57.92207,2018-12-13 00:00:00,34,4,38
"34593",10602,"Corner Brook","NL",48.95224,-57.92207,2018-12-13 01:00:00,34,3,37
"34594",10602,"Corner Brook","NL",48.95224,-57.92207,2018-12-13 02:00:00,35,3,38
"34595",10602,"Corner Brook","NL",48.95224,-57.92207,2018-12-13 03:00:00,37,1,38
"34596",10602,"Corner Brook","NL",48.95224,-57.92207,2018-12-13 04:00:00,36,3,39
"34597",10602,"Corner Brook","NL",48.95224,-57.92207,2018-12-13 05:00:00,34,4,38
"34598",10602,"Corner Brook","NL",48.95224,-57.92207,2018-12-13 06:00:00,36,4,40
"34599",10602,"Corner Brook","NL",48.95224,-57.92207,2018-12-13 07:00:00,36,3,39
"34600",10602,"Corner Brook","NL",48.95224,-57.92207,2018-12-13 08:00:00,38,2,40
"34601",10602,"Corner Brook","NL",48.95224,-57.92207,2018-12-13 09:00:00,38,2,40
"34602",10602,"Corner Brook","NL",48.95224,-57.92207,2018-12-13 10:00:00,38,1,39
"34603",10602,"Corner Brook","NL",48.95224,-57.92207,2018-12-13 11:00:00,38,1,39
"34604",10602,"Corner Brook","NL",48.95224,-57.92207,2018-12-13 12:00:00,36,3,39
"34605",10602,"Corner Brook","NL",48.95224,-57.92207,2018-12-13 13:00:00,36,3,39
"34606",10602,"Corner Brook","NL",48.95224,-57.92207,2018-12-13 14:00:00,36,3,39
"34607",10602,"Corner Brook","NL",48.95224,-57.92207,2018-12-13 15:00:00,37,4,41
"34608",10602,"Corner Brook","NL",48.95224,-57.92207,2018-12-13 16:00:00,37,3,40
"34609",10602,"Corner Brook","NL",48.95224,-57.92207,2018-12-13 17:00:00,39,2,41
"34610",10602,"Corner Brook","NL",48.95224,-57.92207,2018-12-13 18:00:00,38,3,41
"34611",10602,"Corner Brook","NL",48.95224,-57.92207,2018-12-13 19:00:00,38,3,41
"34612",10602,"Corner Brook","NL",48.95224,-57.92207,2018-12-13 20:00:00,36,5,41
"34613",10602,"Corner Brook","NL",48.95224,-57.92207,2018-12-13 21:00:00,35,4,39
"34614",10602,"Corner Brook","NL",48.95224,-57.92207,2018-12-13 22:00:00,35,5,40
"34615",10602,"Corner Brook","NL",48.95224,-57.92207,2018-12-13 23:00:00,37,3,40
"34616",10602,"Corner Brook","NL",48.95224,-57.92207,2018-12-14 00:00:00,40,1,41
"34617",10602,"Corner Brook","NL",48.95224,-57.92207,2018-12-14 01:00:00,41,1,42
"34618",10602,"Corner Brook","NL",48.95224,-57.92207,2018-12-14 02:00:00,41,1,42
"34619",10602,"Corner Brook","NL",48.95224,-57.92207,2018-12-14 03:00:00,41,1,42
"34620",10602,"Corner Brook","NL",48.95224,-57.92207,2018-12-14 04:00:00,40,1,41
"34621",10602,"Corner Brook","NL",48.95224,-57.92207,2018-12-14 05:00:00,37,4,41
"34622",10602,"Corner Brook","NL",48.95224,-57.92207,2018-12-14 06:00:00,37,3,40
"34623",10602,"Corner Brook","NL",48.95224,-57.92207,2018-12-14 07:00:00,38,2,40
"34624",10602,"Corner Brook","NL",48.95224,-57.92207,2018-12-14 08:00:00,38,2,40
"34625",10602,"Corner Brook","NL",48.95224,-57.92207,2018-12-14 09:00:00,37,2,39
"34626",10602,"Corner Brook","NL",48.95224,-57.92207,2018-12-14 10:00:00,36,4,40
"34627",10602,"Corner Brook","NL",48.95224,-57.92207,2018-12-14 11:00:00,36,4,40
"34628",10602,"Corner Brook","NL",48.95224,-57.92207,2018-12-14 12:00:00,37,2,39
"34629",10602,"Corner Brook","NL",48.95224,-57.92207,2018-12-14 13:00:00,36,3,39
"34630",10602,"Corner Brook","NL",48.95224,-57.92207,2018-12-14 14:00:00,37,3,40
"34631",10602,"Corner Brook","NL",48.95224,-57.92207,2018-12-14 15:00:00,37,3,40
"34632",10602,"Corner Brook","NL",48.95224,-57.92207,2018-12-14 16:00:00,37,3,40
"34633",10602,"Corner Brook","NL",48.95224,-57.92207,2018-12-14 17:00:00,39,2,41
"34634",10602,"Corner Brook","NL",48.95224,-57.92207,2018-12-14 18:00:00,39,2,41
"34635",10602,"Corner Brook","NL",48.95224,-57.92207,2018-12-14 19:00:00,37,2,39
"34636",10602,"Corner Brook","NL",48.95224,-57.92207,2018-12-14 20:00:00,37,3,40
"34637",10602,"Corner Brook","NL",48.95224,-57.92207,2018-12-14 21:00:00,36,3,39
"34638",10602,"Corner Brook","NL",48.95224,-57.92207,2018-12-14 22:00:00,36,3,39
"34639",10602,"Corner Brook","NL",48.95224,-57.92207,2018-12-14 23:00:00,36,2,38
"34640",10602,"Corner Brook","NL",48.95224,-57.92207,2018-12-15 00:00:00,35,2,37
"34641",10602,"Corner Brook","NL",48.95224,-57.92207,2018-12-15 01:00:00,36,2,38
"34642",10602,"Corner Brook","NL",48.95224,-57.92207,2018-12-15 02:00:00,36,1,37
"34643",10602,"Corner Brook","NL",48.95224,-57.92207,2018-12-15 03:00:00,35,1,36
"34644",10602,"Corner Brook","NL",48.95224,-57.92207,2018-12-15 04:00:00,35,1,36
"34645",10602,"Corner Brook","NL",48.95224,-57.92207,2018-12-15 05:00:00,35,2,37
"34646",10602,"Corner Brook","NL",48.95224,-57.92207,2018-12-15 06:00:00,35,1,36
"34647",10602,"Corner Brook","NL",48.95224,-57.92207,2018-12-15 07:00:00,33,1,34
"34648",10602,"Corner Brook","NL",48.95224,-57.92207,2018-12-15 08:00:00,32,2,34
"34649",10602,"Corner Brook","NL",48.95224,-57.92207,2018-12-15 09:00:00,33,2,35
"34650",10602,"Corner Brook","NL",48.95224,-57.92207,2018-12-15 10:00:00,35,2,37
"34651",10602,"Corner Brook","NL",48.95224,-57.92207,2018-12-15 11:00:00,35,2,37
"34652",10602,"Corner Brook","NL",48.95224,-57.92207,2018-12-15 12:00:00,32,4,36
"34653",10602,"Corner Brook","NL",48.95224,-57.92207,2018-12-15 13:00:00,32,3,35
"34654",10602,"Corner Brook","NL",48.95224,-57.92207,2018-12-15 14:00:00,30,4,34
"34655",10602,"Corner Brook","NL",48.95224,-57.92207,2018-12-15 15:00:00,26,4,30
"34656",10602,"Corner Brook","NL",48.95224,-57.92207,2018-12-15 16:00:00,24,4,28
"34657",10602,"Corner Brook","NL",48.95224,-57.92207,2018-12-15 17:00:00,25,3,28
"34658",10602,"Corner Brook","NL",48.95224,-57.92207,2018-12-15 18:00:00,26,2,28
"34659",10602,"Corner Brook","NL",48.95224,-57.92207,2018-12-15 19:00:00,25,4,29
"34660",10602,"Corner Brook","NL",48.95224,-57.92207,2018-12-15 20:00:00,23,5,28
"34661",10602,"Corner Brook","NL",48.95224,-57.92207,2018-12-15 21:00:00,23,6,29
"34662",10602,"Corner Brook","NL",48.95224,-57.92207,2018-12-15 22:00:00,19,11,30
"34663",10602,"Corner Brook","NL",48.95224,-57.92207,2018-12-15 23:00:00,24,7,31
"34664",10602,"Corner Brook","NL",48.95224,-57.92207,2018-12-16 00:00:00,26,5,31
"34665",10602,"Corner Brook","NL",48.95224,-57.92207,2018-12-16 01:00:00,30,3,33
"34666",10602,"Corner Brook","NL",48.95224,-57.92207,2018-12-16 02:00:00,30,3,33
"34667",10602,"Corner Brook","NL",48.95224,-57.92207,2018-12-16 03:00:00,31,0,31
"34668",10602,"Corner Brook","NL",48.95224,-57.92207,2018-12-16 04:00:00,32,0,32
"34669",10602,"Corner Brook","NL",48.95224,-57.92207,2018-12-16 05:00:00,34,1,35
"34670",10602,"Corner Brook","NL",48.95224,-57.92207,2018-12-16 06:00:00,35,0,35
"34671",10602,"Corner Brook","NL",48.95224,-57.92207,2018-12-16 07:00:00,35,1,36
"34672",10602,"Corner Brook","NL",48.95224,-57.92207,2018-12-16 08:00:00,35,1,36
"34673",10602,"Corner Brook","NL",48.95224,-57.92207,2018-12-16 09:00:00,35,1,36
"34674",10602,"Corner Brook","NL",48.95224,-57.92207,2018-12-16 10:00:00,34,1,35
"34675",10602,"Corner Brook","NL",48.95224,-57.92207,2018-12-16 11:00:00,34,2,36
"34676",10602,"Corner Brook","NL",48.95224,-57.92207,2018-12-16 12:00:00,34,1,35
"34677",10602,"Corner Brook","NL",48.95224,-57.92207,2018-12-16 13:00:00,35,1,36
"34678",10602,"Corner Brook","NL",48.95224,-57.92207,2018-12-16 14:00:00,36,1,37
"34679",10602,"Corner Brook","NL",48.95224,-57.92207,2018-12-16 15:00:00,36,2,38
"34680",10602,"Corner Brook","NL",48.95224,-57.92207,2018-12-16 16:00:00,36,1,37
"34681",10602,"Corner Brook","NL",48.95224,-57.92207,2018-12-16 17:00:00,36,2,38
"34682",10602,"Corner Brook","NL",48.95224,-57.92207,2018-12-16 18:00:00,35,3,38
"34683",10602,"Corner Brook","NL",48.95224,-57.92207,2018-12-16 19:00:00,34,3,37
"34684",10602,"Corner Brook","NL",48.95224,-57.92207,2018-12-16 20:00:00,33,5,38
"34685",10602,"Corner Brook","NL",48.95224,-57.92207,2018-12-16 21:00:00,36,2,38
"34686",10602,"Corner Brook","NL",48.95224,-57.92207,2018-12-16 22:00:00,33,4,37
"34687",10602,"Corner Brook","NL",48.95224,-57.92207,2018-12-16 23:00:00,34,3,37
"34688",10602,"Corner Brook","NL",48.95224,-57.92207,2018-12-17 00:00:00,31,5,36
"34689",10602,"Corner Brook","NL",48.95224,-57.92207,2018-12-17 01:00:00,34,3,37
"34690",10602,"Corner Brook","NL",48.95224,-57.92207,2018-12-17 02:00:00,33,3,36
"34691",10602,"Corner Brook","NL",48.95224,-57.92207,2018-12-17 03:00:00,33,2,35
"34692",10602,"Corner Brook","NL",48.95224,-57.92207,2018-12-17 04:00:00,33,2,35
"34693",10602,"Corner Brook","NL",48.95224,-57.92207,2018-12-17 05:00:00,33,2,35
"34694",10602,"Corner Brook","NL",48.95224,-57.92207,2018-12-17 06:00:00,33,2,35
"34695",10602,"Corner Brook","NL",48.95224,-57.92207,2018-12-17 07:00:00,33,2,35
"34696",10602,"Corner Brook","NL",48.95224,-57.92207,2018-12-17 08:00:00,23,9,32
"34697",10602,"Corner Brook","NL",48.95224,-57.92207,2018-12-17 09:00:00,24,10,34
"34698",10602,"Corner Brook","NL",48.95224,-57.92207,2018-12-17 10:00:00,30,6,36
"34699",10602,"Corner Brook","NL",48.95224,-57.92207,2018-12-17 11:00:00,32,3,35
"34700",10602,"Corner Brook","NL",48.95224,-57.92207,2018-12-17 12:00:00,32,4,36
"34701",10602,"Corner Brook","NL",48.95224,-57.92207,2018-12-17 13:00:00,29,8,37
"34702",10602,"Corner Brook","NL",48.95224,-57.92207,2018-12-17 14:00:00,34,2,36
"34703",10602,"Corner Brook","NL",48.95224,-57.92207,2018-12-17 15:00:00,34,2,36
"34704",10602,"Corner Brook","NL",48.95224,-57.92207,2018-12-17 16:00:00,32,4,36
"34705",10602,"Corner Brook","NL",48.95224,-57.92207,2018-12-17 17:00:00,26,10,36
"34706",10602,"Corner Brook","NL",48.95224,-57.92207,2018-12-17 18:00:00,30,6,36
"34707",10602,"Corner Brook","NL",48.95224,-57.92207,2018-12-17 19:00:00,28,7,35
"34708",10602,"Corner Brook","NL",48.95224,-57.92207,2018-12-17 20:00:00,33,3,36
"34709",10602,"Corner Brook","NL",48.95224,-57.92207,2018-12-17 21:00:00,31,4,35
"34710",10602,"Corner Brook","NL",48.95224,-57.92207,2018-12-17 22:00:00,33,2,35
"34711",10602,"Corner Brook","NL",48.95224,-57.92207,2018-12-17 23:00:00,33,1,34
"34712",10602,"Corner Brook","NL",48.95224,-57.92207,2018-12-18 00:00:00,33,1,34
"34713",10602,"Corner Brook","NL",48.95224,-57.92207,2018-12-18 01:00:00,32,1,33
"34714",10602,"Corner Brook","NL",48.95224,-57.92207,2018-12-18 02:00:00,32,1,33
"34715",10602,"Corner Brook","NL",48.95224,-57.92207,2018-12-18 03:00:00,32,1,33
"34716",10602,"Corner Brook","NL",48.95224,-57.92207,2018-12-18 04:00:00,32,1,33
"34717",10602,"Corner Brook","NL",48.95224,-57.92207,2018-12-18 05:00:00,31,2,33
"34718",10602,"Corner Brook","NL",48.95224,-57.92207,2018-12-18 06:00:00,32,2,34
"34719",10602,"Corner Brook","NL",48.95224,-57.92207,2018-12-18 07:00:00,33,1,34
"34720",10602,"Corner Brook","NL",48.95224,-57.92207,2018-12-18 08:00:00,34,2,36
"34721",10602,"Corner Brook","NL",48.95224,-57.92207,2018-12-18 09:00:00,33,2,35
"34722",10602,"Corner Brook","NL",48.95224,-57.92207,2018-12-18 10:00:00,33,3,36
"34723",10602,"Corner Brook","NL",48.95224,-57.92207,2018-12-18 11:00:00,34,2,36
"34724",10602,"Corner Brook","NL",48.95224,-57.92207,2018-12-18 12:00:00,33,2,35
"34725",10602,"Corner Brook","NL",48.95224,-57.92207,2018-12-18 13:00:00,31,3,34
"34726",10602,"Corner Brook","NL",48.95224,-57.92207,2018-12-18 14:00:00,29,5,34
"34727",10602,"Corner Brook","NL",48.95224,-57.92207,2018-12-18 15:00:00,27,8,35
"34728",10602,"Corner Brook","NL",48.95224,-57.92207,2018-12-18 16:00:00,29,4,33
"34729",10602,"Corner Brook","NL",48.95224,-57.92207,2018-12-18 17:00:00,30,3,33
"34730",10602,"Corner Brook","NL",48.95224,-57.92207,2018-12-18 18:00:00,27,5,32
"34731",10602,"Corner Brook","NL",48.95224,-57.92207,2018-12-18 19:00:00,22,8,30
"34732",10602,"Corner Brook","NL",48.95224,-57.92207,2018-12-18 20:00:00,20,7,27
"34733",10602,"Corner Brook","NL",48.95224,-57.92207,2018-12-18 21:00:00,21,6,27
"34734",10602,"Corner Brook","NL",48.95224,-57.92207,2018-12-18 22:00:00,18,9,27
"34735",10602,"Corner Brook","NL",48.95224,-57.92207,2018-12-18 23:00:00,19,8,27
"34736",10602,"Corner Brook","NL",48.95224,-57.92207,2018-12-19 00:00:00,21,6,27
"34737",10602,"Corner Brook","NL",48.95224,-57.92207,2018-12-19 01:00:00,17,8,25
"34738",10602,"Corner Brook","NL",48.95224,-57.92207,2018-12-19 02:00:00,15,10,25
"34739",10602,"Corner Brook","NL",48.95224,-57.92207,2018-12-19 03:00:00,20,7,27
"34740",10602,"Corner Brook","NL",48.95224,-57.92207,2018-12-19 04:00:00,23,6,29
"34741",10602,"Corner Brook","NL",48.95224,-57.92207,2018-12-19 05:00:00,24,5,29
"34742",10602,"Corner Brook","NL",48.95224,-57.92207,2018-12-19 06:00:00,27,4,31
"34743",10602,"Corner Brook","NL",48.95224,-57.92207,2018-12-19 07:00:00,25,9,34
"34744",10602,"Corner Brook","NL",48.95224,-57.92207,2018-12-19 08:00:00,27,6,33
"34745",10602,"Corner Brook","NL",48.95224,-57.92207,2018-12-19 09:00:00,28,5,33
"34746",10602,"Corner Brook","NL",48.95224,-57.92207,2018-12-19 10:00:00,27,5,32
"34747",10602,"Corner Brook","NL",48.95224,-57.92207,2018-12-19 11:00:00,27,5,32
"34748",10602,"Corner Brook","NL",48.95224,-57.92207,2018-12-19 12:00:00,27,9,36
"34749",10602,"Corner Brook","NL",48.95224,-57.92207,2018-12-19 13:00:00,29,6,35
"34750",10602,"Corner Brook","NL",48.95224,-57.92207,2018-12-19 14:00:00,29,4,33
"34751",10602,"Corner Brook","NL",48.95224,-57.92207,2018-12-19 15:00:00,28,5,33
"34752",10602,"Corner Brook","NL",48.95224,-57.92207,2018-12-19 16:00:00,30,4,34
"34753",10602,"Corner Brook","NL",48.95224,-57.92207,2018-12-19 17:00:00,29,4,33
"34754",10602,"Corner Brook","NL",48.95224,-57.92207,2018-12-19 18:00:00,30,4,34
"34755",10602,"Corner Brook","NL",48.95224,-57.92207,2018-12-19 19:00:00,29,5,34
"34756",10602,"Corner Brook","NL",48.95224,-57.92207,2018-12-19 20:00:00,30,4,34
"34757",10602,"Corner Brook","NL",48.95224,-57.92207,2018-12-19 21:00:00,30,3,33
"34758",10602,"Corner Brook","NL",48.95224,-57.92207,2018-12-19 22:00:00,31,3,34
"34759",10602,"Corner Brook","NL",48.95224,-57.92207,2018-12-19 23:00:00,31,3,34
"34760",10602,"Corner Brook","NL",48.95224,-57.92207,2018-12-20 00:00:00,31,3,34
"34761",10602,"Corner Brook","NL",48.95224,-57.92207,2018-12-20 01:00:00,30,5,35
"34762",10602,"Corner Brook","NL",48.95224,-57.92207,2018-12-20 02:00:00,27,7,34
"34763",10602,"Corner Brook","NL",48.95224,-57.92207,2018-12-20 03:00:00,30,4,34
"34764",10602,"Corner Brook","NL",48.95224,-57.92207,2018-12-20 04:00:00,NA,NA,NA
"34765",10602,"Corner Brook","NL",48.95224,-57.92207,2018-12-20 05:00:00,NA,NA,NA
"34766",10602,"Corner Brook","NL",48.95224,-57.92207,2018-12-20 06:00:00,NA,NA,NA
"34767",10602,"Corner Brook","NL",48.95224,-57.92207,2018-12-20 07:00:00,NA,NA,NA
"34768",10602,"Corner Brook","NL",48.95224,-57.92207,2018-12-20 08:00:00,NA,NA,NA
"34769",10602,"Corner Brook","NL",48.95224,-57.92207,2018-12-20 09:00:00,NA,NA,NA
"34770",10602,"Corner Brook","NL",48.95224,-57.92207,2018-12-20 10:00:00,NA,NA,NA
"34771",10602,"Corner Brook","NL",48.95224,-57.92207,2018-12-20 11:00:00,NA,NA,NA
"34772",10602,"Corner Brook","NL",48.95224,-57.92207,2018-12-20 12:00:00,NA,NA,NA
"34773",10602,"Corner Brook","NL",48.95224,-57.92207,2018-12-20 13:00:00,NA,NA,NA
"34774",10602,"Corner Brook","NL",48.95224,-57.92207,2018-12-20 14:00:00,NA,NA,NA
"34775",10602,"Corner Brook","NL",48.95224,-57.92207,2018-12-20 15:00:00,NA,NA,NA
"34776",10602,"Corner Brook","NL",48.95224,-57.92207,2018-12-20 16:00:00,NA,NA,NA
"34777",10602,"Corner Brook","NL",48.95224,-57.92207,2018-12-20 17:00:00,NA,NA,NA
"34778",10602,"Corner Brook","NL",48.95224,-57.92207,2018-12-20 18:00:00,NA,NA,NA
"34779",10602,"Corner Brook","NL",48.95224,-57.92207,2018-12-20 19:00:00,NA,NA,NA
"34780",10602,"Corner Brook","NL",48.95224,-57.92207,2018-12-20 20:00:00,NA,NA,NA
"34781",10602,"Corner Brook","NL",48.95224,-57.92207,2018-12-20 21:00:00,NA,NA,NA
"34782",10602,"Corner Brook","NL",48.95224,-57.92207,2018-12-20 22:00:00,NA,NA,NA
"34783",10602,"Corner Brook","NL",48.95224,-57.92207,2018-12-20 23:00:00,NA,NA,NA
"34784",10602,"Corner Brook","NL",48.95224,-57.92207,2018-12-21 00:00:00,NA,NA,NA
"34785",10602,"Corner Brook","NL",48.95224,-57.92207,2018-12-21 01:00:00,NA,NA,NA
"34786",10602,"Corner Brook","NL",48.95224,-57.92207,2018-12-21 02:00:00,NA,NA,NA
"34787",10602,"Corner Brook","NL",48.95224,-57.92207,2018-12-21 03:00:00,NA,NA,NA
"34788",10602,"Corner Brook","NL",48.95224,-57.92207,2018-12-21 04:00:00,NA,NA,NA
"34789",10602,"Corner Brook","NL",48.95224,-57.92207,2018-12-21 05:00:00,NA,NA,NA
"34790",10602,"Corner Brook","NL",48.95224,-57.92207,2018-12-21 06:00:00,NA,NA,NA
"34791",10602,"Corner Brook","NL",48.95224,-57.92207,2018-12-21 07:00:00,NA,NA,NA
"34792",10602,"Corner Brook","NL",48.95224,-57.92207,2018-12-21 08:00:00,NA,NA,NA
"34793",10602,"Corner Brook","NL",48.95224,-57.92207,2018-12-21 09:00:00,NA,NA,NA
"34794",10602,"Corner Brook","NL",48.95224,-57.92207,2018-12-21 10:00:00,NA,NA,NA
"34795",10602,"Corner Brook","NL",48.95224,-57.92207,2018-12-21 11:00:00,NA,NA,NA
"34796",10602,"Corner Brook","NL",48.95224,-57.92207,2018-12-21 12:00:00,NA,NA,NA
"34797",10602,"Corner Brook","NL",48.95224,-57.92207,2018-12-21 13:00:00,NA,NA,NA
"34798",10602,"Corner Brook","NL",48.95224,-57.92207,2018-12-21 14:00:00,NA,NA,NA
"34799",10602,"Corner Brook","NL",48.95224,-57.92207,2018-12-21 15:00:00,NA,NA,NA
"34800",10602,"Corner Brook","NL",48.95224,-57.92207,2018-12-21 16:00:00,NA,NA,NA
"34801",10602,"Corner Brook","NL",48.95224,-57.92207,2018-12-21 17:00:00,NA,NA,NA
"34802",10602,"Corner Brook","NL",48.95224,-57.92207,2018-12-21 18:00:00,NA,NA,NA
"34803",10602,"Corner Brook","NL",48.95224,-57.92207,2018-12-21 19:00:00,NA,NA,NA
"34804",10602,"Corner Brook","NL",48.95224,-57.92207,2018-12-21 20:00:00,NA,NA,NA
"34805",10602,"Corner Brook","NL",48.95224,-57.92207,2018-12-21 21:00:00,NA,NA,NA
"34806",10602,"Corner Brook","NL",48.95224,-57.92207,2018-12-21 22:00:00,NA,NA,NA
"34807",10602,"Corner Brook","NL",48.95224,-57.92207,2018-12-21 23:00:00,NA,NA,NA
"34808",10602,"Corner Brook","NL",48.95224,-57.92207,2018-12-22 00:00:00,NA,NA,NA
"34809",10602,"Corner Brook","NL",48.95224,-57.92207,2018-12-22 01:00:00,NA,NA,NA
"34810",10602,"Corner Brook","NL",48.95224,-57.92207,2018-12-22 02:00:00,NA,NA,NA
"34811",10602,"Corner Brook","NL",48.95224,-57.92207,2018-12-22 03:00:00,NA,NA,NA
"34812",10602,"Corner Brook","NL",48.95224,-57.92207,2018-12-22 04:00:00,NA,NA,NA
"34813",10602,"Corner Brook","NL",48.95224,-57.92207,2018-12-22 05:00:00,NA,NA,NA
"34814",10602,"Corner Brook","NL",48.95224,-57.92207,2018-12-22 06:00:00,NA,NA,NA
"34815",10602,"Corner Brook","NL",48.95224,-57.92207,2018-12-22 07:00:00,NA,NA,NA
"34816",10602,"Corner Brook","NL",48.95224,-57.92207,2018-12-22 08:00:00,NA,NA,NA
"34817",10602,"Corner Brook","NL",48.95224,-57.92207,2018-12-22 09:00:00,NA,NA,NA
"34818",10602,"Corner Brook","NL",48.95224,-57.92207,2018-12-22 10:00:00,NA,NA,NA
"34819",10602,"Corner Brook","NL",48.95224,-57.92207,2018-12-22 11:00:00,NA,NA,NA
"34820",10602,"Corner Brook","NL",48.95224,-57.92207,2018-12-22 12:00:00,NA,NA,NA
"34821",10602,"Corner Brook","NL",48.95224,-57.92207,2018-12-22 13:00:00,NA,NA,NA
"34822",10602,"Corner Brook","NL",48.95224,-57.92207,2018-12-22 14:00:00,NA,NA,NA
"34823",10602,"Corner Brook","NL",48.95224,-57.92207,2018-12-22 15:00:00,NA,NA,NA
"34824",10602,"Corner Brook","NL",48.95224,-57.92207,2018-12-22 16:00:00,NA,NA,NA
"34825",10602,"Corner Brook","NL",48.95224,-57.92207,2018-12-22 17:00:00,NA,NA,NA
"34826",10602,"Corner Brook","NL",48.95224,-57.92207,2018-12-22 18:00:00,NA,NA,NA
"34827",10602,"Corner Brook","NL",48.95224,-57.92207,2018-12-22 19:00:00,NA,NA,NA
"34828",10602,"Corner Brook","NL",48.95224,-57.92207,2018-12-22 20:00:00,NA,NA,NA
"34829",10602,"Corner Brook","NL",48.95224,-57.92207,2018-12-22 21:00:00,NA,NA,NA
"34830",10602,"Corner Brook","NL",48.95224,-57.92207,2018-12-22 22:00:00,NA,NA,NA
"34831",10602,"Corner Brook","NL",48.95224,-57.92207,2018-12-22 23:00:00,NA,NA,NA
"34832",10602,"Corner Brook","NL",48.95224,-57.92207,2018-12-23 00:00:00,NA,NA,NA
"34833",10602,"Corner Brook","NL",48.95224,-57.92207,2018-12-23 01:00:00,NA,NA,NA
"34834",10602,"Corner Brook","NL",48.95224,-57.92207,2018-12-23 02:00:00,NA,NA,NA
"34835",10602,"Corner Brook","NL",48.95224,-57.92207,2018-12-23 03:00:00,NA,NA,NA
"34836",10602,"Corner Brook","NL",48.95224,-57.92207,2018-12-23 04:00:00,NA,NA,NA
"34837",10602,"Corner Brook","NL",48.95224,-57.92207,2018-12-23 05:00:00,NA,NA,NA
"34838",10602,"Corner Brook","NL",48.95224,-57.92207,2018-12-23 06:00:00,NA,NA,NA
"34839",10602,"Corner Brook","NL",48.95224,-57.92207,2018-12-23 07:00:00,NA,NA,NA
"34840",10602,"Corner Brook","NL",48.95224,-57.92207,2018-12-23 08:00:00,NA,NA,NA
"34841",10602,"Corner Brook","NL",48.95224,-57.92207,2018-12-23 09:00:00,NA,NA,NA
"34842",10602,"Corner Brook","NL",48.95224,-57.92207,2018-12-23 10:00:00,NA,NA,NA
"34843",10602,"Corner Brook","NL",48.95224,-57.92207,2018-12-23 11:00:00,NA,NA,NA
"34844",10602,"Corner Brook","NL",48.95224,-57.92207,2018-12-23 12:00:00,NA,NA,NA
"34845",10602,"Corner Brook","NL",48.95224,-57.92207,2018-12-23 13:00:00,NA,NA,NA
"34846",10602,"Corner Brook","NL",48.95224,-57.92207,2018-12-23 14:00:00,NA,NA,NA
"34847",10602,"Corner Brook","NL",48.95224,-57.92207,2018-12-23 15:00:00,NA,NA,NA
"34848",10602,"Corner Brook","NL",48.95224,-57.92207,2018-12-23 16:00:00,NA,NA,NA
"34849",10602,"Corner Brook","NL",48.95224,-57.92207,2018-12-23 17:00:00,NA,NA,NA
"34850",10602,"Corner Brook","NL",48.95224,-57.92207,2018-12-23 18:00:00,NA,NA,NA
"34851",10602,"Corner Brook","NL",48.95224,-57.92207,2018-12-23 19:00:00,NA,NA,NA
"34852",10602,"Corner Brook","NL",48.95224,-57.92207,2018-12-23 20:00:00,NA,NA,NA
"34853",10602,"Corner Brook","NL",48.95224,-57.92207,2018-12-23 21:00:00,NA,NA,NA
"34854",10602,"Corner Brook","NL",48.95224,-57.92207,2018-12-23 22:00:00,NA,NA,NA
"34855",10602,"Corner Brook","NL",48.95224,-57.92207,2018-12-23 23:00:00,NA,NA,NA
"34856",10602,"Corner Brook","NL",48.95224,-57.92207,2018-12-24 00:00:00,NA,NA,NA
"34857",10602,"Corner Brook","NL",48.95224,-57.92207,2018-12-24 01:00:00,NA,NA,NA
"34858",10602,"Corner Brook","NL",48.95224,-57.92207,2018-12-24 02:00:00,NA,NA,NA
"34859",10602,"Corner Brook","NL",48.95224,-57.92207,2018-12-24 03:00:00,NA,NA,NA
"34860",10602,"Corner Brook","NL",48.95224,-57.92207,2018-12-24 04:00:00,NA,NA,NA
"34861",10602,"Corner Brook","NL",48.95224,-57.92207,2018-12-24 05:00:00,NA,NA,NA
"34862",10602,"Corner Brook","NL",48.95224,-57.92207,2018-12-24 06:00:00,NA,NA,NA
"34863",10602,"Corner Brook","NL",48.95224,-57.92207,2018-12-24 07:00:00,NA,NA,NA
"34864",10602,"Corner Brook","NL",48.95224,-57.92207,2018-12-24 08:00:00,NA,NA,NA
"34865",10602,"Corner Brook","NL",48.95224,-57.92207,2018-12-24 09:00:00,NA,NA,NA
"34866",10602,"Corner Brook","NL",48.95224,-57.92207,2018-12-24 10:00:00,NA,NA,NA
"34867",10602,"Corner Brook","NL",48.95224,-57.92207,2018-12-24 11:00:00,NA,NA,NA
"34868",10602,"Corner Brook","NL",48.95224,-57.92207,2018-12-24 12:00:00,NA,NA,NA
"34869",10602,"Corner Brook","NL",48.95224,-57.92207,2018-12-24 13:00:00,41,2,43
"34870",10602,"Corner Brook","NL",48.95224,-57.92207,2018-12-24 14:00:00,41,2,43
"34871",10602,"Corner Brook","NL",48.95224,-57.92207,2018-12-24 15:00:00,41,2,43
"34872",10602,"Corner Brook","NL",48.95224,-57.92207,2018-12-24 16:00:00,39,3,42
"34873",10602,"Corner Brook","NL",48.95224,-57.92207,2018-12-24 17:00:00,39,2,41
"34874",10602,"Corner Brook","NL",48.95224,-57.92207,2018-12-24 18:00:00,40,2,42
"34875",10602,"Corner Brook","NL",48.95224,-57.92207,2018-12-24 19:00:00,39,2,41
"34876",10602,"Corner Brook","NL",48.95224,-57.92207,2018-12-24 20:00:00,40,2,42
"34877",10602,"Corner Brook","NL",48.95224,-57.92207,2018-12-24 21:00:00,40,1,41
"34878",10602,"Corner Brook","NL",48.95224,-57.92207,2018-12-24 22:00:00,39,2,41
"34879",10602,"Corner Brook","NL",48.95224,-57.92207,2018-12-24 23:00:00,39,2,41
"34880",10602,"Corner Brook","NL",48.95224,-57.92207,2018-12-25 00:00:00,40,1,41
"34881",10602,"Corner Brook","NL",48.95224,-57.92207,2018-12-25 01:00:00,41,1,42
"34882",10602,"Corner Brook","NL",48.95224,-57.92207,2018-12-25 02:00:00,40,1,41
"34883",10602,"Corner Brook","NL",48.95224,-57.92207,2018-12-25 03:00:00,39,1,40
"34884",10602,"Corner Brook","NL",48.95224,-57.92207,2018-12-25 04:00:00,38,2,40
"34885",10602,"Corner Brook","NL",48.95224,-57.92207,2018-12-25 05:00:00,39,1,40
"34886",10602,"Corner Brook","NL",48.95224,-57.92207,2018-12-25 06:00:00,39,1,40
"34887",10602,"Corner Brook","NL",48.95224,-57.92207,2018-12-25 07:00:00,39,1,40
"34888",10602,"Corner Brook","NL",48.95224,-57.92207,2018-12-25 08:00:00,39,1,40
"34889",10602,"Corner Brook","NL",48.95224,-57.92207,2018-12-25 09:00:00,39,1,40
"34890",10602,"Corner Brook","NL",48.95224,-57.92207,2018-12-25 10:00:00,40,1,41
"34891",10602,"Corner Brook","NL",48.95224,-57.92207,2018-12-25 11:00:00,40,1,41
"34892",10602,"Corner Brook","NL",48.95224,-57.92207,2018-12-25 12:00:00,39,1,40
"34893",10602,"Corner Brook","NL",48.95224,-57.92207,2018-12-25 13:00:00,40,2,42
"34894",10602,"Corner Brook","NL",48.95224,-57.92207,2018-12-25 14:00:00,40,1,41
"34895",10602,"Corner Brook","NL",48.95224,-57.92207,2018-12-25 15:00:00,39,2,41
"34896",10602,"Corner Brook","NL",48.95224,-57.92207,2018-12-25 16:00:00,39,1,40
"34897",10602,"Corner Brook","NL",48.95224,-57.92207,2018-12-25 17:00:00,39,1,40
"34898",10602,"Corner Brook","NL",48.95224,-57.92207,2018-12-25 18:00:00,38,3,41
"34899",10602,"Corner Brook","NL",48.95224,-57.92207,2018-12-25 19:00:00,39,3,42
"34900",10602,"Corner Brook","NL",48.95224,-57.92207,2018-12-25 20:00:00,40,3,43
"34901",10602,"Corner Brook","NL",48.95224,-57.92207,2018-12-25 21:00:00,41,2,43
"34902",10602,"Corner Brook","NL",48.95224,-57.92207,2018-12-25 22:00:00,40,2,42
"34903",10602,"Corner Brook","NL",48.95224,-57.92207,2018-12-25 23:00:00,41,2,43
"34904",10602,"Corner Brook","NL",48.95224,-57.92207,2018-12-26 00:00:00,42,2,44
"34905",10602,"Corner Brook","NL",48.95224,-57.92207,2018-12-26 01:00:00,42,2,44
"34906",10602,"Corner Brook","NL",48.95224,-57.92207,2018-12-26 02:00:00,43,1,44
"34907",10602,"Corner Brook","NL",48.95224,-57.92207,2018-12-26 03:00:00,42,2,44
"34908",10602,"Corner Brook","NL",48.95224,-57.92207,2018-12-26 04:00:00,43,2,45
"34909",10602,"Corner Brook","NL",48.95224,-57.92207,2018-12-26 05:00:00,42,2,44
"34910",10602,"Corner Brook","NL",48.95224,-57.92207,2018-12-26 06:00:00,42,2,44
"34911",10602,"Corner Brook","NL",48.95224,-57.92207,2018-12-26 07:00:00,42,2,44
"34912",10602,"Corner Brook","NL",48.95224,-57.92207,2018-12-26 08:00:00,42,2,44
"34913",10602,"Corner Brook","NL",48.95224,-57.92207,2018-12-26 09:00:00,42,2,44
"34914",10602,"Corner Brook","NL",48.95224,-57.92207,2018-12-26 10:00:00,43,1,44
"34915",10602,"Corner Brook","NL",48.95224,-57.92207,2018-12-26 11:00:00,42,3,45
"34916",10602,"Corner Brook","NL",48.95224,-57.92207,2018-12-26 12:00:00,42,2,44
"34917",10602,"Corner Brook","NL",48.95224,-57.92207,2018-12-26 13:00:00,42,3,45
"34918",10602,"Corner Brook","NL",48.95224,-57.92207,2018-12-26 14:00:00,43,2,45
"34919",10602,"Corner Brook","NL",48.95224,-57.92207,2018-12-26 15:00:00,42,2,44
"34920",10602,"Corner Brook","NL",48.95224,-57.92207,2018-12-26 16:00:00,42,1,43
"34921",10602,"Corner Brook","NL",48.95224,-57.92207,2018-12-26 17:00:00,42,2,44
"34922",10602,"Corner Brook","NL",48.95224,-57.92207,2018-12-26 18:00:00,41,3,44
"34923",10602,"Corner Brook","NL",48.95224,-57.92207,2018-12-26 19:00:00,41,3,44
"34924",10602,"Corner Brook","NL",48.95224,-57.92207,2018-12-26 20:00:00,39,3,42
"34925",10602,"Corner Brook","NL",48.95224,-57.92207,2018-12-26 21:00:00,39,4,43
"34926",10602,"Corner Brook","NL",48.95224,-57.92207,2018-12-26 22:00:00,41,2,43
"34927",10602,"Corner Brook","NL",48.95224,-57.92207,2018-12-26 23:00:00,40,3,43
"34928",10602,"Corner Brook","NL",48.95224,-57.92207,2018-12-27 00:00:00,41,2,43
"34929",10602,"Corner Brook","NL",48.95224,-57.92207,2018-12-27 01:00:00,42,1,43
"34930",10602,"Corner Brook","NL",48.95224,-57.92207,2018-12-27 02:00:00,39,3,42
"34931",10602,"Corner Brook","NL",48.95224,-57.92207,2018-12-27 03:00:00,39,3,42
"34932",10602,"Corner Brook","NL",48.95224,-57.92207,2018-12-27 04:00:00,40,2,42
"34933",10602,"Corner Brook","NL",48.95224,-57.92207,2018-12-27 05:00:00,39,4,43
"34934",10602,"Corner Brook","NL",48.95224,-57.92207,2018-12-27 06:00:00,41,2,43
"34935",10602,"Corner Brook","NL",48.95224,-57.92207,2018-12-27 07:00:00,42,1,43
"34936",10602,"Corner Brook","NL",48.95224,-57.92207,2018-12-27 08:00:00,42,1,43
"34937",10602,"Corner Brook","NL",48.95224,-57.92207,2018-12-27 09:00:00,40,3,43
"34938",10602,"Corner Brook","NL",48.95224,-57.92207,2018-12-27 10:00:00,40,2,42
"34939",10602,"Corner Brook","NL",48.95224,-57.92207,2018-12-27 11:00:00,41,1,42
"34940",10602,"Corner Brook","NL",48.95224,-57.92207,2018-12-27 12:00:00,40,1,41
"34941",10602,"Corner Brook","NL",48.95224,-57.92207,2018-12-27 13:00:00,40,1,41
"34942",10602,"Corner Brook","NL",48.95224,-57.92207,2018-12-27 14:00:00,40,1,41
"34943",10602,"Corner Brook","NL",48.95224,-57.92207,2018-12-27 15:00:00,39,1,40
"34944",10602,"Corner Brook","NL",48.95224,-57.92207,2018-12-27 16:00:00,39,1,40
"34945",10602,"Corner Brook","NL",48.95224,-57.92207,2018-12-27 17:00:00,39,1,40
"34946",10602,"Corner Brook","NL",48.95224,-57.92207,2018-12-27 18:00:00,38,1,39
"34947",10602,"Corner Brook","NL",48.95224,-57.92207,2018-12-27 19:00:00,38,1,39
"34948",10602,"Corner Brook","NL",48.95224,-57.92207,2018-12-27 20:00:00,36,1,37
"34949",10602,"Corner Brook","NL",48.95224,-57.92207,2018-12-27 21:00:00,36,1,37
"34950",10602,"Corner Brook","NL",48.95224,-57.92207,2018-12-27 22:00:00,36,1,37
"34951",10602,"Corner Brook","NL",48.95224,-57.92207,2018-12-27 23:00:00,36,1,37
"34952",10602,"Corner Brook","NL",48.95224,-57.92207,2018-12-28 00:00:00,36,1,37
"34953",10602,"Corner Brook","NL",48.95224,-57.92207,2018-12-28 01:00:00,37,1,38
"34954",10602,"Corner Brook","NL",48.95224,-57.92207,2018-12-28 02:00:00,38,1,39
"34955",10602,"Corner Brook","NL",48.95224,-57.92207,2018-12-28 03:00:00,37,1,38
"34956",10602,"Corner Brook","NL",48.95224,-57.92207,2018-12-28 04:00:00,37,1,38
"34957",10602,"Corner Brook","NL",48.95224,-57.92207,2018-12-28 05:00:00,37,1,38
"34958",10602,"Corner Brook","NL",48.95224,-57.92207,2018-12-28 06:00:00,36,2,38
"34959",10602,"Corner Brook","NL",48.95224,-57.92207,2018-12-28 07:00:00,35,2,37
"34960",10602,"Corner Brook","NL",48.95224,-57.92207,2018-12-28 08:00:00,37,1,38
"34961",10602,"Corner Brook","NL",48.95224,-57.92207,2018-12-28 09:00:00,37,2,39
"34962",10602,"Corner Brook","NL",48.95224,-57.92207,2018-12-28 10:00:00,36,3,39
"34963",10602,"Corner Brook","NL",48.95224,-57.92207,2018-12-28 11:00:00,36,3,39
"34964",10602,"Corner Brook","NL",48.95224,-57.92207,2018-12-28 12:00:00,37,3,40
"34965",10602,"Corner Brook","NL",48.95224,-57.92207,2018-12-28 13:00:00,37,4,41
"34966",10602,"Corner Brook","NL",48.95224,-57.92207,2018-12-28 14:00:00,38,2,40
"34967",10602,"Corner Brook","NL",48.95224,-57.92207,2018-12-28 15:00:00,37,2,39
"34968",10602,"Corner Brook","NL",48.95224,-57.92207,2018-12-28 16:00:00,36,3,39
"34969",10602,"Corner Brook","NL",48.95224,-57.92207,2018-12-28 17:00:00,32,6,38
"34970",10602,"Corner Brook","NL",48.95224,-57.92207,2018-12-28 18:00:00,32,6,38
"34971",10602,"Corner Brook","NL",48.95224,-57.92207,2018-12-28 19:00:00,36,3,39
"34972",10602,"Corner Brook","NL",48.95224,-57.92207,2018-12-28 20:00:00,37,3,40
"34973",10602,"Corner Brook","NL",48.95224,-57.92207,2018-12-28 21:00:00,37,2,39
"34974",10602,"Corner Brook","NL",48.95224,-57.92207,2018-12-28 22:00:00,37,2,39
"34975",10602,"Corner Brook","NL",48.95224,-57.92207,2018-12-28 23:00:00,37,2,39
"34976",10602,"Corner Brook","NL",48.95224,-57.92207,2018-12-29 00:00:00,38,2,40
"34977",10602,"Corner Brook","NL",48.95224,-57.92207,2018-12-29 01:00:00,39,1,40
"34978",10602,"Corner Brook","NL",48.95224,-57.92207,2018-12-29 02:00:00,39,1,40
"34979",10602,"Corner Brook","NL",48.95224,-57.92207,2018-12-29 03:00:00,38,2,40
"34980",10602,"Corner Brook","NL",48.95224,-57.92207,2018-12-29 04:00:00,38,1,39
"34981",10602,"Corner Brook","NL",48.95224,-57.92207,2018-12-29 05:00:00,38,2,40
"34982",10602,"Corner Brook","NL",48.95224,-57.92207,2018-12-29 06:00:00,39,1,40
"34983",10602,"Corner Brook","NL",48.95224,-57.92207,2018-12-29 07:00:00,39,1,40
"34984",10602,"Corner Brook","NL",48.95224,-57.92207,2018-12-29 08:00:00,38,2,40
"34985",10602,"Corner Brook","NL",48.95224,-57.92207,2018-12-29 09:00:00,37,2,39
"34986",10602,"Corner Brook","NL",48.95224,-57.92207,2018-12-29 10:00:00,36,3,39
"34987",10602,"Corner Brook","NL",48.95224,-57.92207,2018-12-29 11:00:00,37,2,39
"34988",10602,"Corner Brook","NL",48.95224,-57.92207,2018-12-29 12:00:00,38,3,41
"34989",10602,"Corner Brook","NL",48.95224,-57.92207,2018-12-29 13:00:00,40,2,42
"34990",10602,"Corner Brook","NL",48.95224,-57.92207,2018-12-29 14:00:00,39,2,41
"34991",10602,"Corner Brook","NL",48.95224,-57.92207,2018-12-29 15:00:00,38,2,40
"34992",10602,"Corner Brook","NL",48.95224,-57.92207,2018-12-29 16:00:00,37,3,40
"34993",10602,"Corner Brook","NL",48.95224,-57.92207,2018-12-29 17:00:00,36,3,39
"34994",10602,"Corner Brook","NL",48.95224,-57.92207,2018-12-29 18:00:00,37,2,39
"34995",10602,"Corner Brook","NL",48.95224,-57.92207,2018-12-29 19:00:00,36,2,38
"34996",10602,"Corner Brook","NL",48.95224,-57.92207,2018-12-29 20:00:00,35,2,37
"34997",10602,"Corner Brook","NL",48.95224,-57.92207,2018-12-29 21:00:00,34,2,36
"34998",10602,"Corner Brook","NL",48.95224,-57.92207,2018-12-29 22:00:00,32,3,35
"34999",10602,"Corner Brook","NL",48.95224,-57.92207,2018-12-29 23:00:00,32,3,35
"35000",10602,"Corner Brook","NL",48.95224,-57.92207,2018-12-30 00:00:00,31,3,34
"35001",10602,"Corner Brook","NL",48.95224,-57.92207,2018-12-30 01:00:00,31,3,34
"35002",10602,"Corner Brook","NL",48.95224,-57.92207,2018-12-30 02:00:00,30,3,33
"35003",10602,"Corner Brook","NL",48.95224,-57.92207,2018-12-30 03:00:00,30,3,33
"35004",10602,"Corner Brook","NL",48.95224,-57.92207,2018-12-30 04:00:00,30,3,33
"35005",10602,"Corner Brook","NL",48.95224,-57.92207,2018-12-30 05:00:00,30,3,33
"35006",10602,"Corner Brook","NL",48.95224,-57.92207,2018-12-30 06:00:00,29,4,33
"35007",10602,"Corner Brook","NL",48.95224,-57.92207,2018-12-30 07:00:00,26,5,31
"35008",10602,"Corner Brook","NL",48.95224,-57.92207,2018-12-30 08:00:00,23,8,31
"35009",10602,"Corner Brook","NL",48.95224,-57.92207,2018-12-30 09:00:00,29,6,35
"35010",10602,"Corner Brook","NL",48.95224,-57.92207,2018-12-30 10:00:00,33,2,35
"35011",10602,"Corner Brook","NL",48.95224,-57.92207,2018-12-30 11:00:00,34,1,35
"35012",10602,"Corner Brook","NL",48.95224,-57.92207,2018-12-30 12:00:00,35,1,36
"35013",10602,"Corner Brook","NL",48.95224,-57.92207,2018-12-30 13:00:00,35,1,36
"35014",10602,"Corner Brook","NL",48.95224,-57.92207,2018-12-30 14:00:00,35,1,36
"35015",10602,"Corner Brook","NL",48.95224,-57.92207,2018-12-30 15:00:00,36,1,37
"35016",10602,"Corner Brook","NL",48.95224,-57.92207,2018-12-30 16:00:00,37,1,38
"35017",10602,"Corner Brook","NL",48.95224,-57.92207,2018-12-30 17:00:00,37,1,38
"35018",10602,"Corner Brook","NL",48.95224,-57.92207,2018-12-30 18:00:00,38,1,39
"35019",10602,"Corner Brook","NL",48.95224,-57.92207,2018-12-30 19:00:00,38,1,39
"35020",10602,"Corner Brook","NL",48.95224,-57.92207,2018-12-30 20:00:00,37,1,38
"35021",10602,"Corner Brook","NL",48.95224,-57.92207,2018-12-30 21:00:00,35,2,37
"35022",10602,"Corner Brook","NL",48.95224,-57.92207,2018-12-30 22:00:00,36,2,38
"35023",10602,"Corner Brook","NL",48.95224,-57.92207,2018-12-30 23:00:00,37,1,38
"35024",10602,"Corner Brook","NL",48.95224,-57.92207,2018-12-31 00:00:00,38,1,39
"35025",10602,"Corner Brook","NL",48.95224,-57.92207,2018-12-31 01:00:00,39,1,40
"35026",10602,"Corner Brook","NL",48.95224,-57.92207,2018-12-31 02:00:00,38,2,40
"35027",10602,"Corner Brook","NL",48.95224,-57.92207,2018-12-31 03:00:00,38,1,39
"35028",10602,"Corner Brook","NL",48.95224,-57.92207,2018-12-31 04:00:00,38,1,39
"35029",10602,"Corner Brook","NL",48.95224,-57.92207,2018-12-31 05:00:00,39,1,40
"35030",10602,"Corner Brook","NL",48.95224,-57.92207,2018-12-31 06:00:00,39,1,40
"35031",10602,"Corner Brook","NL",48.95224,-57.92207,2018-12-31 07:00:00,40,1,41
"35032",10602,"Corner Brook","NL",48.95224,-57.92207,2018-12-31 08:00:00,40,1,41
"35033",10602,"Corner Brook","NL",48.95224,-57.92207,2018-12-31 09:00:00,40,1,41
"35034",10602,"Corner Brook","NL",48.95224,-57.92207,2018-12-31 10:00:00,39,2,41
"35035",10602,"Corner Brook","NL",48.95224,-57.92207,2018-12-31 11:00:00,39,2,41
"35036",10602,"Corner Brook","NL",48.95224,-57.92207,2018-12-31 12:00:00,39,1,40
"35037",10602,"Corner Brook","NL",48.95224,-57.92207,2018-12-31 13:00:00,39,1,40
"35038",10602,"Corner Brook","NL",48.95224,-57.92207,2018-12-31 14:00:00,40,1,41
"35039",10602,"Corner Brook","NL",48.95224,-57.92207,2018-12-31 15:00:00,39,1,40
"35040",10602,"Corner Brook","NL",48.95224,-57.92207,2018-12-31 16:00:00,38,2,40
"35041",10602,"Corner Brook","NL",48.95224,-57.92207,2018-12-31 17:00:00,36,2,38
"35042",10602,"Corner Brook","NL",48.95224,-57.92207,2018-12-31 18:00:00,36,2,38
"35043",10602,"Corner Brook","NL",48.95224,-57.92207,2018-12-31 19:00:00,37,1,38
"35044",10602,"Corner Brook","NL",48.95224,-57.92207,2018-12-31 20:00:00,37,1,38
"35045",10602,"Corner Brook","NL",48.95224,-57.92207,2018-12-31 21:00:00,37,2,39
"35046",10602,"Corner Brook","NL",48.95224,-57.92207,2018-12-31 22:00:00,37,1,38
"35047",10602,"Corner Brook","NL",48.95224,-57.92207,2018-12-31 23:00:00,35,3,38
"35048",10602,"Corner Brook","NL",48.95224,-57.92207,2019-01-01 00:00:00,33,5,38
"35049",10901,"Marystown","NL",47.09899,-55.19852,2018-01-01 01:00:00,36,NA,NA
"35050",10901,"Marystown","NL",47.09899,-55.19852,2018-01-01 02:00:00,34,NA,NA
"35051",10901,"Marystown","NL",47.09899,-55.19852,2018-01-01 03:00:00,34,NA,NA
"35052",10901,"Marystown","NL",47.09899,-55.19852,2018-01-01 04:00:00,35,NA,NA
"35053",10901,"Marystown","NL",47.09899,-55.19852,2018-01-01 05:00:00,35,NA,NA
"35054",10901,"Marystown","NL",47.09899,-55.19852,2018-01-01 06:00:00,36,NA,NA
"35055",10901,"Marystown","NL",47.09899,-55.19852,2018-01-01 07:00:00,34,NA,NA
"35056",10901,"Marystown","NL",47.09899,-55.19852,2018-01-01 08:00:00,34,NA,NA
"35057",10901,"Marystown","NL",47.09899,-55.19852,2018-01-01 09:00:00,35,NA,NA
"35058",10901,"Marystown","NL",47.09899,-55.19852,2018-01-01 10:00:00,36,NA,NA
"35059",10901,"Marystown","NL",47.09899,-55.19852,2018-01-01 11:00:00,36,NA,NA
"35060",10901,"Marystown","NL",47.09899,-55.19852,2018-01-01 12:00:00,36,NA,NA
"35061",10901,"Marystown","NL",47.09899,-55.19852,2018-01-01 13:00:00,36,NA,NA
"35062",10901,"Marystown","NL",47.09899,-55.19852,2018-01-01 14:00:00,37,NA,NA
"35063",10901,"Marystown","NL",47.09899,-55.19852,2018-01-01 15:00:00,37,NA,NA
"35064",10901,"Marystown","NL",47.09899,-55.19852,2018-01-01 16:00:00,37,NA,NA
"35065",10901,"Marystown","NL",47.09899,-55.19852,2018-01-01 17:00:00,36,NA,NA
"35066",10901,"Marystown","NL",47.09899,-55.19852,2018-01-01 18:00:00,37,NA,NA
"35067",10901,"Marystown","NL",47.09899,-55.19852,2018-01-01 19:00:00,37,NA,NA
"35068",10901,"Marystown","NL",47.09899,-55.19852,2018-01-01 20:00:00,37,NA,NA
"35069",10901,"Marystown","NL",47.09899,-55.19852,2018-01-01 21:00:00,36,NA,NA
"35070",10901,"Marystown","NL",47.09899,-55.19852,2018-01-01 22:00:00,37,NA,NA
"35071",10901,"Marystown","NL",47.09899,-55.19852,2018-01-01 23:00:00,36,NA,NA
"35072",10901,"Marystown","NL",47.09899,-55.19852,2018-01-02 00:00:00,36,NA,NA
"35073",10901,"Marystown","NL",47.09899,-55.19852,2018-01-02 01:00:00,35,NA,NA
"35074",10901,"Marystown","NL",47.09899,-55.19852,2018-01-02 02:00:00,35,NA,NA
"35075",10901,"Marystown","NL",47.09899,-55.19852,2018-01-02 03:00:00,35,NA,NA
"35076",10901,"Marystown","NL",47.09899,-55.19852,2018-01-02 04:00:00,36,NA,NA
"35077",10901,"Marystown","NL",47.09899,-55.19852,2018-01-02 05:00:00,35,NA,NA
"35078",10901,"Marystown","NL",47.09899,-55.19852,2018-01-02 06:00:00,36,NA,NA
"35079",10901,"Marystown","NL",47.09899,-55.19852,2018-01-02 07:00:00,35,NA,NA
"35080",10901,"Marystown","NL",47.09899,-55.19852,2018-01-02 08:00:00,34,NA,NA
"35081",10901,"Marystown","NL",47.09899,-55.19852,2018-01-02 09:00:00,33,NA,NA
"35082",10901,"Marystown","NL",47.09899,-55.19852,2018-01-02 10:00:00,34,NA,NA
"35083",10901,"Marystown","NL",47.09899,-55.19852,2018-01-02 11:00:00,35,NA,NA
"35084",10901,"Marystown","NL",47.09899,-55.19852,2018-01-02 12:00:00,35,NA,NA
"35085",10901,"Marystown","NL",47.09899,-55.19852,2018-01-02 13:00:00,35,NA,NA
"35086",10901,"Marystown","NL",47.09899,-55.19852,2018-01-02 14:00:00,35,NA,NA
"35087",10901,"Marystown","NL",47.09899,-55.19852,2018-01-02 15:00:00,36,NA,NA
"35088",10901,"Marystown","NL",47.09899,-55.19852,2018-01-02 16:00:00,35,NA,NA
"35089",10901,"Marystown","NL",47.09899,-55.19852,2018-01-02 17:00:00,35,NA,NA
"35090",10901,"Marystown","NL",47.09899,-55.19852,2018-01-02 18:00:00,34,NA,NA
"35091",10901,"Marystown","NL",47.09899,-55.19852,2018-01-02 19:00:00,35,NA,NA
"35092",10901,"Marystown","NL",47.09899,-55.19852,2018-01-02 20:00:00,33,NA,NA
"35093",10901,"Marystown","NL",47.09899,-55.19852,2018-01-02 21:00:00,37,NA,NA
"35094",10901,"Marystown","NL",47.09899,-55.19852,2018-01-02 22:00:00,37,NA,NA
"35095",10901,"Marystown","NL",47.09899,-55.19852,2018-01-02 23:00:00,37,NA,NA
"35096",10901,"Marystown","NL",47.09899,-55.19852,2018-01-03 00:00:00,38,NA,NA
"35097",10901,"Marystown","NL",47.09899,-55.19852,2018-01-03 01:00:00,38,NA,NA
"35098",10901,"Marystown","NL",47.09899,-55.19852,2018-01-03 02:00:00,36,NA,NA
"35099",10901,"Marystown","NL",47.09899,-55.19852,2018-01-03 03:00:00,35,NA,NA
"35100",10901,"Marystown","NL",47.09899,-55.19852,2018-01-03 04:00:00,35,NA,NA
"35101",10901,"Marystown","NL",47.09899,-55.19852,2018-01-03 05:00:00,35,NA,NA
"35102",10901,"Marystown","NL",47.09899,-55.19852,2018-01-03 06:00:00,36,NA,NA
"35103",10901,"Marystown","NL",47.09899,-55.19852,2018-01-03 07:00:00,35,NA,NA
"35104",10901,"Marystown","NL",47.09899,-55.19852,2018-01-03 08:00:00,34,NA,NA
"35105",10901,"Marystown","NL",47.09899,-55.19852,2018-01-03 09:00:00,34,NA,NA
"35106",10901,"Marystown","NL",47.09899,-55.19852,2018-01-03 10:00:00,36,NA,NA
"35107",10901,"Marystown","NL",47.09899,-55.19852,2018-01-03 11:00:00,36,NA,NA
"35108",10901,"Marystown","NL",47.09899,-55.19852,2018-01-03 12:00:00,36,NA,NA
"35109",10901,"Marystown","NL",47.09899,-55.19852,2018-01-03 13:00:00,37,NA,NA
"35110",10901,"Marystown","NL",47.09899,-55.19852,2018-01-03 14:00:00,38,NA,NA
"35111",10901,"Marystown","NL",47.09899,-55.19852,2018-01-03 15:00:00,38,NA,NA
"35112",10901,"Marystown","NL",47.09899,-55.19852,2018-01-03 16:00:00,38,NA,NA
"35113",10901,"Marystown","NL",47.09899,-55.19852,2018-01-03 17:00:00,37,NA,NA
"35114",10901,"Marystown","NL",47.09899,-55.19852,2018-01-03 18:00:00,37,NA,NA
"35115",10901,"Marystown","NL",47.09899,-55.19852,2018-01-03 19:00:00,37,NA,NA
"35116",10901,"Marystown","NL",47.09899,-55.19852,2018-01-03 20:00:00,37,NA,NA
"35117",10901,"Marystown","NL",47.09899,-55.19852,2018-01-03 21:00:00,38,NA,NA
"35118",10901,"Marystown","NL",47.09899,-55.19852,2018-01-03 22:00:00,37,NA,NA
"35119",10901,"Marystown","NL",47.09899,-55.19852,2018-01-03 23:00:00,37,NA,NA
"35120",10901,"Marystown","NL",47.09899,-55.19852,2018-01-04 00:00:00,37,NA,NA
"35121",10901,"Marystown","NL",47.09899,-55.19852,2018-01-04 01:00:00,36,NA,NA
"35122",10901,"Marystown","NL",47.09899,-55.19852,2018-01-04 02:00:00,36,NA,NA
"35123",10901,"Marystown","NL",47.09899,-55.19852,2018-01-04 03:00:00,36,NA,NA
"35124",10901,"Marystown","NL",47.09899,-55.19852,2018-01-04 04:00:00,37,NA,NA
"35125",10901,"Marystown","NL",47.09899,-55.19852,2018-01-04 05:00:00,37,NA,NA
"35126",10901,"Marystown","NL",47.09899,-55.19852,2018-01-04 06:00:00,37,NA,NA
"35127",10901,"Marystown","NL",47.09899,-55.19852,2018-01-04 07:00:00,35,NA,NA
"35128",10901,"Marystown","NL",47.09899,-55.19852,2018-01-04 08:00:00,30,NA,NA
"35129",10901,"Marystown","NL",47.09899,-55.19852,2018-01-04 09:00:00,27,NA,NA
"35130",10901,"Marystown","NL",47.09899,-55.19852,2018-01-04 10:00:00,29,NA,NA
"35131",10901,"Marystown","NL",47.09899,-55.19852,2018-01-04 11:00:00,29,NA,NA
"35132",10901,"Marystown","NL",47.09899,-55.19852,2018-01-04 12:00:00,NA,NA,NA
"35133",10901,"Marystown","NL",47.09899,-55.19852,2018-01-04 13:00:00,20,NA,NA
"35134",10901,"Marystown","NL",47.09899,-55.19852,2018-01-04 14:00:00,19,NA,NA
"35135",10901,"Marystown","NL",47.09899,-55.19852,2018-01-04 15:00:00,20,NA,NA
"35136",10901,"Marystown","NL",47.09899,-55.19852,2018-01-04 16:00:00,22,NA,NA
"35137",10901,"Marystown","NL",47.09899,-55.19852,2018-01-04 17:00:00,25,NA,NA
"35138",10901,"Marystown","NL",47.09899,-55.19852,2018-01-04 18:00:00,29,NA,NA
"35139",10901,"Marystown","NL",47.09899,-55.19852,2018-01-04 19:00:00,31,NA,NA
"35140",10901,"Marystown","NL",47.09899,-55.19852,2018-01-04 20:00:00,31,NA,NA
"35141",10901,"Marystown","NL",47.09899,-55.19852,2018-01-04 21:00:00,30,NA,NA
"35142",10901,"Marystown","NL",47.09899,-55.19852,2018-01-04 22:00:00,28,NA,NA
"35143",10901,"Marystown","NL",47.09899,-55.19852,2018-01-04 23:00:00,26,NA,NA
"35144",10901,"Marystown","NL",47.09899,-55.19852,2018-01-05 00:00:00,26,NA,NA
"35145",10901,"Marystown","NL",47.09899,-55.19852,2018-01-05 01:00:00,25,NA,NA
"35146",10901,"Marystown","NL",47.09899,-55.19852,2018-01-05 02:00:00,25,NA,NA
"35147",10901,"Marystown","NL",47.09899,-55.19852,2018-01-05 03:00:00,24,NA,NA
"35148",10901,"Marystown","NL",47.09899,-55.19852,2018-01-05 04:00:00,23,NA,NA
"35149",10901,"Marystown","NL",47.09899,-55.19852,2018-01-05 05:00:00,23,NA,NA
"35150",10901,"Marystown","NL",47.09899,-55.19852,2018-01-05 06:00:00,22,NA,NA
"35151",10901,"Marystown","NL",47.09899,-55.19852,2018-01-05 07:00:00,21,NA,NA
"35152",10901,"Marystown","NL",47.09899,-55.19852,2018-01-05 08:00:00,19,NA,NA
"35153",10901,"Marystown","NL",47.09899,-55.19852,2018-01-05 09:00:00,20,NA,NA
"35154",10901,"Marystown","NL",47.09899,-55.19852,2018-01-05 10:00:00,21,NA,NA
"35155",10901,"Marystown","NL",47.09899,-55.19852,2018-01-05 11:00:00,21,NA,NA
"35156",10901,"Marystown","NL",47.09899,-55.19852,2018-01-05 12:00:00,20,NA,NA
"35157",10901,"Marystown","NL",47.09899,-55.19852,2018-01-05 13:00:00,20,NA,NA
"35158",10901,"Marystown","NL",47.09899,-55.19852,2018-01-05 14:00:00,20,NA,NA
"35159",10901,"Marystown","NL",47.09899,-55.19852,2018-01-05 15:00:00,21,NA,NA
"35160",10901,"Marystown","NL",47.09899,-55.19852,2018-01-05 16:00:00,22,NA,NA
"35161",10901,"Marystown","NL",47.09899,-55.19852,2018-01-05 17:00:00,22,NA,NA
"35162",10901,"Marystown","NL",47.09899,-55.19852,2018-01-05 18:00:00,22,NA,NA
"35163",10901,"Marystown","NL",47.09899,-55.19852,2018-01-05 19:00:00,22,NA,NA
"35164",10901,"Marystown","NL",47.09899,-55.19852,2018-01-05 20:00:00,23,NA,NA
"35165",10901,"Marystown","NL",47.09899,-55.19852,2018-01-05 21:00:00,23,NA,NA
"35166",10901,"Marystown","NL",47.09899,-55.19852,2018-01-05 22:00:00,22,NA,NA
"35167",10901,"Marystown","NL",47.09899,-55.19852,2018-01-05 23:00:00,23,NA,NA
"35168",10901,"Marystown","NL",47.09899,-55.19852,2018-01-06 00:00:00,24,NA,NA
"35169",10901,"Marystown","NL",47.09899,-55.19852,2018-01-06 01:00:00,24,NA,NA
"35170",10901,"Marystown","NL",47.09899,-55.19852,2018-01-06 02:00:00,30,NA,NA
"35171",10901,"Marystown","NL",47.09899,-55.19852,2018-01-06 03:00:00,34,NA,NA
"35172",10901,"Marystown","NL",47.09899,-55.19852,2018-01-06 04:00:00,29,NA,NA
"35173",10901,"Marystown","NL",47.09899,-55.19852,2018-01-06 05:00:00,30,NA,NA
"35174",10901,"Marystown","NL",47.09899,-55.19852,2018-01-06 06:00:00,30,NA,NA
"35175",10901,"Marystown","NL",47.09899,-55.19852,2018-01-06 07:00:00,32,NA,NA
"35176",10901,"Marystown","NL",47.09899,-55.19852,2018-01-06 08:00:00,33,NA,NA
"35177",10901,"Marystown","NL",47.09899,-55.19852,2018-01-06 09:00:00,31,NA,NA
"35178",10901,"Marystown","NL",47.09899,-55.19852,2018-01-06 10:00:00,29,NA,NA
"35179",10901,"Marystown","NL",47.09899,-55.19852,2018-01-06 11:00:00,25,NA,NA
"35180",10901,"Marystown","NL",47.09899,-55.19852,2018-01-06 12:00:00,27,NA,NA
"35181",10901,"Marystown","NL",47.09899,-55.19852,2018-01-06 13:00:00,29,NA,NA
"35182",10901,"Marystown","NL",47.09899,-55.19852,2018-01-06 14:00:00,29,NA,NA
"35183",10901,"Marystown","NL",47.09899,-55.19852,2018-01-06 15:00:00,31,NA,NA
"35184",10901,"Marystown","NL",47.09899,-55.19852,2018-01-06 16:00:00,31,NA,NA
"35185",10901,"Marystown","NL",47.09899,-55.19852,2018-01-06 17:00:00,32,NA,NA
"35186",10901,"Marystown","NL",47.09899,-55.19852,2018-01-06 18:00:00,31,NA,NA
"35187",10901,"Marystown","NL",47.09899,-55.19852,2018-01-06 19:00:00,31,NA,NA
"35188",10901,"Marystown","NL",47.09899,-55.19852,2018-01-06 20:00:00,31,NA,NA
"35189",10901,"Marystown","NL",47.09899,-55.19852,2018-01-06 21:00:00,29,NA,NA
"35190",10901,"Marystown","NL",47.09899,-55.19852,2018-01-06 22:00:00,28,NA,NA
"35191",10901,"Marystown","NL",47.09899,-55.19852,2018-01-06 23:00:00,29,NA,NA
"35192",10901,"Marystown","NL",47.09899,-55.19852,2018-01-07 00:00:00,29,NA,NA
"35193",10901,"Marystown","NL",47.09899,-55.19852,2018-01-07 01:00:00,29,NA,NA
"35194",10901,"Marystown","NL",47.09899,-55.19852,2018-01-07 02:00:00,28,NA,NA
"35195",10901,"Marystown","NL",47.09899,-55.19852,2018-01-07 03:00:00,29,NA,NA
"35196",10901,"Marystown","NL",47.09899,-55.19852,2018-01-07 04:00:00,28,NA,NA
"35197",10901,"Marystown","NL",47.09899,-55.19852,2018-01-07 05:00:00,28,NA,NA
"35198",10901,"Marystown","NL",47.09899,-55.19852,2018-01-07 06:00:00,28,NA,NA
"35199",10901,"Marystown","NL",47.09899,-55.19852,2018-01-07 07:00:00,28,NA,NA
"35200",10901,"Marystown","NL",47.09899,-55.19852,2018-01-07 08:00:00,29,NA,NA
"35201",10901,"Marystown","NL",47.09899,-55.19852,2018-01-07 09:00:00,29,NA,NA
"35202",10901,"Marystown","NL",47.09899,-55.19852,2018-01-07 10:00:00,30,NA,NA
"35203",10901,"Marystown","NL",47.09899,-55.19852,2018-01-07 11:00:00,26,NA,NA
"35204",10901,"Marystown","NL",47.09899,-55.19852,2018-01-07 12:00:00,29,NA,NA
"35205",10901,"Marystown","NL",47.09899,-55.19852,2018-01-07 13:00:00,32,NA,NA
"35206",10901,"Marystown","NL",47.09899,-55.19852,2018-01-07 14:00:00,32,NA,NA
"35207",10901,"Marystown","NL",47.09899,-55.19852,2018-01-07 15:00:00,31,NA,NA
"35208",10901,"Marystown","NL",47.09899,-55.19852,2018-01-07 16:00:00,31,NA,NA
"35209",10901,"Marystown","NL",47.09899,-55.19852,2018-01-07 17:00:00,31,NA,NA
"35210",10901,"Marystown","NL",47.09899,-55.19852,2018-01-07 18:00:00,31,NA,NA
"35211",10901,"Marystown","NL",47.09899,-55.19852,2018-01-07 19:00:00,31,NA,NA
"35212",10901,"Marystown","NL",47.09899,-55.19852,2018-01-07 20:00:00,32,NA,NA
"35213",10901,"Marystown","NL",47.09899,-55.19852,2018-01-07 21:00:00,32,NA,NA
"35214",10901,"Marystown","NL",47.09899,-55.19852,2018-01-07 22:00:00,32,NA,NA
"35215",10901,"Marystown","NL",47.09899,-55.19852,2018-01-07 23:00:00,25,NA,NA
"35216",10901,"Marystown","NL",47.09899,-55.19852,2018-01-08 00:00:00,NA,NA,NA
"35217",10901,"Marystown","NL",47.09899,-55.19852,2018-01-08 01:00:00,32,NA,NA
"35218",10901,"Marystown","NL",47.09899,-55.19852,2018-01-08 02:00:00,33,NA,NA
"35219",10901,"Marystown","NL",47.09899,-55.19852,2018-01-08 03:00:00,35,NA,NA
"35220",10901,"Marystown","NL",47.09899,-55.19852,2018-01-08 04:00:00,33,NA,NA
"35221",10901,"Marystown","NL",47.09899,-55.19852,2018-01-08 05:00:00,34,NA,NA
"35222",10901,"Marystown","NL",47.09899,-55.19852,2018-01-08 06:00:00,35,NA,NA
"35223",10901,"Marystown","NL",47.09899,-55.19852,2018-01-08 07:00:00,34,NA,NA
"35224",10901,"Marystown","NL",47.09899,-55.19852,2018-01-08 08:00:00,35,NA,NA
"35225",10901,"Marystown","NL",47.09899,-55.19852,2018-01-08 09:00:00,33,NA,NA
"35226",10901,"Marystown","NL",47.09899,-55.19852,2018-01-08 10:00:00,33,NA,NA
"35227",10901,"Marystown","NL",47.09899,-55.19852,2018-01-08 11:00:00,27,NA,NA
"35228",10901,"Marystown","NL",47.09899,-55.19852,2018-01-08 12:00:00,29,NA,NA
"35229",10901,"Marystown","NL",47.09899,-55.19852,2018-01-08 13:00:00,33,NA,NA
"35230",10901,"Marystown","NL",47.09899,-55.19852,2018-01-08 14:00:00,33,NA,NA
"35231",10901,"Marystown","NL",47.09899,-55.19852,2018-01-08 15:00:00,33,NA,NA
"35232",10901,"Marystown","NL",47.09899,-55.19852,2018-01-08 16:00:00,31,NA,NA
"35233",10901,"Marystown","NL",47.09899,-55.19852,2018-01-08 17:00:00,28,NA,NA
"35234",10901,"Marystown","NL",47.09899,-55.19852,2018-01-08 18:00:00,28,NA,NA
"35235",10901,"Marystown","NL",47.09899,-55.19852,2018-01-08 19:00:00,29,NA,NA
"35236",10901,"Marystown","NL",47.09899,-55.19852,2018-01-08 20:00:00,27,NA,NA
"35237",10901,"Marystown","NL",47.09899,-55.19852,2018-01-08 21:00:00,26,NA,NA
"35238",10901,"Marystown","NL",47.09899,-55.19852,2018-01-08 22:00:00,26,NA,NA
"35239",10901,"Marystown","NL",47.09899,-55.19852,2018-01-08 23:00:00,25,NA,NA
"35240",10901,"Marystown","NL",47.09899,-55.19852,2018-01-09 00:00:00,26,NA,NA
"35241",10901,"Marystown","NL",47.09899,-55.19852,2018-01-09 01:00:00,26,NA,NA
"35242",10901,"Marystown","NL",47.09899,-55.19852,2018-01-09 02:00:00,25,NA,NA
"35243",10901,"Marystown","NL",47.09899,-55.19852,2018-01-09 03:00:00,24,NA,NA
"35244",10901,"Marystown","NL",47.09899,-55.19852,2018-01-09 04:00:00,26,NA,NA
"35245",10901,"Marystown","NL",47.09899,-55.19852,2018-01-09 05:00:00,26,NA,NA
"35246",10901,"Marystown","NL",47.09899,-55.19852,2018-01-09 06:00:00,24,NA,NA
"35247",10901,"Marystown","NL",47.09899,-55.19852,2018-01-09 07:00:00,23,NA,NA
"35248",10901,"Marystown","NL",47.09899,-55.19852,2018-01-09 08:00:00,24,NA,NA
"35249",10901,"Marystown","NL",47.09899,-55.19852,2018-01-09 09:00:00,25,NA,NA
"35250",10901,"Marystown","NL",47.09899,-55.19852,2018-01-09 10:00:00,25,NA,NA
"35251",10901,"Marystown","NL",47.09899,-55.19852,2018-01-09 11:00:00,20,NA,NA
"35252",10901,"Marystown","NL",47.09899,-55.19852,2018-01-09 12:00:00,21,NA,NA
"35253",10901,"Marystown","NL",47.09899,-55.19852,2018-01-09 13:00:00,22,NA,NA
"35254",10901,"Marystown","NL",47.09899,-55.19852,2018-01-09 14:00:00,22,NA,NA
"35255",10901,"Marystown","NL",47.09899,-55.19852,2018-01-09 15:00:00,25,NA,NA
"35256",10901,"Marystown","NL",47.09899,-55.19852,2018-01-09 16:00:00,24,NA,NA
"35257",10901,"Marystown","NL",47.09899,-55.19852,2018-01-09 17:00:00,23,NA,NA
"35258",10901,"Marystown","NL",47.09899,-55.19852,2018-01-09 18:00:00,23,NA,NA
"35259",10901,"Marystown","NL",47.09899,-55.19852,2018-01-09 19:00:00,23,NA,NA
"35260",10901,"Marystown","NL",47.09899,-55.19852,2018-01-09 20:00:00,24,NA,NA
"35261",10901,"Marystown","NL",47.09899,-55.19852,2018-01-09 21:00:00,24,NA,NA
"35262",10901,"Marystown","NL",47.09899,-55.19852,2018-01-09 22:00:00,25,NA,NA
"35263",10901,"Marystown","NL",47.09899,-55.19852,2018-01-09 23:00:00,25,NA,NA
"35264",10901,"Marystown","NL",47.09899,-55.19852,2018-01-10 00:00:00,23,NA,NA
"35265",10901,"Marystown","NL",47.09899,-55.19852,2018-01-10 01:00:00,24,NA,NA
"35266",10901,"Marystown","NL",47.09899,-55.19852,2018-01-10 02:00:00,25,NA,NA
"35267",10901,"Marystown","NL",47.09899,-55.19852,2018-01-10 03:00:00,26,NA,NA
"35268",10901,"Marystown","NL",47.09899,-55.19852,2018-01-10 04:00:00,27,NA,NA
"35269",10901,"Marystown","NL",47.09899,-55.19852,2018-01-10 05:00:00,28,NA,NA
"35270",10901,"Marystown","NL",47.09899,-55.19852,2018-01-10 06:00:00,28,NA,NA
"35271",10901,"Marystown","NL",47.09899,-55.19852,2018-01-10 07:00:00,29,NA,NA
"35272",10901,"Marystown","NL",47.09899,-55.19852,2018-01-10 08:00:00,29,NA,NA
"35273",10901,"Marystown","NL",47.09899,-55.19852,2018-01-10 09:00:00,28,NA,NA
"35274",10901,"Marystown","NL",47.09899,-55.19852,2018-01-10 10:00:00,28,NA,NA
"35275",10901,"Marystown","NL",47.09899,-55.19852,2018-01-10 11:00:00,23,NA,NA
"35276",10901,"Marystown","NL",47.09899,-55.19852,2018-01-10 12:00:00,26,NA,NA
"35277",10901,"Marystown","NL",47.09899,-55.19852,2018-01-10 13:00:00,29,NA,NA
"35278",10901,"Marystown","NL",47.09899,-55.19852,2018-01-10 14:00:00,29,NA,NA
"35279",10901,"Marystown","NL",47.09899,-55.19852,2018-01-10 15:00:00,30,NA,NA
"35280",10901,"Marystown","NL",47.09899,-55.19852,2018-01-10 16:00:00,31,NA,NA
"35281",10901,"Marystown","NL",47.09899,-55.19852,2018-01-10 17:00:00,32,NA,NA
"35282",10901,"Marystown","NL",47.09899,-55.19852,2018-01-10 18:00:00,31,NA,NA
"35283",10901,"Marystown","NL",47.09899,-55.19852,2018-01-10 19:00:00,30,NA,NA
"35284",10901,"Marystown","NL",47.09899,-55.19852,2018-01-10 20:00:00,28,NA,NA
"35285",10901,"Marystown","NL",47.09899,-55.19852,2018-01-10 21:00:00,28,NA,NA
"35286",10901,"Marystown","NL",47.09899,-55.19852,2018-01-10 22:00:00,27,NA,NA
"35287",10901,"Marystown","NL",47.09899,-55.19852,2018-01-10 23:00:00,27,NA,NA
"35288",10901,"Marystown","NL",47.09899,-55.19852,2018-01-11 00:00:00,NA,NA,NA
"35289",10901,"Marystown","NL",47.09899,-55.19852,2018-01-11 01:00:00,27,NA,NA
"35290",10901,"Marystown","NL",47.09899,-55.19852,2018-01-11 02:00:00,26,NA,NA
"35291",10901,"Marystown","NL",47.09899,-55.19852,2018-01-11 03:00:00,26,NA,NA
"35292",10901,"Marystown","NL",47.09899,-55.19852,2018-01-11 04:00:00,26,NA,NA
"35293",10901,"Marystown","NL",47.09899,-55.19852,2018-01-11 05:00:00,26,NA,NA
"35294",10901,"Marystown","NL",47.09899,-55.19852,2018-01-11 06:00:00,26,NA,NA
"35295",10901,"Marystown","NL",47.09899,-55.19852,2018-01-11 07:00:00,26,NA,NA
"35296",10901,"Marystown","NL",47.09899,-55.19852,2018-01-11 08:00:00,27,NA,NA
"35297",10901,"Marystown","NL",47.09899,-55.19852,2018-01-11 09:00:00,27,NA,NA
"35298",10901,"Marystown","NL",47.09899,-55.19852,2018-01-11 10:00:00,27,NA,NA
"35299",10901,"Marystown","NL",47.09899,-55.19852,2018-01-11 11:00:00,24,NA,NA
"35300",10901,"Marystown","NL",47.09899,-55.19852,2018-01-11 12:00:00,27,NA,NA
"35301",10901,"Marystown","NL",47.09899,-55.19852,2018-01-11 13:00:00,29,NA,NA
"35302",10901,"Marystown","NL",47.09899,-55.19852,2018-01-11 14:00:00,30,NA,NA
"35303",10901,"Marystown","NL",47.09899,-55.19852,2018-01-11 15:00:00,29,NA,NA
"35304",10901,"Marystown","NL",47.09899,-55.19852,2018-01-11 16:00:00,28,NA,NA
"35305",10901,"Marystown","NL",47.09899,-55.19852,2018-01-11 17:00:00,26,NA,NA
"35306",10901,"Marystown","NL",47.09899,-55.19852,2018-01-11 18:00:00,24,NA,NA
"35307",10901,"Marystown","NL",47.09899,-55.19852,2018-01-11 19:00:00,24,NA,NA
"35308",10901,"Marystown","NL",47.09899,-55.19852,2018-01-11 20:00:00,23,NA,NA
"35309",10901,"Marystown","NL",47.09899,-55.19852,2018-01-11 21:00:00,23,NA,NA
"35310",10901,"Marystown","NL",47.09899,-55.19852,2018-01-11 22:00:00,22,NA,NA
"35311",10901,"Marystown","NL",47.09899,-55.19852,2018-01-11 23:00:00,20,NA,NA
"35312",10901,"Marystown","NL",47.09899,-55.19852,2018-01-12 00:00:00,19,NA,NA
"35313",10901,"Marystown","NL",47.09899,-55.19852,2018-01-12 01:00:00,19,NA,NA
"35314",10901,"Marystown","NL",47.09899,-55.19852,2018-01-12 02:00:00,20,NA,NA
"35315",10901,"Marystown","NL",47.09899,-55.19852,2018-01-12 03:00:00,21,NA,NA
"35316",10901,"Marystown","NL",47.09899,-55.19852,2018-01-12 04:00:00,22,NA,NA
"35317",10901,"Marystown","NL",47.09899,-55.19852,2018-01-12 05:00:00,21,NA,NA
"35318",10901,"Marystown","NL",47.09899,-55.19852,2018-01-12 06:00:00,20,NA,NA
"35319",10901,"Marystown","NL",47.09899,-55.19852,2018-01-12 07:00:00,19,NA,NA
"35320",10901,"Marystown","NL",47.09899,-55.19852,2018-01-12 08:00:00,20,NA,NA
"35321",10901,"Marystown","NL",47.09899,-55.19852,2018-01-12 09:00:00,22,NA,NA
"35322",10901,"Marystown","NL",47.09899,-55.19852,2018-01-12 10:00:00,21,NA,NA
"35323",10901,"Marystown","NL",47.09899,-55.19852,2018-01-12 11:00:00,18,NA,NA
"35324",10901,"Marystown","NL",47.09899,-55.19852,2018-01-12 12:00:00,20,NA,NA
"35325",10901,"Marystown","NL",47.09899,-55.19852,2018-01-12 13:00:00,21,NA,NA
"35326",10901,"Marystown","NL",47.09899,-55.19852,2018-01-12 14:00:00,22,NA,NA
"35327",10901,"Marystown","NL",47.09899,-55.19852,2018-01-12 15:00:00,23,NA,NA
"35328",10901,"Marystown","NL",47.09899,-55.19852,2018-01-12 16:00:00,24,NA,NA
"35329",10901,"Marystown","NL",47.09899,-55.19852,2018-01-12 17:00:00,24,NA,NA
"35330",10901,"Marystown","NL",47.09899,-55.19852,2018-01-12 18:00:00,22,NA,NA
"35331",10901,"Marystown","NL",47.09899,-55.19852,2018-01-12 19:00:00,21,NA,NA
"35332",10901,"Marystown","NL",47.09899,-55.19852,2018-01-12 20:00:00,21,NA,NA
"35333",10901,"Marystown","NL",47.09899,-55.19852,2018-01-12 21:00:00,21,NA,NA
"35334",10901,"Marystown","NL",47.09899,-55.19852,2018-01-12 22:00:00,22,NA,NA
"35335",10901,"Marystown","NL",47.09899,-55.19852,2018-01-12 23:00:00,22,NA,NA
"35336",10901,"Marystown","NL",47.09899,-55.19852,2018-01-13 00:00:00,22,NA,NA
"35337",10901,"Marystown","NL",47.09899,-55.19852,2018-01-13 01:00:00,22,NA,NA
"35338",10901,"Marystown","NL",47.09899,-55.19852,2018-01-13 02:00:00,23,NA,NA
"35339",10901,"Marystown","NL",47.09899,-55.19852,2018-01-13 03:00:00,23,NA,NA
"35340",10901,"Marystown","NL",47.09899,-55.19852,2018-01-13 04:00:00,23,NA,NA
"35341",10901,"Marystown","NL",47.09899,-55.19852,2018-01-13 05:00:00,24,NA,NA
"35342",10901,"Marystown","NL",47.09899,-55.19852,2018-01-13 06:00:00,25,NA,NA
"35343",10901,"Marystown","NL",47.09899,-55.19852,2018-01-13 07:00:00,24,NA,NA
"35344",10901,"Marystown","NL",47.09899,-55.19852,2018-01-13 08:00:00,24,NA,NA
"35345",10901,"Marystown","NL",47.09899,-55.19852,2018-01-13 09:00:00,23,NA,NA
"35346",10901,"Marystown","NL",47.09899,-55.19852,2018-01-13 10:00:00,23,NA,NA
"35347",10901,"Marystown","NL",47.09899,-55.19852,2018-01-13 11:00:00,20,NA,NA
"35348",10901,"Marystown","NL",47.09899,-55.19852,2018-01-13 12:00:00,24,NA,NA
"35349",10901,"Marystown","NL",47.09899,-55.19852,2018-01-13 13:00:00,26,NA,NA
"35350",10901,"Marystown","NL",47.09899,-55.19852,2018-01-13 14:00:00,27,NA,NA
"35351",10901,"Marystown","NL",47.09899,-55.19852,2018-01-13 15:00:00,27,NA,NA
"35352",10901,"Marystown","NL",47.09899,-55.19852,2018-01-13 16:00:00,27,NA,NA
"35353",10901,"Marystown","NL",47.09899,-55.19852,2018-01-13 17:00:00,28,NA,NA
"35354",10901,"Marystown","NL",47.09899,-55.19852,2018-01-13 18:00:00,29,NA,NA
"35355",10901,"Marystown","NL",47.09899,-55.19852,2018-01-13 19:00:00,30,NA,NA
"35356",10901,"Marystown","NL",47.09899,-55.19852,2018-01-13 20:00:00,30,NA,NA
"35357",10901,"Marystown","NL",47.09899,-55.19852,2018-01-13 21:00:00,30,NA,NA
"35358",10901,"Marystown","NL",47.09899,-55.19852,2018-01-13 22:00:00,31,NA,NA
"35359",10901,"Marystown","NL",47.09899,-55.19852,2018-01-13 23:00:00,24,NA,NA
"35360",10901,"Marystown","NL",47.09899,-55.19852,2018-01-14 00:00:00,NA,NA,NA
"35361",10901,"Marystown","NL",47.09899,-55.19852,2018-01-14 01:00:00,31,NA,NA
"35362",10901,"Marystown","NL",47.09899,-55.19852,2018-01-14 02:00:00,31,NA,NA
"35363",10901,"Marystown","NL",47.09899,-55.19852,2018-01-14 03:00:00,31,NA,NA
"35364",10901,"Marystown","NL",47.09899,-55.19852,2018-01-14 04:00:00,31,NA,NA
"35365",10901,"Marystown","NL",47.09899,-55.19852,2018-01-14 05:00:00,30,NA,NA
"35366",10901,"Marystown","NL",47.09899,-55.19852,2018-01-14 06:00:00,28,NA,NA
"35367",10901,"Marystown","NL",47.09899,-55.19852,2018-01-14 07:00:00,27,NA,NA
"35368",10901,"Marystown","NL",47.09899,-55.19852,2018-01-14 08:00:00,25,NA,NA
"35369",10901,"Marystown","NL",47.09899,-55.19852,2018-01-14 09:00:00,25,NA,NA
"35370",10901,"Marystown","NL",47.09899,-55.19852,2018-01-14 10:00:00,24,NA,NA
"35371",10901,"Marystown","NL",47.09899,-55.19852,2018-01-14 11:00:00,18,NA,NA
"35372",10901,"Marystown","NL",47.09899,-55.19852,2018-01-14 12:00:00,18,NA,NA
"35373",10901,"Marystown","NL",47.09899,-55.19852,2018-01-14 13:00:00,19,NA,NA
"35374",10901,"Marystown","NL",47.09899,-55.19852,2018-01-14 14:00:00,20,NA,NA
"35375",10901,"Marystown","NL",47.09899,-55.19852,2018-01-14 15:00:00,21,NA,NA
"35376",10901,"Marystown","NL",47.09899,-55.19852,2018-01-14 16:00:00,21,NA,NA
"35377",10901,"Marystown","NL",47.09899,-55.19852,2018-01-14 17:00:00,22,NA,NA
"35378",10901,"Marystown","NL",47.09899,-55.19852,2018-01-14 18:00:00,21,NA,NA
"35379",10901,"Marystown","NL",47.09899,-55.19852,2018-01-14 19:00:00,19,NA,NA
"35380",10901,"Marystown","NL",47.09899,-55.19852,2018-01-14 20:00:00,18,NA,NA
"35381",10901,"Marystown","NL",47.09899,-55.19852,2018-01-14 21:00:00,17,NA,NA
"35382",10901,"Marystown","NL",47.09899,-55.19852,2018-01-14 22:00:00,18,NA,NA
"35383",10901,"Marystown","NL",47.09899,-55.19852,2018-01-14 23:00:00,18,NA,NA
"35384",10901,"Marystown","NL",47.09899,-55.19852,2018-01-15 00:00:00,19,NA,NA
"35385",10901,"Marystown","NL",47.09899,-55.19852,2018-01-15 01:00:00,20,NA,NA
"35386",10901,"Marystown","NL",47.09899,-55.19852,2018-01-15 02:00:00,20,NA,NA
"35387",10901,"Marystown","NL",47.09899,-55.19852,2018-01-15 03:00:00,20,NA,NA
"35388",10901,"Marystown","NL",47.09899,-55.19852,2018-01-15 04:00:00,21,NA,NA
"35389",10901,"Marystown","NL",47.09899,-55.19852,2018-01-15 05:00:00,21,NA,NA
"35390",10901,"Marystown","NL",47.09899,-55.19852,2018-01-15 06:00:00,21,NA,NA
"35391",10901,"Marystown","NL",47.09899,-55.19852,2018-01-15 07:00:00,22,NA,NA
"35392",10901,"Marystown","NL",47.09899,-55.19852,2018-01-15 08:00:00,21,NA,NA
"35393",10901,"Marystown","NL",47.09899,-55.19852,2018-01-15 09:00:00,21,NA,NA
"35394",10901,"Marystown","NL",47.09899,-55.19852,2018-01-15 10:00:00,22,NA,NA
"35395",10901,"Marystown","NL",47.09899,-55.19852,2018-01-15 11:00:00,18,NA,NA
"35396",10901,"Marystown","NL",47.09899,-55.19852,2018-01-15 12:00:00,22,NA,NA
"35397",10901,"Marystown","NL",47.09899,-55.19852,2018-01-15 13:00:00,23,NA,NA
"35398",10901,"Marystown","NL",47.09899,-55.19852,2018-01-15 14:00:00,23,NA,NA
"35399",10901,"Marystown","NL",47.09899,-55.19852,2018-01-15 15:00:00,23,NA,NA
"35400",10901,"Marystown","NL",47.09899,-55.19852,2018-01-15 16:00:00,23,NA,NA
"35401",10901,"Marystown","NL",47.09899,-55.19852,2018-01-15 17:00:00,23,NA,NA
"35402",10901,"Marystown","NL",47.09899,-55.19852,2018-01-15 18:00:00,23,NA,NA
"35403",10901,"Marystown","NL",47.09899,-55.19852,2018-01-15 19:00:00,24,NA,NA
"35404",10901,"Marystown","NL",47.09899,-55.19852,2018-01-15 20:00:00,24,NA,NA
"35405",10901,"Marystown","NL",47.09899,-55.19852,2018-01-15 21:00:00,25,NA,NA
"35406",10901,"Marystown","NL",47.09899,-55.19852,2018-01-15 22:00:00,26,NA,NA
"35407",10901,"Marystown","NL",47.09899,-55.19852,2018-01-15 23:00:00,28,NA,NA
"35408",10901,"Marystown","NL",47.09899,-55.19852,2018-01-16 00:00:00,28,NA,NA
"35409",10901,"Marystown","NL",47.09899,-55.19852,2018-01-16 01:00:00,28,NA,NA
"35410",10901,"Marystown","NL",47.09899,-55.19852,2018-01-16 02:00:00,30,NA,NA
"35411",10901,"Marystown","NL",47.09899,-55.19852,2018-01-16 03:00:00,30,NA,NA
"35412",10901,"Marystown","NL",47.09899,-55.19852,2018-01-16 04:00:00,30,NA,NA
"35413",10901,"Marystown","NL",47.09899,-55.19852,2018-01-16 05:00:00,29,NA,NA
"35414",10901,"Marystown","NL",47.09899,-55.19852,2018-01-16 06:00:00,28,NA,NA
"35415",10901,"Marystown","NL",47.09899,-55.19852,2018-01-16 07:00:00,29,NA,NA
"35416",10901,"Marystown","NL",47.09899,-55.19852,2018-01-16 08:00:00,28,NA,NA
"35417",10901,"Marystown","NL",47.09899,-55.19852,2018-01-16 09:00:00,28,NA,NA
"35418",10901,"Marystown","NL",47.09899,-55.19852,2018-01-16 10:00:00,27,NA,NA
"35419",10901,"Marystown","NL",47.09899,-55.19852,2018-01-16 11:00:00,22,NA,NA
"35420",10901,"Marystown","NL",47.09899,-55.19852,2018-01-16 12:00:00,24,NA,NA
"35421",10901,"Marystown","NL",47.09899,-55.19852,2018-01-16 13:00:00,26,NA,NA
"35422",10901,"Marystown","NL",47.09899,-55.19852,2018-01-16 14:00:00,26,NA,NA
"35423",10901,"Marystown","NL",47.09899,-55.19852,2018-01-16 15:00:00,27,NA,NA
"35424",10901,"Marystown","NL",47.09899,-55.19852,2018-01-16 16:00:00,27,NA,NA
"35425",10901,"Marystown","NL",47.09899,-55.19852,2018-01-16 17:00:00,25,NA,NA
"35426",10901,"Marystown","NL",47.09899,-55.19852,2018-01-16 18:00:00,24,NA,NA
"35427",10901,"Marystown","NL",47.09899,-55.19852,2018-01-16 19:00:00,23,NA,NA
"35428",10901,"Marystown","NL",47.09899,-55.19852,2018-01-16 20:00:00,23,NA,NA
"35429",10901,"Marystown","NL",47.09899,-55.19852,2018-01-16 21:00:00,23,NA,NA
"35430",10901,"Marystown","NL",47.09899,-55.19852,2018-01-16 22:00:00,23,NA,NA
"35431",10901,"Marystown","NL",47.09899,-55.19852,2018-01-16 23:00:00,27,NA,NA
"35432",10901,"Marystown","NL",47.09899,-55.19852,2018-01-17 00:00:00,NA,NA,NA
"35433",10901,"Marystown","NL",47.09899,-55.19852,2018-01-17 01:00:00,22,NA,NA
"35434",10901,"Marystown","NL",47.09899,-55.19852,2018-01-17 02:00:00,22,NA,NA
"35435",10901,"Marystown","NL",47.09899,-55.19852,2018-01-17 03:00:00,23,NA,NA
"35436",10901,"Marystown","NL",47.09899,-55.19852,2018-01-17 04:00:00,24,NA,NA
"35437",10901,"Marystown","NL",47.09899,-55.19852,2018-01-17 05:00:00,27,NA,NA
"35438",10901,"Marystown","NL",47.09899,-55.19852,2018-01-17 06:00:00,27,NA,NA
"35439",10901,"Marystown","NL",47.09899,-55.19852,2018-01-17 07:00:00,28,NA,NA
"35440",10901,"Marystown","NL",47.09899,-55.19852,2018-01-17 08:00:00,29,NA,NA
"35441",10901,"Marystown","NL",47.09899,-55.19852,2018-01-17 09:00:00,28,NA,NA
"35442",10901,"Marystown","NL",47.09899,-55.19852,2018-01-17 10:00:00,28,NA,NA
"35443",10901,"Marystown","NL",47.09899,-55.19852,2018-01-17 11:00:00,NA,NA,NA
"35444",10901,"Marystown","NL",47.09899,-55.19852,2018-01-17 12:00:00,29,NA,NA
"35445",10901,"Marystown","NL",47.09899,-55.19852,2018-01-17 13:00:00,NA,NA,NA
"35446",10901,"Marystown","NL",47.09899,-55.19852,2018-01-17 14:00:00,24,NA,NA
"35447",10901,"Marystown","NL",47.09899,-55.19852,2018-01-17 15:00:00,23,NA,NA
"35448",10901,"Marystown","NL",47.09899,-55.19852,2018-01-17 16:00:00,23,NA,NA
"35449",10901,"Marystown","NL",47.09899,-55.19852,2018-01-17 17:00:00,24,NA,NA
"35450",10901,"Marystown","NL",47.09899,-55.19852,2018-01-17 18:00:00,23,NA,NA
"35451",10901,"Marystown","NL",47.09899,-55.19852,2018-01-17 19:00:00,23,NA,NA
"35452",10901,"Marystown","NL",47.09899,-55.19852,2018-01-17 20:00:00,21,NA,NA
"35453",10901,"Marystown","NL",47.09899,-55.19852,2018-01-17 21:00:00,22,NA,NA
"35454",10901,"Marystown","NL",47.09899,-55.19852,2018-01-17 22:00:00,22,NA,NA
"35455",10901,"Marystown","NL",47.09899,-55.19852,2018-01-17 23:00:00,21,NA,NA
"35456",10901,"Marystown","NL",47.09899,-55.19852,2018-01-18 00:00:00,23,NA,NA
"35457",10901,"Marystown","NL",47.09899,-55.19852,2018-01-18 01:00:00,26,NA,NA
"35458",10901,"Marystown","NL",47.09899,-55.19852,2018-01-18 02:00:00,28,NA,NA
"35459",10901,"Marystown","NL",47.09899,-55.19852,2018-01-18 03:00:00,29,NA,NA
"35460",10901,"Marystown","NL",47.09899,-55.19852,2018-01-18 04:00:00,30,NA,NA
"35461",10901,"Marystown","NL",47.09899,-55.19852,2018-01-18 05:00:00,31,NA,NA
"35462",10901,"Marystown","NL",47.09899,-55.19852,2018-01-18 06:00:00,32,NA,NA
"35463",10901,"Marystown","NL",47.09899,-55.19852,2018-01-18 07:00:00,31,NA,NA
"35464",10901,"Marystown","NL",47.09899,-55.19852,2018-01-18 08:00:00,31,NA,NA
"35465",10901,"Marystown","NL",47.09899,-55.19852,2018-01-18 09:00:00,31,NA,NA
"35466",10901,"Marystown","NL",47.09899,-55.19852,2018-01-18 10:00:00,29,NA,NA
"35467",10901,"Marystown","NL",47.09899,-55.19852,2018-01-18 11:00:00,29,NA,NA
"35468",10901,"Marystown","NL",47.09899,-55.19852,2018-01-18 12:00:00,26,NA,NA
"35469",10901,"Marystown","NL",47.09899,-55.19852,2018-01-18 13:00:00,23,NA,NA
"35470",10901,"Marystown","NL",47.09899,-55.19852,2018-01-18 14:00:00,23,NA,NA
"35471",10901,"Marystown","NL",47.09899,-55.19852,2018-01-18 15:00:00,24,NA,NA
"35472",10901,"Marystown","NL",47.09899,-55.19852,2018-01-18 16:00:00,23,NA,NA
"35473",10901,"Marystown","NL",47.09899,-55.19852,2018-01-18 17:00:00,24,NA,NA
"35474",10901,"Marystown","NL",47.09899,-55.19852,2018-01-18 18:00:00,25,NA,NA
"35475",10901,"Marystown","NL",47.09899,-55.19852,2018-01-18 19:00:00,24,NA,NA
"35476",10901,"Marystown","NL",47.09899,-55.19852,2018-01-18 20:00:00,24,NA,NA
"35477",10901,"Marystown","NL",47.09899,-55.19852,2018-01-18 21:00:00,23,NA,NA
"35478",10901,"Marystown","NL",47.09899,-55.19852,2018-01-18 22:00:00,22,NA,NA
"35479",10901,"Marystown","NL",47.09899,-55.19852,2018-01-18 23:00:00,22,NA,NA
"35480",10901,"Marystown","NL",47.09899,-55.19852,2018-01-19 00:00:00,22,NA,NA
"35481",10901,"Marystown","NL",47.09899,-55.19852,2018-01-19 01:00:00,21,NA,NA
"35482",10901,"Marystown","NL",47.09899,-55.19852,2018-01-19 02:00:00,24,NA,NA
"35483",10901,"Marystown","NL",47.09899,-55.19852,2018-01-19 03:00:00,25,NA,NA
"35484",10901,"Marystown","NL",47.09899,-55.19852,2018-01-19 04:00:00,25,NA,NA
"35485",10901,"Marystown","NL",47.09899,-55.19852,2018-01-19 05:00:00,23,NA,NA
"35486",10901,"Marystown","NL",47.09899,-55.19852,2018-01-19 06:00:00,22,NA,NA
"35487",10901,"Marystown","NL",47.09899,-55.19852,2018-01-19 07:00:00,22,NA,NA
"35488",10901,"Marystown","NL",47.09899,-55.19852,2018-01-19 08:00:00,20,NA,NA
"35489",10901,"Marystown","NL",47.09899,-55.19852,2018-01-19 09:00:00,19,NA,NA
"35490",10901,"Marystown","NL",47.09899,-55.19852,2018-01-19 10:00:00,21,NA,NA
"35491",10901,"Marystown","NL",47.09899,-55.19852,2018-01-19 11:00:00,22,NA,NA
"35492",10901,"Marystown","NL",47.09899,-55.19852,2018-01-19 12:00:00,22,NA,NA
"35493",10901,"Marystown","NL",47.09899,-55.19852,2018-01-19 13:00:00,22,NA,NA
"35494",10901,"Marystown","NL",47.09899,-55.19852,2018-01-19 14:00:00,22,NA,NA
"35495",10901,"Marystown","NL",47.09899,-55.19852,2018-01-19 15:00:00,23,NA,NA
"35496",10901,"Marystown","NL",47.09899,-55.19852,2018-01-19 16:00:00,23,NA,NA
"35497",10901,"Marystown","NL",47.09899,-55.19852,2018-01-19 17:00:00,23,NA,NA
"35498",10901,"Marystown","NL",47.09899,-55.19852,2018-01-19 18:00:00,23,NA,NA
"35499",10901,"Marystown","NL",47.09899,-55.19852,2018-01-19 19:00:00,23,NA,NA
"35500",10901,"Marystown","NL",47.09899,-55.19852,2018-01-19 20:00:00,22,NA,NA
"35501",10901,"Marystown","NL",47.09899,-55.19852,2018-01-19 21:00:00,21,NA,NA
"35502",10901,"Marystown","NL",47.09899,-55.19852,2018-01-19 22:00:00,21,NA,NA
"35503",10901,"Marystown","NL",47.09899,-55.19852,2018-01-19 23:00:00,21,NA,NA
"35504",10901,"Marystown","NL",47.09899,-55.19852,2018-01-20 00:00:00,23,NA,NA
"35505",10901,"Marystown","NL",47.09899,-55.19852,2018-01-20 01:00:00,23,NA,NA
"35506",10901,"Marystown","NL",47.09899,-55.19852,2018-01-20 02:00:00,23,NA,NA
"35507",10901,"Marystown","NL",47.09899,-55.19852,2018-01-20 03:00:00,23,NA,NA
"35508",10901,"Marystown","NL",47.09899,-55.19852,2018-01-20 04:00:00,21,NA,NA
"35509",10901,"Marystown","NL",47.09899,-55.19852,2018-01-20 05:00:00,20,NA,NA
"35510",10901,"Marystown","NL",47.09899,-55.19852,2018-01-20 06:00:00,19,NA,NA
"35511",10901,"Marystown","NL",47.09899,-55.19852,2018-01-20 07:00:00,20,NA,NA
"35512",10901,"Marystown","NL",47.09899,-55.19852,2018-01-20 08:00:00,20,NA,NA
"35513",10901,"Marystown","NL",47.09899,-55.19852,2018-01-20 09:00:00,21,NA,NA
"35514",10901,"Marystown","NL",47.09899,-55.19852,2018-01-20 10:00:00,24,NA,NA
"35515",10901,"Marystown","NL",47.09899,-55.19852,2018-01-20 11:00:00,25,NA,NA
"35516",10901,"Marystown","NL",47.09899,-55.19852,2018-01-20 12:00:00,25,NA,NA
"35517",10901,"Marystown","NL",47.09899,-55.19852,2018-01-20 13:00:00,26,NA,NA
"35518",10901,"Marystown","NL",47.09899,-55.19852,2018-01-20 14:00:00,27,NA,NA
"35519",10901,"Marystown","NL",47.09899,-55.19852,2018-01-20 15:00:00,29,NA,NA
"35520",10901,"Marystown","NL",47.09899,-55.19852,2018-01-20 16:00:00,28,NA,NA
"35521",10901,"Marystown","NL",47.09899,-55.19852,2018-01-20 17:00:00,27,NA,NA
"35522",10901,"Marystown","NL",47.09899,-55.19852,2018-01-20 18:00:00,26,NA,NA
"35523",10901,"Marystown","NL",47.09899,-55.19852,2018-01-20 19:00:00,27,NA,NA
"35524",10901,"Marystown","NL",47.09899,-55.19852,2018-01-20 20:00:00,27,NA,NA
"35525",10901,"Marystown","NL",47.09899,-55.19852,2018-01-20 21:00:00,28,NA,NA
"35526",10901,"Marystown","NL",47.09899,-55.19852,2018-01-20 22:00:00,26,NA,NA
"35527",10901,"Marystown","NL",47.09899,-55.19852,2018-01-20 23:00:00,25,NA,NA
"35528",10901,"Marystown","NL",47.09899,-55.19852,2018-01-21 00:00:00,24,NA,NA
"35529",10901,"Marystown","NL",47.09899,-55.19852,2018-01-21 01:00:00,23,NA,NA
"35530",10901,"Marystown","NL",47.09899,-55.19852,2018-01-21 02:00:00,22,NA,NA
"35531",10901,"Marystown","NL",47.09899,-55.19852,2018-01-21 03:00:00,23,NA,NA
"35532",10901,"Marystown","NL",47.09899,-55.19852,2018-01-21 04:00:00,23,NA,NA
"35533",10901,"Marystown","NL",47.09899,-55.19852,2018-01-21 05:00:00,22,NA,NA
"35534",10901,"Marystown","NL",47.09899,-55.19852,2018-01-21 06:00:00,22,NA,NA
"35535",10901,"Marystown","NL",47.09899,-55.19852,2018-01-21 07:00:00,20,NA,NA
"35536",10901,"Marystown","NL",47.09899,-55.19852,2018-01-21 08:00:00,19,NA,NA
"35537",10901,"Marystown","NL",47.09899,-55.19852,2018-01-21 09:00:00,20,NA,NA
"35538",10901,"Marystown","NL",47.09899,-55.19852,2018-01-21 10:00:00,20,NA,NA
"35539",10901,"Marystown","NL",47.09899,-55.19852,2018-01-21 11:00:00,22,NA,NA
"35540",10901,"Marystown","NL",47.09899,-55.19852,2018-01-21 12:00:00,23,NA,NA
"35541",10901,"Marystown","NL",47.09899,-55.19852,2018-01-21 13:00:00,25,NA,NA
"35542",10901,"Marystown","NL",47.09899,-55.19852,2018-01-21 14:00:00,26,NA,NA
"35543",10901,"Marystown","NL",47.09899,-55.19852,2018-01-21 15:00:00,30,NA,NA
"35544",10901,"Marystown","NL",47.09899,-55.19852,2018-01-21 16:00:00,32,NA,NA
"35545",10901,"Marystown","NL",47.09899,-55.19852,2018-01-21 17:00:00,31,NA,NA
"35546",10901,"Marystown","NL",47.09899,-55.19852,2018-01-21 18:00:00,31,NA,NA
"35547",10901,"Marystown","NL",47.09899,-55.19852,2018-01-21 19:00:00,32,NA,NA
"35548",10901,"Marystown","NL",47.09899,-55.19852,2018-01-21 20:00:00,32,NA,NA
"35549",10901,"Marystown","NL",47.09899,-55.19852,2018-01-21 21:00:00,32,NA,NA
"35550",10901,"Marystown","NL",47.09899,-55.19852,2018-01-21 22:00:00,33,NA,NA
"35551",10901,"Marystown","NL",47.09899,-55.19852,2018-01-21 23:00:00,33,NA,NA
"35552",10901,"Marystown","NL",47.09899,-55.19852,2018-01-22 00:00:00,32,NA,NA
"35553",10901,"Marystown","NL",47.09899,-55.19852,2018-01-22 01:00:00,31,NA,NA
"35554",10901,"Marystown","NL",47.09899,-55.19852,2018-01-22 02:00:00,31,NA,NA
"35555",10901,"Marystown","NL",47.09899,-55.19852,2018-01-22 03:00:00,31,NA,NA
"35556",10901,"Marystown","NL",47.09899,-55.19852,2018-01-22 04:00:00,32,NA,NA
"35557",10901,"Marystown","NL",47.09899,-55.19852,2018-01-22 05:00:00,30,NA,NA
"35558",10901,"Marystown","NL",47.09899,-55.19852,2018-01-22 06:00:00,30,NA,NA
"35559",10901,"Marystown","NL",47.09899,-55.19852,2018-01-22 07:00:00,30,NA,NA
"35560",10901,"Marystown","NL",47.09899,-55.19852,2018-01-22 08:00:00,29,NA,NA
"35561",10901,"Marystown","NL",47.09899,-55.19852,2018-01-22 09:00:00,30,NA,NA
"35562",10901,"Marystown","NL",47.09899,-55.19852,2018-01-22 10:00:00,31,NA,NA
"35563",10901,"Marystown","NL",47.09899,-55.19852,2018-01-22 11:00:00,32,NA,NA
"35564",10901,"Marystown","NL",47.09899,-55.19852,2018-01-22 12:00:00,31,NA,NA
"35565",10901,"Marystown","NL",47.09899,-55.19852,2018-01-22 13:00:00,31,NA,NA
"35566",10901,"Marystown","NL",47.09899,-55.19852,2018-01-22 14:00:00,31,NA,NA
"35567",10901,"Marystown","NL",47.09899,-55.19852,2018-01-22 15:00:00,31,NA,NA
"35568",10901,"Marystown","NL",47.09899,-55.19852,2018-01-22 16:00:00,31,NA,NA
"35569",10901,"Marystown","NL",47.09899,-55.19852,2018-01-22 17:00:00,32,NA,NA
"35570",10901,"Marystown","NL",47.09899,-55.19852,2018-01-22 18:00:00,30,NA,NA
"35571",10901,"Marystown","NL",47.09899,-55.19852,2018-01-22 19:00:00,30,NA,NA
"35572",10901,"Marystown","NL",47.09899,-55.19852,2018-01-22 20:00:00,29,NA,NA
"35573",10901,"Marystown","NL",47.09899,-55.19852,2018-01-22 21:00:00,28,NA,NA
"35574",10901,"Marystown","NL",47.09899,-55.19852,2018-01-22 22:00:00,27,NA,NA
"35575",10901,"Marystown","NL",47.09899,-55.19852,2018-01-22 23:00:00,27,NA,NA
"35576",10901,"Marystown","NL",47.09899,-55.19852,2018-01-23 00:00:00,27,NA,NA
"35577",10901,"Marystown","NL",47.09899,-55.19852,2018-01-23 01:00:00,28,NA,NA
"35578",10901,"Marystown","NL",47.09899,-55.19852,2018-01-23 02:00:00,27,NA,NA
"35579",10901,"Marystown","NL",47.09899,-55.19852,2018-01-23 03:00:00,27,NA,NA
"35580",10901,"Marystown","NL",47.09899,-55.19852,2018-01-23 04:00:00,28,NA,NA
"35581",10901,"Marystown","NL",47.09899,-55.19852,2018-01-23 05:00:00,27,NA,NA
"35582",10901,"Marystown","NL",47.09899,-55.19852,2018-01-23 06:00:00,26,NA,NA
"35583",10901,"Marystown","NL",47.09899,-55.19852,2018-01-23 07:00:00,27,NA,NA
"35584",10901,"Marystown","NL",47.09899,-55.19852,2018-01-23 08:00:00,25,NA,NA
"35585",10901,"Marystown","NL",47.09899,-55.19852,2018-01-23 09:00:00,25,NA,NA
"35586",10901,"Marystown","NL",47.09899,-55.19852,2018-01-23 10:00:00,25,NA,NA
"35587",10901,"Marystown","NL",47.09899,-55.19852,2018-01-23 11:00:00,25,NA,NA
"35588",10901,"Marystown","NL",47.09899,-55.19852,2018-01-23 12:00:00,25,NA,NA
"35589",10901,"Marystown","NL",47.09899,-55.19852,2018-01-23 13:00:00,25,NA,NA
"35590",10901,"Marystown","NL",47.09899,-55.19852,2018-01-23 14:00:00,24,NA,NA
"35591",10901,"Marystown","NL",47.09899,-55.19852,2018-01-23 15:00:00,24,NA,NA
"35592",10901,"Marystown","NL",47.09899,-55.19852,2018-01-23 16:00:00,25,NA,NA
"35593",10901,"Marystown","NL",47.09899,-55.19852,2018-01-23 17:00:00,26,NA,NA
"35594",10901,"Marystown","NL",47.09899,-55.19852,2018-01-23 18:00:00,25,NA,NA
"35595",10901,"Marystown","NL",47.09899,-55.19852,2018-01-23 19:00:00,23,NA,NA
"35596",10901,"Marystown","NL",47.09899,-55.19852,2018-01-23 20:00:00,23,NA,NA
"35597",10901,"Marystown","NL",47.09899,-55.19852,2018-01-23 21:00:00,24,NA,NA
"35598",10901,"Marystown","NL",47.09899,-55.19852,2018-01-23 22:00:00,25,NA,NA
"35599",10901,"Marystown","NL",47.09899,-55.19852,2018-01-23 23:00:00,26,NA,NA
"35600",10901,"Marystown","NL",47.09899,-55.19852,2018-01-24 00:00:00,26,NA,NA
"35601",10901,"Marystown","NL",47.09899,-55.19852,2018-01-24 01:00:00,27,NA,NA
"35602",10901,"Marystown","NL",47.09899,-55.19852,2018-01-24 02:00:00,27,NA,NA
"35603",10901,"Marystown","NL",47.09899,-55.19852,2018-01-24 03:00:00,26,NA,NA
"35604",10901,"Marystown","NL",47.09899,-55.19852,2018-01-24 04:00:00,26,NA,NA
"35605",10901,"Marystown","NL",47.09899,-55.19852,2018-01-24 05:00:00,24,NA,NA
"35606",10901,"Marystown","NL",47.09899,-55.19852,2018-01-24 06:00:00,24,NA,NA
"35607",10901,"Marystown","NL",47.09899,-55.19852,2018-01-24 07:00:00,24,NA,NA
"35608",10901,"Marystown","NL",47.09899,-55.19852,2018-01-24 08:00:00,23,NA,NA
"35609",10901,"Marystown","NL",47.09899,-55.19852,2018-01-24 09:00:00,22,NA,NA
"35610",10901,"Marystown","NL",47.09899,-55.19852,2018-01-24 10:00:00,20,NA,NA
"35611",10901,"Marystown","NL",47.09899,-55.19852,2018-01-24 11:00:00,19,NA,NA
"35612",10901,"Marystown","NL",47.09899,-55.19852,2018-01-24 12:00:00,20,NA,NA
"35613",10901,"Marystown","NL",47.09899,-55.19852,2018-01-24 13:00:00,19,NA,NA
"35614",10901,"Marystown","NL",47.09899,-55.19852,2018-01-24 14:00:00,21,NA,NA
"35615",10901,"Marystown","NL",47.09899,-55.19852,2018-01-24 15:00:00,21,NA,NA
"35616",10901,"Marystown","NL",47.09899,-55.19852,2018-01-24 16:00:00,24,NA,NA
"35617",10901,"Marystown","NL",47.09899,-55.19852,2018-01-24 17:00:00,26,NA,NA
"35618",10901,"Marystown","NL",47.09899,-55.19852,2018-01-24 18:00:00,26,NA,NA
"35619",10901,"Marystown","NL",47.09899,-55.19852,2018-01-24 19:00:00,24,NA,NA
"35620",10901,"Marystown","NL",47.09899,-55.19852,2018-01-24 20:00:00,24,NA,NA
"35621",10901,"Marystown","NL",47.09899,-55.19852,2018-01-24 21:00:00,24,NA,NA
"35622",10901,"Marystown","NL",47.09899,-55.19852,2018-01-24 22:00:00,23,NA,NA
"35623",10901,"Marystown","NL",47.09899,-55.19852,2018-01-24 23:00:00,24,NA,NA
"35624",10901,"Marystown","NL",47.09899,-55.19852,2018-01-25 00:00:00,26,NA,NA
"35625",10901,"Marystown","NL",47.09899,-55.19852,2018-01-25 01:00:00,26,NA,NA
"35626",10901,"Marystown","NL",47.09899,-55.19852,2018-01-25 02:00:00,24,NA,NA
"35627",10901,"Marystown","NL",47.09899,-55.19852,2018-01-25 03:00:00,21,NA,NA
"35628",10901,"Marystown","NL",47.09899,-55.19852,2018-01-25 04:00:00,22,NA,NA
"35629",10901,"Marystown","NL",47.09899,-55.19852,2018-01-25 05:00:00,26,NA,NA
"35630",10901,"Marystown","NL",47.09899,-55.19852,2018-01-25 06:00:00,28,NA,NA
"35631",10901,"Marystown","NL",47.09899,-55.19852,2018-01-25 07:00:00,29,NA,NA
"35632",10901,"Marystown","NL",47.09899,-55.19852,2018-01-25 08:00:00,30,NA,NA
"35633",10901,"Marystown","NL",47.09899,-55.19852,2018-01-25 09:00:00,31,NA,NA
"35634",10901,"Marystown","NL",47.09899,-55.19852,2018-01-25 10:00:00,32,NA,NA
"35635",10901,"Marystown","NL",47.09899,-55.19852,2018-01-25 11:00:00,32,NA,NA
"35636",10901,"Marystown","NL",47.09899,-55.19852,2018-01-25 12:00:00,32,NA,NA
"35637",10901,"Marystown","NL",47.09899,-55.19852,2018-01-25 13:00:00,32,NA,NA
"35638",10901,"Marystown","NL",47.09899,-55.19852,2018-01-25 14:00:00,33,NA,NA
"35639",10901,"Marystown","NL",47.09899,-55.19852,2018-01-25 15:00:00,33,NA,NA
"35640",10901,"Marystown","NL",47.09899,-55.19852,2018-01-25 16:00:00,32,NA,NA
"35641",10901,"Marystown","NL",47.09899,-55.19852,2018-01-25 17:00:00,32,NA,NA
"35642",10901,"Marystown","NL",47.09899,-55.19852,2018-01-25 18:00:00,31,NA,NA
"35643",10901,"Marystown","NL",47.09899,-55.19852,2018-01-25 19:00:00,32,NA,NA
"35644",10901,"Marystown","NL",47.09899,-55.19852,2018-01-25 20:00:00,33,NA,NA
"35645",10901,"Marystown","NL",47.09899,-55.19852,2018-01-25 21:00:00,32,NA,NA
"35646",10901,"Marystown","NL",47.09899,-55.19852,2018-01-25 22:00:00,31,NA,NA
"35647",10901,"Marystown","NL",47.09899,-55.19852,2018-01-25 23:00:00,30,NA,NA
"35648",10901,"Marystown","NL",47.09899,-55.19852,2018-01-26 00:00:00,29,NA,NA
"35649",10901,"Marystown","NL",47.09899,-55.19852,2018-01-26 01:00:00,27,NA,NA
"35650",10901,"Marystown","NL",47.09899,-55.19852,2018-01-26 02:00:00,27,NA,NA
"35651",10901,"Marystown","NL",47.09899,-55.19852,2018-01-26 03:00:00,29,NA,NA
"35652",10901,"Marystown","NL",47.09899,-55.19852,2018-01-26 04:00:00,29,NA,NA
"35653",10901,"Marystown","NL",47.09899,-55.19852,2018-01-26 05:00:00,29,NA,NA
"35654",10901,"Marystown","NL",47.09899,-55.19852,2018-01-26 06:00:00,29,NA,NA
"35655",10901,"Marystown","NL",47.09899,-55.19852,2018-01-26 07:00:00,29,NA,NA
"35656",10901,"Marystown","NL",47.09899,-55.19852,2018-01-26 08:00:00,28,NA,NA
"35657",10901,"Marystown","NL",47.09899,-55.19852,2018-01-26 09:00:00,26,NA,NA
"35658",10901,"Marystown","NL",47.09899,-55.19852,2018-01-26 10:00:00,26,NA,NA
"35659",10901,"Marystown","NL",47.09899,-55.19852,2018-01-26 11:00:00,26,NA,NA
"35660",10901,"Marystown","NL",47.09899,-55.19852,2018-01-26 12:00:00,26,NA,NA
"35661",10901,"Marystown","NL",47.09899,-55.19852,2018-01-26 13:00:00,26,NA,NA
"35662",10901,"Marystown","NL",47.09899,-55.19852,2018-01-26 14:00:00,26,NA,NA
"35663",10901,"Marystown","NL",47.09899,-55.19852,2018-01-26 15:00:00,26,NA,NA
"35664",10901,"Marystown","NL",47.09899,-55.19852,2018-01-26 16:00:00,26,NA,NA
"35665",10901,"Marystown","NL",47.09899,-55.19852,2018-01-26 17:00:00,27,NA,NA
"35666",10901,"Marystown","NL",47.09899,-55.19852,2018-01-26 18:00:00,26,NA,NA
"35667",10901,"Marystown","NL",47.09899,-55.19852,2018-01-26 19:00:00,25,NA,NA
"35668",10901,"Marystown","NL",47.09899,-55.19852,2018-01-26 20:00:00,24,NA,NA
"35669",10901,"Marystown","NL",47.09899,-55.19852,2018-01-26 21:00:00,24,NA,NA
"35670",10901,"Marystown","NL",47.09899,-55.19852,2018-01-26 22:00:00,24,NA,NA
"35671",10901,"Marystown","NL",47.09899,-55.19852,2018-01-26 23:00:00,24,NA,NA
"35672",10901,"Marystown","NL",47.09899,-55.19852,2018-01-27 00:00:00,24,NA,NA
"35673",10901,"Marystown","NL",47.09899,-55.19852,2018-01-27 01:00:00,25,NA,NA
"35674",10901,"Marystown","NL",47.09899,-55.19852,2018-01-27 02:00:00,26,NA,NA
"35675",10901,"Marystown","NL",47.09899,-55.19852,2018-01-27 03:00:00,27,NA,NA
"35676",10901,"Marystown","NL",47.09899,-55.19852,2018-01-27 04:00:00,28,NA,NA
"35677",10901,"Marystown","NL",47.09899,-55.19852,2018-01-27 05:00:00,28,NA,NA
"35678",10901,"Marystown","NL",47.09899,-55.19852,2018-01-27 06:00:00,28,NA,NA
"35679",10901,"Marystown","NL",47.09899,-55.19852,2018-01-27 07:00:00,27,NA,NA
"35680",10901,"Marystown","NL",47.09899,-55.19852,2018-01-27 08:00:00,26,NA,NA
"35681",10901,"Marystown","NL",47.09899,-55.19852,2018-01-27 09:00:00,26,NA,NA
"35682",10901,"Marystown","NL",47.09899,-55.19852,2018-01-27 10:00:00,25,NA,NA
"35683",10901,"Marystown","NL",47.09899,-55.19852,2018-01-27 11:00:00,26,NA,NA
"35684",10901,"Marystown","NL",47.09899,-55.19852,2018-01-27 12:00:00,27,NA,NA
"35685",10901,"Marystown","NL",47.09899,-55.19852,2018-01-27 13:00:00,27,NA,NA
"35686",10901,"Marystown","NL",47.09899,-55.19852,2018-01-27 14:00:00,28,NA,NA
"35687",10901,"Marystown","NL",47.09899,-55.19852,2018-01-27 15:00:00,28,NA,NA
"35688",10901,"Marystown","NL",47.09899,-55.19852,2018-01-27 16:00:00,28,NA,NA
"35689",10901,"Marystown","NL",47.09899,-55.19852,2018-01-27 17:00:00,28,NA,NA
"35690",10901,"Marystown","NL",47.09899,-55.19852,2018-01-27 18:00:00,27,NA,NA
"35691",10901,"Marystown","NL",47.09899,-55.19852,2018-01-27 19:00:00,27,NA,NA
"35692",10901,"Marystown","NL",47.09899,-55.19852,2018-01-27 20:00:00,26,NA,NA
"35693",10901,"Marystown","NL",47.09899,-55.19852,2018-01-27 21:00:00,27,NA,NA
"35694",10901,"Marystown","NL",47.09899,-55.19852,2018-01-27 22:00:00,28,NA,NA
"35695",10901,"Marystown","NL",47.09899,-55.19852,2018-01-27 23:00:00,29,NA,NA
"35696",10901,"Marystown","NL",47.09899,-55.19852,2018-01-28 00:00:00,30,NA,NA
"35697",10901,"Marystown","NL",47.09899,-55.19852,2018-01-28 01:00:00,32,NA,NA
"35698",10901,"Marystown","NL",47.09899,-55.19852,2018-01-28 02:00:00,31,NA,NA
"35699",10901,"Marystown","NL",47.09899,-55.19852,2018-01-28 03:00:00,30,NA,NA
"35700",10901,"Marystown","NL",47.09899,-55.19852,2018-01-28 04:00:00,29,NA,NA
"35701",10901,"Marystown","NL",47.09899,-55.19852,2018-01-28 05:00:00,29,NA,NA
"35702",10901,"Marystown","NL",47.09899,-55.19852,2018-01-28 06:00:00,27,NA,NA
"35703",10901,"Marystown","NL",47.09899,-55.19852,2018-01-28 07:00:00,26,NA,NA
"35704",10901,"Marystown","NL",47.09899,-55.19852,2018-01-28 08:00:00,25,NA,NA
"35705",10901,"Marystown","NL",47.09899,-55.19852,2018-01-28 09:00:00,26,NA,NA
"35706",10901,"Marystown","NL",47.09899,-55.19852,2018-01-28 10:00:00,26,NA,NA
"35707",10901,"Marystown","NL",47.09899,-55.19852,2018-01-28 11:00:00,29,NA,NA
"35708",10901,"Marystown","NL",47.09899,-55.19852,2018-01-28 12:00:00,30,NA,NA
"35709",10901,"Marystown","NL",47.09899,-55.19852,2018-01-28 13:00:00,29,NA,NA
"35710",10901,"Marystown","NL",47.09899,-55.19852,2018-01-28 14:00:00,28,NA,NA
"35711",10901,"Marystown","NL",47.09899,-55.19852,2018-01-28 15:00:00,28,NA,NA
"35712",10901,"Marystown","NL",47.09899,-55.19852,2018-01-28 16:00:00,29,NA,NA
"35713",10901,"Marystown","NL",47.09899,-55.19852,2018-01-28 17:00:00,29,NA,NA
"35714",10901,"Marystown","NL",47.09899,-55.19852,2018-01-28 18:00:00,30,NA,NA
"35715",10901,"Marystown","NL",47.09899,-55.19852,2018-01-28 19:00:00,30,NA,NA
"35716",10901,"Marystown","NL",47.09899,-55.19852,2018-01-28 20:00:00,30,NA,NA
"35717",10901,"Marystown","NL",47.09899,-55.19852,2018-01-28 21:00:00,29,NA,NA
"35718",10901,"Marystown","NL",47.09899,-55.19852,2018-01-28 22:00:00,27,NA,NA
"35719",10901,"Marystown","NL",47.09899,-55.19852,2018-01-28 23:00:00,24,NA,NA
"35720",10901,"Marystown","NL",47.09899,-55.19852,2018-01-29 00:00:00,20,NA,NA
"35721",10901,"Marystown","NL",47.09899,-55.19852,2018-01-29 01:00:00,20,NA,NA
"35722",10901,"Marystown","NL",47.09899,-55.19852,2018-01-29 02:00:00,21,NA,NA
"35723",10901,"Marystown","NL",47.09899,-55.19852,2018-01-29 03:00:00,21,NA,NA
"35724",10901,"Marystown","NL",47.09899,-55.19852,2018-01-29 04:00:00,18,NA,NA
"35725",10901,"Marystown","NL",47.09899,-55.19852,2018-01-29 05:00:00,20,NA,NA
"35726",10901,"Marystown","NL",47.09899,-55.19852,2018-01-29 06:00:00,21,NA,NA
"35727",10901,"Marystown","NL",47.09899,-55.19852,2018-01-29 07:00:00,20,NA,NA
"35728",10901,"Marystown","NL",47.09899,-55.19852,2018-01-29 08:00:00,20,NA,NA
"35729",10901,"Marystown","NL",47.09899,-55.19852,2018-01-29 09:00:00,20,NA,NA
"35730",10901,"Marystown","NL",47.09899,-55.19852,2018-01-29 10:00:00,20,NA,NA
"35731",10901,"Marystown","NL",47.09899,-55.19852,2018-01-29 11:00:00,22,NA,NA
"35732",10901,"Marystown","NL",47.09899,-55.19852,2018-01-29 12:00:00,25,NA,NA
"35733",10901,"Marystown","NL",47.09899,-55.19852,2018-01-29 13:00:00,25,NA,NA
"35734",10901,"Marystown","NL",47.09899,-55.19852,2018-01-29 14:00:00,26,NA,NA
"35735",10901,"Marystown","NL",47.09899,-55.19852,2018-01-29 15:00:00,25,NA,NA
"35736",10901,"Marystown","NL",47.09899,-55.19852,2018-01-29 16:00:00,24,NA,NA
"35737",10901,"Marystown","NL",47.09899,-55.19852,2018-01-29 17:00:00,24,NA,NA
"35738",10901,"Marystown","NL",47.09899,-55.19852,2018-01-29 18:00:00,23,NA,NA
"35739",10901,"Marystown","NL",47.09899,-55.19852,2018-01-29 19:00:00,23,NA,NA
"35740",10901,"Marystown","NL",47.09899,-55.19852,2018-01-29 20:00:00,23,NA,NA
"35741",10901,"Marystown","NL",47.09899,-55.19852,2018-01-29 21:00:00,24,NA,NA
"35742",10901,"Marystown","NL",47.09899,-55.19852,2018-01-29 22:00:00,24,NA,NA
"35743",10901,"Marystown","NL",47.09899,-55.19852,2018-01-29 23:00:00,24,NA,NA
"35744",10901,"Marystown","NL",47.09899,-55.19852,2018-01-30 00:00:00,25,NA,NA
"35745",10901,"Marystown","NL",47.09899,-55.19852,2018-01-30 01:00:00,25,NA,NA
"35746",10901,"Marystown","NL",47.09899,-55.19852,2018-01-30 02:00:00,25,NA,NA
"35747",10901,"Marystown","NL",47.09899,-55.19852,2018-01-30 03:00:00,26,NA,NA
"35748",10901,"Marystown","NL",47.09899,-55.19852,2018-01-30 04:00:00,28,NA,NA
"35749",10901,"Marystown","NL",47.09899,-55.19852,2018-01-30 05:00:00,29,NA,NA
"35750",10901,"Marystown","NL",47.09899,-55.19852,2018-01-30 06:00:00,30,NA,NA
"35751",10901,"Marystown","NL",47.09899,-55.19852,2018-01-30 07:00:00,31,NA,NA
"35752",10901,"Marystown","NL",47.09899,-55.19852,2018-01-30 08:00:00,30,NA,NA
"35753",10901,"Marystown","NL",47.09899,-55.19852,2018-01-30 09:00:00,29,NA,NA
"35754",10901,"Marystown","NL",47.09899,-55.19852,2018-01-30 10:00:00,29,NA,NA
"35755",10901,"Marystown","NL",47.09899,-55.19852,2018-01-30 11:00:00,29,NA,NA
"35756",10901,"Marystown","NL",47.09899,-55.19852,2018-01-30 12:00:00,30,NA,NA
"35757",10901,"Marystown","NL",47.09899,-55.19852,2018-01-30 13:00:00,30,NA,NA
"35758",10901,"Marystown","NL",47.09899,-55.19852,2018-01-30 14:00:00,30,NA,NA
"35759",10901,"Marystown","NL",47.09899,-55.19852,2018-01-30 15:00:00,30,NA,NA
"35760",10901,"Marystown","NL",47.09899,-55.19852,2018-01-30 16:00:00,30,NA,NA
"35761",10901,"Marystown","NL",47.09899,-55.19852,2018-01-30 17:00:00,30,NA,NA
"35762",10901,"Marystown","NL",47.09899,-55.19852,2018-01-30 18:00:00,30,NA,NA
"35763",10901,"Marystown","NL",47.09899,-55.19852,2018-01-30 19:00:00,27,NA,NA
"35764",10901,"Marystown","NL",47.09899,-55.19852,2018-01-30 20:00:00,25,NA,NA
"35765",10901,"Marystown","NL",47.09899,-55.19852,2018-01-30 21:00:00,23,NA,NA
"35766",10901,"Marystown","NL",47.09899,-55.19852,2018-01-30 22:00:00,23,NA,NA
"35767",10901,"Marystown","NL",47.09899,-55.19852,2018-01-30 23:00:00,23,NA,NA
"35768",10901,"Marystown","NL",47.09899,-55.19852,2018-01-31 00:00:00,23,NA,NA
"35769",10901,"Marystown","NL",47.09899,-55.19852,2018-01-31 01:00:00,24,NA,NA
"35770",10901,"Marystown","NL",47.09899,-55.19852,2018-01-31 02:00:00,24,NA,NA
"35771",10901,"Marystown","NL",47.09899,-55.19852,2018-01-31 03:00:00,24,NA,NA
"35772",10901,"Marystown","NL",47.09899,-55.19852,2018-01-31 04:00:00,23,NA,NA
"35773",10901,"Marystown","NL",47.09899,-55.19852,2018-01-31 05:00:00,23,NA,NA
"35774",10901,"Marystown","NL",47.09899,-55.19852,2018-01-31 06:00:00,24,NA,NA
"35775",10901,"Marystown","NL",47.09899,-55.19852,2018-01-31 07:00:00,25,NA,NA
"35776",10901,"Marystown","NL",47.09899,-55.19852,2018-01-31 08:00:00,27,NA,NA
"35777",10901,"Marystown","NL",47.09899,-55.19852,2018-01-31 09:00:00,25,NA,NA
"35778",10901,"Marystown","NL",47.09899,-55.19852,2018-01-31 10:00:00,27,NA,NA
"35779",10901,"Marystown","NL",47.09899,-55.19852,2018-01-31 11:00:00,29,NA,NA
"35780",10901,"Marystown","NL",47.09899,-55.19852,2018-01-31 12:00:00,30,NA,NA
"35781",10901,"Marystown","NL",47.09899,-55.19852,2018-01-31 13:00:00,31,NA,NA
"35782",10901,"Marystown","NL",47.09899,-55.19852,2018-01-31 14:00:00,32,NA,NA
"35783",10901,"Marystown","NL",47.09899,-55.19852,2018-01-31 15:00:00,31,NA,NA
"35784",10901,"Marystown","NL",47.09899,-55.19852,2018-01-31 16:00:00,32,NA,NA
"35785",10901,"Marystown","NL",47.09899,-55.19852,2018-01-31 17:00:00,32,NA,NA
"35786",10901,"Marystown","NL",47.09899,-55.19852,2018-01-31 18:00:00,32,NA,NA
"35787",10901,"Marystown","NL",47.09899,-55.19852,2018-01-31 19:00:00,32,NA,NA
"35788",10901,"Marystown","NL",47.09899,-55.19852,2018-01-31 20:00:00,32,NA,NA
"35789",10901,"Marystown","NL",47.09899,-55.19852,2018-01-31 21:00:00,33,NA,NA
"35790",10901,"Marystown","NL",47.09899,-55.19852,2018-01-31 22:00:00,33,NA,NA
"35791",10901,"Marystown","NL",47.09899,-55.19852,2018-01-31 23:00:00,33,NA,NA
"35792",10901,"Marystown","NL",47.09899,-55.19852,2018-02-01 00:00:00,33,NA,NA
"35793",10901,"Marystown","NL",47.09899,-55.19852,2018-02-01 01:00:00,33,NA,NA
"35794",10901,"Marystown","NL",47.09899,-55.19852,2018-02-01 02:00:00,32,NA,NA
"35795",10901,"Marystown","NL",47.09899,-55.19852,2018-02-01 03:00:00,33,NA,NA
"35796",10901,"Marystown","NL",47.09899,-55.19852,2018-02-01 04:00:00,33,NA,NA
"35797",10901,"Marystown","NL",47.09899,-55.19852,2018-02-01 05:00:00,32,NA,NA
"35798",10901,"Marystown","NL",47.09899,-55.19852,2018-02-01 06:00:00,33,NA,NA
"35799",10901,"Marystown","NL",47.09899,-55.19852,2018-02-01 07:00:00,32,NA,NA
"35800",10901,"Marystown","NL",47.09899,-55.19852,2018-02-01 08:00:00,32,NA,NA
"35801",10901,"Marystown","NL",47.09899,-55.19852,2018-02-01 09:00:00,32,NA,NA
"35802",10901,"Marystown","NL",47.09899,-55.19852,2018-02-01 10:00:00,30,NA,NA
"35803",10901,"Marystown","NL",47.09899,-55.19852,2018-02-01 11:00:00,30,NA,NA
"35804",10901,"Marystown","NL",47.09899,-55.19852,2018-02-01 12:00:00,24,NA,NA
"35805",10901,"Marystown","NL",47.09899,-55.19852,2018-02-01 13:00:00,27,NA,NA
"35806",10901,"Marystown","NL",47.09899,-55.19852,2018-02-01 14:00:00,25,NA,NA
"35807",10901,"Marystown","NL",47.09899,-55.19852,2018-02-01 15:00:00,28,NA,NA
"35808",10901,"Marystown","NL",47.09899,-55.19852,2018-02-01 16:00:00,33,NA,NA
"35809",10901,"Marystown","NL",47.09899,-55.19852,2018-02-01 17:00:00,32,NA,NA
"35810",10901,"Marystown","NL",47.09899,-55.19852,2018-02-01 18:00:00,28,NA,NA
"35811",10901,"Marystown","NL",47.09899,-55.19852,2018-02-01 19:00:00,29,NA,NA
"35812",10901,"Marystown","NL",47.09899,-55.19852,2018-02-01 20:00:00,29,NA,NA
"35813",10901,"Marystown","NL",47.09899,-55.19852,2018-02-01 21:00:00,29,NA,NA
"35814",10901,"Marystown","NL",47.09899,-55.19852,2018-02-01 22:00:00,30,NA,NA
"35815",10901,"Marystown","NL",47.09899,-55.19852,2018-02-01 23:00:00,30,NA,NA
"35816",10901,"Marystown","NL",47.09899,-55.19852,2018-02-02 00:00:00,30,NA,NA
"35817",10901,"Marystown","NL",47.09899,-55.19852,2018-02-02 01:00:00,29,NA,NA
"35818",10901,"Marystown","NL",47.09899,-55.19852,2018-02-02 02:00:00,29,NA,NA
"35819",10901,"Marystown","NL",47.09899,-55.19852,2018-02-02 03:00:00,29,NA,NA
"35820",10901,"Marystown","NL",47.09899,-55.19852,2018-02-02 04:00:00,27,NA,NA
"35821",10901,"Marystown","NL",47.09899,-55.19852,2018-02-02 05:00:00,28,NA,NA
"35822",10901,"Marystown","NL",47.09899,-55.19852,2018-02-02 06:00:00,28,NA,NA
"35823",10901,"Marystown","NL",47.09899,-55.19852,2018-02-02 07:00:00,28,NA,NA
"35824",10901,"Marystown","NL",47.09899,-55.19852,2018-02-02 08:00:00,26,NA,NA
"35825",10901,"Marystown","NL",47.09899,-55.19852,2018-02-02 09:00:00,25,NA,NA
"35826",10901,"Marystown","NL",47.09899,-55.19852,2018-02-02 10:00:00,24,NA,NA
"35827",10901,"Marystown","NL",47.09899,-55.19852,2018-02-02 11:00:00,24,NA,NA
"35828",10901,"Marystown","NL",47.09899,-55.19852,2018-02-02 12:00:00,24,NA,NA
"35829",10901,"Marystown","NL",47.09899,-55.19852,2018-02-02 13:00:00,25,NA,NA
"35830",10901,"Marystown","NL",47.09899,-55.19852,2018-02-02 14:00:00,25,NA,NA
"35831",10901,"Marystown","NL",47.09899,-55.19852,2018-02-02 15:00:00,26,NA,NA
"35832",10901,"Marystown","NL",47.09899,-55.19852,2018-02-02 16:00:00,26,NA,NA
"35833",10901,"Marystown","NL",47.09899,-55.19852,2018-02-02 17:00:00,28,NA,NA
"35834",10901,"Marystown","NL",47.09899,-55.19852,2018-02-02 18:00:00,30,NA,NA
"35835",10901,"Marystown","NL",47.09899,-55.19852,2018-02-02 19:00:00,31,NA,NA
"35836",10901,"Marystown","NL",47.09899,-55.19852,2018-02-02 20:00:00,32,NA,NA
"35837",10901,"Marystown","NL",47.09899,-55.19852,2018-02-02 21:00:00,34,NA,NA
"35838",10901,"Marystown","NL",47.09899,-55.19852,2018-02-02 22:00:00,35,NA,NA
"35839",10901,"Marystown","NL",47.09899,-55.19852,2018-02-02 23:00:00,35,NA,NA
"35840",10901,"Marystown","NL",47.09899,-55.19852,2018-02-03 00:00:00,35,NA,NA
"35841",10901,"Marystown","NL",47.09899,-55.19852,2018-02-03 01:00:00,38,NA,NA
"35842",10901,"Marystown","NL",47.09899,-55.19852,2018-02-03 02:00:00,40,NA,NA
"35843",10901,"Marystown","NL",47.09899,-55.19852,2018-02-03 03:00:00,39,NA,NA
"35844",10901,"Marystown","NL",47.09899,-55.19852,2018-02-03 04:00:00,33,NA,NA
"35845",10901,"Marystown","NL",47.09899,-55.19852,2018-02-03 05:00:00,26,NA,NA
"35846",10901,"Marystown","NL",47.09899,-55.19852,2018-02-03 06:00:00,25,NA,NA
"35847",10901,"Marystown","NL",47.09899,-55.19852,2018-02-03 07:00:00,25,NA,NA
"35848",10901,"Marystown","NL",47.09899,-55.19852,2018-02-03 08:00:00,26,NA,NA
"35849",10901,"Marystown","NL",47.09899,-55.19852,2018-02-03 09:00:00,27,NA,NA
"35850",10901,"Marystown","NL",47.09899,-55.19852,2018-02-03 10:00:00,28,NA,NA
"35851",10901,"Marystown","NL",47.09899,-55.19852,2018-02-03 11:00:00,30,NA,NA
"35852",10901,"Marystown","NL",47.09899,-55.19852,2018-02-03 12:00:00,29,NA,NA
"35853",10901,"Marystown","NL",47.09899,-55.19852,2018-02-03 13:00:00,30,NA,NA
"35854",10901,"Marystown","NL",47.09899,-55.19852,2018-02-03 14:00:00,30,NA,NA
"35855",10901,"Marystown","NL",47.09899,-55.19852,2018-02-03 15:00:00,32,NA,NA
"35856",10901,"Marystown","NL",47.09899,-55.19852,2018-02-03 16:00:00,33,NA,NA
"35857",10901,"Marystown","NL",47.09899,-55.19852,2018-02-03 17:00:00,34,NA,NA
"35858",10901,"Marystown","NL",47.09899,-55.19852,2018-02-03 18:00:00,35,NA,NA
"35859",10901,"Marystown","NL",47.09899,-55.19852,2018-02-03 19:00:00,34,NA,NA
"35860",10901,"Marystown","NL",47.09899,-55.19852,2018-02-03 20:00:00,34,NA,NA
"35861",10901,"Marystown","NL",47.09899,-55.19852,2018-02-03 21:00:00,34,NA,NA
"35862",10901,"Marystown","NL",47.09899,-55.19852,2018-02-03 22:00:00,33,NA,NA
"35863",10901,"Marystown","NL",47.09899,-55.19852,2018-02-03 23:00:00,33,NA,NA
"35864",10901,"Marystown","NL",47.09899,-55.19852,2018-02-04 00:00:00,33,NA,NA
"35865",10901,"Marystown","NL",47.09899,-55.19852,2018-02-04 01:00:00,34,NA,NA
"35866",10901,"Marystown","NL",47.09899,-55.19852,2018-02-04 02:00:00,33,NA,NA
"35867",10901,"Marystown","NL",47.09899,-55.19852,2018-02-04 03:00:00,32,NA,NA
"35868",10901,"Marystown","NL",47.09899,-55.19852,2018-02-04 04:00:00,33,NA,NA
"35869",10901,"Marystown","NL",47.09899,-55.19852,2018-02-04 05:00:00,31,NA,NA
"35870",10901,"Marystown","NL",47.09899,-55.19852,2018-02-04 06:00:00,31,NA,NA
"35871",10901,"Marystown","NL",47.09899,-55.19852,2018-02-04 07:00:00,32,NA,NA
"35872",10901,"Marystown","NL",47.09899,-55.19852,2018-02-04 08:00:00,32,NA,NA
"35873",10901,"Marystown","NL",47.09899,-55.19852,2018-02-04 09:00:00,33,NA,NA
"35874",10901,"Marystown","NL",47.09899,-55.19852,2018-02-04 10:00:00,33,NA,NA
"35875",10901,"Marystown","NL",47.09899,-55.19852,2018-02-04 11:00:00,33,NA,NA
"35876",10901,"Marystown","NL",47.09899,-55.19852,2018-02-04 12:00:00,33,NA,NA
"35877",10901,"Marystown","NL",47.09899,-55.19852,2018-02-04 13:00:00,32,NA,NA
"35878",10901,"Marystown","NL",47.09899,-55.19852,2018-02-04 14:00:00,32,NA,NA
"35879",10901,"Marystown","NL",47.09899,-55.19852,2018-02-04 15:00:00,32,NA,NA
"35880",10901,"Marystown","NL",47.09899,-55.19852,2018-02-04 16:00:00,31,NA,NA
"35881",10901,"Marystown","NL",47.09899,-55.19852,2018-02-04 17:00:00,30,NA,NA
"35882",10901,"Marystown","NL",47.09899,-55.19852,2018-02-04 18:00:00,31,NA,NA
"35883",10901,"Marystown","NL",47.09899,-55.19852,2018-02-04 19:00:00,31,NA,NA
"35884",10901,"Marystown","NL",47.09899,-55.19852,2018-02-04 20:00:00,32,NA,NA
"35885",10901,"Marystown","NL",47.09899,-55.19852,2018-02-04 21:00:00,34,NA,NA
"35886",10901,"Marystown","NL",47.09899,-55.19852,2018-02-04 22:00:00,34,NA,NA
"35887",10901,"Marystown","NL",47.09899,-55.19852,2018-02-04 23:00:00,33,NA,NA
"35888",10901,"Marystown","NL",47.09899,-55.19852,2018-02-05 00:00:00,33,NA,NA
"35889",10901,"Marystown","NL",47.09899,-55.19852,2018-02-05 01:00:00,32,NA,NA
"35890",10901,"Marystown","NL",47.09899,-55.19852,2018-02-05 02:00:00,32,NA,NA
"35891",10901,"Marystown","NL",47.09899,-55.19852,2018-02-05 03:00:00,32,NA,NA
"35892",10901,"Marystown","NL",47.09899,-55.19852,2018-02-05 04:00:00,31,NA,NA
"35893",10901,"Marystown","NL",47.09899,-55.19852,2018-02-05 05:00:00,31,NA,NA
"35894",10901,"Marystown","NL",47.09899,-55.19852,2018-02-05 06:00:00,31,NA,NA
"35895",10901,"Marystown","NL",47.09899,-55.19852,2018-02-05 07:00:00,31,NA,NA
"35896",10901,"Marystown","NL",47.09899,-55.19852,2018-02-05 08:00:00,31,NA,NA
"35897",10901,"Marystown","NL",47.09899,-55.19852,2018-02-05 09:00:00,30,NA,NA
"35898",10901,"Marystown","NL",47.09899,-55.19852,2018-02-05 10:00:00,31,NA,NA
"35899",10901,"Marystown","NL",47.09899,-55.19852,2018-02-05 11:00:00,30,NA,NA
"35900",10901,"Marystown","NL",47.09899,-55.19852,2018-02-05 12:00:00,30,NA,NA
"35901",10901,"Marystown","NL",47.09899,-55.19852,2018-02-05 13:00:00,29,NA,NA
"35902",10901,"Marystown","NL",47.09899,-55.19852,2018-02-05 14:00:00,31,NA,NA
"35903",10901,"Marystown","NL",47.09899,-55.19852,2018-02-05 15:00:00,29,NA,NA
"35904",10901,"Marystown","NL",47.09899,-55.19852,2018-02-05 16:00:00,28,NA,NA
"35905",10901,"Marystown","NL",47.09899,-55.19852,2018-02-05 17:00:00,28,NA,NA
"35906",10901,"Marystown","NL",47.09899,-55.19852,2018-02-05 18:00:00,29,NA,NA
"35907",10901,"Marystown","NL",47.09899,-55.19852,2018-02-05 19:00:00,31,NA,NA
"35908",10901,"Marystown","NL",47.09899,-55.19852,2018-02-05 20:00:00,30,NA,NA
"35909",10901,"Marystown","NL",47.09899,-55.19852,2018-02-05 21:00:00,29,NA,NA
"35910",10901,"Marystown","NL",47.09899,-55.19852,2018-02-05 22:00:00,25,NA,NA
"35911",10901,"Marystown","NL",47.09899,-55.19852,2018-02-05 23:00:00,23,NA,NA
"35912",10901,"Marystown","NL",47.09899,-55.19852,2018-02-06 00:00:00,25,NA,NA
"35913",10901,"Marystown","NL",47.09899,-55.19852,2018-02-06 01:00:00,27,NA,NA
"35914",10901,"Marystown","NL",47.09899,-55.19852,2018-02-06 02:00:00,26,NA,NA
"35915",10901,"Marystown","NL",47.09899,-55.19852,2018-02-06 03:00:00,25,NA,NA
"35916",10901,"Marystown","NL",47.09899,-55.19852,2018-02-06 04:00:00,25,NA,NA
"35917",10901,"Marystown","NL",47.09899,-55.19852,2018-02-06 05:00:00,25,NA,NA
"35918",10901,"Marystown","NL",47.09899,-55.19852,2018-02-06 06:00:00,25,NA,NA
"35919",10901,"Marystown","NL",47.09899,-55.19852,2018-02-06 07:00:00,28,NA,NA
"35920",10901,"Marystown","NL",47.09899,-55.19852,2018-02-06 08:00:00,30,NA,NA
"35921",10901,"Marystown","NL",47.09899,-55.19852,2018-02-06 09:00:00,29,NA,NA
"35922",10901,"Marystown","NL",47.09899,-55.19852,2018-02-06 10:00:00,31,NA,NA
"35923",10901,"Marystown","NL",47.09899,-55.19852,2018-02-06 11:00:00,32,NA,NA
"35924",10901,"Marystown","NL",47.09899,-55.19852,2018-02-06 12:00:00,31,NA,NA
"35925",10901,"Marystown","NL",47.09899,-55.19852,2018-02-06 13:00:00,32,NA,NA
"35926",10901,"Marystown","NL",47.09899,-55.19852,2018-02-06 14:00:00,31,NA,NA
"35927",10901,"Marystown","NL",47.09899,-55.19852,2018-02-06 15:00:00,31,NA,NA
"35928",10901,"Marystown","NL",47.09899,-55.19852,2018-02-06 16:00:00,31,NA,NA
"35929",10901,"Marystown","NL",47.09899,-55.19852,2018-02-06 17:00:00,32,NA,NA
"35930",10901,"Marystown","NL",47.09899,-55.19852,2018-02-06 18:00:00,31,NA,NA
"35931",10901,"Marystown","NL",47.09899,-55.19852,2018-02-06 19:00:00,30,NA,NA
"35932",10901,"Marystown","NL",47.09899,-55.19852,2018-02-06 20:00:00,31,NA,NA
"35933",10901,"Marystown","NL",47.09899,-55.19852,2018-02-06 21:00:00,30,NA,NA
"35934",10901,"Marystown","NL",47.09899,-55.19852,2018-02-06 22:00:00,29,NA,NA
"35935",10901,"Marystown","NL",47.09899,-55.19852,2018-02-06 23:00:00,28,NA,NA
"35936",10901,"Marystown","NL",47.09899,-55.19852,2018-02-07 00:00:00,28,NA,NA
"35937",10901,"Marystown","NL",47.09899,-55.19852,2018-02-07 01:00:00,28,NA,NA
"35938",10901,"Marystown","NL",47.09899,-55.19852,2018-02-07 02:00:00,26,NA,NA
"35939",10901,"Marystown","NL",47.09899,-55.19852,2018-02-07 03:00:00,21,NA,NA
"35940",10901,"Marystown","NL",47.09899,-55.19852,2018-02-07 04:00:00,22,NA,NA
"35941",10901,"Marystown","NL",47.09899,-55.19852,2018-02-07 05:00:00,23,NA,NA
"35942",10901,"Marystown","NL",47.09899,-55.19852,2018-02-07 06:00:00,23,NA,NA
"35943",10901,"Marystown","NL",47.09899,-55.19852,2018-02-07 07:00:00,23,NA,NA
"35944",10901,"Marystown","NL",47.09899,-55.19852,2018-02-07 08:00:00,22,NA,NA
"35945",10901,"Marystown","NL",47.09899,-55.19852,2018-02-07 09:00:00,23,NA,NA
"35946",10901,"Marystown","NL",47.09899,-55.19852,2018-02-07 10:00:00,24,NA,NA
"35947",10901,"Marystown","NL",47.09899,-55.19852,2018-02-07 11:00:00,25,NA,NA
"35948",10901,"Marystown","NL",47.09899,-55.19852,2018-02-07 12:00:00,27,NA,NA
"35949",10901,"Marystown","NL",47.09899,-55.19852,2018-02-07 13:00:00,27,NA,NA
"35950",10901,"Marystown","NL",47.09899,-55.19852,2018-02-07 14:00:00,27,NA,NA
"35951",10901,"Marystown","NL",47.09899,-55.19852,2018-02-07 15:00:00,27,NA,NA
"35952",10901,"Marystown","NL",47.09899,-55.19852,2018-02-07 16:00:00,26,NA,NA
"35953",10901,"Marystown","NL",47.09899,-55.19852,2018-02-07 17:00:00,26,NA,NA
"35954",10901,"Marystown","NL",47.09899,-55.19852,2018-02-07 18:00:00,25,NA,NA
"35955",10901,"Marystown","NL",47.09899,-55.19852,2018-02-07 19:00:00,26,NA,NA
"35956",10901,"Marystown","NL",47.09899,-55.19852,2018-02-07 20:00:00,25,NA,NA
"35957",10901,"Marystown","NL",47.09899,-55.19852,2018-02-07 21:00:00,25,NA,NA
"35958",10901,"Marystown","NL",47.09899,-55.19852,2018-02-07 22:00:00,25,NA,NA
"35959",10901,"Marystown","NL",47.09899,-55.19852,2018-02-07 23:00:00,26,NA,NA
"35960",10901,"Marystown","NL",47.09899,-55.19852,2018-02-08 00:00:00,26,NA,NA
"35961",10901,"Marystown","NL",47.09899,-55.19852,2018-02-08 01:00:00,26,NA,NA
"35962",10901,"Marystown","NL",47.09899,-55.19852,2018-02-08 02:00:00,25,NA,NA
"35963",10901,"Marystown","NL",47.09899,-55.19852,2018-02-08 03:00:00,25,NA,NA
"35964",10901,"Marystown","NL",47.09899,-55.19852,2018-02-08 04:00:00,23,NA,NA
"35965",10901,"Marystown","NL",47.09899,-55.19852,2018-02-08 05:00:00,26,NA,NA
"35966",10901,"Marystown","NL",47.09899,-55.19852,2018-02-08 06:00:00,26,NA,NA
"35967",10901,"Marystown","NL",47.09899,-55.19852,2018-02-08 07:00:00,28,NA,NA
"35968",10901,"Marystown","NL",47.09899,-55.19852,2018-02-08 08:00:00,29,NA,NA
"35969",10901,"Marystown","NL",47.09899,-55.19852,2018-02-08 09:00:00,28,NA,NA
"35970",10901,"Marystown","NL",47.09899,-55.19852,2018-02-08 10:00:00,24,NA,NA
"35971",10901,"Marystown","NL",47.09899,-55.19852,2018-02-08 11:00:00,25,NA,NA
"35972",10901,"Marystown","NL",47.09899,-55.19852,2018-02-08 12:00:00,26,NA,NA
"35973",10901,"Marystown","NL",47.09899,-55.19852,2018-02-08 13:00:00,31,NA,NA
"35974",10901,"Marystown","NL",47.09899,-55.19852,2018-02-08 14:00:00,33,NA,NA
"35975",10901,"Marystown","NL",47.09899,-55.19852,2018-02-08 15:00:00,35,NA,NA
"35976",10901,"Marystown","NL",47.09899,-55.19852,2018-02-08 16:00:00,30,NA,NA
"35977",10901,"Marystown","NL",47.09899,-55.19852,2018-02-08 17:00:00,29,NA,NA
"35978",10901,"Marystown","NL",47.09899,-55.19852,2018-02-08 18:00:00,27,NA,NA
"35979",10901,"Marystown","NL",47.09899,-55.19852,2018-02-08 19:00:00,27,NA,NA
"35980",10901,"Marystown","NL",47.09899,-55.19852,2018-02-08 20:00:00,27,NA,NA
"35981",10901,"Marystown","NL",47.09899,-55.19852,2018-02-08 21:00:00,26,NA,NA
"35982",10901,"Marystown","NL",47.09899,-55.19852,2018-02-08 22:00:00,25,NA,NA
"35983",10901,"Marystown","NL",47.09899,-55.19852,2018-02-08 23:00:00,25,NA,NA
"35984",10901,"Marystown","NL",47.09899,-55.19852,2018-02-09 00:00:00,25,NA,NA
"35985",10901,"Marystown","NL",47.09899,-55.19852,2018-02-09 01:00:00,26,NA,NA
"35986",10901,"Marystown","NL",47.09899,-55.19852,2018-02-09 02:00:00,26,NA,NA
"35987",10901,"Marystown","NL",47.09899,-55.19852,2018-02-09 03:00:00,26,NA,NA
"35988",10901,"Marystown","NL",47.09899,-55.19852,2018-02-09 04:00:00,26,NA,NA
"35989",10901,"Marystown","NL",47.09899,-55.19852,2018-02-09 05:00:00,26,NA,NA
"35990",10901,"Marystown","NL",47.09899,-55.19852,2018-02-09 06:00:00,26,NA,NA
"35991",10901,"Marystown","NL",47.09899,-55.19852,2018-02-09 07:00:00,25,NA,NA
"35992",10901,"Marystown","NL",47.09899,-55.19852,2018-02-09 08:00:00,26,NA,NA
"35993",10901,"Marystown","NL",47.09899,-55.19852,2018-02-09 09:00:00,27,NA,NA
"35994",10901,"Marystown","NL",47.09899,-55.19852,2018-02-09 10:00:00,26,NA,NA
"35995",10901,"Marystown","NL",47.09899,-55.19852,2018-02-09 11:00:00,27,NA,NA
"35996",10901,"Marystown","NL",47.09899,-55.19852,2018-02-09 12:00:00,27,NA,NA
"35997",10901,"Marystown","NL",47.09899,-55.19852,2018-02-09 13:00:00,29,NA,NA
"35998",10901,"Marystown","NL",47.09899,-55.19852,2018-02-09 14:00:00,29,NA,NA
"35999",10901,"Marystown","NL",47.09899,-55.19852,2018-02-09 15:00:00,29,NA,NA
"36000",10901,"Marystown","NL",47.09899,-55.19852,2018-02-09 16:00:00,30,NA,NA
"36001",10901,"Marystown","NL",47.09899,-55.19852,2018-02-09 17:00:00,32,NA,NA
"36002",10901,"Marystown","NL",47.09899,-55.19852,2018-02-09 18:00:00,32,NA,NA
"36003",10901,"Marystown","NL",47.09899,-55.19852,2018-02-09 19:00:00,31,NA,NA
"36004",10901,"Marystown","NL",47.09899,-55.19852,2018-02-09 20:00:00,29,NA,NA
"36005",10901,"Marystown","NL",47.09899,-55.19852,2018-02-09 21:00:00,29,NA,NA
"36006",10901,"Marystown","NL",47.09899,-55.19852,2018-02-09 22:00:00,29,NA,NA
"36007",10901,"Marystown","NL",47.09899,-55.19852,2018-02-09 23:00:00,29,NA,NA
"36008",10901,"Marystown","NL",47.09899,-55.19852,2018-02-10 00:00:00,28,NA,NA
"36009",10901,"Marystown","NL",47.09899,-55.19852,2018-02-10 01:00:00,26,NA,NA
"36010",10901,"Marystown","NL",47.09899,-55.19852,2018-02-10 02:00:00,27,NA,NA
"36011",10901,"Marystown","NL",47.09899,-55.19852,2018-02-10 03:00:00,28,NA,NA
"36012",10901,"Marystown","NL",47.09899,-55.19852,2018-02-10 04:00:00,27,NA,NA
"36013",10901,"Marystown","NL",47.09899,-55.19852,2018-02-10 05:00:00,23,NA,NA
"36014",10901,"Marystown","NL",47.09899,-55.19852,2018-02-10 06:00:00,23,NA,NA
"36015",10901,"Marystown","NL",47.09899,-55.19852,2018-02-10 07:00:00,25,NA,NA
"36016",10901,"Marystown","NL",47.09899,-55.19852,2018-02-10 08:00:00,24,NA,NA
"36017",10901,"Marystown","NL",47.09899,-55.19852,2018-02-10 09:00:00,22,NA,NA
"36018",10901,"Marystown","NL",47.09899,-55.19852,2018-02-10 10:00:00,28,NA,NA
"36019",10901,"Marystown","NL",47.09899,-55.19852,2018-02-10 11:00:00,30,NA,NA
"36020",10901,"Marystown","NL",47.09899,-55.19852,2018-02-10 12:00:00,31,NA,NA
"36021",10901,"Marystown","NL",47.09899,-55.19852,2018-02-10 13:00:00,32,NA,NA
"36022",10901,"Marystown","NL",47.09899,-55.19852,2018-02-10 14:00:00,33,NA,NA
"36023",10901,"Marystown","NL",47.09899,-55.19852,2018-02-10 15:00:00,32,NA,NA
"36024",10901,"Marystown","NL",47.09899,-55.19852,2018-02-10 16:00:00,31,NA,NA
"36025",10901,"Marystown","NL",47.09899,-55.19852,2018-02-10 17:00:00,32,NA,NA
"36026",10901,"Marystown","NL",47.09899,-55.19852,2018-02-10 18:00:00,31,NA,NA
"36027",10901,"Marystown","NL",47.09899,-55.19852,2018-02-10 19:00:00,31,NA,NA
"36028",10901,"Marystown","NL",47.09899,-55.19852,2018-02-10 20:00:00,34,NA,NA
"36029",10901,"Marystown","NL",47.09899,-55.19852,2018-02-10 21:00:00,32,NA,NA
"36030",10901,"Marystown","NL",47.09899,-55.19852,2018-02-10 22:00:00,30,NA,NA
"36031",10901,"Marystown","NL",47.09899,-55.19852,2018-02-10 23:00:00,29,NA,NA
"36032",10901,"Marystown","NL",47.09899,-55.19852,2018-02-11 00:00:00,29,NA,NA
"36033",10901,"Marystown","NL",47.09899,-55.19852,2018-02-11 01:00:00,30,NA,NA
"36034",10901,"Marystown","NL",47.09899,-55.19852,2018-02-11 02:00:00,30,NA,NA
"36035",10901,"Marystown","NL",47.09899,-55.19852,2018-02-11 03:00:00,29,NA,NA
"36036",10901,"Marystown","NL",47.09899,-55.19852,2018-02-11 04:00:00,28,NA,NA
"36037",10901,"Marystown","NL",47.09899,-55.19852,2018-02-11 05:00:00,29,NA,NA
"36038",10901,"Marystown","NL",47.09899,-55.19852,2018-02-11 06:00:00,30,NA,NA
"36039",10901,"Marystown","NL",47.09899,-55.19852,2018-02-11 07:00:00,34,NA,NA
"36040",10901,"Marystown","NL",47.09899,-55.19852,2018-02-11 08:00:00,34,NA,NA
"36041",10901,"Marystown","NL",47.09899,-55.19852,2018-02-11 09:00:00,31,NA,NA
"36042",10901,"Marystown","NL",47.09899,-55.19852,2018-02-11 10:00:00,25,NA,NA
"36043",10901,"Marystown","NL",47.09899,-55.19852,2018-02-11 11:00:00,24,NA,NA
"36044",10901,"Marystown","NL",47.09899,-55.19852,2018-02-11 12:00:00,24,NA,NA
"36045",10901,"Marystown","NL",47.09899,-55.19852,2018-02-11 13:00:00,25,NA,NA
"36046",10901,"Marystown","NL",47.09899,-55.19852,2018-02-11 14:00:00,25,NA,NA
"36047",10901,"Marystown","NL",47.09899,-55.19852,2018-02-11 15:00:00,23,NA,NA
"36048",10901,"Marystown","NL",47.09899,-55.19852,2018-02-11 16:00:00,22,NA,NA
"36049",10901,"Marystown","NL",47.09899,-55.19852,2018-02-11 17:00:00,22,NA,NA
"36050",10901,"Marystown","NL",47.09899,-55.19852,2018-02-11 18:00:00,22,NA,NA
"36051",10901,"Marystown","NL",47.09899,-55.19852,2018-02-11 19:00:00,21,NA,NA
"36052",10901,"Marystown","NL",47.09899,-55.19852,2018-02-11 20:00:00,23,NA,NA
"36053",10901,"Marystown","NL",47.09899,-55.19852,2018-02-11 21:00:00,25,NA,NA
"36054",10901,"Marystown","NL",47.09899,-55.19852,2018-02-11 22:00:00,25,NA,NA
"36055",10901,"Marystown","NL",47.09899,-55.19852,2018-02-11 23:00:00,25,NA,NA
"36056",10901,"Marystown","NL",47.09899,-55.19852,2018-02-12 00:00:00,30,NA,NA
"36057",10901,"Marystown","NL",47.09899,-55.19852,2018-02-12 01:00:00,31,NA,NA
"36058",10901,"Marystown","NL",47.09899,-55.19852,2018-02-12 02:00:00,33,NA,NA
"36059",10901,"Marystown","NL",47.09899,-55.19852,2018-02-12 03:00:00,33,NA,NA
"36060",10901,"Marystown","NL",47.09899,-55.19852,2018-02-12 04:00:00,32,NA,NA
"36061",10901,"Marystown","NL",47.09899,-55.19852,2018-02-12 05:00:00,31,NA,NA
"36062",10901,"Marystown","NL",47.09899,-55.19852,2018-02-12 06:00:00,32,NA,NA
"36063",10901,"Marystown","NL",47.09899,-55.19852,2018-02-12 07:00:00,33,NA,NA
"36064",10901,"Marystown","NL",47.09899,-55.19852,2018-02-12 08:00:00,33,NA,NA
"36065",10901,"Marystown","NL",47.09899,-55.19852,2018-02-12 09:00:00,30,NA,NA
"36066",10901,"Marystown","NL",47.09899,-55.19852,2018-02-12 10:00:00,26,NA,NA
"36067",10901,"Marystown","NL",47.09899,-55.19852,2018-02-12 11:00:00,22,NA,NA
"36068",10901,"Marystown","NL",47.09899,-55.19852,2018-02-12 12:00:00,22,NA,NA
"36069",10901,"Marystown","NL",47.09899,-55.19852,2018-02-12 13:00:00,20,NA,NA
"36070",10901,"Marystown","NL",47.09899,-55.19852,2018-02-12 14:00:00,21,NA,NA
"36071",10901,"Marystown","NL",47.09899,-55.19852,2018-02-12 15:00:00,21,NA,NA
"36072",10901,"Marystown","NL",47.09899,-55.19852,2018-02-12 16:00:00,20,NA,NA
"36073",10901,"Marystown","NL",47.09899,-55.19852,2018-02-12 17:00:00,20,NA,NA
"36074",10901,"Marystown","NL",47.09899,-55.19852,2018-02-12 18:00:00,22,NA,NA
"36075",10901,"Marystown","NL",47.09899,-55.19852,2018-02-12 19:00:00,25,NA,NA
"36076",10901,"Marystown","NL",47.09899,-55.19852,2018-02-12 20:00:00,28,NA,NA
"36077",10901,"Marystown","NL",47.09899,-55.19852,2018-02-12 21:00:00,30,NA,NA
"36078",10901,"Marystown","NL",47.09899,-55.19852,2018-02-12 22:00:00,32,NA,NA
"36079",10901,"Marystown","NL",47.09899,-55.19852,2018-02-12 23:00:00,36,NA,NA
"36080",10901,"Marystown","NL",47.09899,-55.19852,2018-02-13 00:00:00,36,NA,NA
"36081",10901,"Marystown","NL",47.09899,-55.19852,2018-02-13 01:00:00,35,NA,NA
"36082",10901,"Marystown","NL",47.09899,-55.19852,2018-02-13 02:00:00,33,NA,NA
"36083",10901,"Marystown","NL",47.09899,-55.19852,2018-02-13 03:00:00,32,NA,NA
"36084",10901,"Marystown","NL",47.09899,-55.19852,2018-02-13 04:00:00,32,NA,NA
"36085",10901,"Marystown","NL",47.09899,-55.19852,2018-02-13 05:00:00,32,NA,NA
"36086",10901,"Marystown","NL",47.09899,-55.19852,2018-02-13 06:00:00,32,NA,NA
"36087",10901,"Marystown","NL",47.09899,-55.19852,2018-02-13 07:00:00,32,NA,NA
"36088",10901,"Marystown","NL",47.09899,-55.19852,2018-02-13 08:00:00,34,NA,NA
"36089",10901,"Marystown","NL",47.09899,-55.19852,2018-02-13 09:00:00,34,NA,NA
"36090",10901,"Marystown","NL",47.09899,-55.19852,2018-02-13 10:00:00,33,NA,NA
"36091",10901,"Marystown","NL",47.09899,-55.19852,2018-02-13 11:00:00,33,NA,NA
"36092",10901,"Marystown","NL",47.09899,-55.19852,2018-02-13 12:00:00,33,NA,NA
"36093",10901,"Marystown","NL",47.09899,-55.19852,2018-02-13 13:00:00,31,NA,NA
"36094",10901,"Marystown","NL",47.09899,-55.19852,2018-02-13 14:00:00,31,NA,NA
"36095",10901,"Marystown","NL",47.09899,-55.19852,2018-02-13 15:00:00,32,NA,NA
"36096",10901,"Marystown","NL",47.09899,-55.19852,2018-02-13 16:00:00,32,NA,NA
"36097",10901,"Marystown","NL",47.09899,-55.19852,2018-02-13 17:00:00,32,NA,NA
"36098",10901,"Marystown","NL",47.09899,-55.19852,2018-02-13 18:00:00,31,NA,NA
"36099",10901,"Marystown","NL",47.09899,-55.19852,2018-02-13 19:00:00,31,NA,NA
"36100",10901,"Marystown","NL",47.09899,-55.19852,2018-02-13 20:00:00,31,NA,NA
"36101",10901,"Marystown","NL",47.09899,-55.19852,2018-02-13 21:00:00,30,NA,NA
"36102",10901,"Marystown","NL",47.09899,-55.19852,2018-02-13 22:00:00,29,NA,NA
"36103",10901,"Marystown","NL",47.09899,-55.19852,2018-02-13 23:00:00,29,NA,NA
"36104",10901,"Marystown","NL",47.09899,-55.19852,2018-02-14 00:00:00,29,NA,NA
"36105",10901,"Marystown","NL",47.09899,-55.19852,2018-02-14 01:00:00,29,NA,NA
"36106",10901,"Marystown","NL",47.09899,-55.19852,2018-02-14 02:00:00,29,NA,NA
"36107",10901,"Marystown","NL",47.09899,-55.19852,2018-02-14 03:00:00,28,NA,NA
"36108",10901,"Marystown","NL",47.09899,-55.19852,2018-02-14 04:00:00,28,NA,NA
"36109",10901,"Marystown","NL",47.09899,-55.19852,2018-02-14 05:00:00,30,NA,NA
"36110",10901,"Marystown","NL",47.09899,-55.19852,2018-02-14 06:00:00,31,NA,NA
"36111",10901,"Marystown","NL",47.09899,-55.19852,2018-02-14 07:00:00,32,NA,NA
"36112",10901,"Marystown","NL",47.09899,-55.19852,2018-02-14 08:00:00,33,NA,NA
"36113",10901,"Marystown","NL",47.09899,-55.19852,2018-02-14 09:00:00,33,NA,NA
"36114",10901,"Marystown","NL",47.09899,-55.19852,2018-02-14 10:00:00,33,NA,NA
"36115",10901,"Marystown","NL",47.09899,-55.19852,2018-02-14 11:00:00,35,NA,NA
"36116",10901,"Marystown","NL",47.09899,-55.19852,2018-02-14 12:00:00,35,NA,NA
"36117",10901,"Marystown","NL",47.09899,-55.19852,2018-02-14 13:00:00,37,NA,NA
"36118",10901,"Marystown","NL",47.09899,-55.19852,2018-02-14 14:00:00,37,NA,NA
"36119",10901,"Marystown","NL",47.09899,-55.19852,2018-02-14 15:00:00,38,NA,NA
"36120",10901,"Marystown","NL",47.09899,-55.19852,2018-02-14 16:00:00,37,NA,NA
"36121",10901,"Marystown","NL",47.09899,-55.19852,2018-02-14 17:00:00,38,NA,NA
"36122",10901,"Marystown","NL",47.09899,-55.19852,2018-02-14 18:00:00,36,NA,NA
"36123",10901,"Marystown","NL",47.09899,-55.19852,2018-02-14 19:00:00,36,NA,NA
"36124",10901,"Marystown","NL",47.09899,-55.19852,2018-02-14 20:00:00,35,NA,NA
"36125",10901,"Marystown","NL",47.09899,-55.19852,2018-02-14 21:00:00,36,NA,NA
"36126",10901,"Marystown","NL",47.09899,-55.19852,2018-02-14 22:00:00,35,NA,NA
"36127",10901,"Marystown","NL",47.09899,-55.19852,2018-02-14 23:00:00,33,NA,NA
"36128",10901,"Marystown","NL",47.09899,-55.19852,2018-02-15 00:00:00,34,NA,NA
"36129",10901,"Marystown","NL",47.09899,-55.19852,2018-02-15 01:00:00,33,NA,NA
"36130",10901,"Marystown","NL",47.09899,-55.19852,2018-02-15 02:00:00,32,NA,NA
"36131",10901,"Marystown","NL",47.09899,-55.19852,2018-02-15 03:00:00,31,NA,NA
"36132",10901,"Marystown","NL",47.09899,-55.19852,2018-02-15 04:00:00,30,NA,NA
"36133",10901,"Marystown","NL",47.09899,-55.19852,2018-02-15 05:00:00,29,NA,NA
"36134",10901,"Marystown","NL",47.09899,-55.19852,2018-02-15 06:00:00,26,NA,NA
"36135",10901,"Marystown","NL",47.09899,-55.19852,2018-02-15 07:00:00,22,NA,NA
"36136",10901,"Marystown","NL",47.09899,-55.19852,2018-02-15 08:00:00,17,NA,NA
"36137",10901,"Marystown","NL",47.09899,-55.19852,2018-02-15 09:00:00,12,NA,NA
"36138",10901,"Marystown","NL",47.09899,-55.19852,2018-02-15 10:00:00,19,NA,NA
"36139",10901,"Marystown","NL",47.09899,-55.19852,2018-02-15 11:00:00,24,NA,NA
"36140",10901,"Marystown","NL",47.09899,-55.19852,2018-02-15 12:00:00,25,NA,NA
"36141",10901,"Marystown","NL",47.09899,-55.19852,2018-02-15 13:00:00,25,NA,NA
"36142",10901,"Marystown","NL",47.09899,-55.19852,2018-02-15 14:00:00,27,NA,NA
"36143",10901,"Marystown","NL",47.09899,-55.19852,2018-02-15 15:00:00,27,NA,NA
"36144",10901,"Marystown","NL",47.09899,-55.19852,2018-02-15 16:00:00,26,NA,NA
"36145",10901,"Marystown","NL",47.09899,-55.19852,2018-02-15 17:00:00,26,NA,NA
"36146",10901,"Marystown","NL",47.09899,-55.19852,2018-02-15 18:00:00,25,NA,NA
"36147",10901,"Marystown","NL",47.09899,-55.19852,2018-02-15 19:00:00,24,NA,NA
"36148",10901,"Marystown","NL",47.09899,-55.19852,2018-02-15 20:00:00,18,NA,NA
"36149",10901,"Marystown","NL",47.09899,-55.19852,2018-02-15 21:00:00,16,NA,NA
"36150",10901,"Marystown","NL",47.09899,-55.19852,2018-02-15 22:00:00,16,NA,NA
"36151",10901,"Marystown","NL",47.09899,-55.19852,2018-02-15 23:00:00,15,NA,NA
"36152",10901,"Marystown","NL",47.09899,-55.19852,2018-02-16 00:00:00,18,NA,NA
"36153",10901,"Marystown","NL",47.09899,-55.19852,2018-02-16 01:00:00,22,NA,NA
"36154",10901,"Marystown","NL",47.09899,-55.19852,2018-02-16 02:00:00,25,NA,NA
"36155",10901,"Marystown","NL",47.09899,-55.19852,2018-02-16 03:00:00,26,NA,NA
"36156",10901,"Marystown","NL",47.09899,-55.19852,2018-02-16 04:00:00,27,NA,NA
"36157",10901,"Marystown","NL",47.09899,-55.19852,2018-02-16 05:00:00,27,NA,NA
"36158",10901,"Marystown","NL",47.09899,-55.19852,2018-02-16 06:00:00,30,NA,NA
"36159",10901,"Marystown","NL",47.09899,-55.19852,2018-02-16 07:00:00,30,NA,NA
"36160",10901,"Marystown","NL",47.09899,-55.19852,2018-02-16 08:00:00,28,NA,NA
"36161",10901,"Marystown","NL",47.09899,-55.19852,2018-02-16 09:00:00,27,NA,NA
"36162",10901,"Marystown","NL",47.09899,-55.19852,2018-02-16 10:00:00,29,NA,NA
"36163",10901,"Marystown","NL",47.09899,-55.19852,2018-02-16 11:00:00,29,NA,NA
"36164",10901,"Marystown","NL",47.09899,-55.19852,2018-02-16 12:00:00,27,NA,NA
"36165",10901,"Marystown","NL",47.09899,-55.19852,2018-02-16 13:00:00,28,NA,NA
"36166",10901,"Marystown","NL",47.09899,-55.19852,2018-02-16 14:00:00,25,NA,NA
"36167",10901,"Marystown","NL",47.09899,-55.19852,2018-02-16 15:00:00,25,NA,NA
"36168",10901,"Marystown","NL",47.09899,-55.19852,2018-02-16 16:00:00,23,NA,NA
"36169",10901,"Marystown","NL",47.09899,-55.19852,2018-02-16 17:00:00,23,NA,NA
"36170",10901,"Marystown","NL",47.09899,-55.19852,2018-02-16 18:00:00,22,NA,NA
"36171",10901,"Marystown","NL",47.09899,-55.19852,2018-02-16 19:00:00,22,NA,NA
"36172",10901,"Marystown","NL",47.09899,-55.19852,2018-02-16 20:00:00,20,NA,NA
"36173",10901,"Marystown","NL",47.09899,-55.19852,2018-02-16 21:00:00,17,NA,NA
"36174",10901,"Marystown","NL",47.09899,-55.19852,2018-02-16 22:00:00,15,NA,NA
"36175",10901,"Marystown","NL",47.09899,-55.19852,2018-02-16 23:00:00,13,NA,NA
"36176",10901,"Marystown","NL",47.09899,-55.19852,2018-02-17 00:00:00,11,NA,NA
"36177",10901,"Marystown","NL",47.09899,-55.19852,2018-02-17 01:00:00,12,NA,NA
"36178",10901,"Marystown","NL",47.09899,-55.19852,2018-02-17 02:00:00,13,NA,NA
"36179",10901,"Marystown","NL",47.09899,-55.19852,2018-02-17 03:00:00,16,NA,NA
"36180",10901,"Marystown","NL",47.09899,-55.19852,2018-02-17 04:00:00,19,NA,NA
"36181",10901,"Marystown","NL",47.09899,-55.19852,2018-02-17 05:00:00,22,NA,NA
"36182",10901,"Marystown","NL",47.09899,-55.19852,2018-02-17 06:00:00,25,NA,NA
"36183",10901,"Marystown","NL",47.09899,-55.19852,2018-02-17 07:00:00,28,NA,NA
"36184",10901,"Marystown","NL",47.09899,-55.19852,2018-02-17 08:00:00,28,NA,NA
"36185",10901,"Marystown","NL",47.09899,-55.19852,2018-02-17 09:00:00,28,NA,NA
"36186",10901,"Marystown","NL",47.09899,-55.19852,2018-02-17 10:00:00,28,NA,NA
"36187",10901,"Marystown","NL",47.09899,-55.19852,2018-02-17 11:00:00,28,NA,NA
"36188",10901,"Marystown","NL",47.09899,-55.19852,2018-02-17 12:00:00,28,NA,NA
"36189",10901,"Marystown","NL",47.09899,-55.19852,2018-02-17 13:00:00,32,NA,NA
"36190",10901,"Marystown","NL",47.09899,-55.19852,2018-02-17 14:00:00,33,NA,NA
"36191",10901,"Marystown","NL",47.09899,-55.19852,2018-02-17 15:00:00,33,NA,NA
"36192",10901,"Marystown","NL",47.09899,-55.19852,2018-02-17 16:00:00,32,NA,NA
"36193",10901,"Marystown","NL",47.09899,-55.19852,2018-02-17 17:00:00,32,NA,NA
"36194",10901,"Marystown","NL",47.09899,-55.19852,2018-02-17 18:00:00,32,NA,NA
"36195",10901,"Marystown","NL",47.09899,-55.19852,2018-02-17 19:00:00,33,NA,NA
"36196",10901,"Marystown","NL",47.09899,-55.19852,2018-02-17 20:00:00,31,NA,NA
"36197",10901,"Marystown","NL",47.09899,-55.19852,2018-02-17 21:00:00,30,NA,NA
"36198",10901,"Marystown","NL",47.09899,-55.19852,2018-02-17 22:00:00,29,NA,NA
"36199",10901,"Marystown","NL",47.09899,-55.19852,2018-02-17 23:00:00,28,NA,NA
"36200",10901,"Marystown","NL",47.09899,-55.19852,2018-02-18 00:00:00,28,NA,NA
"36201",10901,"Marystown","NL",47.09899,-55.19852,2018-02-18 01:00:00,28,NA,NA
"36202",10901,"Marystown","NL",47.09899,-55.19852,2018-02-18 02:00:00,28,NA,NA
"36203",10901,"Marystown","NL",47.09899,-55.19852,2018-02-18 03:00:00,27,NA,NA
"36204",10901,"Marystown","NL",47.09899,-55.19852,2018-02-18 04:00:00,27,NA,NA
"36205",10901,"Marystown","NL",47.09899,-55.19852,2018-02-18 05:00:00,27,NA,NA
"36206",10901,"Marystown","NL",47.09899,-55.19852,2018-02-18 06:00:00,27,NA,NA
"36207",10901,"Marystown","NL",47.09899,-55.19852,2018-02-18 07:00:00,25,NA,NA
"36208",10901,"Marystown","NL",47.09899,-55.19852,2018-02-18 08:00:00,23,NA,NA
"36209",10901,"Marystown","NL",47.09899,-55.19852,2018-02-18 09:00:00,23,NA,NA
"36210",10901,"Marystown","NL",47.09899,-55.19852,2018-02-18 10:00:00,26,NA,NA
"36211",10901,"Marystown","NL",47.09899,-55.19852,2018-02-18 11:00:00,27,NA,NA
"36212",10901,"Marystown","NL",47.09899,-55.19852,2018-02-18 12:00:00,27,NA,NA
"36213",10901,"Marystown","NL",47.09899,-55.19852,2018-02-18 13:00:00,27,NA,NA
"36214",10901,"Marystown","NL",47.09899,-55.19852,2018-02-18 14:00:00,28,NA,NA
"36215",10901,"Marystown","NL",47.09899,-55.19852,2018-02-18 15:00:00,29,NA,NA
"36216",10901,"Marystown","NL",47.09899,-55.19852,2018-02-18 16:00:00,29,NA,NA
"36217",10901,"Marystown","NL",47.09899,-55.19852,2018-02-18 17:00:00,29,NA,NA
"36218",10901,"Marystown","NL",47.09899,-55.19852,2018-02-18 18:00:00,29,NA,NA
"36219",10901,"Marystown","NL",47.09899,-55.19852,2018-02-18 19:00:00,28,NA,NA
"36220",10901,"Marystown","NL",47.09899,-55.19852,2018-02-18 20:00:00,29,NA,NA
"36221",10901,"Marystown","NL",47.09899,-55.19852,2018-02-18 21:00:00,27,NA,NA
"36222",10901,"Marystown","NL",47.09899,-55.19852,2018-02-18 22:00:00,24,NA,NA
"36223",10901,"Marystown","NL",47.09899,-55.19852,2018-02-18 23:00:00,24,NA,NA
"36224",10901,"Marystown","NL",47.09899,-55.19852,2018-02-19 00:00:00,24,NA,NA
"36225",10901,"Marystown","NL",47.09899,-55.19852,2018-02-19 01:00:00,24,NA,NA
"36226",10901,"Marystown","NL",47.09899,-55.19852,2018-02-19 02:00:00,24,NA,NA
"36227",10901,"Marystown","NL",47.09899,-55.19852,2018-02-19 03:00:00,24,NA,NA
"36228",10901,"Marystown","NL",47.09899,-55.19852,2018-02-19 04:00:00,24,NA,NA
"36229",10901,"Marystown","NL",47.09899,-55.19852,2018-02-19 05:00:00,24,NA,NA
"36230",10901,"Marystown","NL",47.09899,-55.19852,2018-02-19 06:00:00,24,NA,NA
"36231",10901,"Marystown","NL",47.09899,-55.19852,2018-02-19 07:00:00,24,NA,NA
"36232",10901,"Marystown","NL",47.09899,-55.19852,2018-02-19 08:00:00,22,NA,NA
"36233",10901,"Marystown","NL",47.09899,-55.19852,2018-02-19 09:00:00,22,NA,NA
"36234",10901,"Marystown","NL",47.09899,-55.19852,2018-02-19 10:00:00,24,NA,NA
"36235",10901,"Marystown","NL",47.09899,-55.19852,2018-02-19 11:00:00,25,NA,NA
"36236",10901,"Marystown","NL",47.09899,-55.19852,2018-02-19 12:00:00,25,NA,NA
"36237",10901,"Marystown","NL",47.09899,-55.19852,2018-02-19 13:00:00,26,NA,NA
"36238",10901,"Marystown","NL",47.09899,-55.19852,2018-02-19 14:00:00,27,NA,NA
"36239",10901,"Marystown","NL",47.09899,-55.19852,2018-02-19 15:00:00,28,NA,NA
"36240",10901,"Marystown","NL",47.09899,-55.19852,2018-02-19 16:00:00,29,NA,NA
"36241",10901,"Marystown","NL",47.09899,-55.19852,2018-02-19 17:00:00,29,NA,NA
"36242",10901,"Marystown","NL",47.09899,-55.19852,2018-02-19 18:00:00,27,NA,NA
"36243",10901,"Marystown","NL",47.09899,-55.19852,2018-02-19 19:00:00,25,NA,NA
"36244",10901,"Marystown","NL",47.09899,-55.19852,2018-02-19 20:00:00,24,NA,NA
"36245",10901,"Marystown","NL",47.09899,-55.19852,2018-02-19 21:00:00,25,NA,NA
"36246",10901,"Marystown","NL",47.09899,-55.19852,2018-02-19 22:00:00,24,NA,NA
"36247",10901,"Marystown","NL",47.09899,-55.19852,2018-02-19 23:00:00,26,NA,NA
"36248",10901,"Marystown","NL",47.09899,-55.19852,2018-02-20 00:00:00,28,NA,NA
"36249",10901,"Marystown","NL",47.09899,-55.19852,2018-02-20 01:00:00,28,NA,NA
"36250",10901,"Marystown","NL",47.09899,-55.19852,2018-02-20 02:00:00,29,NA,NA
"36251",10901,"Marystown","NL",47.09899,-55.19852,2018-02-20 03:00:00,28,NA,NA
"36252",10901,"Marystown","NL",47.09899,-55.19852,2018-02-20 04:00:00,27,NA,NA
"36253",10901,"Marystown","NL",47.09899,-55.19852,2018-02-20 05:00:00,27,NA,NA
"36254",10901,"Marystown","NL",47.09899,-55.19852,2018-02-20 06:00:00,29,NA,NA
"36255",10901,"Marystown","NL",47.09899,-55.19852,2018-02-20 07:00:00,26,NA,NA
"36256",10901,"Marystown","NL",47.09899,-55.19852,2018-02-20 08:00:00,26,NA,NA
"36257",10901,"Marystown","NL",47.09899,-55.19852,2018-02-20 09:00:00,28,NA,NA
"36258",10901,"Marystown","NL",47.09899,-55.19852,2018-02-20 10:00:00,26,NA,NA
"36259",10901,"Marystown","NL",47.09899,-55.19852,2018-02-20 11:00:00,26,NA,NA
"36260",10901,"Marystown","NL",47.09899,-55.19852,2018-02-20 12:00:00,22,NA,NA
"36261",10901,"Marystown","NL",47.09899,-55.19852,2018-02-20 13:00:00,23,NA,NA
"36262",10901,"Marystown","NL",47.09899,-55.19852,2018-02-20 14:00:00,24,NA,NA
"36263",10901,"Marystown","NL",47.09899,-55.19852,2018-02-20 15:00:00,24,NA,NA
"36264",10901,"Marystown","NL",47.09899,-55.19852,2018-02-20 16:00:00,24,NA,NA
"36265",10901,"Marystown","NL",47.09899,-55.19852,2018-02-20 17:00:00,23,NA,NA
"36266",10901,"Marystown","NL",47.09899,-55.19852,2018-02-20 18:00:00,20,NA,NA
"36267",10901,"Marystown","NL",47.09899,-55.19852,2018-02-20 19:00:00,22,NA,NA
"36268",10901,"Marystown","NL",47.09899,-55.19852,2018-02-20 20:00:00,22,NA,NA
"36269",10901,"Marystown","NL",47.09899,-55.19852,2018-02-20 21:00:00,23,NA,NA
"36270",10901,"Marystown","NL",47.09899,-55.19852,2018-02-20 22:00:00,22,NA,NA
"36271",10901,"Marystown","NL",47.09899,-55.19852,2018-02-20 23:00:00,22,NA,NA
"36272",10901,"Marystown","NL",47.09899,-55.19852,2018-02-21 00:00:00,21,NA,NA
"36273",10901,"Marystown","NL",47.09899,-55.19852,2018-02-21 01:00:00,24,NA,NA
"36274",10901,"Marystown","NL",47.09899,-55.19852,2018-02-21 02:00:00,26,NA,NA
"36275",10901,"Marystown","NL",47.09899,-55.19852,2018-02-21 03:00:00,24,NA,NA
"36276",10901,"Marystown","NL",47.09899,-55.19852,2018-02-21 04:00:00,25,NA,NA
"36277",10901,"Marystown","NL",47.09899,-55.19852,2018-02-21 05:00:00,26,NA,NA
"36278",10901,"Marystown","NL",47.09899,-55.19852,2018-02-21 06:00:00,28,NA,NA
"36279",10901,"Marystown","NL",47.09899,-55.19852,2018-02-21 07:00:00,29,NA,NA
"36280",10901,"Marystown","NL",47.09899,-55.19852,2018-02-21 08:00:00,30,NA,NA
"36281",10901,"Marystown","NL",47.09899,-55.19852,2018-02-21 09:00:00,30,NA,NA
"36282",10901,"Marystown","NL",47.09899,-55.19852,2018-02-21 10:00:00,31,NA,NA
"36283",10901,"Marystown","NL",47.09899,-55.19852,2018-02-21 11:00:00,30,NA,NA
"36284",10901,"Marystown","NL",47.09899,-55.19852,2018-02-21 12:00:00,29,NA,NA
"36285",10901,"Marystown","NL",47.09899,-55.19852,2018-02-21 13:00:00,30,NA,NA
"36286",10901,"Marystown","NL",47.09899,-55.19852,2018-02-21 14:00:00,30,NA,NA
"36287",10901,"Marystown","NL",47.09899,-55.19852,2018-02-21 15:00:00,30,NA,NA
"36288",10901,"Marystown","NL",47.09899,-55.19852,2018-02-21 16:00:00,30,NA,NA
"36289",10901,"Marystown","NL",47.09899,-55.19852,2018-02-21 17:00:00,29,NA,NA
"36290",10901,"Marystown","NL",47.09899,-55.19852,2018-02-21 18:00:00,29,NA,NA
"36291",10901,"Marystown","NL",47.09899,-55.19852,2018-02-21 19:00:00,28,NA,NA
"36292",10901,"Marystown","NL",47.09899,-55.19852,2018-02-21 20:00:00,27,NA,NA
"36293",10901,"Marystown","NL",47.09899,-55.19852,2018-02-21 21:00:00,25,NA,NA
"36294",10901,"Marystown","NL",47.09899,-55.19852,2018-02-21 22:00:00,24,NA,NA
"36295",10901,"Marystown","NL",47.09899,-55.19852,2018-02-21 23:00:00,22,NA,NA
"36296",10901,"Marystown","NL",47.09899,-55.19852,2018-02-22 00:00:00,21,NA,NA
"36297",10901,"Marystown","NL",47.09899,-55.19852,2018-02-22 01:00:00,21,NA,NA
"36298",10901,"Marystown","NL",47.09899,-55.19852,2018-02-22 02:00:00,23,NA,NA
"36299",10901,"Marystown","NL",47.09899,-55.19852,2018-02-22 03:00:00,25,NA,NA
"36300",10901,"Marystown","NL",47.09899,-55.19852,2018-02-22 04:00:00,24,NA,NA
"36301",10901,"Marystown","NL",47.09899,-55.19852,2018-02-22 05:00:00,26,NA,NA
"36302",10901,"Marystown","NL",47.09899,-55.19852,2018-02-22 06:00:00,28,NA,NA
"36303",10901,"Marystown","NL",47.09899,-55.19852,2018-02-22 07:00:00,28,NA,NA
"36304",10901,"Marystown","NL",47.09899,-55.19852,2018-02-22 08:00:00,27,NA,NA
"36305",10901,"Marystown","NL",47.09899,-55.19852,2018-02-22 09:00:00,27,NA,NA
"36306",10901,"Marystown","NL",47.09899,-55.19852,2018-02-22 10:00:00,27,NA,NA
"36307",10901,"Marystown","NL",47.09899,-55.19852,2018-02-22 11:00:00,27,NA,NA
"36308",10901,"Marystown","NL",47.09899,-55.19852,2018-02-22 12:00:00,26,NA,NA
"36309",10901,"Marystown","NL",47.09899,-55.19852,2018-02-22 13:00:00,26,NA,NA
"36310",10901,"Marystown","NL",47.09899,-55.19852,2018-02-22 14:00:00,27,NA,NA
"36311",10901,"Marystown","NL",47.09899,-55.19852,2018-02-22 15:00:00,28,NA,NA
"36312",10901,"Marystown","NL",47.09899,-55.19852,2018-02-22 16:00:00,29,NA,NA
"36313",10901,"Marystown","NL",47.09899,-55.19852,2018-02-22 17:00:00,28,NA,NA
"36314",10901,"Marystown","NL",47.09899,-55.19852,2018-02-22 18:00:00,28,NA,NA
"36315",10901,"Marystown","NL",47.09899,-55.19852,2018-02-22 19:00:00,28,NA,NA
"36316",10901,"Marystown","NL",47.09899,-55.19852,2018-02-22 20:00:00,28,NA,NA
"36317",10901,"Marystown","NL",47.09899,-55.19852,2018-02-22 21:00:00,29,NA,NA
"36318",10901,"Marystown","NL",47.09899,-55.19852,2018-02-22 22:00:00,31,NA,NA
"36319",10901,"Marystown","NL",47.09899,-55.19852,2018-02-22 23:00:00,31,NA,NA
"36320",10901,"Marystown","NL",47.09899,-55.19852,2018-02-23 00:00:00,31,NA,NA
"36321",10901,"Marystown","NL",47.09899,-55.19852,2018-02-23 01:00:00,32,NA,NA
"36322",10901,"Marystown","NL",47.09899,-55.19852,2018-02-23 02:00:00,31,NA,NA
"36323",10901,"Marystown","NL",47.09899,-55.19852,2018-02-23 03:00:00,30,NA,NA
"36324",10901,"Marystown","NL",47.09899,-55.19852,2018-02-23 04:00:00,30,NA,NA
"36325",10901,"Marystown","NL",47.09899,-55.19852,2018-02-23 05:00:00,29,NA,NA
"36326",10901,"Marystown","NL",47.09899,-55.19852,2018-02-23 06:00:00,31,NA,NA
"36327",10901,"Marystown","NL",47.09899,-55.19852,2018-02-23 07:00:00,31,NA,NA
"36328",10901,"Marystown","NL",47.09899,-55.19852,2018-02-23 08:00:00,31,NA,NA
"36329",10901,"Marystown","NL",47.09899,-55.19852,2018-02-23 09:00:00,31,NA,NA
"36330",10901,"Marystown","NL",47.09899,-55.19852,2018-02-23 10:00:00,32,NA,NA
"36331",10901,"Marystown","NL",47.09899,-55.19852,2018-02-23 11:00:00,31,NA,NA
"36332",10901,"Marystown","NL",47.09899,-55.19852,2018-02-23 12:00:00,31,NA,NA
"36333",10901,"Marystown","NL",47.09899,-55.19852,2018-02-23 13:00:00,32,NA,NA
"36334",10901,"Marystown","NL",47.09899,-55.19852,2018-02-23 14:00:00,33,NA,NA
"36335",10901,"Marystown","NL",47.09899,-55.19852,2018-02-23 15:00:00,32,NA,NA
"36336",10901,"Marystown","NL",47.09899,-55.19852,2018-02-23 16:00:00,32,NA,NA
"36337",10901,"Marystown","NL",47.09899,-55.19852,2018-02-23 17:00:00,32,NA,NA
"36338",10901,"Marystown","NL",47.09899,-55.19852,2018-02-23 18:00:00,31,NA,NA
"36339",10901,"Marystown","NL",47.09899,-55.19852,2018-02-23 19:00:00,31,NA,NA
"36340",10901,"Marystown","NL",47.09899,-55.19852,2018-02-23 20:00:00,31,NA,NA
"36341",10901,"Marystown","NL",47.09899,-55.19852,2018-02-23 21:00:00,30,NA,NA
"36342",10901,"Marystown","NL",47.09899,-55.19852,2018-02-23 22:00:00,29,NA,NA
"36343",10901,"Marystown","NL",47.09899,-55.19852,2018-02-23 23:00:00,28,NA,NA
"36344",10901,"Marystown","NL",47.09899,-55.19852,2018-02-24 00:00:00,27,NA,NA
"36345",10901,"Marystown","NL",47.09899,-55.19852,2018-02-24 01:00:00,32,NA,NA
"36346",10901,"Marystown","NL",47.09899,-55.19852,2018-02-24 02:00:00,34,NA,NA
"36347",10901,"Marystown","NL",47.09899,-55.19852,2018-02-24 03:00:00,33,NA,NA
"36348",10901,"Marystown","NL",47.09899,-55.19852,2018-02-24 04:00:00,31,NA,NA
"36349",10901,"Marystown","NL",47.09899,-55.19852,2018-02-24 05:00:00,30,NA,NA
"36350",10901,"Marystown","NL",47.09899,-55.19852,2018-02-24 06:00:00,30,NA,NA
"36351",10901,"Marystown","NL",47.09899,-55.19852,2018-02-24 07:00:00,32,NA,NA
"36352",10901,"Marystown","NL",47.09899,-55.19852,2018-02-24 08:00:00,30,NA,NA
"36353",10901,"Marystown","NL",47.09899,-55.19852,2018-02-24 09:00:00,31,NA,NA
"36354",10901,"Marystown","NL",47.09899,-55.19852,2018-02-24 10:00:00,31,NA,NA
"36355",10901,"Marystown","NL",47.09899,-55.19852,2018-02-24 11:00:00,30,NA,NA
"36356",10901,"Marystown","NL",47.09899,-55.19852,2018-02-24 12:00:00,31,NA,NA
"36357",10901,"Marystown","NL",47.09899,-55.19852,2018-02-24 13:00:00,29,NA,NA
"36358",10901,"Marystown","NL",47.09899,-55.19852,2018-02-24 14:00:00,28,NA,NA
"36359",10901,"Marystown","NL",47.09899,-55.19852,2018-02-24 15:00:00,26,NA,NA
"36360",10901,"Marystown","NL",47.09899,-55.19852,2018-02-24 16:00:00,27,NA,NA
"36361",10901,"Marystown","NL",47.09899,-55.19852,2018-02-24 17:00:00,27,NA,NA
"36362",10901,"Marystown","NL",47.09899,-55.19852,2018-02-24 18:00:00,27,NA,NA
"36363",10901,"Marystown","NL",47.09899,-55.19852,2018-02-24 19:00:00,26,NA,NA
"36364",10901,"Marystown","NL",47.09899,-55.19852,2018-02-24 20:00:00,27,NA,NA
"36365",10901,"Marystown","NL",47.09899,-55.19852,2018-02-24 21:00:00,26,NA,NA
"36366",10901,"Marystown","NL",47.09899,-55.19852,2018-02-24 22:00:00,27,NA,NA
"36367",10901,"Marystown","NL",47.09899,-55.19852,2018-02-24 23:00:00,27,NA,NA
"36368",10901,"Marystown","NL",47.09899,-55.19852,2018-02-25 00:00:00,28,NA,NA
"36369",10901,"Marystown","NL",47.09899,-55.19852,2018-02-25 01:00:00,28,NA,NA
"36370",10901,"Marystown","NL",47.09899,-55.19852,2018-02-25 02:00:00,28,NA,NA
"36371",10901,"Marystown","NL",47.09899,-55.19852,2018-02-25 03:00:00,28,NA,NA
"36372",10901,"Marystown","NL",47.09899,-55.19852,2018-02-25 04:00:00,30,NA,NA
"36373",10901,"Marystown","NL",47.09899,-55.19852,2018-02-25 05:00:00,31,NA,NA
"36374",10901,"Marystown","NL",47.09899,-55.19852,2018-02-25 06:00:00,29,NA,NA
"36375",10901,"Marystown","NL",47.09899,-55.19852,2018-02-25 07:00:00,29,NA,NA
"36376",10901,"Marystown","NL",47.09899,-55.19852,2018-02-25 08:00:00,30,NA,NA
"36377",10901,"Marystown","NL",47.09899,-55.19852,2018-02-25 09:00:00,29,NA,NA
"36378",10901,"Marystown","NL",47.09899,-55.19852,2018-02-25 10:00:00,29,NA,NA
"36379",10901,"Marystown","NL",47.09899,-55.19852,2018-02-25 11:00:00,29,NA,NA
"36380",10901,"Marystown","NL",47.09899,-55.19852,2018-02-25 12:00:00,29,NA,NA
"36381",10901,"Marystown","NL",47.09899,-55.19852,2018-02-25 13:00:00,29,NA,NA
"36382",10901,"Marystown","NL",47.09899,-55.19852,2018-02-25 14:00:00,29,NA,NA
"36383",10901,"Marystown","NL",47.09899,-55.19852,2018-02-25 15:00:00,28,NA,NA
"36384",10901,"Marystown","NL",47.09899,-55.19852,2018-02-25 16:00:00,29,NA,NA
"36385",10901,"Marystown","NL",47.09899,-55.19852,2018-02-25 17:00:00,29,NA,NA
"36386",10901,"Marystown","NL",47.09899,-55.19852,2018-02-25 18:00:00,28,NA,NA
"36387",10901,"Marystown","NL",47.09899,-55.19852,2018-02-25 19:00:00,27,NA,NA
"36388",10901,"Marystown","NL",47.09899,-55.19852,2018-02-25 20:00:00,24,NA,NA
"36389",10901,"Marystown","NL",47.09899,-55.19852,2018-02-25 21:00:00,20,NA,NA
"36390",10901,"Marystown","NL",47.09899,-55.19852,2018-02-25 22:00:00,21,NA,NA
"36391",10901,"Marystown","NL",47.09899,-55.19852,2018-02-25 23:00:00,25,NA,NA
"36392",10901,"Marystown","NL",47.09899,-55.19852,2018-02-26 00:00:00,22,NA,NA
"36393",10901,"Marystown","NL",47.09899,-55.19852,2018-02-26 01:00:00,18,NA,NA
"36394",10901,"Marystown","NL",47.09899,-55.19852,2018-02-26 02:00:00,16,NA,NA
"36395",10901,"Marystown","NL",47.09899,-55.19852,2018-02-26 03:00:00,18,NA,NA
"36396",10901,"Marystown","NL",47.09899,-55.19852,2018-02-26 04:00:00,21,NA,NA
"36397",10901,"Marystown","NL",47.09899,-55.19852,2018-02-26 05:00:00,18,NA,NA
"36398",10901,"Marystown","NL",47.09899,-55.19852,2018-02-26 06:00:00,16,NA,NA
"36399",10901,"Marystown","NL",47.09899,-55.19852,2018-02-26 07:00:00,13,NA,NA
"36400",10901,"Marystown","NL",47.09899,-55.19852,2018-02-26 08:00:00,11,NA,NA
"36401",10901,"Marystown","NL",47.09899,-55.19852,2018-02-26 09:00:00,13,NA,NA
"36402",10901,"Marystown","NL",47.09899,-55.19852,2018-02-26 10:00:00,21,NA,NA
"36403",10901,"Marystown","NL",47.09899,-55.19852,2018-02-26 11:00:00,30,NA,NA
"36404",10901,"Marystown","NL",47.09899,-55.19852,2018-02-26 12:00:00,30,NA,NA
"36405",10901,"Marystown","NL",47.09899,-55.19852,2018-02-26 13:00:00,30,NA,NA
"36406",10901,"Marystown","NL",47.09899,-55.19852,2018-02-26 14:00:00,30,NA,NA
"36407",10901,"Marystown","NL",47.09899,-55.19852,2018-02-26 15:00:00,32,NA,NA
"36408",10901,"Marystown","NL",47.09899,-55.19852,2018-02-26 16:00:00,24,NA,NA
"36409",10901,"Marystown","NL",47.09899,-55.19852,2018-02-26 17:00:00,23,NA,NA
"36410",10901,"Marystown","NL",47.09899,-55.19852,2018-02-26 18:00:00,30,NA,NA
"36411",10901,"Marystown","NL",47.09899,-55.19852,2018-02-26 19:00:00,32,NA,NA
"36412",10901,"Marystown","NL",47.09899,-55.19852,2018-02-26 20:00:00,31,NA,NA
"36413",10901,"Marystown","NL",47.09899,-55.19852,2018-02-26 21:00:00,32,NA,NA
"36414",10901,"Marystown","NL",47.09899,-55.19852,2018-02-26 22:00:00,33,NA,NA
"36415",10901,"Marystown","NL",47.09899,-55.19852,2018-02-26 23:00:00,33,NA,NA
"36416",10901,"Marystown","NL",47.09899,-55.19852,2018-02-27 00:00:00,33,NA,NA
"36417",10901,"Marystown","NL",47.09899,-55.19852,2018-02-27 01:00:00,34,NA,NA
"36418",10901,"Marystown","NL",47.09899,-55.19852,2018-02-27 02:00:00,33,NA,NA
"36419",10901,"Marystown","NL",47.09899,-55.19852,2018-02-27 03:00:00,31,NA,NA
"36420",10901,"Marystown","NL",47.09899,-55.19852,2018-02-27 04:00:00,31,NA,NA
"36421",10901,"Marystown","NL",47.09899,-55.19852,2018-02-27 05:00:00,31,NA,NA
"36422",10901,"Marystown","NL",47.09899,-55.19852,2018-02-27 06:00:00,32,NA,NA
"36423",10901,"Marystown","NL",47.09899,-55.19852,2018-02-27 07:00:00,32,NA,NA
"36424",10901,"Marystown","NL",47.09899,-55.19852,2018-02-27 08:00:00,31,NA,NA
"36425",10901,"Marystown","NL",47.09899,-55.19852,2018-02-27 09:00:00,31,NA,NA
"36426",10901,"Marystown","NL",47.09899,-55.19852,2018-02-27 10:00:00,31,NA,NA
"36427",10901,"Marystown","NL",47.09899,-55.19852,2018-02-27 11:00:00,32,NA,NA
"36428",10901,"Marystown","NL",47.09899,-55.19852,2018-02-27 12:00:00,30,NA,NA
"36429",10901,"Marystown","NL",47.09899,-55.19852,2018-02-27 13:00:00,27,NA,NA
"36430",10901,"Marystown","NL",47.09899,-55.19852,2018-02-27 14:00:00,24,NA,NA
"36431",10901,"Marystown","NL",47.09899,-55.19852,2018-02-27 15:00:00,24,NA,NA
"36432",10901,"Marystown","NL",47.09899,-55.19852,2018-02-27 16:00:00,25,NA,NA
"36433",10901,"Marystown","NL",47.09899,-55.19852,2018-02-27 17:00:00,25,NA,NA
"36434",10901,"Marystown","NL",47.09899,-55.19852,2018-02-27 18:00:00,26,NA,NA
"36435",10901,"Marystown","NL",47.09899,-55.19852,2018-02-27 19:00:00,25,NA,NA
"36436",10901,"Marystown","NL",47.09899,-55.19852,2018-02-27 20:00:00,25,NA,NA
"36437",10901,"Marystown","NL",47.09899,-55.19852,2018-02-27 21:00:00,25,NA,NA
"36438",10901,"Marystown","NL",47.09899,-55.19852,2018-02-27 22:00:00,26,NA,NA
"36439",10901,"Marystown","NL",47.09899,-55.19852,2018-02-27 23:00:00,26,NA,NA
"36440",10901,"Marystown","NL",47.09899,-55.19852,2018-02-28 00:00:00,27,NA,NA
"36441",10901,"Marystown","NL",47.09899,-55.19852,2018-02-28 01:00:00,27,NA,NA
"36442",10901,"Marystown","NL",47.09899,-55.19852,2018-02-28 02:00:00,28,NA,NA
"36443",10901,"Marystown","NL",47.09899,-55.19852,2018-02-28 03:00:00,28,NA,NA
"36444",10901,"Marystown","NL",47.09899,-55.19852,2018-02-28 04:00:00,28,NA,NA
"36445",10901,"Marystown","NL",47.09899,-55.19852,2018-02-28 05:00:00,28,NA,NA
"36446",10901,"Marystown","NL",47.09899,-55.19852,2018-02-28 06:00:00,28,NA,NA
"36447",10901,"Marystown","NL",47.09899,-55.19852,2018-02-28 07:00:00,28,NA,NA
"36448",10901,"Marystown","NL",47.09899,-55.19852,2018-02-28 08:00:00,26,NA,NA
"36449",10901,"Marystown","NL",47.09899,-55.19852,2018-02-28 09:00:00,26,NA,NA
"36450",10901,"Marystown","NL",47.09899,-55.19852,2018-02-28 10:00:00,26,NA,NA
"36451",10901,"Marystown","NL",47.09899,-55.19852,2018-02-28 11:00:00,27,NA,NA
"36452",10901,"Marystown","NL",47.09899,-55.19852,2018-02-28 12:00:00,27,NA,NA
"36453",10901,"Marystown","NL",47.09899,-55.19852,2018-02-28 13:00:00,27,NA,NA
"36454",10901,"Marystown","NL",47.09899,-55.19852,2018-02-28 14:00:00,26,NA,NA
"36455",10901,"Marystown","NL",47.09899,-55.19852,2018-02-28 15:00:00,26,NA,NA
"36456",10901,"Marystown","NL",47.09899,-55.19852,2018-02-28 16:00:00,27,NA,NA
"36457",10901,"Marystown","NL",47.09899,-55.19852,2018-02-28 17:00:00,25,NA,NA
"36458",10901,"Marystown","NL",47.09899,-55.19852,2018-02-28 18:00:00,23,NA,NA
"36459",10901,"Marystown","NL",47.09899,-55.19852,2018-02-28 19:00:00,22,NA,NA
"36460",10901,"Marystown","NL",47.09899,-55.19852,2018-02-28 20:00:00,21,NA,NA
"36461",10901,"Marystown","NL",47.09899,-55.19852,2018-02-28 21:00:00,22,NA,NA
"36462",10901,"Marystown","NL",47.09899,-55.19852,2018-02-28 22:00:00,22,NA,NA
"36463",10901,"Marystown","NL",47.09899,-55.19852,2018-02-28 23:00:00,22,NA,NA
"36464",10901,"Marystown","NL",47.09899,-55.19852,2018-03-01 00:00:00,21,NA,NA
"36465",10901,"Marystown","NL",47.09899,-55.19852,2018-03-01 01:00:00,22,NA,NA
"36466",10901,"Marystown","NL",47.09899,-55.19852,2018-03-01 02:00:00,23,NA,NA
"36467",10901,"Marystown","NL",47.09899,-55.19852,2018-03-01 03:00:00,23,NA,NA
"36468",10901,"Marystown","NL",47.09899,-55.19852,2018-03-01 04:00:00,23,NA,NA
"36469",10901,"Marystown","NL",47.09899,-55.19852,2018-03-01 05:00:00,24,NA,NA
"36470",10901,"Marystown","NL",47.09899,-55.19852,2018-03-01 06:00:00,25,NA,NA
"36471",10901,"Marystown","NL",47.09899,-55.19852,2018-03-01 07:00:00,24,NA,NA
"36472",10901,"Marystown","NL",47.09899,-55.19852,2018-03-01 08:00:00,25,NA,NA
"36473",10901,"Marystown","NL",47.09899,-55.19852,2018-03-01 09:00:00,26,NA,NA
"36474",10901,"Marystown","NL",47.09899,-55.19852,2018-03-01 10:00:00,25,NA,NA
"36475",10901,"Marystown","NL",47.09899,-55.19852,2018-03-01 11:00:00,31,NA,NA
"36476",10901,"Marystown","NL",47.09899,-55.19852,2018-03-01 12:00:00,39,NA,NA
"36477",10901,"Marystown","NL",47.09899,-55.19852,2018-03-01 13:00:00,39,NA,NA
"36478",10901,"Marystown","NL",47.09899,-55.19852,2018-03-01 14:00:00,39,NA,NA
"36479",10901,"Marystown","NL",47.09899,-55.19852,2018-03-01 15:00:00,29,NA,NA
"36480",10901,"Marystown","NL",47.09899,-55.19852,2018-03-01 16:00:00,34,0,34
"36481",10901,"Marystown","NL",47.09899,-55.19852,2018-03-01 17:00:00,39,0,39
"36482",10901,"Marystown","NL",47.09899,-55.19852,2018-03-01 18:00:00,38,0,38
"36483",10901,"Marystown","NL",47.09899,-55.19852,2018-03-01 19:00:00,37,0,37
"36484",10901,"Marystown","NL",47.09899,-55.19852,2018-03-01 20:00:00,36,0,36
"36485",10901,"Marystown","NL",47.09899,-55.19852,2018-03-01 21:00:00,36,0,36
"36486",10901,"Marystown","NL",47.09899,-55.19852,2018-03-01 22:00:00,35,0,35
"36487",10901,"Marystown","NL",47.09899,-55.19852,2018-03-01 23:00:00,34,0,34
"36488",10901,"Marystown","NL",47.09899,-55.19852,2018-03-02 00:00:00,33,0,33
"36489",10901,"Marystown","NL",47.09899,-55.19852,2018-03-02 01:00:00,31,0,31
"36490",10901,"Marystown","NL",47.09899,-55.19852,2018-03-02 02:00:00,29,0,29
"36491",10901,"Marystown","NL",47.09899,-55.19852,2018-03-02 03:00:00,33,0,33
"36492",10901,"Marystown","NL",47.09899,-55.19852,2018-03-02 04:00:00,39,0,39
"36493",10901,"Marystown","NL",47.09899,-55.19852,2018-03-02 05:00:00,39,0,39
"36494",10901,"Marystown","NL",47.09899,-55.19852,2018-03-02 06:00:00,39,0,39
"36495",10901,"Marystown","NL",47.09899,-55.19852,2018-03-02 07:00:00,39,0,39
"36496",10901,"Marystown","NL",47.09899,-55.19852,2018-03-02 08:00:00,39,0,39
"36497",10901,"Marystown","NL",47.09899,-55.19852,2018-03-02 09:00:00,38,0,38
"36498",10901,"Marystown","NL",47.09899,-55.19852,2018-03-02 10:00:00,38,0,38
"36499",10901,"Marystown","NL",47.09899,-55.19852,2018-03-02 11:00:00,39,0,39
"36500",10901,"Marystown","NL",47.09899,-55.19852,2018-03-02 12:00:00,39,1,40
"36501",10901,"Marystown","NL",47.09899,-55.19852,2018-03-02 13:00:00,39,1,40
"36502",10901,"Marystown","NL",47.09899,-55.19852,2018-03-02 14:00:00,40,0,40
"36503",10901,"Marystown","NL",47.09899,-55.19852,2018-03-02 15:00:00,40,1,41
"36504",10901,"Marystown","NL",47.09899,-55.19852,2018-03-02 16:00:00,40,1,41
"36505",10901,"Marystown","NL",47.09899,-55.19852,2018-03-02 17:00:00,40,0,40
"36506",10901,"Marystown","NL",47.09899,-55.19852,2018-03-02 18:00:00,41,0,41
"36507",10901,"Marystown","NL",47.09899,-55.19852,2018-03-02 19:00:00,40,1,41
"36508",10901,"Marystown","NL",47.09899,-55.19852,2018-03-02 20:00:00,40,1,41
"36509",10901,"Marystown","NL",47.09899,-55.19852,2018-03-02 21:00:00,40,0,40
"36510",10901,"Marystown","NL",47.09899,-55.19852,2018-03-02 22:00:00,40,0,40
"36511",10901,"Marystown","NL",47.09899,-55.19852,2018-03-02 23:00:00,41,0,41
"36512",10901,"Marystown","NL",47.09899,-55.19852,2018-03-03 00:00:00,41,0,41
"36513",10901,"Marystown","NL",47.09899,-55.19852,2018-03-03 01:00:00,40,0,40
"36514",10901,"Marystown","NL",47.09899,-55.19852,2018-03-03 02:00:00,40,0,40
"36515",10901,"Marystown","NL",47.09899,-55.19852,2018-03-03 03:00:00,40,0,40
"36516",10901,"Marystown","NL",47.09899,-55.19852,2018-03-03 04:00:00,40,0,40
"36517",10901,"Marystown","NL",47.09899,-55.19852,2018-03-03 05:00:00,40,0,40
"36518",10901,"Marystown","NL",47.09899,-55.19852,2018-03-03 06:00:00,40,0,40
"36519",10901,"Marystown","NL",47.09899,-55.19852,2018-03-03 07:00:00,41,0,41
"36520",10901,"Marystown","NL",47.09899,-55.19852,2018-03-03 08:00:00,41,0,41
"36521",10901,"Marystown","NL",47.09899,-55.19852,2018-03-03 09:00:00,41,0,41
"36522",10901,"Marystown","NL",47.09899,-55.19852,2018-03-03 10:00:00,41,0,41
"36523",10901,"Marystown","NL",47.09899,-55.19852,2018-03-03 11:00:00,40,0,40
"36524",10901,"Marystown","NL",47.09899,-55.19852,2018-03-03 12:00:00,39,0,39
"36525",10901,"Marystown","NL",47.09899,-55.19852,2018-03-03 13:00:00,39,0,39
"36526",10901,"Marystown","NL",47.09899,-55.19852,2018-03-03 14:00:00,39,0,39
"36527",10901,"Marystown","NL",47.09899,-55.19852,2018-03-03 15:00:00,39,0,39
"36528",10901,"Marystown","NL",47.09899,-55.19852,2018-03-03 16:00:00,39,0,39
"36529",10901,"Marystown","NL",47.09899,-55.19852,2018-03-03 17:00:00,39,0,39
"36530",10901,"Marystown","NL",47.09899,-55.19852,2018-03-03 18:00:00,40,0,40
"36531",10901,"Marystown","NL",47.09899,-55.19852,2018-03-03 19:00:00,41,0,41
"36532",10901,"Marystown","NL",47.09899,-55.19852,2018-03-03 20:00:00,41,0,41
"36533",10901,"Marystown","NL",47.09899,-55.19852,2018-03-03 21:00:00,41,0,41
"36534",10901,"Marystown","NL",47.09899,-55.19852,2018-03-03 22:00:00,42,0,42
"36535",10901,"Marystown","NL",47.09899,-55.19852,2018-03-03 23:00:00,42,0,42
"36536",10901,"Marystown","NL",47.09899,-55.19852,2018-03-04 00:00:00,42,0,42
"36537",10901,"Marystown","NL",47.09899,-55.19852,2018-03-04 01:00:00,42,0,42
"36538",10901,"Marystown","NL",47.09899,-55.19852,2018-03-04 02:00:00,42,0,42
"36539",10901,"Marystown","NL",47.09899,-55.19852,2018-03-04 03:00:00,42,0,42
"36540",10901,"Marystown","NL",47.09899,-55.19852,2018-03-04 04:00:00,42,0,42
"36541",10901,"Marystown","NL",47.09899,-55.19852,2018-03-04 05:00:00,43,0,43
"36542",10901,"Marystown","NL",47.09899,-55.19852,2018-03-04 06:00:00,43,0,43
"36543",10901,"Marystown","NL",47.09899,-55.19852,2018-03-04 07:00:00,42,0,42
"36544",10901,"Marystown","NL",47.09899,-55.19852,2018-03-04 08:00:00,42,0,42
"36545",10901,"Marystown","NL",47.09899,-55.19852,2018-03-04 09:00:00,42,0,42
"36546",10901,"Marystown","NL",47.09899,-55.19852,2018-03-04 10:00:00,42,0,42
"36547",10901,"Marystown","NL",47.09899,-55.19852,2018-03-04 11:00:00,42,0,42
"36548",10901,"Marystown","NL",47.09899,-55.19852,2018-03-04 12:00:00,43,0,43
"36549",10901,"Marystown","NL",47.09899,-55.19852,2018-03-04 13:00:00,43,0,43
"36550",10901,"Marystown","NL",47.09899,-55.19852,2018-03-04 14:00:00,43,0,43
"36551",10901,"Marystown","NL",47.09899,-55.19852,2018-03-04 15:00:00,42,0,42
"36552",10901,"Marystown","NL",47.09899,-55.19852,2018-03-04 16:00:00,42,0,42
"36553",10901,"Marystown","NL",47.09899,-55.19852,2018-03-04 17:00:00,42,0,42
"36554",10901,"Marystown","NL",47.09899,-55.19852,2018-03-04 18:00:00,42,1,43
"36555",10901,"Marystown","NL",47.09899,-55.19852,2018-03-04 19:00:00,42,1,43
"36556",10901,"Marystown","NL",47.09899,-55.19852,2018-03-04 20:00:00,42,0,42
"36557",10901,"Marystown","NL",47.09899,-55.19852,2018-03-04 21:00:00,42,0,42
"36558",10901,"Marystown","NL",47.09899,-55.19852,2018-03-04 22:00:00,42,0,42
"36559",10901,"Marystown","NL",47.09899,-55.19852,2018-03-04 23:00:00,42,0,42
"36560",10901,"Marystown","NL",47.09899,-55.19852,2018-03-05 00:00:00,42,0,42
"36561",10901,"Marystown","NL",47.09899,-55.19852,2018-03-05 01:00:00,42,0,42
"36562",10901,"Marystown","NL",47.09899,-55.19852,2018-03-05 02:00:00,42,0,42
"36563",10901,"Marystown","NL",47.09899,-55.19852,2018-03-05 03:00:00,42,0,42
"36564",10901,"Marystown","NL",47.09899,-55.19852,2018-03-05 04:00:00,42,0,42
"36565",10901,"Marystown","NL",47.09899,-55.19852,2018-03-05 05:00:00,42,0,42
"36566",10901,"Marystown","NL",47.09899,-55.19852,2018-03-05 06:00:00,42,0,42
"36567",10901,"Marystown","NL",47.09899,-55.19852,2018-03-05 07:00:00,42,0,42
"36568",10901,"Marystown","NL",47.09899,-55.19852,2018-03-05 08:00:00,42,0,42
"36569",10901,"Marystown","NL",47.09899,-55.19852,2018-03-05 09:00:00,42,1,43
"36570",10901,"Marystown","NL",47.09899,-55.19852,2018-03-05 10:00:00,42,0,42
"36571",10901,"Marystown","NL",47.09899,-55.19852,2018-03-05 11:00:00,42,0,42
"36572",10901,"Marystown","NL",47.09899,-55.19852,2018-03-05 12:00:00,41,0,41
"36573",10901,"Marystown","NL",47.09899,-55.19852,2018-03-05 13:00:00,41,1,42
"36574",10901,"Marystown","NL",47.09899,-55.19852,2018-03-05 14:00:00,41,0,41
"36575",10901,"Marystown","NL",47.09899,-55.19852,2018-03-05 15:00:00,42,0,42
"36576",10901,"Marystown","NL",47.09899,-55.19852,2018-03-05 16:00:00,42,0,42
"36577",10901,"Marystown","NL",47.09899,-55.19852,2018-03-05 17:00:00,41,0,41
"36578",10901,"Marystown","NL",47.09899,-55.19852,2018-03-05 18:00:00,41,0,41
"36579",10901,"Marystown","NL",47.09899,-55.19852,2018-03-05 19:00:00,41,0,41
"36580",10901,"Marystown","NL",47.09899,-55.19852,2018-03-05 20:00:00,41,0,41
"36581",10901,"Marystown","NL",47.09899,-55.19852,2018-03-05 21:00:00,41,0,41
"36582",10901,"Marystown","NL",47.09899,-55.19852,2018-03-05 22:00:00,41,0,41
"36583",10901,"Marystown","NL",47.09899,-55.19852,2018-03-05 23:00:00,41,0,41
"36584",10901,"Marystown","NL",47.09899,-55.19852,2018-03-06 00:00:00,42,0,42
"36585",10901,"Marystown","NL",47.09899,-55.19852,2018-03-06 01:00:00,42,0,42
"36586",10901,"Marystown","NL",47.09899,-55.19852,2018-03-06 02:00:00,42,0,42
"36587",10901,"Marystown","NL",47.09899,-55.19852,2018-03-06 03:00:00,42,0,42
"36588",10901,"Marystown","NL",47.09899,-55.19852,2018-03-06 04:00:00,41,0,41
"36589",10901,"Marystown","NL",47.09899,-55.19852,2018-03-06 05:00:00,41,0,41
"36590",10901,"Marystown","NL",47.09899,-55.19852,2018-03-06 06:00:00,41,0,41
"36591",10901,"Marystown","NL",47.09899,-55.19852,2018-03-06 07:00:00,39,0,39
"36592",10901,"Marystown","NL",47.09899,-55.19852,2018-03-06 08:00:00,39,0,39
"36593",10901,"Marystown","NL",47.09899,-55.19852,2018-03-06 09:00:00,40,0,40
"36594",10901,"Marystown","NL",47.09899,-55.19852,2018-03-06 10:00:00,41,0,41
"36595",10901,"Marystown","NL",47.09899,-55.19852,2018-03-06 11:00:00,41,0,41
"36596",10901,"Marystown","NL",47.09899,-55.19852,2018-03-06 12:00:00,42,0,42
"36597",10901,"Marystown","NL",47.09899,-55.19852,2018-03-06 13:00:00,43,0,43
"36598",10901,"Marystown","NL",47.09899,-55.19852,2018-03-06 14:00:00,44,0,44
"36599",10901,"Marystown","NL",47.09899,-55.19852,2018-03-06 15:00:00,43,1,44
"36600",10901,"Marystown","NL",47.09899,-55.19852,2018-03-06 16:00:00,43,0,43
"36601",10901,"Marystown","NL",47.09899,-55.19852,2018-03-06 17:00:00,43,0,43
"36602",10901,"Marystown","NL",47.09899,-55.19852,2018-03-06 18:00:00,43,0,43
"36603",10901,"Marystown","NL",47.09899,-55.19852,2018-03-06 19:00:00,44,0,44
"36604",10901,"Marystown","NL",47.09899,-55.19852,2018-03-06 20:00:00,44,0,44
"36605",10901,"Marystown","NL",47.09899,-55.19852,2018-03-06 21:00:00,43,0,43
"36606",10901,"Marystown","NL",47.09899,-55.19852,2018-03-06 22:00:00,43,0,43
"36607",10901,"Marystown","NL",47.09899,-55.19852,2018-03-06 23:00:00,43,0,43
"36608",10901,"Marystown","NL",47.09899,-55.19852,2018-03-07 00:00:00,43,0,43
"36609",10901,"Marystown","NL",47.09899,-55.19852,2018-03-07 01:00:00,43,0,43
"36610",10901,"Marystown","NL",47.09899,-55.19852,2018-03-07 02:00:00,43,0,43
"36611",10901,"Marystown","NL",47.09899,-55.19852,2018-03-07 03:00:00,43,0,43
"36612",10901,"Marystown","NL",47.09899,-55.19852,2018-03-07 04:00:00,43,0,43
"36613",10901,"Marystown","NL",47.09899,-55.19852,2018-03-07 05:00:00,43,0,43
"36614",10901,"Marystown","NL",47.09899,-55.19852,2018-03-07 06:00:00,43,0,43
"36615",10901,"Marystown","NL",47.09899,-55.19852,2018-03-07 07:00:00,43,0,43
"36616",10901,"Marystown","NL",47.09899,-55.19852,2018-03-07 08:00:00,44,0,44
"36617",10901,"Marystown","NL",47.09899,-55.19852,2018-03-07 09:00:00,43,0,43
"36618",10901,"Marystown","NL",47.09899,-55.19852,2018-03-07 10:00:00,43,0,43
"36619",10901,"Marystown","NL",47.09899,-55.19852,2018-03-07 11:00:00,43,0,43
"36620",10901,"Marystown","NL",47.09899,-55.19852,2018-03-07 12:00:00,42,0,42
"36621",10901,"Marystown","NL",47.09899,-55.19852,2018-03-07 13:00:00,43,0,43
"36622",10901,"Marystown","NL",47.09899,-55.19852,2018-03-07 14:00:00,43,0,43
"36623",10901,"Marystown","NL",47.09899,-55.19852,2018-03-07 15:00:00,42,0,42
"36624",10901,"Marystown","NL",47.09899,-55.19852,2018-03-07 16:00:00,42,0,42
"36625",10901,"Marystown","NL",47.09899,-55.19852,2018-03-07 17:00:00,43,0,43
"36626",10901,"Marystown","NL",47.09899,-55.19852,2018-03-07 18:00:00,43,0,43
"36627",10901,"Marystown","NL",47.09899,-55.19852,2018-03-07 19:00:00,44,0,44
"36628",10901,"Marystown","NL",47.09899,-55.19852,2018-03-07 20:00:00,43,0,43
"36629",10901,"Marystown","NL",47.09899,-55.19852,2018-03-07 21:00:00,43,0,43
"36630",10901,"Marystown","NL",47.09899,-55.19852,2018-03-07 22:00:00,44,0,44
"36631",10901,"Marystown","NL",47.09899,-55.19852,2018-03-07 23:00:00,44,0,44
"36632",10901,"Marystown","NL",47.09899,-55.19852,2018-03-08 00:00:00,44,0,44
"36633",10901,"Marystown","NL",47.09899,-55.19852,2018-03-08 01:00:00,44,0,44
"36634",10901,"Marystown","NL",47.09899,-55.19852,2018-03-08 02:00:00,44,0,44
"36635",10901,"Marystown","NL",47.09899,-55.19852,2018-03-08 03:00:00,43,0,43
"36636",10901,"Marystown","NL",47.09899,-55.19852,2018-03-08 04:00:00,44,0,44
"36637",10901,"Marystown","NL",47.09899,-55.19852,2018-03-08 05:00:00,43,0,43
"36638",10901,"Marystown","NL",47.09899,-55.19852,2018-03-08 06:00:00,43,0,43
"36639",10901,"Marystown","NL",47.09899,-55.19852,2018-03-08 07:00:00,44,0,44
"36640",10901,"Marystown","NL",47.09899,-55.19852,2018-03-08 08:00:00,44,0,44
"36641",10901,"Marystown","NL",47.09899,-55.19852,2018-03-08 09:00:00,44,0,44
"36642",10901,"Marystown","NL",47.09899,-55.19852,2018-03-08 10:00:00,44,0,44
"36643",10901,"Marystown","NL",47.09899,-55.19852,2018-03-08 11:00:00,44,0,44
"36644",10901,"Marystown","NL",47.09899,-55.19852,2018-03-08 12:00:00,43,0,43
"36645",10901,"Marystown","NL",47.09899,-55.19852,2018-03-08 13:00:00,43,0,43
"36646",10901,"Marystown","NL",47.09899,-55.19852,2018-03-08 14:00:00,43,0,43
"36647",10901,"Marystown","NL",47.09899,-55.19852,2018-03-08 15:00:00,43,0,43
"36648",10901,"Marystown","NL",47.09899,-55.19852,2018-03-08 16:00:00,43,0,43
"36649",10901,"Marystown","NL",47.09899,-55.19852,2018-03-08 17:00:00,43,0,43
"36650",10901,"Marystown","NL",47.09899,-55.19852,2018-03-08 18:00:00,43,0,43
"36651",10901,"Marystown","NL",47.09899,-55.19852,2018-03-08 19:00:00,44,0,44
"36652",10901,"Marystown","NL",47.09899,-55.19852,2018-03-08 20:00:00,44,0,44
"36653",10901,"Marystown","NL",47.09899,-55.19852,2018-03-08 21:00:00,43,0,43
"36654",10901,"Marystown","NL",47.09899,-55.19852,2018-03-08 22:00:00,43,1,44
"36655",10901,"Marystown","NL",47.09899,-55.19852,2018-03-08 23:00:00,43,0,43
"36656",10901,"Marystown","NL",47.09899,-55.19852,2018-03-09 00:00:00,43,0,43
"36657",10901,"Marystown","NL",47.09899,-55.19852,2018-03-09 01:00:00,43,0,43
"36658",10901,"Marystown","NL",47.09899,-55.19852,2018-03-09 02:00:00,43,0,43
"36659",10901,"Marystown","NL",47.09899,-55.19852,2018-03-09 03:00:00,43,0,43
"36660",10901,"Marystown","NL",47.09899,-55.19852,2018-03-09 04:00:00,43,0,43
"36661",10901,"Marystown","NL",47.09899,-55.19852,2018-03-09 05:00:00,42,0,42
"36662",10901,"Marystown","NL",47.09899,-55.19852,2018-03-09 06:00:00,42,0,42
"36663",10901,"Marystown","NL",47.09899,-55.19852,2018-03-09 07:00:00,41,0,41
"36664",10901,"Marystown","NL",47.09899,-55.19852,2018-03-09 08:00:00,41,0,41
"36665",10901,"Marystown","NL",47.09899,-55.19852,2018-03-09 09:00:00,41,1,42
"36666",10901,"Marystown","NL",47.09899,-55.19852,2018-03-09 10:00:00,41,0,41
"36667",10901,"Marystown","NL",47.09899,-55.19852,2018-03-09 11:00:00,41,1,42
"36668",10901,"Marystown","NL",47.09899,-55.19852,2018-03-09 12:00:00,41,0,41
"36669",10901,"Marystown","NL",47.09899,-55.19852,2018-03-09 13:00:00,42,0,42
"36670",10901,"Marystown","NL",47.09899,-55.19852,2018-03-09 14:00:00,42,0,42
"36671",10901,"Marystown","NL",47.09899,-55.19852,2018-03-09 15:00:00,43,0,43
"36672",10901,"Marystown","NL",47.09899,-55.19852,2018-03-09 16:00:00,43,0,43
"36673",10901,"Marystown","NL",47.09899,-55.19852,2018-03-09 17:00:00,43,0,43
"36674",10901,"Marystown","NL",47.09899,-55.19852,2018-03-09 18:00:00,43,0,43
"36675",10901,"Marystown","NL",47.09899,-55.19852,2018-03-09 19:00:00,42,0,42
"36676",10901,"Marystown","NL",47.09899,-55.19852,2018-03-09 20:00:00,42,0,42
"36677",10901,"Marystown","NL",47.09899,-55.19852,2018-03-09 21:00:00,42,0,42
"36678",10901,"Marystown","NL",47.09899,-55.19852,2018-03-09 22:00:00,42,0,42
"36679",10901,"Marystown","NL",47.09899,-55.19852,2018-03-09 23:00:00,42,0,42
"36680",10901,"Marystown","NL",47.09899,-55.19852,2018-03-10 00:00:00,43,0,43
"36681",10901,"Marystown","NL",47.09899,-55.19852,2018-03-10 01:00:00,43,0,43
"36682",10901,"Marystown","NL",47.09899,-55.19852,2018-03-10 02:00:00,43,0,43
"36683",10901,"Marystown","NL",47.09899,-55.19852,2018-03-10 03:00:00,44,0,44
"36684",10901,"Marystown","NL",47.09899,-55.19852,2018-03-10 04:00:00,44,0,44
"36685",10901,"Marystown","NL",47.09899,-55.19852,2018-03-10 05:00:00,44,0,44
"36686",10901,"Marystown","NL",47.09899,-55.19852,2018-03-10 06:00:00,43,0,43
"36687",10901,"Marystown","NL",47.09899,-55.19852,2018-03-10 07:00:00,42,0,42
"36688",10901,"Marystown","NL",47.09899,-55.19852,2018-03-10 08:00:00,41,1,42
"36689",10901,"Marystown","NL",47.09899,-55.19852,2018-03-10 09:00:00,40,1,41
"36690",10901,"Marystown","NL",47.09899,-55.19852,2018-03-10 10:00:00,40,1,41
"36691",10901,"Marystown","NL",47.09899,-55.19852,2018-03-10 11:00:00,39,1,40
"36692",10901,"Marystown","NL",47.09899,-55.19852,2018-03-10 12:00:00,41,0,41
"36693",10901,"Marystown","NL",47.09899,-55.19852,2018-03-10 13:00:00,40,1,41
"36694",10901,"Marystown","NL",47.09899,-55.19852,2018-03-10 14:00:00,41,1,42
"36695",10901,"Marystown","NL",47.09899,-55.19852,2018-03-10 15:00:00,42,0,42
"36696",10901,"Marystown","NL",47.09899,-55.19852,2018-03-10 16:00:00,43,1,44
"36697",10901,"Marystown","NL",47.09899,-55.19852,2018-03-10 17:00:00,44,1,45
"36698",10901,"Marystown","NL",47.09899,-55.19852,2018-03-10 18:00:00,44,1,45
"36699",10901,"Marystown","NL",47.09899,-55.19852,2018-03-10 19:00:00,44,1,45
"36700",10901,"Marystown","NL",47.09899,-55.19852,2018-03-10 20:00:00,44,1,45
"36701",10901,"Marystown","NL",47.09899,-55.19852,2018-03-10 21:00:00,45,1,46
"36702",10901,"Marystown","NL",47.09899,-55.19852,2018-03-10 22:00:00,44,1,45
"36703",10901,"Marystown","NL",47.09899,-55.19852,2018-03-10 23:00:00,43,1,44
"36704",10901,"Marystown","NL",47.09899,-55.19852,2018-03-11 00:00:00,43,1,44
"36705",10901,"Marystown","NL",47.09899,-55.19852,2018-03-11 01:00:00,43,1,44
"36706",10901,"Marystown","NL",47.09899,-55.19852,2018-03-11 01:00:00,43,0,43
"36707",10901,"Marystown","NL",47.09899,-55.19852,2018-03-11 01:00:00,43,1,44
"36708",10901,"Marystown","NL",47.09899,-55.19852,2018-03-11 01:00:00,43,0,43
"36709",10901,"Marystown","NL",47.09899,-55.19852,2018-03-11 03:00:00,42,0,42
"36710",10901,"Marystown","NL",47.09899,-55.19852,2018-03-11 04:00:00,42,0,42
"36711",10901,"Marystown","NL",47.09899,-55.19852,2018-03-11 05:00:00,40,1,41
"36712",10901,"Marystown","NL",47.09899,-55.19852,2018-03-11 06:00:00,40,1,41
"36713",10901,"Marystown","NL",47.09899,-55.19852,2018-03-11 07:00:00,40,0,40
"36714",10901,"Marystown","NL",47.09899,-55.19852,2018-03-11 08:00:00,40,1,41
"36715",10901,"Marystown","NL",47.09899,-55.19852,2018-03-11 09:00:00,39,1,40
"36716",10901,"Marystown","NL",47.09899,-55.19852,2018-03-11 10:00:00,38,1,39
"36717",10901,"Marystown","NL",47.09899,-55.19852,2018-03-11 11:00:00,39,0,39
"36718",10901,"Marystown","NL",47.09899,-55.19852,2018-03-11 12:00:00,38,0,38
"36719",10901,"Marystown","NL",47.09899,-55.19852,2018-03-11 13:00:00,38,0,38
"36720",10901,"Marystown","NL",47.09899,-55.19852,2018-03-11 14:00:00,38,1,39
"36721",10901,"Marystown","NL",47.09899,-55.19852,2018-03-11 15:00:00,38,1,39
"36722",10901,"Marystown","NL",47.09899,-55.19852,2018-03-11 16:00:00,39,1,40
"36723",10901,"Marystown","NL",47.09899,-55.19852,2018-03-11 17:00:00,40,0,40
"36724",10901,"Marystown","NL",47.09899,-55.19852,2018-03-11 18:00:00,40,0,40
"36725",10901,"Marystown","NL",47.09899,-55.19852,2018-03-11 19:00:00,41,0,41
"36726",10901,"Marystown","NL",47.09899,-55.19852,2018-03-11 20:00:00,42,0,42
"36727",10901,"Marystown","NL",47.09899,-55.19852,2018-03-11 21:00:00,43,0,43
"36728",10901,"Marystown","NL",47.09899,-55.19852,2018-03-11 22:00:00,45,0,45
"36729",10901,"Marystown","NL",47.09899,-55.19852,2018-03-11 23:00:00,46,0,46
"36730",10901,"Marystown","NL",47.09899,-55.19852,2018-03-12 00:00:00,46,0,46
"36731",10901,"Marystown","NL",47.09899,-55.19852,2018-03-12 01:00:00,45,0,45
"36732",10901,"Marystown","NL",47.09899,-55.19852,2018-03-12 02:00:00,43,0,43
"36733",10901,"Marystown","NL",47.09899,-55.19852,2018-03-12 03:00:00,44,0,44
"36734",10901,"Marystown","NL",47.09899,-55.19852,2018-03-12 04:00:00,43,0,43
"36735",10901,"Marystown","NL",47.09899,-55.19852,2018-03-12 05:00:00,42,0,42
"36736",10901,"Marystown","NL",47.09899,-55.19852,2018-03-12 06:00:00,41,0,41
"36737",10901,"Marystown","NL",47.09899,-55.19852,2018-03-12 07:00:00,41,1,42
"36738",10901,"Marystown","NL",47.09899,-55.19852,2018-03-12 08:00:00,41,0,41
"36739",10901,"Marystown","NL",47.09899,-55.19852,2018-03-12 09:00:00,41,0,41
"36740",10901,"Marystown","NL",47.09899,-55.19852,2018-03-12 10:00:00,42,0,42
"36741",10901,"Marystown","NL",47.09899,-55.19852,2018-03-12 11:00:00,42,0,42
"36742",10901,"Marystown","NL",47.09899,-55.19852,2018-03-12 12:00:00,41,0,41
"36743",10901,"Marystown","NL",47.09899,-55.19852,2018-03-12 13:00:00,41,0,41
"36744",10901,"Marystown","NL",47.09899,-55.19852,2018-03-12 14:00:00,42,0,42
"36745",10901,"Marystown","NL",47.09899,-55.19852,2018-03-12 15:00:00,42,0,42
"36746",10901,"Marystown","NL",47.09899,-55.19852,2018-03-12 16:00:00,42,0,42
"36747",10901,"Marystown","NL",47.09899,-55.19852,2018-03-12 17:00:00,43,0,43
"36748",10901,"Marystown","NL",47.09899,-55.19852,2018-03-12 18:00:00,43,0,43
"36749",10901,"Marystown","NL",47.09899,-55.19852,2018-03-12 19:00:00,42,0,42
"36750",10901,"Marystown","NL",47.09899,-55.19852,2018-03-12 20:00:00,43,0,43
"36751",10901,"Marystown","NL",47.09899,-55.19852,2018-03-12 21:00:00,42,0,42
"36752",10901,"Marystown","NL",47.09899,-55.19852,2018-03-12 22:00:00,41,0,41
"36753",10901,"Marystown","NL",47.09899,-55.19852,2018-03-12 23:00:00,41,0,41
"36754",10901,"Marystown","NL",47.09899,-55.19852,2018-03-13 00:00:00,42,0,42
"36755",10901,"Marystown","NL",47.09899,-55.19852,2018-03-13 01:00:00,42,0,42
"36756",10901,"Marystown","NL",47.09899,-55.19852,2018-03-13 02:00:00,40,0,40
"36757",10901,"Marystown","NL",47.09899,-55.19852,2018-03-13 03:00:00,40,0,40
"36758",10901,"Marystown","NL",47.09899,-55.19852,2018-03-13 04:00:00,39,0,39
"36759",10901,"Marystown","NL",47.09899,-55.19852,2018-03-13 05:00:00,39,0,39
"36760",10901,"Marystown","NL",47.09899,-55.19852,2018-03-13 06:00:00,39,0,39
"36761",10901,"Marystown","NL",47.09899,-55.19852,2018-03-13 07:00:00,40,0,40
"36762",10901,"Marystown","NL",47.09899,-55.19852,2018-03-13 08:00:00,38,1,39
"36763",10901,"Marystown","NL",47.09899,-55.19852,2018-03-13 09:00:00,36,0,36
"36764",10901,"Marystown","NL",47.09899,-55.19852,2018-03-13 10:00:00,35,0,35
"36765",10901,"Marystown","NL",47.09899,-55.19852,2018-03-13 11:00:00,36,1,37
"36766",10901,"Marystown","NL",47.09899,-55.19852,2018-03-13 12:00:00,37,1,38
"36767",10901,"Marystown","NL",47.09899,-55.19852,2018-03-13 13:00:00,37,0,37
"36768",10901,"Marystown","NL",47.09899,-55.19852,2018-03-13 14:00:00,38,1,39
"36769",10901,"Marystown","NL",47.09899,-55.19852,2018-03-13 15:00:00,38,0,38
"36770",10901,"Marystown","NL",47.09899,-55.19852,2018-03-13 16:00:00,39,0,39
"36771",10901,"Marystown","NL",47.09899,-55.19852,2018-03-13 17:00:00,40,0,40
"36772",10901,"Marystown","NL",47.09899,-55.19852,2018-03-13 18:00:00,39,1,40
"36773",10901,"Marystown","NL",47.09899,-55.19852,2018-03-13 19:00:00,39,1,40
"36774",10901,"Marystown","NL",47.09899,-55.19852,2018-03-13 20:00:00,39,0,39
"36775",10901,"Marystown","NL",47.09899,-55.19852,2018-03-13 21:00:00,37,1,38
"36776",10901,"Marystown","NL",47.09899,-55.19852,2018-03-13 22:00:00,37,1,38
"36777",10901,"Marystown","NL",47.09899,-55.19852,2018-03-13 23:00:00,38,0,38
"36778",10901,"Marystown","NL",47.09899,-55.19852,2018-03-14 00:00:00,39,0,39
"36779",10901,"Marystown","NL",47.09899,-55.19852,2018-03-14 01:00:00,41,0,41
"36780",10901,"Marystown","NL",47.09899,-55.19852,2018-03-14 02:00:00,42,0,42
"36781",10901,"Marystown","NL",47.09899,-55.19852,2018-03-14 03:00:00,42,0,42
"36782",10901,"Marystown","NL",47.09899,-55.19852,2018-03-14 04:00:00,42,0,42
"36783",10901,"Marystown","NL",47.09899,-55.19852,2018-03-14 05:00:00,42,0,42
"36784",10901,"Marystown","NL",47.09899,-55.19852,2018-03-14 06:00:00,42,0,42
"36785",10901,"Marystown","NL",47.09899,-55.19852,2018-03-14 07:00:00,42,0,42
"36786",10901,"Marystown","NL",47.09899,-55.19852,2018-03-14 08:00:00,41,1,42
"36787",10901,"Marystown","NL",47.09899,-55.19852,2018-03-14 09:00:00,41,0,41
"36788",10901,"Marystown","NL",47.09899,-55.19852,2018-03-14 10:00:00,41,0,41
"36789",10901,"Marystown","NL",47.09899,-55.19852,2018-03-14 11:00:00,41,0,41
"36790",10901,"Marystown","NL",47.09899,-55.19852,2018-03-14 12:00:00,41,0,41
"36791",10901,"Marystown","NL",47.09899,-55.19852,2018-03-14 13:00:00,42,0,42
"36792",10901,"Marystown","NL",47.09899,-55.19852,2018-03-14 14:00:00,42,0,42
"36793",10901,"Marystown","NL",47.09899,-55.19852,2018-03-14 15:00:00,43,1,44
"36794",10901,"Marystown","NL",47.09899,-55.19852,2018-03-14 16:00:00,42,1,43
"36795",10901,"Marystown","NL",47.09899,-55.19852,2018-03-14 17:00:00,41,0,41
"36796",10901,"Marystown","NL",47.09899,-55.19852,2018-03-14 18:00:00,40,0,40
"36797",10901,"Marystown","NL",47.09899,-55.19852,2018-03-14 19:00:00,38,1,39
"36798",10901,"Marystown","NL",47.09899,-55.19852,2018-03-14 20:00:00,37,1,38
"36799",10901,"Marystown","NL",47.09899,-55.19852,2018-03-14 21:00:00,36,1,37
"36800",10901,"Marystown","NL",47.09899,-55.19852,2018-03-14 22:00:00,31,1,32
"36801",10901,"Marystown","NL",47.09899,-55.19852,2018-03-14 23:00:00,38,1,39
"36802",10901,"Marystown","NL",47.09899,-55.19852,2018-03-15 00:00:00,39,1,40
"36803",10901,"Marystown","NL",47.09899,-55.19852,2018-03-15 01:00:00,36,0,36
"36804",10901,"Marystown","NL",47.09899,-55.19852,2018-03-15 02:00:00,39,0,39
"36805",10901,"Marystown","NL",47.09899,-55.19852,2018-03-15 03:00:00,44,0,44
"36806",10901,"Marystown","NL",47.09899,-55.19852,2018-03-15 04:00:00,44,0,44
"36807",10901,"Marystown","NL",47.09899,-55.19852,2018-03-15 05:00:00,45,0,45
"36808",10901,"Marystown","NL",47.09899,-55.19852,2018-03-15 06:00:00,46,0,46
"36809",10901,"Marystown","NL",47.09899,-55.19852,2018-03-15 07:00:00,46,0,46
"36810",10901,"Marystown","NL",47.09899,-55.19852,2018-03-15 08:00:00,46,0,46
"36811",10901,"Marystown","NL",47.09899,-55.19852,2018-03-15 09:00:00,46,0,46
"36812",10901,"Marystown","NL",47.09899,-55.19852,2018-03-15 10:00:00,46,0,46
"36813",10901,"Marystown","NL",47.09899,-55.19852,2018-03-15 11:00:00,46,0,46
"36814",10901,"Marystown","NL",47.09899,-55.19852,2018-03-15 12:00:00,47,7,54
"36815",10901,"Marystown","NL",47.09899,-55.19852,2018-03-15 13:00:00,46,0,46
"36816",10901,"Marystown","NL",47.09899,-55.19852,2018-03-15 14:00:00,46,0,46
"36817",10901,"Marystown","NL",47.09899,-55.19852,2018-03-15 15:00:00,46,1,47
"36818",10901,"Marystown","NL",47.09899,-55.19852,2018-03-15 16:00:00,46,1,47
"36819",10901,"Marystown","NL",47.09899,-55.19852,2018-03-15 17:00:00,46,1,47
"36820",10901,"Marystown","NL",47.09899,-55.19852,2018-03-15 18:00:00,45,1,46
"36821",10901,"Marystown","NL",47.09899,-55.19852,2018-03-15 19:00:00,40,1,41
"36822",10901,"Marystown","NL",47.09899,-55.19852,2018-03-15 20:00:00,43,1,44
"36823",10901,"Marystown","NL",47.09899,-55.19852,2018-03-15 21:00:00,44,1,45
"36824",10901,"Marystown","NL",47.09899,-55.19852,2018-03-15 22:00:00,46,1,47
"36825",10901,"Marystown","NL",47.09899,-55.19852,2018-03-15 23:00:00,46,0,46
"36826",10901,"Marystown","NL",47.09899,-55.19852,2018-03-16 00:00:00,46,1,47
"36827",10901,"Marystown","NL",47.09899,-55.19852,2018-03-16 01:00:00,44,1,45
"36828",10901,"Marystown","NL",47.09899,-55.19852,2018-03-16 02:00:00,41,0,41
"36829",10901,"Marystown","NL",47.09899,-55.19852,2018-03-16 03:00:00,41,0,41
"36830",10901,"Marystown","NL",47.09899,-55.19852,2018-03-16 04:00:00,40,0,40
"36831",10901,"Marystown","NL",47.09899,-55.19852,2018-03-16 05:00:00,40,0,40
"36832",10901,"Marystown","NL",47.09899,-55.19852,2018-03-16 06:00:00,39,0,39
"36833",10901,"Marystown","NL",47.09899,-55.19852,2018-03-16 07:00:00,38,1,39
"36834",10901,"Marystown","NL",47.09899,-55.19852,2018-03-16 08:00:00,38,2,40
"36835",10901,"Marystown","NL",47.09899,-55.19852,2018-03-16 09:00:00,39,1,40
"36836",10901,"Marystown","NL",47.09899,-55.19852,2018-03-16 10:00:00,39,1,40
"36837",10901,"Marystown","NL",47.09899,-55.19852,2018-03-16 11:00:00,39,1,40
"36838",10901,"Marystown","NL",47.09899,-55.19852,2018-03-16 12:00:00,39,1,40
"36839",10901,"Marystown","NL",47.09899,-55.19852,2018-03-16 13:00:00,39,1,40
"36840",10901,"Marystown","NL",47.09899,-55.19852,2018-03-16 14:00:00,39,1,40
"36841",10901,"Marystown","NL",47.09899,-55.19852,2018-03-16 15:00:00,40,0,40
"36842",10901,"Marystown","NL",47.09899,-55.19852,2018-03-16 16:00:00,39,1,40
"36843",10901,"Marystown","NL",47.09899,-55.19852,2018-03-16 17:00:00,40,0,40
"36844",10901,"Marystown","NL",47.09899,-55.19852,2018-03-16 18:00:00,40,0,40
"36845",10901,"Marystown","NL",47.09899,-55.19852,2018-03-16 19:00:00,38,1,39
"36846",10901,"Marystown","NL",47.09899,-55.19852,2018-03-16 20:00:00,33,2,35
"36847",10901,"Marystown","NL",47.09899,-55.19852,2018-03-16 21:00:00,31,1,32
"36848",10901,"Marystown","NL",47.09899,-55.19852,2018-03-16 22:00:00,37,0,37
"36849",10901,"Marystown","NL",47.09899,-55.19852,2018-03-16 23:00:00,37,0,37
"36850",10901,"Marystown","NL",47.09899,-55.19852,2018-03-17 00:00:00,30,1,31
"36851",10901,"Marystown","NL",47.09899,-55.19852,2018-03-17 01:00:00,26,0,26
"36852",10901,"Marystown","NL",47.09899,-55.19852,2018-03-17 02:00:00,20,1,21
"36853",10901,"Marystown","NL",47.09899,-55.19852,2018-03-17 03:00:00,19,0,19
"36854",10901,"Marystown","NL",47.09899,-55.19852,2018-03-17 04:00:00,19,0,19
"36855",10901,"Marystown","NL",47.09899,-55.19852,2018-03-17 05:00:00,18,0,18
"36856",10901,"Marystown","NL",47.09899,-55.19852,2018-03-17 06:00:00,17,1,18
"36857",10901,"Marystown","NL",47.09899,-55.19852,2018-03-17 07:00:00,20,1,21
"36858",10901,"Marystown","NL",47.09899,-55.19852,2018-03-17 08:00:00,22,1,23
"36859",10901,"Marystown","NL",47.09899,-55.19852,2018-03-17 09:00:00,28,1,29
"36860",10901,"Marystown","NL",47.09899,-55.19852,2018-03-17 10:00:00,34,0,34
"36861",10901,"Marystown","NL",47.09899,-55.19852,2018-03-17 11:00:00,36,0,36
"36862",10901,"Marystown","NL",47.09899,-55.19852,2018-03-17 12:00:00,36,0,36
"36863",10901,"Marystown","NL",47.09899,-55.19852,2018-03-17 13:00:00,37,0,37
"36864",10901,"Marystown","NL",47.09899,-55.19852,2018-03-17 14:00:00,37,0,37
"36865",10901,"Marystown","NL",47.09899,-55.19852,2018-03-17 15:00:00,38,0,38
"36866",10901,"Marystown","NL",47.09899,-55.19852,2018-03-17 16:00:00,37,0,37
"36867",10901,"Marystown","NL",47.09899,-55.19852,2018-03-17 17:00:00,37,1,38
"36868",10901,"Marystown","NL",47.09899,-55.19852,2018-03-17 18:00:00,36,1,37
"36869",10901,"Marystown","NL",47.09899,-55.19852,2018-03-17 19:00:00,39,0,39
"36870",10901,"Marystown","NL",47.09899,-55.19852,2018-03-17 20:00:00,38,0,38
"36871",10901,"Marystown","NL",47.09899,-55.19852,2018-03-17 21:00:00,34,0,34
"36872",10901,"Marystown","NL",47.09899,-55.19852,2018-03-17 22:00:00,28,2,30
"36873",10901,"Marystown","NL",47.09899,-55.19852,2018-03-17 23:00:00,32,1,33
"36874",10901,"Marystown","NL",47.09899,-55.19852,2018-03-18 00:00:00,35,0,35
"36875",10901,"Marystown","NL",47.09899,-55.19852,2018-03-18 01:00:00,35,0,35
"36876",10901,"Marystown","NL",47.09899,-55.19852,2018-03-18 02:00:00,37,0,37
"36877",10901,"Marystown","NL",47.09899,-55.19852,2018-03-18 03:00:00,38,0,38
"36878",10901,"Marystown","NL",47.09899,-55.19852,2018-03-18 04:00:00,37,0,37
"36879",10901,"Marystown","NL",47.09899,-55.19852,2018-03-18 05:00:00,36,0,36
"36880",10901,"Marystown","NL",47.09899,-55.19852,2018-03-18 06:00:00,37,0,37
"36881",10901,"Marystown","NL",47.09899,-55.19852,2018-03-18 07:00:00,37,0,37
"36882",10901,"Marystown","NL",47.09899,-55.19852,2018-03-18 08:00:00,36,0,36
"36883",10901,"Marystown","NL",47.09899,-55.19852,2018-03-18 09:00:00,36,0,36
"36884",10901,"Marystown","NL",47.09899,-55.19852,2018-03-18 10:00:00,36,0,36
"36885",10901,"Marystown","NL",47.09899,-55.19852,2018-03-18 11:00:00,37,0,37
"36886",10901,"Marystown","NL",47.09899,-55.19852,2018-03-18 12:00:00,37,0,37
"36887",10901,"Marystown","NL",47.09899,-55.19852,2018-03-18 13:00:00,38,0,38
"36888",10901,"Marystown","NL",47.09899,-55.19852,2018-03-18 14:00:00,36,0,36
"36889",10901,"Marystown","NL",47.09899,-55.19852,2018-03-18 15:00:00,36,0,36
"36890",10901,"Marystown","NL",47.09899,-55.19852,2018-03-18 16:00:00,36,0,36
"36891",10901,"Marystown","NL",47.09899,-55.19852,2018-03-18 17:00:00,36,0,36
"36892",10901,"Marystown","NL",47.09899,-55.19852,2018-03-18 18:00:00,37,0,37
"36893",10901,"Marystown","NL",47.09899,-55.19852,2018-03-18 19:00:00,37,0,37
"36894",10901,"Marystown","NL",47.09899,-55.19852,2018-03-18 20:00:00,37,0,37
"36895",10901,"Marystown","NL",47.09899,-55.19852,2018-03-18 21:00:00,38,0,38
"36896",10901,"Marystown","NL",47.09899,-55.19852,2018-03-18 22:00:00,38,0,38
"36897",10901,"Marystown","NL",47.09899,-55.19852,2018-03-18 23:00:00,37,0,37
"36898",10901,"Marystown","NL",47.09899,-55.19852,2018-03-19 00:00:00,36,0,36
"36899",10901,"Marystown","NL",47.09899,-55.19852,2018-03-19 01:00:00,36,0,36
"36900",10901,"Marystown","NL",47.09899,-55.19852,2018-03-19 02:00:00,36,0,36
"36901",10901,"Marystown","NL",47.09899,-55.19852,2018-03-19 03:00:00,36,0,36
"36902",10901,"Marystown","NL",47.09899,-55.19852,2018-03-19 04:00:00,36,0,36
"36903",10901,"Marystown","NL",47.09899,-55.19852,2018-03-19 05:00:00,36,0,36
"36904",10901,"Marystown","NL",47.09899,-55.19852,2018-03-19 06:00:00,36,0,36
"36905",10901,"Marystown","NL",47.09899,-55.19852,2018-03-19 07:00:00,36,0,36
"36906",10901,"Marystown","NL",47.09899,-55.19852,2018-03-19 08:00:00,35,0,35
"36907",10901,"Marystown","NL",47.09899,-55.19852,2018-03-19 09:00:00,34,0,34
"36908",10901,"Marystown","NL",47.09899,-55.19852,2018-03-19 10:00:00,33,1,34
"36909",10901,"Marystown","NL",47.09899,-55.19852,2018-03-19 11:00:00,33,0,33
"36910",10901,"Marystown","NL",47.09899,-55.19852,2018-03-19 12:00:00,31,1,32
"36911",10901,"Marystown","NL",47.09899,-55.19852,2018-03-19 13:00:00,31,1,32
"36912",10901,"Marystown","NL",47.09899,-55.19852,2018-03-19 14:00:00,32,1,33
"36913",10901,"Marystown","NL",47.09899,-55.19852,2018-03-19 15:00:00,32,1,33
"36914",10901,"Marystown","NL",47.09899,-55.19852,2018-03-19 16:00:00,33,1,34
"36915",10901,"Marystown","NL",47.09899,-55.19852,2018-03-19 17:00:00,33,1,34
"36916",10901,"Marystown","NL",47.09899,-55.19852,2018-03-19 18:00:00,33,0,33
"36917",10901,"Marystown","NL",47.09899,-55.19852,2018-03-19 19:00:00,34,0,34
"36918",10901,"Marystown","NL",47.09899,-55.19852,2018-03-19 20:00:00,34,1,35
"36919",10901,"Marystown","NL",47.09899,-55.19852,2018-03-19 21:00:00,33,1,34
"36920",10901,"Marystown","NL",47.09899,-55.19852,2018-03-19 22:00:00,33,1,34
"36921",10901,"Marystown","NL",47.09899,-55.19852,2018-03-19 23:00:00,32,1,33
"36922",10901,"Marystown","NL",47.09899,-55.19852,2018-03-20 00:00:00,33,1,34
"36923",10901,"Marystown","NL",47.09899,-55.19852,2018-03-20 01:00:00,32,1,33
"36924",10901,"Marystown","NL",47.09899,-55.19852,2018-03-20 02:00:00,32,1,33
"36925",10901,"Marystown","NL",47.09899,-55.19852,2018-03-20 03:00:00,31,1,32
"36926",10901,"Marystown","NL",47.09899,-55.19852,2018-03-20 04:00:00,30,1,31
"36927",10901,"Marystown","NL",47.09899,-55.19852,2018-03-20 05:00:00,30,1,31
"36928",10901,"Marystown","NL",47.09899,-55.19852,2018-03-20 06:00:00,31,1,32
"36929",10901,"Marystown","NL",47.09899,-55.19852,2018-03-20 07:00:00,31,1,32
"36930",10901,"Marystown","NL",47.09899,-55.19852,2018-03-20 08:00:00,30,1,31
"36931",10901,"Marystown","NL",47.09899,-55.19852,2018-03-20 09:00:00,31,1,32
"36932",10901,"Marystown","NL",47.09899,-55.19852,2018-03-20 10:00:00,32,0,32
"36933",10901,"Marystown","NL",47.09899,-55.19852,2018-03-20 11:00:00,33,1,34
"36934",10901,"Marystown","NL",47.09899,-55.19852,2018-03-20 12:00:00,33,0,33
"36935",10901,"Marystown","NL",47.09899,-55.19852,2018-03-20 13:00:00,34,0,34
"36936",10901,"Marystown","NL",47.09899,-55.19852,2018-03-20 14:00:00,34,0,34
"36937",10901,"Marystown","NL",47.09899,-55.19852,2018-03-20 15:00:00,35,0,35
"36938",10901,"Marystown","NL",47.09899,-55.19852,2018-03-20 16:00:00,36,0,36
"36939",10901,"Marystown","NL",47.09899,-55.19852,2018-03-20 17:00:00,36,0,36
"36940",10901,"Marystown","NL",47.09899,-55.19852,2018-03-20 18:00:00,36,0,36
"36941",10901,"Marystown","NL",47.09899,-55.19852,2018-03-20 19:00:00,37,0,37
"36942",10901,"Marystown","NL",47.09899,-55.19852,2018-03-20 20:00:00,37,0,37
"36943",10901,"Marystown","NL",47.09899,-55.19852,2018-03-20 21:00:00,39,0,39
"36944",10901,"Marystown","NL",47.09899,-55.19852,2018-03-20 22:00:00,39,0,39
"36945",10901,"Marystown","NL",47.09899,-55.19852,2018-03-20 23:00:00,40,0,40
"36946",10901,"Marystown","NL",47.09899,-55.19852,2018-03-21 00:00:00,40,0,40
"36947",10901,"Marystown","NL",47.09899,-55.19852,2018-03-21 01:00:00,41,0,41
"36948",10901,"Marystown","NL",47.09899,-55.19852,2018-03-21 02:00:00,40,0,40
"36949",10901,"Marystown","NL",47.09899,-55.19852,2018-03-21 03:00:00,39,0,39
"36950",10901,"Marystown","NL",47.09899,-55.19852,2018-03-21 04:00:00,39,0,39
"36951",10901,"Marystown","NL",47.09899,-55.19852,2018-03-21 05:00:00,39,0,39
"36952",10901,"Marystown","NL",47.09899,-55.19852,2018-03-21 06:00:00,40,0,40
"36953",10901,"Marystown","NL",47.09899,-55.19852,2018-03-21 07:00:00,39,0,39
"36954",10901,"Marystown","NL",47.09899,-55.19852,2018-03-21 08:00:00,38,0,38
"36955",10901,"Marystown","NL",47.09899,-55.19852,2018-03-21 09:00:00,37,0,37
"36956",10901,"Marystown","NL",47.09899,-55.19852,2018-03-21 10:00:00,38,0,38
"36957",10901,"Marystown","NL",47.09899,-55.19852,2018-03-21 11:00:00,38,0,38
"36958",10901,"Marystown","NL",47.09899,-55.19852,2018-03-21 12:00:00,38,0,38
"36959",10901,"Marystown","NL",47.09899,-55.19852,2018-03-21 13:00:00,38,0,38
"36960",10901,"Marystown","NL",47.09899,-55.19852,2018-03-21 14:00:00,38,0,38
"36961",10901,"Marystown","NL",47.09899,-55.19852,2018-03-21 15:00:00,38,0,38
"36962",10901,"Marystown","NL",47.09899,-55.19852,2018-03-21 16:00:00,39,1,40
"36963",10901,"Marystown","NL",47.09899,-55.19852,2018-03-21 17:00:00,39,1,40
"36964",10901,"Marystown","NL",47.09899,-55.19852,2018-03-21 18:00:00,37,2,39
"36965",10901,"Marystown","NL",47.09899,-55.19852,2018-03-21 19:00:00,35,2,37
"36966",10901,"Marystown","NL",47.09899,-55.19852,2018-03-21 20:00:00,35,2,37
"36967",10901,"Marystown","NL",47.09899,-55.19852,2018-03-21 21:00:00,37,2,39
"36968",10901,"Marystown","NL",47.09899,-55.19852,2018-03-21 22:00:00,39,1,40
"36969",10901,"Marystown","NL",47.09899,-55.19852,2018-03-21 23:00:00,38,0,38
"36970",10901,"Marystown","NL",47.09899,-55.19852,2018-03-22 00:00:00,38,0,38
"36971",10901,"Marystown","NL",47.09899,-55.19852,2018-03-22 01:00:00,37,1,38
"36972",10901,"Marystown","NL",47.09899,-55.19852,2018-03-22 02:00:00,38,0,38
"36973",10901,"Marystown","NL",47.09899,-55.19852,2018-03-22 03:00:00,37,0,37
"36974",10901,"Marystown","NL",47.09899,-55.19852,2018-03-22 04:00:00,37,0,37
"36975",10901,"Marystown","NL",47.09899,-55.19852,2018-03-22 05:00:00,38,0,38
"36976",10901,"Marystown","NL",47.09899,-55.19852,2018-03-22 06:00:00,38,0,38
"36977",10901,"Marystown","NL",47.09899,-55.19852,2018-03-22 07:00:00,38,1,39
"36978",10901,"Marystown","NL",47.09899,-55.19852,2018-03-22 08:00:00,38,1,39
"36979",10901,"Marystown","NL",47.09899,-55.19852,2018-03-22 09:00:00,38,1,39
"36980",10901,"Marystown","NL",47.09899,-55.19852,2018-03-22 10:00:00,39,0,39
"36981",10901,"Marystown","NL",47.09899,-55.19852,2018-03-22 11:00:00,39,0,39
"36982",10901,"Marystown","NL",47.09899,-55.19852,2018-03-22 12:00:00,39,0,39
"36983",10901,"Marystown","NL",47.09899,-55.19852,2018-03-22 13:00:00,39,0,39
"36984",10901,"Marystown","NL",47.09899,-55.19852,2018-03-22 14:00:00,39,0,39
"36985",10901,"Marystown","NL",47.09899,-55.19852,2018-03-22 15:00:00,39,0,39
"36986",10901,"Marystown","NL",47.09899,-55.19852,2018-03-22 16:00:00,39,0,39
"36987",10901,"Marystown","NL",47.09899,-55.19852,2018-03-22 17:00:00,39,0,39
"36988",10901,"Marystown","NL",47.09899,-55.19852,2018-03-22 18:00:00,40,0,40
"36989",10901,"Marystown","NL",47.09899,-55.19852,2018-03-22 19:00:00,40,0,40
"36990",10901,"Marystown","NL",47.09899,-55.19852,2018-03-22 20:00:00,41,0,41
"36991",10901,"Marystown","NL",47.09899,-55.19852,2018-03-22 21:00:00,40,0,40
"36992",10901,"Marystown","NL",47.09899,-55.19852,2018-03-22 22:00:00,40,0,40
"36993",10901,"Marystown","NL",47.09899,-55.19852,2018-03-22 23:00:00,39,0,39
"36994",10901,"Marystown","NL",47.09899,-55.19852,2018-03-23 00:00:00,39,0,39
"36995",10901,"Marystown","NL",47.09899,-55.19852,2018-03-23 01:00:00,38,0,38
"36996",10901,"Marystown","NL",47.09899,-55.19852,2018-03-23 02:00:00,38,0,38
"36997",10901,"Marystown","NL",47.09899,-55.19852,2018-03-23 03:00:00,38,0,38
"36998",10901,"Marystown","NL",47.09899,-55.19852,2018-03-23 04:00:00,38,0,38
"36999",10901,"Marystown","NL",47.09899,-55.19852,2018-03-23 05:00:00,37,0,37
"37000",10901,"Marystown","NL",47.09899,-55.19852,2018-03-23 06:00:00,37,0,37
"37001",10901,"Marystown","NL",47.09899,-55.19852,2018-03-23 07:00:00,36,0,36
"37002",10901,"Marystown","NL",47.09899,-55.19852,2018-03-23 08:00:00,35,1,36
"37003",10901,"Marystown","NL",47.09899,-55.19852,2018-03-23 09:00:00,38,1,39
"37004",10901,"Marystown","NL",47.09899,-55.19852,2018-03-23 10:00:00,40,1,41
"37005",10901,"Marystown","NL",47.09899,-55.19852,2018-03-23 11:00:00,38,0,38
"37006",10901,"Marystown","NL",47.09899,-55.19852,2018-03-23 12:00:00,38,1,39
"37007",10901,"Marystown","NL",47.09899,-55.19852,2018-03-23 13:00:00,38,0,38
"37008",10901,"Marystown","NL",47.09899,-55.19852,2018-03-23 14:00:00,38,0,38
"37009",10901,"Marystown","NL",47.09899,-55.19852,2018-03-23 15:00:00,38,0,38
"37010",10901,"Marystown","NL",47.09899,-55.19852,2018-03-23 16:00:00,38,0,38
"37011",10901,"Marystown","NL",47.09899,-55.19852,2018-03-23 17:00:00,37,0,37
"37012",10901,"Marystown","NL",47.09899,-55.19852,2018-03-23 18:00:00,36,0,36
"37013",10901,"Marystown","NL",47.09899,-55.19852,2018-03-23 19:00:00,38,1,39
"37014",10901,"Marystown","NL",47.09899,-55.19852,2018-03-23 20:00:00,38,0,38
"37015",10901,"Marystown","NL",47.09899,-55.19852,2018-03-23 21:00:00,36,1,37
"37016",10901,"Marystown","NL",47.09899,-55.19852,2018-03-23 22:00:00,33,1,34
"37017",10901,"Marystown","NL",47.09899,-55.19852,2018-03-23 23:00:00,32,0,32
"37018",10901,"Marystown","NL",47.09899,-55.19852,2018-03-24 00:00:00,32,0,32
"37019",10901,"Marystown","NL",47.09899,-55.19852,2018-03-24 01:00:00,31,0,31
"37020",10901,"Marystown","NL",47.09899,-55.19852,2018-03-24 02:00:00,33,0,33
"37021",10901,"Marystown","NL",47.09899,-55.19852,2018-03-24 03:00:00,33,0,33
"37022",10901,"Marystown","NL",47.09899,-55.19852,2018-03-24 04:00:00,31,0,31
"37023",10901,"Marystown","NL",47.09899,-55.19852,2018-03-24 05:00:00,28,1,29
"37024",10901,"Marystown","NL",47.09899,-55.19852,2018-03-24 06:00:00,16,1,17
"37025",10901,"Marystown","NL",47.09899,-55.19852,2018-03-24 07:00:00,16,1,17
"37026",10901,"Marystown","NL",47.09899,-55.19852,2018-03-24 08:00:00,31,1,32
"37027",10901,"Marystown","NL",47.09899,-55.19852,2018-03-24 09:00:00,36,0,36
"37028",10901,"Marystown","NL",47.09899,-55.19852,2018-03-24 10:00:00,38,0,38
"37029",10901,"Marystown","NL",47.09899,-55.19852,2018-03-24 11:00:00,38,0,38
"37030",10901,"Marystown","NL",47.09899,-55.19852,2018-03-24 12:00:00,38,0,38
"37031",10901,"Marystown","NL",47.09899,-55.19852,2018-03-24 13:00:00,38,0,38
"37032",10901,"Marystown","NL",47.09899,-55.19852,2018-03-24 14:00:00,40,0,40
"37033",10901,"Marystown","NL",47.09899,-55.19852,2018-03-24 15:00:00,41,0,41
"37034",10901,"Marystown","NL",47.09899,-55.19852,2018-03-24 16:00:00,41,0,41
"37035",10901,"Marystown","NL",47.09899,-55.19852,2018-03-24 17:00:00,40,0,40
"37036",10901,"Marystown","NL",47.09899,-55.19852,2018-03-24 18:00:00,41,0,41
"37037",10901,"Marystown","NL",47.09899,-55.19852,2018-03-24 19:00:00,41,0,41
"37038",10901,"Marystown","NL",47.09899,-55.19852,2018-03-24 20:00:00,42,0,42
"37039",10901,"Marystown","NL",47.09899,-55.19852,2018-03-24 21:00:00,42,0,42
"37040",10901,"Marystown","NL",47.09899,-55.19852,2018-03-24 22:00:00,42,0,42
"37041",10901,"Marystown","NL",47.09899,-55.19852,2018-03-24 23:00:00,42,0,42
"37042",10901,"Marystown","NL",47.09899,-55.19852,2018-03-25 00:00:00,41,0,41
"37043",10901,"Marystown","NL",47.09899,-55.19852,2018-03-25 01:00:00,41,0,41
"37044",10901,"Marystown","NL",47.09899,-55.19852,2018-03-25 02:00:00,40,0,40
"37045",10901,"Marystown","NL",47.09899,-55.19852,2018-03-25 03:00:00,40,0,40
"37046",10901,"Marystown","NL",47.09899,-55.19852,2018-03-25 04:00:00,40,0,40
"37047",10901,"Marystown","NL",47.09899,-55.19852,2018-03-25 05:00:00,41,0,41
"37048",10901,"Marystown","NL",47.09899,-55.19852,2018-03-25 06:00:00,41,0,41
"37049",10901,"Marystown","NL",47.09899,-55.19852,2018-03-25 07:00:00,40,0,40
"37050",10901,"Marystown","NL",47.09899,-55.19852,2018-03-25 08:00:00,41,0,41
"37051",10901,"Marystown","NL",47.09899,-55.19852,2018-03-25 09:00:00,41,0,41
"37052",10901,"Marystown","NL",47.09899,-55.19852,2018-03-25 10:00:00,41,0,41
"37053",10901,"Marystown","NL",47.09899,-55.19852,2018-03-25 11:00:00,41,0,41
"37054",10901,"Marystown","NL",47.09899,-55.19852,2018-03-25 12:00:00,41,0,41
"37055",10901,"Marystown","NL",47.09899,-55.19852,2018-03-25 13:00:00,42,0,42
"37056",10901,"Marystown","NL",47.09899,-55.19852,2018-03-25 14:00:00,42,0,42
"37057",10901,"Marystown","NL",47.09899,-55.19852,2018-03-25 15:00:00,42,0,42
"37058",10901,"Marystown","NL",47.09899,-55.19852,2018-03-25 16:00:00,42,0,42
"37059",10901,"Marystown","NL",47.09899,-55.19852,2018-03-25 17:00:00,42,0,42
"37060",10901,"Marystown","NL",47.09899,-55.19852,2018-03-25 18:00:00,42,0,42
"37061",10901,"Marystown","NL",47.09899,-55.19852,2018-03-25 19:00:00,42,0,42
"37062",10901,"Marystown","NL",47.09899,-55.19852,2018-03-25 20:00:00,42,0,42
"37063",10901,"Marystown","NL",47.09899,-55.19852,2018-03-25 21:00:00,42,0,42
"37064",10901,"Marystown","NL",47.09899,-55.19852,2018-03-25 22:00:00,42,0,42
"37065",10901,"Marystown","NL",47.09899,-55.19852,2018-03-25 23:00:00,42,0,42
"37066",10901,"Marystown","NL",47.09899,-55.19852,2018-03-26 00:00:00,42,0,42
"37067",10901,"Marystown","NL",47.09899,-55.19852,2018-03-26 01:00:00,41,0,41
"37068",10901,"Marystown","NL",47.09899,-55.19852,2018-03-26 02:00:00,41,0,41
"37069",10901,"Marystown","NL",47.09899,-55.19852,2018-03-26 03:00:00,41,0,41
"37070",10901,"Marystown","NL",47.09899,-55.19852,2018-03-26 04:00:00,40,1,41
"37071",10901,"Marystown","NL",47.09899,-55.19852,2018-03-26 05:00:00,38,1,39
"37072",10901,"Marystown","NL",47.09899,-55.19852,2018-03-26 06:00:00,35,2,37
"37073",10901,"Marystown","NL",47.09899,-55.19852,2018-03-26 07:00:00,33,2,35
"37074",10901,"Marystown","NL",47.09899,-55.19852,2018-03-26 08:00:00,35,2,37
"37075",10901,"Marystown","NL",47.09899,-55.19852,2018-03-26 09:00:00,40,0,40
"37076",10901,"Marystown","NL",47.09899,-55.19852,2018-03-26 10:00:00,41,0,41
"37077",10901,"Marystown","NL",47.09899,-55.19852,2018-03-26 11:00:00,41,0,41
"37078",10901,"Marystown","NL",47.09899,-55.19852,2018-03-26 12:00:00,40,0,40
"37079",10901,"Marystown","NL",47.09899,-55.19852,2018-03-26 13:00:00,40,0,40
"37080",10901,"Marystown","NL",47.09899,-55.19852,2018-03-26 14:00:00,40,0,40
"37081",10901,"Marystown","NL",47.09899,-55.19852,2018-03-26 15:00:00,40,0,40
"37082",10901,"Marystown","NL",47.09899,-55.19852,2018-03-26 16:00:00,40,0,40
"37083",10901,"Marystown","NL",47.09899,-55.19852,2018-03-26 17:00:00,41,0,41
"37084",10901,"Marystown","NL",47.09899,-55.19852,2018-03-26 18:00:00,41,0,41
"37085",10901,"Marystown","NL",47.09899,-55.19852,2018-03-26 19:00:00,40,0,40
"37086",10901,"Marystown","NL",47.09899,-55.19852,2018-03-26 20:00:00,34,1,35
"37087",10901,"Marystown","NL",47.09899,-55.19852,2018-03-26 21:00:00,27,3,30
"37088",10901,"Marystown","NL",47.09899,-55.19852,2018-03-26 22:00:00,26,1,27
"37089",10901,"Marystown","NL",47.09899,-55.19852,2018-03-26 23:00:00,24,1,25
"37090",10901,"Marystown","NL",47.09899,-55.19852,2018-03-27 00:00:00,24,1,25
"37091",10901,"Marystown","NL",47.09899,-55.19852,2018-03-27 01:00:00,23,1,24
"37092",10901,"Marystown","NL",47.09899,-55.19852,2018-03-27 02:00:00,24,0,24
"37093",10901,"Marystown","NL",47.09899,-55.19852,2018-03-27 03:00:00,21,1,22
"37094",10901,"Marystown","NL",47.09899,-55.19852,2018-03-27 04:00:00,18,1,19
"37095",10901,"Marystown","NL",47.09899,-55.19852,2018-03-27 05:00:00,14,1,15
"37096",10901,"Marystown","NL",47.09899,-55.19852,2018-03-27 06:00:00,14,2,16
"37097",10901,"Marystown","NL",47.09899,-55.19852,2018-03-27 07:00:00,16,3,19
"37098",10901,"Marystown","NL",47.09899,-55.19852,2018-03-27 08:00:00,19,5,24
"37099",10901,"Marystown","NL",47.09899,-55.19852,2018-03-27 09:00:00,27,3,30
"37100",10901,"Marystown","NL",47.09899,-55.19852,2018-03-27 10:00:00,34,1,35
"37101",10901,"Marystown","NL",47.09899,-55.19852,2018-03-27 11:00:00,38,1,39
"37102",10901,"Marystown","NL",47.09899,-55.19852,2018-03-27 12:00:00,44,1,45
"37103",10901,"Marystown","NL",47.09899,-55.19852,2018-03-27 13:00:00,45,1,46
"37104",10901,"Marystown","NL",47.09899,-55.19852,2018-03-27 14:00:00,46,1,47
"37105",10901,"Marystown","NL",47.09899,-55.19852,2018-03-27 15:00:00,45,1,46
"37106",10901,"Marystown","NL",47.09899,-55.19852,2018-03-27 16:00:00,46,1,47
"37107",10901,"Marystown","NL",47.09899,-55.19852,2018-03-27 17:00:00,46,1,47
"37108",10901,"Marystown","NL",47.09899,-55.19852,2018-03-27 18:00:00,45,1,46
"37109",10901,"Marystown","NL",47.09899,-55.19852,2018-03-27 19:00:00,38,2,40
"37110",10901,"Marystown","NL",47.09899,-55.19852,2018-03-27 20:00:00,35,3,38
"37111",10901,"Marystown","NL",47.09899,-55.19852,2018-03-27 21:00:00,36,1,37
"37112",10901,"Marystown","NL",47.09899,-55.19852,2018-03-27 22:00:00,35,1,36
"37113",10901,"Marystown","NL",47.09899,-55.19852,2018-03-27 23:00:00,37,2,39
"37114",10901,"Marystown","NL",47.09899,-55.19852,2018-03-28 00:00:00,42,1,43
"37115",10901,"Marystown","NL",47.09899,-55.19852,2018-03-28 01:00:00,43,0,43
"37116",10901,"Marystown","NL",47.09899,-55.19852,2018-03-28 02:00:00,43,0,43
"37117",10901,"Marystown","NL",47.09899,-55.19852,2018-03-28 03:00:00,45,0,45
"37118",10901,"Marystown","NL",47.09899,-55.19852,2018-03-28 04:00:00,45,0,45
"37119",10901,"Marystown","NL",47.09899,-55.19852,2018-03-28 05:00:00,45,1,46
"37120",10901,"Marystown","NL",47.09899,-55.19852,2018-03-28 06:00:00,45,0,45
"37121",10901,"Marystown","NL",47.09899,-55.19852,2018-03-28 07:00:00,45,0,45
"37122",10901,"Marystown","NL",47.09899,-55.19852,2018-03-28 08:00:00,45,0,45
"37123",10901,"Marystown","NL",47.09899,-55.19852,2018-03-28 09:00:00,44,0,44
"37124",10901,"Marystown","NL",47.09899,-55.19852,2018-03-28 10:00:00,43,1,44
"37125",10901,"Marystown","NL",47.09899,-55.19852,2018-03-28 11:00:00,41,1,42
"37126",10901,"Marystown","NL",47.09899,-55.19852,2018-03-28 12:00:00,38,1,39
"37127",10901,"Marystown","NL",47.09899,-55.19852,2018-03-28 13:00:00,40,1,41
"37128",10901,"Marystown","NL",47.09899,-55.19852,2018-03-28 14:00:00,40,1,41
"37129",10901,"Marystown","NL",47.09899,-55.19852,2018-03-28 15:00:00,40,1,41
"37130",10901,"Marystown","NL",47.09899,-55.19852,2018-03-28 16:00:00,40,1,41
"37131",10901,"Marystown","NL",47.09899,-55.19852,2018-03-28 17:00:00,40,1,41
"37132",10901,"Marystown","NL",47.09899,-55.19852,2018-03-28 18:00:00,40,1,41
"37133",10901,"Marystown","NL",47.09899,-55.19852,2018-03-28 19:00:00,39,1,40
"37134",10901,"Marystown","NL",47.09899,-55.19852,2018-03-28 20:00:00,38,1,39
"37135",10901,"Marystown","NL",47.09899,-55.19852,2018-03-28 21:00:00,37,1,38
"37136",10901,"Marystown","NL",47.09899,-55.19852,2018-03-28 22:00:00,36,1,37
"37137",10901,"Marystown","NL",47.09899,-55.19852,2018-03-28 23:00:00,37,1,38
"37138",10901,"Marystown","NL",47.09899,-55.19852,2018-03-29 00:00:00,36,1,37
"37139",10901,"Marystown","NL",47.09899,-55.19852,2018-03-29 01:00:00,36,1,37
"37140",10901,"Marystown","NL",47.09899,-55.19852,2018-03-29 02:00:00,35,1,36
"37141",10901,"Marystown","NL",47.09899,-55.19852,2018-03-29 03:00:00,36,1,37
"37142",10901,"Marystown","NL",47.09899,-55.19852,2018-03-29 04:00:00,36,1,37
"37143",10901,"Marystown","NL",47.09899,-55.19852,2018-03-29 05:00:00,36,1,37
"37144",10901,"Marystown","NL",47.09899,-55.19852,2018-03-29 06:00:00,35,0,35
"37145",10901,"Marystown","NL",47.09899,-55.19852,2018-03-29 07:00:00,35,1,36
"37146",10901,"Marystown","NL",47.09899,-55.19852,2018-03-29 08:00:00,37,0,37
"37147",10901,"Marystown","NL",47.09899,-55.19852,2018-03-29 09:00:00,39,0,39
"37148",10901,"Marystown","NL",47.09899,-55.19852,2018-03-29 10:00:00,41,0,41
"37149",10901,"Marystown","NL",47.09899,-55.19852,2018-03-29 11:00:00,40,1,41
"37150",10901,"Marystown","NL",47.09899,-55.19852,2018-03-29 12:00:00,38,1,39
"37151",10901,"Marystown","NL",47.09899,-55.19852,2018-03-29 13:00:00,39,1,40
"37152",10901,"Marystown","NL",47.09899,-55.19852,2018-03-29 14:00:00,37,1,38
"37153",10901,"Marystown","NL",47.09899,-55.19852,2018-03-29 15:00:00,35,0,35
"37154",10901,"Marystown","NL",47.09899,-55.19852,2018-03-29 16:00:00,36,0,36
"37155",10901,"Marystown","NL",47.09899,-55.19852,2018-03-29 17:00:00,35,0,35
"37156",10901,"Marystown","NL",47.09899,-55.19852,2018-03-29 18:00:00,38,0,38
"37157",10901,"Marystown","NL",47.09899,-55.19852,2018-03-29 19:00:00,39,0,39
"37158",10901,"Marystown","NL",47.09899,-55.19852,2018-03-29 20:00:00,39,0,39
"37159",10901,"Marystown","NL",47.09899,-55.19852,2018-03-29 21:00:00,40,0,40
"37160",10901,"Marystown","NL",47.09899,-55.19852,2018-03-29 22:00:00,41,0,41
"37161",10901,"Marystown","NL",47.09899,-55.19852,2018-03-29 23:00:00,40,0,40
"37162",10901,"Marystown","NL",47.09899,-55.19852,2018-03-30 00:00:00,40,0,40
"37163",10901,"Marystown","NL",47.09899,-55.19852,2018-03-30 01:00:00,39,0,39
"37164",10901,"Marystown","NL",47.09899,-55.19852,2018-03-30 02:00:00,39,0,39
"37165",10901,"Marystown","NL",47.09899,-55.19852,2018-03-30 03:00:00,37,0,37
"37166",10901,"Marystown","NL",47.09899,-55.19852,2018-03-30 04:00:00,38,0,38
"37167",10901,"Marystown","NL",47.09899,-55.19852,2018-03-30 05:00:00,38,0,38
"37168",10901,"Marystown","NL",47.09899,-55.19852,2018-03-30 06:00:00,36,0,36
"37169",10901,"Marystown","NL",47.09899,-55.19852,2018-03-30 07:00:00,38,0,38
"37170",10901,"Marystown","NL",47.09899,-55.19852,2018-03-30 08:00:00,40,0,40
"37171",10901,"Marystown","NL",47.09899,-55.19852,2018-03-30 09:00:00,42,0,42
"37172",10901,"Marystown","NL",47.09899,-55.19852,2018-03-30 10:00:00,41,0,41
"37173",10901,"Marystown","NL",47.09899,-55.19852,2018-03-30 11:00:00,41,0,41
"37174",10901,"Marystown","NL",47.09899,-55.19852,2018-03-30 12:00:00,40,0,40
"37175",10901,"Marystown","NL",47.09899,-55.19852,2018-03-30 13:00:00,40,0,40
"37176",10901,"Marystown","NL",47.09899,-55.19852,2018-03-30 14:00:00,40,1,41
"37177",10901,"Marystown","NL",47.09899,-55.19852,2018-03-30 15:00:00,40,1,41
"37178",10901,"Marystown","NL",47.09899,-55.19852,2018-03-30 16:00:00,40,1,41
"37179",10901,"Marystown","NL",47.09899,-55.19852,2018-03-30 17:00:00,41,0,41
"37180",10901,"Marystown","NL",47.09899,-55.19852,2018-03-30 18:00:00,40,1,41
"37181",10901,"Marystown","NL",47.09899,-55.19852,2018-03-30 19:00:00,37,1,38
"37182",10901,"Marystown","NL",47.09899,-55.19852,2018-03-30 20:00:00,37,1,38
"37183",10901,"Marystown","NL",47.09899,-55.19852,2018-03-30 21:00:00,38,0,38
"37184",10901,"Marystown","NL",47.09899,-55.19852,2018-03-30 22:00:00,39,0,39
"37185",10901,"Marystown","NL",47.09899,-55.19852,2018-03-30 23:00:00,39,0,39
"37186",10901,"Marystown","NL",47.09899,-55.19852,2018-03-31 00:00:00,40,0,40
"37187",10901,"Marystown","NL",47.09899,-55.19852,2018-03-31 01:00:00,41,0,41
"37188",10901,"Marystown","NL",47.09899,-55.19852,2018-03-31 02:00:00,41,0,41
"37189",10901,"Marystown","NL",47.09899,-55.19852,2018-03-31 03:00:00,40,1,41
"37190",10901,"Marystown","NL",47.09899,-55.19852,2018-03-31 04:00:00,38,1,39
"37191",10901,"Marystown","NL",47.09899,-55.19852,2018-03-31 05:00:00,36,1,37
"37192",10901,"Marystown","NL",47.09899,-55.19852,2018-03-31 06:00:00,38,1,39
"37193",10901,"Marystown","NL",47.09899,-55.19852,2018-03-31 07:00:00,39,1,40
"37194",10901,"Marystown","NL",47.09899,-55.19852,2018-03-31 08:00:00,36,1,37
"37195",10901,"Marystown","NL",47.09899,-55.19852,2018-03-31 09:00:00,35,2,37
"37196",10901,"Marystown","NL",47.09899,-55.19852,2018-03-31 10:00:00,34,2,36
"37197",10901,"Marystown","NL",47.09899,-55.19852,2018-03-31 11:00:00,34,1,35
"37198",10901,"Marystown","NL",47.09899,-55.19852,2018-03-31 12:00:00,34,0,34
"37199",10901,"Marystown","NL",47.09899,-55.19852,2018-03-31 13:00:00,34,0,34
"37200",10901,"Marystown","NL",47.09899,-55.19852,2018-03-31 14:00:00,33,0,33
"37201",10901,"Marystown","NL",47.09899,-55.19852,2018-03-31 15:00:00,39,0,39
"37202",10901,"Marystown","NL",47.09899,-55.19852,2018-03-31 16:00:00,39,0,39
"37203",10901,"Marystown","NL",47.09899,-55.19852,2018-03-31 17:00:00,39,0,39
"37204",10901,"Marystown","NL",47.09899,-55.19852,2018-03-31 18:00:00,38,0,38
"37205",10901,"Marystown","NL",47.09899,-55.19852,2018-03-31 19:00:00,38,0,38
"37206",10901,"Marystown","NL",47.09899,-55.19852,2018-03-31 20:00:00,39,0,39
"37207",10901,"Marystown","NL",47.09899,-55.19852,2018-03-31 21:00:00,43,0,43
"37208",10901,"Marystown","NL",47.09899,-55.19852,2018-03-31 22:00:00,45,0,45
"37209",10901,"Marystown","NL",47.09899,-55.19852,2018-03-31 23:00:00,44,0,44
"37210",10901,"Marystown","NL",47.09899,-55.19852,2018-04-01 00:00:00,43,0,43
"37211",10901,"Marystown","NL",47.09899,-55.19852,2018-04-01 01:00:00,43,0,43
"37212",10901,"Marystown","NL",47.09899,-55.19852,2018-04-01 02:00:00,42,0,42
"37213",10901,"Marystown","NL",47.09899,-55.19852,2018-04-01 03:00:00,42,0,42
"37214",10901,"Marystown","NL",47.09899,-55.19852,2018-04-01 04:00:00,42,0,42
"37215",10901,"Marystown","NL",47.09899,-55.19852,2018-04-01 05:00:00,42,0,42
"37216",10901,"Marystown","NL",47.09899,-55.19852,2018-04-01 06:00:00,42,0,42
"37217",10901,"Marystown","NL",47.09899,-55.19852,2018-04-01 07:00:00,41,0,41
"37218",10901,"Marystown","NL",47.09899,-55.19852,2018-04-01 08:00:00,40,0,40
"37219",10901,"Marystown","NL",47.09899,-55.19852,2018-04-01 09:00:00,40,0,40
"37220",10901,"Marystown","NL",47.09899,-55.19852,2018-04-01 10:00:00,40,0,40
"37221",10901,"Marystown","NL",47.09899,-55.19852,2018-04-01 11:00:00,41,0,41
"37222",10901,"Marystown","NL",47.09899,-55.19852,2018-04-01 12:00:00,40,0,40
"37223",10901,"Marystown","NL",47.09899,-55.19852,2018-04-01 13:00:00,42,0,42
"37224",10901,"Marystown","NL",47.09899,-55.19852,2018-04-01 14:00:00,42,0,42
"37225",10901,"Marystown","NL",47.09899,-55.19852,2018-04-01 15:00:00,42,0,42
"37226",10901,"Marystown","NL",47.09899,-55.19852,2018-04-01 16:00:00,42,0,42
"37227",10901,"Marystown","NL",47.09899,-55.19852,2018-04-01 17:00:00,43,0,43
"37228",10901,"Marystown","NL",47.09899,-55.19852,2018-04-01 18:00:00,44,0,44
"37229",10901,"Marystown","NL",47.09899,-55.19852,2018-04-01 19:00:00,45,0,45
"37230",10901,"Marystown","NL",47.09899,-55.19852,2018-04-01 20:00:00,44,0,44
"37231",10901,"Marystown","NL",47.09899,-55.19852,2018-04-01 21:00:00,44,0,44
"37232",10901,"Marystown","NL",47.09899,-55.19852,2018-04-01 22:00:00,44,0,44
"37233",10901,"Marystown","NL",47.09899,-55.19852,2018-04-01 23:00:00,43,0,43
"37234",10901,"Marystown","NL",47.09899,-55.19852,2018-04-02 00:00:00,43,0,43
"37235",10901,"Marystown","NL",47.09899,-55.19852,2018-04-02 01:00:00,44,0,44
"37236",10901,"Marystown","NL",47.09899,-55.19852,2018-04-02 02:00:00,45,0,45
"37237",10901,"Marystown","NL",47.09899,-55.19852,2018-04-02 03:00:00,45,0,45
"37238",10901,"Marystown","NL",47.09899,-55.19852,2018-04-02 04:00:00,44,0,44
"37239",10901,"Marystown","NL",47.09899,-55.19852,2018-04-02 05:00:00,42,0,42
"37240",10901,"Marystown","NL",47.09899,-55.19852,2018-04-02 06:00:00,43,0,43
"37241",10901,"Marystown","NL",47.09899,-55.19852,2018-04-02 07:00:00,42,0,42
"37242",10901,"Marystown","NL",47.09899,-55.19852,2018-04-02 08:00:00,40,0,40
"37243",10901,"Marystown","NL",47.09899,-55.19852,2018-04-02 09:00:00,39,0,39
"37244",10901,"Marystown","NL",47.09899,-55.19852,2018-04-02 10:00:00,39,0,39
"37245",10901,"Marystown","NL",47.09899,-55.19852,2018-04-02 11:00:00,40,0,40
"37246",10901,"Marystown","NL",47.09899,-55.19852,2018-04-02 12:00:00,40,0,40
"37247",10901,"Marystown","NL",47.09899,-55.19852,2018-04-02 13:00:00,40,0,40
"37248",10901,"Marystown","NL",47.09899,-55.19852,2018-04-02 14:00:00,40,0,40
"37249",10901,"Marystown","NL",47.09899,-55.19852,2018-04-02 15:00:00,39,0,39
"37250",10901,"Marystown","NL",47.09899,-55.19852,2018-04-02 16:00:00,39,0,39
"37251",10901,"Marystown","NL",47.09899,-55.19852,2018-04-02 17:00:00,39,0,39
"37252",10901,"Marystown","NL",47.09899,-55.19852,2018-04-02 18:00:00,39,0,39
"37253",10901,"Marystown","NL",47.09899,-55.19852,2018-04-02 19:00:00,39,0,39
"37254",10901,"Marystown","NL",47.09899,-55.19852,2018-04-02 20:00:00,39,0,39
"37255",10901,"Marystown","NL",47.09899,-55.19852,2018-04-02 21:00:00,39,0,39
"37256",10901,"Marystown","NL",47.09899,-55.19852,2018-04-02 22:00:00,39,0,39
"37257",10901,"Marystown","NL",47.09899,-55.19852,2018-04-02 23:00:00,39,0,39
"37258",10901,"Marystown","NL",47.09899,-55.19852,2018-04-03 00:00:00,38,0,38
"37259",10901,"Marystown","NL",47.09899,-55.19852,2018-04-03 01:00:00,39,0,39
"37260",10901,"Marystown","NL",47.09899,-55.19852,2018-04-03 02:00:00,38,0,38
"37261",10901,"Marystown","NL",47.09899,-55.19852,2018-04-03 03:00:00,38,0,38
"37262",10901,"Marystown","NL",47.09899,-55.19852,2018-04-03 04:00:00,39,0,39
"37263",10901,"Marystown","NL",47.09899,-55.19852,2018-04-03 05:00:00,39,0,39
"37264",10901,"Marystown","NL",47.09899,-55.19852,2018-04-03 06:00:00,40,0,40
"37265",10901,"Marystown","NL",47.09899,-55.19852,2018-04-03 07:00:00,39,0,39
"37266",10901,"Marystown","NL",47.09899,-55.19852,2018-04-03 08:00:00,40,0,40
"37267",10901,"Marystown","NL",47.09899,-55.19852,2018-04-03 09:00:00,40,0,40
"37268",10901,"Marystown","NL",47.09899,-55.19852,2018-04-03 10:00:00,40,0,40
"37269",10901,"Marystown","NL",47.09899,-55.19852,2018-04-03 11:00:00,39,0,39
"37270",10901,"Marystown","NL",47.09899,-55.19852,2018-04-03 12:00:00,41,0,41
"37271",10901,"Marystown","NL",47.09899,-55.19852,2018-04-03 13:00:00,41,0,41
"37272",10901,"Marystown","NL",47.09899,-55.19852,2018-04-03 14:00:00,41,0,41
"37273",10901,"Marystown","NL",47.09899,-55.19852,2018-04-03 15:00:00,41,0,41
"37274",10901,"Marystown","NL",47.09899,-55.19852,2018-04-03 16:00:00,41,0,41
"37275",10901,"Marystown","NL",47.09899,-55.19852,2018-04-03 17:00:00,41,0,41
"37276",10901,"Marystown","NL",47.09899,-55.19852,2018-04-03 18:00:00,42,0,42
"37277",10901,"Marystown","NL",47.09899,-55.19852,2018-04-03 19:00:00,43,0,43
"37278",10901,"Marystown","NL",47.09899,-55.19852,2018-04-03 20:00:00,42,0,42
"37279",10901,"Marystown","NL",47.09899,-55.19852,2018-04-03 21:00:00,42,0,42
"37280",10901,"Marystown","NL",47.09899,-55.19852,2018-04-03 22:00:00,43,0,43
"37281",10901,"Marystown","NL",47.09899,-55.19852,2018-04-03 23:00:00,42,0,42
"37282",10901,"Marystown","NL",47.09899,-55.19852,2018-04-04 00:00:00,43,0,43
"37283",10901,"Marystown","NL",47.09899,-55.19852,2018-04-04 01:00:00,42,0,42
"37284",10901,"Marystown","NL",47.09899,-55.19852,2018-04-04 02:00:00,41,0,41
"37285",10901,"Marystown","NL",47.09899,-55.19852,2018-04-04 03:00:00,39,0,39
"37286",10901,"Marystown","NL",47.09899,-55.19852,2018-04-04 04:00:00,35,1,36
"37287",10901,"Marystown","NL",47.09899,-55.19852,2018-04-04 05:00:00,29,1,30
"37288",10901,"Marystown","NL",47.09899,-55.19852,2018-04-04 06:00:00,31,1,32
"37289",10901,"Marystown","NL",47.09899,-55.19852,2018-04-04 07:00:00,35,1,36
"37290",10901,"Marystown","NL",47.09899,-55.19852,2018-04-04 08:00:00,36,6,42
"37291",10901,"Marystown","NL",47.09899,-55.19852,2018-04-04 09:00:00,39,2,41
"37292",10901,"Marystown","NL",47.09899,-55.19852,2018-04-04 10:00:00,41,1,42
"37293",10901,"Marystown","NL",47.09899,-55.19852,2018-04-04 11:00:00,42,1,43
"37294",10901,"Marystown","NL",47.09899,-55.19852,2018-04-04 12:00:00,41,0,41
"37295",10901,"Marystown","NL",47.09899,-55.19852,2018-04-04 13:00:00,42,0,42
"37296",10901,"Marystown","NL",47.09899,-55.19852,2018-04-04 14:00:00,42,1,43
"37297",10901,"Marystown","NL",47.09899,-55.19852,2018-04-04 15:00:00,43,0,43
"37298",10901,"Marystown","NL",47.09899,-55.19852,2018-04-04 16:00:00,43,0,43
"37299",10901,"Marystown","NL",47.09899,-55.19852,2018-04-04 17:00:00,43,0,43
"37300",10901,"Marystown","NL",47.09899,-55.19852,2018-04-04 18:00:00,46,0,46
"37301",10901,"Marystown","NL",47.09899,-55.19852,2018-04-04 19:00:00,46,0,46
"37302",10901,"Marystown","NL",47.09899,-55.19852,2018-04-04 20:00:00,46,0,46
"37303",10901,"Marystown","NL",47.09899,-55.19852,2018-04-04 21:00:00,46,0,46
"37304",10901,"Marystown","NL",47.09899,-55.19852,2018-04-04 22:00:00,46,0,46
"37305",10901,"Marystown","NL",47.09899,-55.19852,2018-04-04 23:00:00,46,0,46
"37306",10901,"Marystown","NL",47.09899,-55.19852,2018-04-05 00:00:00,45,0,45
"37307",10901,"Marystown","NL",47.09899,-55.19852,2018-04-05 01:00:00,45,0,45
"37308",10901,"Marystown","NL",47.09899,-55.19852,2018-04-05 02:00:00,45,0,45
"37309",10901,"Marystown","NL",47.09899,-55.19852,2018-04-05 03:00:00,44,0,44
"37310",10901,"Marystown","NL",47.09899,-55.19852,2018-04-05 04:00:00,42,0,42
"37311",10901,"Marystown","NL",47.09899,-55.19852,2018-04-05 05:00:00,40,0,40
"37312",10901,"Marystown","NL",47.09899,-55.19852,2018-04-05 06:00:00,37,1,38
"37313",10901,"Marystown","NL",47.09899,-55.19852,2018-04-05 07:00:00,37,0,37
"37314",10901,"Marystown","NL",47.09899,-55.19852,2018-04-05 08:00:00,37,0,37
"37315",10901,"Marystown","NL",47.09899,-55.19852,2018-04-05 09:00:00,38,0,38
"37316",10901,"Marystown","NL",47.09899,-55.19852,2018-04-05 10:00:00,39,0,39
"37317",10901,"Marystown","NL",47.09899,-55.19852,2018-04-05 11:00:00,41,0,41
"37318",10901,"Marystown","NL",47.09899,-55.19852,2018-04-05 12:00:00,37,0,37
"37319",10901,"Marystown","NL",47.09899,-55.19852,2018-04-05 13:00:00,32,0,32
"37320",10901,"Marystown","NL",47.09899,-55.19852,2018-04-05 14:00:00,30,0,30
"37321",10901,"Marystown","NL",47.09899,-55.19852,2018-04-05 15:00:00,34,1,35
"37322",10901,"Marystown","NL",47.09899,-55.19852,2018-04-05 16:00:00,37,0,37
"37323",10901,"Marystown","NL",47.09899,-55.19852,2018-04-05 17:00:00,40,0,40
"37324",10901,"Marystown","NL",47.09899,-55.19852,2018-04-05 18:00:00,41,0,41
"37325",10901,"Marystown","NL",47.09899,-55.19852,2018-04-05 19:00:00,40,0,40
"37326",10901,"Marystown","NL",47.09899,-55.19852,2018-04-05 20:00:00,39,0,39
"37327",10901,"Marystown","NL",47.09899,-55.19852,2018-04-05 21:00:00,39,0,39
"37328",10901,"Marystown","NL",47.09899,-55.19852,2018-04-05 22:00:00,39,0,39
"37329",10901,"Marystown","NL",47.09899,-55.19852,2018-04-05 23:00:00,38,0,38
"37330",10901,"Marystown","NL",47.09899,-55.19852,2018-04-06 00:00:00,36,0,36
"37331",10901,"Marystown","NL",47.09899,-55.19852,2018-04-06 01:00:00,35,0,35
"37332",10901,"Marystown","NL",47.09899,-55.19852,2018-04-06 02:00:00,36,0,36
"37333",10901,"Marystown","NL",47.09899,-55.19852,2018-04-06 03:00:00,37,0,37
"37334",10901,"Marystown","NL",47.09899,-55.19852,2018-04-06 04:00:00,37,0,37
"37335",10901,"Marystown","NL",47.09899,-55.19852,2018-04-06 05:00:00,37,0,37
"37336",10901,"Marystown","NL",47.09899,-55.19852,2018-04-06 06:00:00,38,0,38
"37337",10901,"Marystown","NL",47.09899,-55.19852,2018-04-06 07:00:00,39,0,39
"37338",10901,"Marystown","NL",47.09899,-55.19852,2018-04-06 08:00:00,39,0,39
"37339",10901,"Marystown","NL",47.09899,-55.19852,2018-04-06 09:00:00,40,0,40
"37340",10901,"Marystown","NL",47.09899,-55.19852,2018-04-06 10:00:00,39,0,39
"37341",10901,"Marystown","NL",47.09899,-55.19852,2018-04-06 11:00:00,39,0,39
"37342",10901,"Marystown","NL",47.09899,-55.19852,2018-04-06 12:00:00,40,0,40
"37343",10901,"Marystown","NL",47.09899,-55.19852,2018-04-06 13:00:00,42,0,42
"37344",10901,"Marystown","NL",47.09899,-55.19852,2018-04-06 14:00:00,41,0,41
"37345",10901,"Marystown","NL",47.09899,-55.19852,2018-04-06 15:00:00,42,0,42
"37346",10901,"Marystown","NL",47.09899,-55.19852,2018-04-06 16:00:00,41,0,41
"37347",10901,"Marystown","NL",47.09899,-55.19852,2018-04-06 17:00:00,41,0,41
"37348",10901,"Marystown","NL",47.09899,-55.19852,2018-04-06 18:00:00,42,0,42
"37349",10901,"Marystown","NL",47.09899,-55.19852,2018-04-06 19:00:00,42,0,42
"37350",10901,"Marystown","NL",47.09899,-55.19852,2018-04-06 20:00:00,43,0,43
"37351",10901,"Marystown","NL",47.09899,-55.19852,2018-04-06 21:00:00,42,1,43
"37352",10901,"Marystown","NL",47.09899,-55.19852,2018-04-06 22:00:00,41,0,41
"37353",10901,"Marystown","NL",47.09899,-55.19852,2018-04-06 23:00:00,42,1,43
"37354",10901,"Marystown","NL",47.09899,-55.19852,2018-04-07 00:00:00,41,1,42
"37355",10901,"Marystown","NL",47.09899,-55.19852,2018-04-07 01:00:00,39,0,39
"37356",10901,"Marystown","NL",47.09899,-55.19852,2018-04-07 02:00:00,39,1,40
"37357",10901,"Marystown","NL",47.09899,-55.19852,2018-04-07 03:00:00,38,2,40
"37358",10901,"Marystown","NL",47.09899,-55.19852,2018-04-07 04:00:00,37,1,38
"37359",10901,"Marystown","NL",47.09899,-55.19852,2018-04-07 05:00:00,40,0,40
"37360",10901,"Marystown","NL",47.09899,-55.19852,2018-04-07 06:00:00,43,1,44
"37361",10901,"Marystown","NL",47.09899,-55.19852,2018-04-07 07:00:00,45,0,45
"37362",10901,"Marystown","NL",47.09899,-55.19852,2018-04-07 08:00:00,44,1,45
"37363",10901,"Marystown","NL",47.09899,-55.19852,2018-04-07 09:00:00,45,1,46
"37364",10901,"Marystown","NL",47.09899,-55.19852,2018-04-07 10:00:00,44,1,45
"37365",10901,"Marystown","NL",47.09899,-55.19852,2018-04-07 11:00:00,44,1,45
"37366",10901,"Marystown","NL",47.09899,-55.19852,2018-04-07 12:00:00,43,1,44
"37367",10901,"Marystown","NL",47.09899,-55.19852,2018-04-07 13:00:00,45,1,46
"37368",10901,"Marystown","NL",47.09899,-55.19852,2018-04-07 14:00:00,47,0,47
"37369",10901,"Marystown","NL",47.09899,-55.19852,2018-04-07 15:00:00,48,0,48
"37370",10901,"Marystown","NL",47.09899,-55.19852,2018-04-07 16:00:00,47,1,48
"37371",10901,"Marystown","NL",47.09899,-55.19852,2018-04-07 17:00:00,46,1,47
"37372",10901,"Marystown","NL",47.09899,-55.19852,2018-04-07 18:00:00,46,0,46
"37373",10901,"Marystown","NL",47.09899,-55.19852,2018-04-07 19:00:00,48,0,48
"37374",10901,"Marystown","NL",47.09899,-55.19852,2018-04-07 20:00:00,47,0,47
"37375",10901,"Marystown","NL",47.09899,-55.19852,2018-04-07 21:00:00,45,0,45
"37376",10901,"Marystown","NL",47.09899,-55.19852,2018-04-07 22:00:00,46,1,47
"37377",10901,"Marystown","NL",47.09899,-55.19852,2018-04-07 23:00:00,47,0,47
"37378",10901,"Marystown","NL",47.09899,-55.19852,2018-04-08 00:00:00,45,1,46
"37379",10901,"Marystown","NL",47.09899,-55.19852,2018-04-08 01:00:00,44,0,44
"37380",10901,"Marystown","NL",47.09899,-55.19852,2018-04-08 02:00:00,44,0,44
"37381",10901,"Marystown","NL",47.09899,-55.19852,2018-04-08 03:00:00,42,0,42
"37382",10901,"Marystown","NL",47.09899,-55.19852,2018-04-08 04:00:00,41,0,41
"37383",10901,"Marystown","NL",47.09899,-55.19852,2018-04-08 05:00:00,37,1,38
"37384",10901,"Marystown","NL",47.09899,-55.19852,2018-04-08 06:00:00,30,1,31
"37385",10901,"Marystown","NL",47.09899,-55.19852,2018-04-08 07:00:00,25,1,26
"37386",10901,"Marystown","NL",47.09899,-55.19852,2018-04-08 08:00:00,30,1,31
"37387",10901,"Marystown","NL",47.09899,-55.19852,2018-04-08 09:00:00,37,1,38
"37388",10901,"Marystown","NL",47.09899,-55.19852,2018-04-08 10:00:00,39,1,40
"37389",10901,"Marystown","NL",47.09899,-55.19852,2018-04-08 11:00:00,40,1,41
"37390",10901,"Marystown","NL",47.09899,-55.19852,2018-04-08 12:00:00,41,1,42
"37391",10901,"Marystown","NL",47.09899,-55.19852,2018-04-08 13:00:00,44,1,45
"37392",10901,"Marystown","NL",47.09899,-55.19852,2018-04-08 14:00:00,44,1,45
"37393",10901,"Marystown","NL",47.09899,-55.19852,2018-04-08 15:00:00,43,1,44
"37394",10901,"Marystown","NL",47.09899,-55.19852,2018-04-08 16:00:00,42,1,43
"37395",10901,"Marystown","NL",47.09899,-55.19852,2018-04-08 17:00:00,42,1,43
"37396",10901,"Marystown","NL",47.09899,-55.19852,2018-04-08 18:00:00,39,0,39
"37397",10901,"Marystown","NL",47.09899,-55.19852,2018-04-08 19:00:00,40,0,40
"37398",10901,"Marystown","NL",47.09899,-55.19852,2018-04-08 20:00:00,41,0,41
"37399",10901,"Marystown","NL",47.09899,-55.19852,2018-04-08 21:00:00,42,1,43
"37400",10901,"Marystown","NL",47.09899,-55.19852,2018-04-08 22:00:00,43,0,43
"37401",10901,"Marystown","NL",47.09899,-55.19852,2018-04-08 23:00:00,45,0,45
"37402",10901,"Marystown","NL",47.09899,-55.19852,2018-04-09 00:00:00,48,0,48
"37403",10901,"Marystown","NL",47.09899,-55.19852,2018-04-09 01:00:00,36,0,36
"37404",10901,"Marystown","NL",47.09899,-55.19852,2018-04-09 02:00:00,20,0,20
"37405",10901,"Marystown","NL",47.09899,-55.19852,2018-04-09 03:00:00,20,0,20
"37406",10901,"Marystown","NL",47.09899,-55.19852,2018-04-09 04:00:00,22,0,22
"37407",10901,"Marystown","NL",47.09899,-55.19852,2018-04-09 05:00:00,25,0,25
"37408",10901,"Marystown","NL",47.09899,-55.19852,2018-04-09 06:00:00,34,0,34
"37409",10901,"Marystown","NL",47.09899,-55.19852,2018-04-09 07:00:00,39,0,39
"37410",10901,"Marystown","NL",47.09899,-55.19852,2018-04-09 08:00:00,41,0,41
"37411",10901,"Marystown","NL",47.09899,-55.19852,2018-04-09 09:00:00,42,0,42
"37412",10901,"Marystown","NL",47.09899,-55.19852,2018-04-09 10:00:00,43,0,43
"37413",10901,"Marystown","NL",47.09899,-55.19852,2018-04-09 11:00:00,43,0,43
"37414",10901,"Marystown","NL",47.09899,-55.19852,2018-04-09 12:00:00,42,0,42
"37415",10901,"Marystown","NL",47.09899,-55.19852,2018-04-09 13:00:00,41,0,41
"37416",10901,"Marystown","NL",47.09899,-55.19852,2018-04-09 14:00:00,39,0,39
"37417",10901,"Marystown","NL",47.09899,-55.19852,2018-04-09 15:00:00,38,0,38
"37418",10901,"Marystown","NL",47.09899,-55.19852,2018-04-09 16:00:00,38,0,38
"37419",10901,"Marystown","NL",47.09899,-55.19852,2018-04-09 17:00:00,38,0,38
"37420",10901,"Marystown","NL",47.09899,-55.19852,2018-04-09 18:00:00,38,0,38
"37421",10901,"Marystown","NL",47.09899,-55.19852,2018-04-09 19:00:00,38,0,38
"37422",10901,"Marystown","NL",47.09899,-55.19852,2018-04-09 20:00:00,38,0,38
"37423",10901,"Marystown","NL",47.09899,-55.19852,2018-04-09 21:00:00,38,0,38
"37424",10901,"Marystown","NL",47.09899,-55.19852,2018-04-09 22:00:00,38,0,38
"37425",10901,"Marystown","NL",47.09899,-55.19852,2018-04-09 23:00:00,38,0,38
"37426",10901,"Marystown","NL",47.09899,-55.19852,2018-04-10 00:00:00,38,0,38
"37427",10901,"Marystown","NL",47.09899,-55.19852,2018-04-10 01:00:00,38,0,38
"37428",10901,"Marystown","NL",47.09899,-55.19852,2018-04-10 02:00:00,39,0,39
"37429",10901,"Marystown","NL",47.09899,-55.19852,2018-04-10 03:00:00,41,0,41
"37430",10901,"Marystown","NL",47.09899,-55.19852,2018-04-10 04:00:00,40,0,40
"37431",10901,"Marystown","NL",47.09899,-55.19852,2018-04-10 05:00:00,40,0,40
"37432",10901,"Marystown","NL",47.09899,-55.19852,2018-04-10 06:00:00,39,0,39
"37433",10901,"Marystown","NL",47.09899,-55.19852,2018-04-10 07:00:00,38,0,38
"37434",10901,"Marystown","NL",47.09899,-55.19852,2018-04-10 08:00:00,37,0,37
"37435",10901,"Marystown","NL",47.09899,-55.19852,2018-04-10 09:00:00,37,0,37
"37436",10901,"Marystown","NL",47.09899,-55.19852,2018-04-10 10:00:00,37,0,37
"37437",10901,"Marystown","NL",47.09899,-55.19852,2018-04-10 11:00:00,37,0,37
"37438",10901,"Marystown","NL",47.09899,-55.19852,2018-04-10 12:00:00,37,0,37
"37439",10901,"Marystown","NL",47.09899,-55.19852,2018-04-10 13:00:00,37,0,37
"37440",10901,"Marystown","NL",47.09899,-55.19852,2018-04-10 14:00:00,37,0,37
"37441",10901,"Marystown","NL",47.09899,-55.19852,2018-04-10 15:00:00,37,0,37
"37442",10901,"Marystown","NL",47.09899,-55.19852,2018-04-10 16:00:00,37,0,37
"37443",10901,"Marystown","NL",47.09899,-55.19852,2018-04-10 17:00:00,38,0,38
"37444",10901,"Marystown","NL",47.09899,-55.19852,2018-04-10 18:00:00,38,0,38
"37445",10901,"Marystown","NL",47.09899,-55.19852,2018-04-10 19:00:00,39,0,39
"37446",10901,"Marystown","NL",47.09899,-55.19852,2018-04-10 20:00:00,38,0,38
"37447",10901,"Marystown","NL",47.09899,-55.19852,2018-04-10 21:00:00,37,0,37
"37448",10901,"Marystown","NL",47.09899,-55.19852,2018-04-10 22:00:00,36,0,36
"37449",10901,"Marystown","NL",47.09899,-55.19852,2018-04-10 23:00:00,36,0,36
"37450",10901,"Marystown","NL",47.09899,-55.19852,2018-04-11 00:00:00,35,0,35
"37451",10901,"Marystown","NL",47.09899,-55.19852,2018-04-11 01:00:00,35,0,35
"37452",10901,"Marystown","NL",47.09899,-55.19852,2018-04-11 02:00:00,34,0,34
"37453",10901,"Marystown","NL",47.09899,-55.19852,2018-04-11 03:00:00,29,0,29
"37454",10901,"Marystown","NL",47.09899,-55.19852,2018-04-11 04:00:00,30,0,30
"37455",10901,"Marystown","NL",47.09899,-55.19852,2018-04-11 05:00:00,29,0,29
"37456",10901,"Marystown","NL",47.09899,-55.19852,2018-04-11 06:00:00,22,2,24
"37457",10901,"Marystown","NL",47.09899,-55.19852,2018-04-11 07:00:00,21,3,24
"37458",10901,"Marystown","NL",47.09899,-55.19852,2018-04-11 08:00:00,27,2,29
"37459",10901,"Marystown","NL",47.09899,-55.19852,2018-04-11 09:00:00,31,1,32
"37460",10901,"Marystown","NL",47.09899,-55.19852,2018-04-11 10:00:00,33,2,35
"37461",10901,"Marystown","NL",47.09899,-55.19852,2018-04-11 11:00:00,34,1,35
"37462",10901,"Marystown","NL",47.09899,-55.19852,2018-04-11 12:00:00,34,1,35
"37463",10901,"Marystown","NL",47.09899,-55.19852,2018-04-11 13:00:00,36,1,37
"37464",10901,"Marystown","NL",47.09899,-55.19852,2018-04-11 14:00:00,36,1,37
"37465",10901,"Marystown","NL",47.09899,-55.19852,2018-04-11 15:00:00,35,1,36
"37466",10901,"Marystown","NL",47.09899,-55.19852,2018-04-11 16:00:00,36,0,36
"37467",10901,"Marystown","NL",47.09899,-55.19852,2018-04-11 17:00:00,38,0,38
"37468",10901,"Marystown","NL",47.09899,-55.19852,2018-04-11 18:00:00,38,1,39
"37469",10901,"Marystown","NL",47.09899,-55.19852,2018-04-11 19:00:00,38,1,39
"37470",10901,"Marystown","NL",47.09899,-55.19852,2018-04-11 20:00:00,33,1,34
"37471",10901,"Marystown","NL",47.09899,-55.19852,2018-04-11 21:00:00,25,2,27
"37472",10901,"Marystown","NL",47.09899,-55.19852,2018-04-11 22:00:00,22,1,23
"37473",10901,"Marystown","NL",47.09899,-55.19852,2018-04-11 23:00:00,19,1,20
"37474",10901,"Marystown","NL",47.09899,-55.19852,2018-04-12 00:00:00,14,2,16
"37475",10901,"Marystown","NL",47.09899,-55.19852,2018-04-12 01:00:00,18,1,19
"37476",10901,"Marystown","NL",47.09899,-55.19852,2018-04-12 02:00:00,24,0,24
"37477",10901,"Marystown","NL",47.09899,-55.19852,2018-04-12 03:00:00,27,1,28
"37478",10901,"Marystown","NL",47.09899,-55.19852,2018-04-12 04:00:00,28,0,28
"37479",10901,"Marystown","NL",47.09899,-55.19852,2018-04-12 05:00:00,23,1,24
"37480",10901,"Marystown","NL",47.09899,-55.19852,2018-04-12 06:00:00,17,2,19
"37481",10901,"Marystown","NL",47.09899,-55.19852,2018-04-12 07:00:00,15,3,18
"37482",10901,"Marystown","NL",47.09899,-55.19852,2018-04-12 08:00:00,20,5,25
"37483",10901,"Marystown","NL",47.09899,-55.19852,2018-04-12 09:00:00,31,1,32
"37484",10901,"Marystown","NL",47.09899,-55.19852,2018-04-12 10:00:00,32,0,32
"37485",10901,"Marystown","NL",47.09899,-55.19852,2018-04-12 11:00:00,29,1,30
"37486",10901,"Marystown","NL",47.09899,-55.19852,2018-04-12 12:00:00,NA,2,NA
"37487",10901,"Marystown","NL",47.09899,-55.19852,2018-04-12 13:00:00,25,4,29
"37488",10901,"Marystown","NL",47.09899,-55.19852,2018-04-12 14:00:00,30,4,34
"37489",10901,"Marystown","NL",47.09899,-55.19852,2018-04-12 15:00:00,38,2,40
"37490",10901,"Marystown","NL",47.09899,-55.19852,2018-04-12 16:00:00,40,0,40
"37491",10901,"Marystown","NL",47.09899,-55.19852,2018-04-12 17:00:00,40,0,40
"37492",10901,"Marystown","NL",47.09899,-55.19852,2018-04-12 18:00:00,40,1,41
"37493",10901,"Marystown","NL",47.09899,-55.19852,2018-04-12 19:00:00,39,0,39
"37494",10901,"Marystown","NL",47.09899,-55.19852,2018-04-12 20:00:00,36,0,36
"37495",10901,"Marystown","NL",47.09899,-55.19852,2018-04-12 21:00:00,30,1,31
"37496",10901,"Marystown","NL",47.09899,-55.19852,2018-04-12 22:00:00,33,1,34
"37497",10901,"Marystown","NL",47.09899,-55.19852,2018-04-12 23:00:00,32,0,32
"37498",10901,"Marystown","NL",47.09899,-55.19852,2018-04-13 00:00:00,29,1,30
"37499",10901,"Marystown","NL",47.09899,-55.19852,2018-04-13 01:00:00,26,0,26
"37500",10901,"Marystown","NL",47.09899,-55.19852,2018-04-13 02:00:00,23,0,23
"37501",10901,"Marystown","NL",47.09899,-55.19852,2018-04-13 03:00:00,23,0,23
"37502",10901,"Marystown","NL",47.09899,-55.19852,2018-04-13 04:00:00,22,0,22
"37503",10901,"Marystown","NL",47.09899,-55.19852,2018-04-13 05:00:00,22,0,22
"37504",10901,"Marystown","NL",47.09899,-55.19852,2018-04-13 06:00:00,22,1,23
"37505",10901,"Marystown","NL",47.09899,-55.19852,2018-04-13 07:00:00,19,5,24
"37506",10901,"Marystown","NL",47.09899,-55.19852,2018-04-13 08:00:00,32,2,34
"37507",10901,"Marystown","NL",47.09899,-55.19852,2018-04-13 09:00:00,38,1,39
"37508",10901,"Marystown","NL",47.09899,-55.19852,2018-04-13 10:00:00,39,0,39
"37509",10901,"Marystown","NL",47.09899,-55.19852,2018-04-13 11:00:00,40,0,40
"37510",10901,"Marystown","NL",47.09899,-55.19852,2018-04-13 12:00:00,39,0,39
"37511",10901,"Marystown","NL",47.09899,-55.19852,2018-04-13 13:00:00,39,0,39
"37512",10901,"Marystown","NL",47.09899,-55.19852,2018-04-13 14:00:00,38,1,39
"37513",10901,"Marystown","NL",47.09899,-55.19852,2018-04-13 15:00:00,37,0,37
"37514",10901,"Marystown","NL",47.09899,-55.19852,2018-04-13 16:00:00,38,0,38
"37515",10901,"Marystown","NL",47.09899,-55.19852,2018-04-13 17:00:00,40,0,40
"37516",10901,"Marystown","NL",47.09899,-55.19852,2018-04-13 18:00:00,41,0,41
"37517",10901,"Marystown","NL",47.09899,-55.19852,2018-04-13 19:00:00,40,0,40
"37518",10901,"Marystown","NL",47.09899,-55.19852,2018-04-13 20:00:00,40,0,40
"37519",10901,"Marystown","NL",47.09899,-55.19852,2018-04-13 21:00:00,40,0,40
"37520",10901,"Marystown","NL",47.09899,-55.19852,2018-04-13 22:00:00,41,0,41
"37521",10901,"Marystown","NL",47.09899,-55.19852,2018-04-13 23:00:00,42,0,42
"37522",10901,"Marystown","NL",47.09899,-55.19852,2018-04-14 00:00:00,47,0,47
"37523",10901,"Marystown","NL",47.09899,-55.19852,2018-04-14 01:00:00,44,0,44
"37524",10901,"Marystown","NL",47.09899,-55.19852,2018-04-14 02:00:00,44,0,44
"37525",10901,"Marystown","NL",47.09899,-55.19852,2018-04-14 03:00:00,45,0,45
"37526",10901,"Marystown","NL",47.09899,-55.19852,2018-04-14 04:00:00,45,0,45
"37527",10901,"Marystown","NL",47.09899,-55.19852,2018-04-14 05:00:00,45,0,45
"37528",10901,"Marystown","NL",47.09899,-55.19852,2018-04-14 06:00:00,48,0,48
"37529",10901,"Marystown","NL",47.09899,-55.19852,2018-04-14 07:00:00,49,0,49
"37530",10901,"Marystown","NL",47.09899,-55.19852,2018-04-14 08:00:00,48,0,48
"37531",10901,"Marystown","NL",47.09899,-55.19852,2018-04-14 09:00:00,46,1,47
"37532",10901,"Marystown","NL",47.09899,-55.19852,2018-04-14 10:00:00,45,1,46
"37533",10901,"Marystown","NL",47.09899,-55.19852,2018-04-14 11:00:00,44,1,45
"37534",10901,"Marystown","NL",47.09899,-55.19852,2018-04-14 12:00:00,43,1,44
"37535",10901,"Marystown","NL",47.09899,-55.19852,2018-04-14 13:00:00,43,1,44
"37536",10901,"Marystown","NL",47.09899,-55.19852,2018-04-14 14:00:00,43,1,44
"37537",10901,"Marystown","NL",47.09899,-55.19852,2018-04-14 15:00:00,45,1,46
"37538",10901,"Marystown","NL",47.09899,-55.19852,2018-04-14 16:00:00,43,0,43
"37539",10901,"Marystown","NL",47.09899,-55.19852,2018-04-14 17:00:00,45,0,45
"37540",10901,"Marystown","NL",47.09899,-55.19852,2018-04-14 18:00:00,47,0,47
"37541",10901,"Marystown","NL",47.09899,-55.19852,2018-04-14 19:00:00,47,0,47
"37542",10901,"Marystown","NL",47.09899,-55.19852,2018-04-14 20:00:00,43,0,43
"37543",10901,"Marystown","NL",47.09899,-55.19852,2018-04-14 21:00:00,40,0,40
"37544",10901,"Marystown","NL",47.09899,-55.19852,2018-04-14 22:00:00,41,0,41
"37545",10901,"Marystown","NL",47.09899,-55.19852,2018-04-14 23:00:00,38,0,38
"37546",10901,"Marystown","NL",47.09899,-55.19852,2018-04-15 00:00:00,39,0,39
"37547",10901,"Marystown","NL",47.09899,-55.19852,2018-04-15 01:00:00,40,0,40
"37548",10901,"Marystown","NL",47.09899,-55.19852,2018-04-15 02:00:00,41,0,41
"37549",10901,"Marystown","NL",47.09899,-55.19852,2018-04-15 03:00:00,40,0,40
"37550",10901,"Marystown","NL",47.09899,-55.19852,2018-04-15 04:00:00,40,0,40
"37551",10901,"Marystown","NL",47.09899,-55.19852,2018-04-15 05:00:00,39,0,39
"37552",10901,"Marystown","NL",47.09899,-55.19852,2018-04-15 06:00:00,39,0,39
"37553",10901,"Marystown","NL",47.09899,-55.19852,2018-04-15 07:00:00,38,0,38
"37554",10901,"Marystown","NL",47.09899,-55.19852,2018-04-15 08:00:00,38,0,38
"37555",10901,"Marystown","NL",47.09899,-55.19852,2018-04-15 09:00:00,37,0,37
"37556",10901,"Marystown","NL",47.09899,-55.19852,2018-04-15 10:00:00,37,0,37
"37557",10901,"Marystown","NL",47.09899,-55.19852,2018-04-15 11:00:00,37,0,37
"37558",10901,"Marystown","NL",47.09899,-55.19852,2018-04-15 12:00:00,35,0,35
"37559",10901,"Marystown","NL",47.09899,-55.19852,2018-04-15 13:00:00,34,0,34
"37560",10901,"Marystown","NL",47.09899,-55.19852,2018-04-15 14:00:00,33,0,33
"37561",10901,"Marystown","NL",47.09899,-55.19852,2018-04-15 15:00:00,32,0,32
"37562",10901,"Marystown","NL",47.09899,-55.19852,2018-04-15 16:00:00,32,0,32
"37563",10901,"Marystown","NL",47.09899,-55.19852,2018-04-15 17:00:00,36,0,36
"37564",10901,"Marystown","NL",47.09899,-55.19852,2018-04-15 18:00:00,37,0,37
"37565",10901,"Marystown","NL",47.09899,-55.19852,2018-04-15 19:00:00,38,0,38
"37566",10901,"Marystown","NL",47.09899,-55.19852,2018-04-15 20:00:00,39,0,39
"37567",10901,"Marystown","NL",47.09899,-55.19852,2018-04-15 21:00:00,38,0,38
"37568",10901,"Marystown","NL",47.09899,-55.19852,2018-04-15 22:00:00,36,0,36
"37569",10901,"Marystown","NL",47.09899,-55.19852,2018-04-15 23:00:00,35,0,35
"37570",10901,"Marystown","NL",47.09899,-55.19852,2018-04-16 00:00:00,31,0,31
"37571",10901,"Marystown","NL",47.09899,-55.19852,2018-04-16 01:00:00,32,0,32
"37572",10901,"Marystown","NL",47.09899,-55.19852,2018-04-16 02:00:00,32,0,32
"37573",10901,"Marystown","NL",47.09899,-55.19852,2018-04-16 03:00:00,32,0,32
"37574",10901,"Marystown","NL",47.09899,-55.19852,2018-04-16 04:00:00,32,0,32
"37575",10901,"Marystown","NL",47.09899,-55.19852,2018-04-16 05:00:00,32,0,32
"37576",10901,"Marystown","NL",47.09899,-55.19852,2018-04-16 06:00:00,30,0,30
"37577",10901,"Marystown","NL",47.09899,-55.19852,2018-04-16 07:00:00,29,0,29
"37578",10901,"Marystown","NL",47.09899,-55.19852,2018-04-16 08:00:00,31,0,31
"37579",10901,"Marystown","NL",47.09899,-55.19852,2018-04-16 09:00:00,32,0,32
"37580",10901,"Marystown","NL",47.09899,-55.19852,2018-04-16 10:00:00,34,0,34
"37581",10901,"Marystown","NL",47.09899,-55.19852,2018-04-16 11:00:00,34,0,34
"37582",10901,"Marystown","NL",47.09899,-55.19852,2018-04-16 12:00:00,34,0,34
"37583",10901,"Marystown","NL",47.09899,-55.19852,2018-04-16 13:00:00,36,0,36
"37584",10901,"Marystown","NL",47.09899,-55.19852,2018-04-16 14:00:00,39,0,39
"37585",10901,"Marystown","NL",47.09899,-55.19852,2018-04-16 15:00:00,40,1,41
"37586",10901,"Marystown","NL",47.09899,-55.19852,2018-04-16 16:00:00,43,0,43
"37587",10901,"Marystown","NL",47.09899,-55.19852,2018-04-16 17:00:00,44,0,44
"37588",10901,"Marystown","NL",47.09899,-55.19852,2018-04-16 18:00:00,45,0,45
"37589",10901,"Marystown","NL",47.09899,-55.19852,2018-04-16 19:00:00,45,0,45
"37590",10901,"Marystown","NL",47.09899,-55.19852,2018-04-16 20:00:00,44,0,44
"37591",10901,"Marystown","NL",47.09899,-55.19852,2018-04-16 21:00:00,43,0,43
"37592",10901,"Marystown","NL",47.09899,-55.19852,2018-04-16 22:00:00,42,0,42
"37593",10901,"Marystown","NL",47.09899,-55.19852,2018-04-16 23:00:00,42,0,42
"37594",10901,"Marystown","NL",47.09899,-55.19852,2018-04-17 00:00:00,38,0,38
"37595",10901,"Marystown","NL",47.09899,-55.19852,2018-04-17 01:00:00,35,1,36
"37596",10901,"Marystown","NL",47.09899,-55.19852,2018-04-17 02:00:00,36,1,37
"37597",10901,"Marystown","NL",47.09899,-55.19852,2018-04-17 03:00:00,34,1,35
"37598",10901,"Marystown","NL",47.09899,-55.19852,2018-04-17 04:00:00,32,1,33
"37599",10901,"Marystown","NL",47.09899,-55.19852,2018-04-17 05:00:00,29,1,30
"37600",10901,"Marystown","NL",47.09899,-55.19852,2018-04-17 06:00:00,27,2,29
"37601",10901,"Marystown","NL",47.09899,-55.19852,2018-04-17 07:00:00,29,2,31
"37602",10901,"Marystown","NL",47.09899,-55.19852,2018-04-17 08:00:00,34,2,36
"37603",10901,"Marystown","NL",47.09899,-55.19852,2018-04-17 09:00:00,40,0,40
"37604",10901,"Marystown","NL",47.09899,-55.19852,2018-04-17 10:00:00,43,0,43
"37605",10901,"Marystown","NL",47.09899,-55.19852,2018-04-17 11:00:00,45,0,45
"37606",10901,"Marystown","NL",47.09899,-55.19852,2018-04-17 12:00:00,46,1,47
"37607",10901,"Marystown","NL",47.09899,-55.19852,2018-04-17 13:00:00,44,1,45
"37608",10901,"Marystown","NL",47.09899,-55.19852,2018-04-17 14:00:00,45,0,45
"37609",10901,"Marystown","NL",47.09899,-55.19852,2018-04-17 15:00:00,46,1,47
"37610",10901,"Marystown","NL",47.09899,-55.19852,2018-04-17 16:00:00,47,0,47
"37611",10901,"Marystown","NL",47.09899,-55.19852,2018-04-17 17:00:00,47,0,47
"37612",10901,"Marystown","NL",47.09899,-55.19852,2018-04-17 18:00:00,46,1,47
"37613",10901,"Marystown","NL",47.09899,-55.19852,2018-04-17 19:00:00,44,1,45
"37614",10901,"Marystown","NL",47.09899,-55.19852,2018-04-17 20:00:00,43,1,44
"37615",10901,"Marystown","NL",47.09899,-55.19852,2018-04-17 21:00:00,45,1,46
"37616",10901,"Marystown","NL",47.09899,-55.19852,2018-04-17 22:00:00,46,0,46
"37617",10901,"Marystown","NL",47.09899,-55.19852,2018-04-17 23:00:00,45,0,45
"37618",10901,"Marystown","NL",47.09899,-55.19852,2018-04-18 00:00:00,45,1,46
"37619",10901,"Marystown","NL",47.09899,-55.19852,2018-04-18 01:00:00,45,0,45
"37620",10901,"Marystown","NL",47.09899,-55.19852,2018-04-18 02:00:00,45,0,45
"37621",10901,"Marystown","NL",47.09899,-55.19852,2018-04-18 03:00:00,45,1,46
"37622",10901,"Marystown","NL",47.09899,-55.19852,2018-04-18 04:00:00,46,1,47
"37623",10901,"Marystown","NL",47.09899,-55.19852,2018-04-18 05:00:00,46,0,46
"37624",10901,"Marystown","NL",47.09899,-55.19852,2018-04-18 06:00:00,46,0,46
"37625",10901,"Marystown","NL",47.09899,-55.19852,2018-04-18 07:00:00,45,1,46
"37626",10901,"Marystown","NL",47.09899,-55.19852,2018-04-18 08:00:00,45,1,46
"37627",10901,"Marystown","NL",47.09899,-55.19852,2018-04-18 09:00:00,44,1,45
"37628",10901,"Marystown","NL",47.09899,-55.19852,2018-04-18 10:00:00,44,1,45
"37629",10901,"Marystown","NL",47.09899,-55.19852,2018-04-18 11:00:00,43,1,44
"37630",10901,"Marystown","NL",47.09899,-55.19852,2018-04-18 12:00:00,43,0,43
"37631",10901,"Marystown","NL",47.09899,-55.19852,2018-04-18 13:00:00,42,1,43
"37632",10901,"Marystown","NL",47.09899,-55.19852,2018-04-18 14:00:00,39,1,40
"37633",10901,"Marystown","NL",47.09899,-55.19852,2018-04-18 15:00:00,37,0,37
"37634",10901,"Marystown","NL",47.09899,-55.19852,2018-04-18 16:00:00,36,0,36
"37635",10901,"Marystown","NL",47.09899,-55.19852,2018-04-18 17:00:00,36,0,36
"37636",10901,"Marystown","NL",47.09899,-55.19852,2018-04-18 18:00:00,40,1,41
"37637",10901,"Marystown","NL",47.09899,-55.19852,2018-04-18 19:00:00,41,1,42
"37638",10901,"Marystown","NL",47.09899,-55.19852,2018-04-18 20:00:00,41,1,42
"37639",10901,"Marystown","NL",47.09899,-55.19852,2018-04-18 21:00:00,41,1,42
"37640",10901,"Marystown","NL",47.09899,-55.19852,2018-04-18 22:00:00,41,1,42
"37641",10901,"Marystown","NL",47.09899,-55.19852,2018-04-18 23:00:00,40,0,40
"37642",10901,"Marystown","NL",47.09899,-55.19852,2018-04-19 00:00:00,40,1,41
"37643",10901,"Marystown","NL",47.09899,-55.19852,2018-04-19 01:00:00,40,0,40
"37644",10901,"Marystown","NL",47.09899,-55.19852,2018-04-19 02:00:00,40,0,40
"37645",10901,"Marystown","NL",47.09899,-55.19852,2018-04-19 03:00:00,41,0,41
"37646",10901,"Marystown","NL",47.09899,-55.19852,2018-04-19 04:00:00,41,0,41
"37647",10901,"Marystown","NL",47.09899,-55.19852,2018-04-19 05:00:00,41,0,41
"37648",10901,"Marystown","NL",47.09899,-55.19852,2018-04-19 06:00:00,39,1,40
"37649",10901,"Marystown","NL",47.09899,-55.19852,2018-04-19 07:00:00,38,0,38
"37650",10901,"Marystown","NL",47.09899,-55.19852,2018-04-19 08:00:00,36,1,37
"37651",10901,"Marystown","NL",47.09899,-55.19852,2018-04-19 09:00:00,33,1,34
"37652",10901,"Marystown","NL",47.09899,-55.19852,2018-04-19 10:00:00,33,1,34
"37653",10901,"Marystown","NL",47.09899,-55.19852,2018-04-19 11:00:00,34,0,34
"37654",10901,"Marystown","NL",47.09899,-55.19852,2018-04-19 12:00:00,34,0,34
"37655",10901,"Marystown","NL",47.09899,-55.19852,2018-04-19 13:00:00,34,0,34
"37656",10901,"Marystown","NL",47.09899,-55.19852,2018-04-19 14:00:00,33,0,33
"37657",10901,"Marystown","NL",47.09899,-55.19852,2018-04-19 15:00:00,34,0,34
"37658",10901,"Marystown","NL",47.09899,-55.19852,2018-04-19 16:00:00,34,0,34
"37659",10901,"Marystown","NL",47.09899,-55.19852,2018-04-19 17:00:00,34,0,34
"37660",10901,"Marystown","NL",47.09899,-55.19852,2018-04-19 18:00:00,35,0,35
"37661",10901,"Marystown","NL",47.09899,-55.19852,2018-04-19 19:00:00,35,0,35
"37662",10901,"Marystown","NL",47.09899,-55.19852,2018-04-19 20:00:00,34,0,34
"37663",10901,"Marystown","NL",47.09899,-55.19852,2018-04-19 21:00:00,33,0,33
"37664",10901,"Marystown","NL",47.09899,-55.19852,2018-04-19 22:00:00,31,1,32
"37665",10901,"Marystown","NL",47.09899,-55.19852,2018-04-19 23:00:00,21,1,22
"37666",10901,"Marystown","NL",47.09899,-55.19852,2018-04-20 00:00:00,23,0,23
"37667",10901,"Marystown","NL",47.09899,-55.19852,2018-04-20 01:00:00,31,0,31
"37668",10901,"Marystown","NL",47.09899,-55.19852,2018-04-20 02:00:00,30,1,31
"37669",10901,"Marystown","NL",47.09899,-55.19852,2018-04-20 03:00:00,24,0,24
"37670",10901,"Marystown","NL",47.09899,-55.19852,2018-04-20 04:00:00,28,0,28
"37671",10901,"Marystown","NL",47.09899,-55.19852,2018-04-20 05:00:00,31,0,31
"37672",10901,"Marystown","NL",47.09899,-55.19852,2018-04-20 06:00:00,33,0,33
"37673",10901,"Marystown","NL",47.09899,-55.19852,2018-04-20 07:00:00,34,0,34
"37674",10901,"Marystown","NL",47.09899,-55.19852,2018-04-20 08:00:00,34,0,34
"37675",10901,"Marystown","NL",47.09899,-55.19852,2018-04-20 09:00:00,32,0,32
"37676",10901,"Marystown","NL",47.09899,-55.19852,2018-04-20 10:00:00,29,0,29
"37677",10901,"Marystown","NL",47.09899,-55.19852,2018-04-20 11:00:00,29,0,29
"37678",10901,"Marystown","NL",47.09899,-55.19852,2018-04-20 12:00:00,31,1,32
"37679",10901,"Marystown","NL",47.09899,-55.19852,2018-04-20 13:00:00,32,1,33
"37680",10901,"Marystown","NL",47.09899,-55.19852,2018-04-20 14:00:00,35,1,36
"37681",10901,"Marystown","NL",47.09899,-55.19852,2018-04-20 15:00:00,41,1,42
"37682",10901,"Marystown","NL",47.09899,-55.19852,2018-04-20 16:00:00,40,1,41
"37683",10901,"Marystown","NL",47.09899,-55.19852,2018-04-20 17:00:00,39,0,39
"37684",10901,"Marystown","NL",47.09899,-55.19852,2018-04-20 18:00:00,35,0,35
"37685",10901,"Marystown","NL",47.09899,-55.19852,2018-04-20 19:00:00,33,0,33
"37686",10901,"Marystown","NL",47.09899,-55.19852,2018-04-20 20:00:00,35,0,35
"37687",10901,"Marystown","NL",47.09899,-55.19852,2018-04-20 21:00:00,34,0,34
"37688",10901,"Marystown","NL",47.09899,-55.19852,2018-04-20 22:00:00,33,0,33
"37689",10901,"Marystown","NL",47.09899,-55.19852,2018-04-20 23:00:00,33,0,33
"37690",10901,"Marystown","NL",47.09899,-55.19852,2018-04-21 00:00:00,33,0,33
"37691",10901,"Marystown","NL",47.09899,-55.19852,2018-04-21 01:00:00,33,0,33
"37692",10901,"Marystown","NL",47.09899,-55.19852,2018-04-21 02:00:00,33,0,33
"37693",10901,"Marystown","NL",47.09899,-55.19852,2018-04-21 03:00:00,33,0,33
"37694",10901,"Marystown","NL",47.09899,-55.19852,2018-04-21 04:00:00,33,0,33
"37695",10901,"Marystown","NL",47.09899,-55.19852,2018-04-21 05:00:00,34,0,34
"37696",10901,"Marystown","NL",47.09899,-55.19852,2018-04-21 06:00:00,34,0,34
"37697",10901,"Marystown","NL",47.09899,-55.19852,2018-04-21 07:00:00,35,0,35
"37698",10901,"Marystown","NL",47.09899,-55.19852,2018-04-21 08:00:00,36,0,36
"37699",10901,"Marystown","NL",47.09899,-55.19852,2018-04-21 09:00:00,37,0,37
"37700",10901,"Marystown","NL",47.09899,-55.19852,2018-04-21 10:00:00,38,0,38
"37701",10901,"Marystown","NL",47.09899,-55.19852,2018-04-21 11:00:00,38,0,38
"37702",10901,"Marystown","NL",47.09899,-55.19852,2018-04-21 12:00:00,38,0,38
"37703",10901,"Marystown","NL",47.09899,-55.19852,2018-04-21 13:00:00,38,0,38
"37704",10901,"Marystown","NL",47.09899,-55.19852,2018-04-21 14:00:00,39,0,39
"37705",10901,"Marystown","NL",47.09899,-55.19852,2018-04-21 15:00:00,39,0,39
"37706",10901,"Marystown","NL",47.09899,-55.19852,2018-04-21 16:00:00,40,0,40
"37707",10901,"Marystown","NL",47.09899,-55.19852,2018-04-21 17:00:00,41,0,41
"37708",10901,"Marystown","NL",47.09899,-55.19852,2018-04-21 18:00:00,41,0,41
"37709",10901,"Marystown","NL",47.09899,-55.19852,2018-04-21 19:00:00,41,0,41
"37710",10901,"Marystown","NL",47.09899,-55.19852,2018-04-21 20:00:00,41,0,41
"37711",10901,"Marystown","NL",47.09899,-55.19852,2018-04-21 21:00:00,41,0,41
"37712",10901,"Marystown","NL",47.09899,-55.19852,2018-04-21 22:00:00,41,0,41
"37713",10901,"Marystown","NL",47.09899,-55.19852,2018-04-21 23:00:00,40,0,40
"37714",10901,"Marystown","NL",47.09899,-55.19852,2018-04-22 00:00:00,41,0,41
"37715",10901,"Marystown","NL",47.09899,-55.19852,2018-04-22 01:00:00,41,0,41
"37716",10901,"Marystown","NL",47.09899,-55.19852,2018-04-22 02:00:00,41,0,41
"37717",10901,"Marystown","NL",47.09899,-55.19852,2018-04-22 03:00:00,42,0,42
"37718",10901,"Marystown","NL",47.09899,-55.19852,2018-04-22 04:00:00,42,0,42
"37719",10901,"Marystown","NL",47.09899,-55.19852,2018-04-22 05:00:00,42,0,42
"37720",10901,"Marystown","NL",47.09899,-55.19852,2018-04-22 06:00:00,42,0,42
"37721",10901,"Marystown","NL",47.09899,-55.19852,2018-04-22 07:00:00,42,0,42
"37722",10901,"Marystown","NL",47.09899,-55.19852,2018-04-22 08:00:00,42,0,42
"37723",10901,"Marystown","NL",47.09899,-55.19852,2018-04-22 09:00:00,43,0,43
"37724",10901,"Marystown","NL",47.09899,-55.19852,2018-04-22 10:00:00,44,0,44
"37725",10901,"Marystown","NL",47.09899,-55.19852,2018-04-22 11:00:00,44,0,44
"37726",10901,"Marystown","NL",47.09899,-55.19852,2018-04-22 12:00:00,44,0,44
"37727",10901,"Marystown","NL",47.09899,-55.19852,2018-04-22 13:00:00,43,0,43
"37728",10901,"Marystown","NL",47.09899,-55.19852,2018-04-22 14:00:00,43,0,43
"37729",10901,"Marystown","NL",47.09899,-55.19852,2018-04-22 15:00:00,42,0,42
"37730",10901,"Marystown","NL",47.09899,-55.19852,2018-04-22 16:00:00,42,0,42
"37731",10901,"Marystown","NL",47.09899,-55.19852,2018-04-22 17:00:00,43,0,43
"37732",10901,"Marystown","NL",47.09899,-55.19852,2018-04-22 18:00:00,43,0,43
"37733",10901,"Marystown","NL",47.09899,-55.19852,2018-04-22 19:00:00,43,0,43
"37734",10901,"Marystown","NL",47.09899,-55.19852,2018-04-22 20:00:00,42,0,42
"37735",10901,"Marystown","NL",47.09899,-55.19852,2018-04-22 21:00:00,42,0,42
"37736",10901,"Marystown","NL",47.09899,-55.19852,2018-04-22 22:00:00,41,0,41
"37737",10901,"Marystown","NL",47.09899,-55.19852,2018-04-22 23:00:00,40,0,40
"37738",10901,"Marystown","NL",47.09899,-55.19852,2018-04-23 00:00:00,37,1,38
"37739",10901,"Marystown","NL",47.09899,-55.19852,2018-04-23 01:00:00,34,0,34
"37740",10901,"Marystown","NL",47.09899,-55.19852,2018-04-23 02:00:00,34,0,34
"37741",10901,"Marystown","NL",47.09899,-55.19852,2018-04-23 03:00:00,35,0,35
"37742",10901,"Marystown","NL",47.09899,-55.19852,2018-04-23 04:00:00,37,0,37
"37743",10901,"Marystown","NL",47.09899,-55.19852,2018-04-23 05:00:00,36,0,36
"37744",10901,"Marystown","NL",47.09899,-55.19852,2018-04-23 06:00:00,30,2,32
"37745",10901,"Marystown","NL",47.09899,-55.19852,2018-04-23 07:00:00,30,2,32
"37746",10901,"Marystown","NL",47.09899,-55.19852,2018-04-23 08:00:00,41,0,41
"37747",10901,"Marystown","NL",47.09899,-55.19852,2018-04-23 09:00:00,43,0,43
"37748",10901,"Marystown","NL",47.09899,-55.19852,2018-04-23 10:00:00,45,0,45
"37749",10901,"Marystown","NL",47.09899,-55.19852,2018-04-23 11:00:00,46,0,46
"37750",10901,"Marystown","NL",47.09899,-55.19852,2018-04-23 12:00:00,46,0,46
"37751",10901,"Marystown","NL",47.09899,-55.19852,2018-04-23 13:00:00,46,0,46
"37752",10901,"Marystown","NL",47.09899,-55.19852,2018-04-23 14:00:00,47,0,47
"37753",10901,"Marystown","NL",47.09899,-55.19852,2018-04-23 15:00:00,47,0,47
"37754",10901,"Marystown","NL",47.09899,-55.19852,2018-04-23 16:00:00,47,0,47
"37755",10901,"Marystown","NL",47.09899,-55.19852,2018-04-23 17:00:00,47,0,47
"37756",10901,"Marystown","NL",47.09899,-55.19852,2018-04-23 18:00:00,47,0,47
"37757",10901,"Marystown","NL",47.09899,-55.19852,2018-04-23 19:00:00,47,0,47
"37758",10901,"Marystown","NL",47.09899,-55.19852,2018-04-23 20:00:00,46,0,46
"37759",10901,"Marystown","NL",47.09899,-55.19852,2018-04-23 21:00:00,46,0,46
"37760",10901,"Marystown","NL",47.09899,-55.19852,2018-04-23 22:00:00,45,0,45
"37761",10901,"Marystown","NL",47.09899,-55.19852,2018-04-23 23:00:00,44,0,44
"37762",10901,"Marystown","NL",47.09899,-55.19852,2018-04-24 00:00:00,42,0,42
"37763",10901,"Marystown","NL",47.09899,-55.19852,2018-04-24 01:00:00,41,1,42
"37764",10901,"Marystown","NL",47.09899,-55.19852,2018-04-24 02:00:00,42,1,43
"37765",10901,"Marystown","NL",47.09899,-55.19852,2018-04-24 03:00:00,41,1,42
"37766",10901,"Marystown","NL",47.09899,-55.19852,2018-04-24 04:00:00,41,0,41
"37767",10901,"Marystown","NL",47.09899,-55.19852,2018-04-24 05:00:00,40,0,40
"37768",10901,"Marystown","NL",47.09899,-55.19852,2018-04-24 06:00:00,34,2,36
"37769",10901,"Marystown","NL",47.09899,-55.19852,2018-04-24 07:00:00,42,1,43
"37770",10901,"Marystown","NL",47.09899,-55.19852,2018-04-24 08:00:00,44,0,44
"37771",10901,"Marystown","NL",47.09899,-55.19852,2018-04-24 09:00:00,45,0,45
"37772",10901,"Marystown","NL",47.09899,-55.19852,2018-04-24 10:00:00,46,0,46
"37773",10901,"Marystown","NL",47.09899,-55.19852,2018-04-24 11:00:00,47,0,47
"37774",10901,"Marystown","NL",47.09899,-55.19852,2018-04-24 12:00:00,47,0,47
"37775",10901,"Marystown","NL",47.09899,-55.19852,2018-04-24 13:00:00,48,1,49
"37776",10901,"Marystown","NL",47.09899,-55.19852,2018-04-24 14:00:00,47,1,48
"37777",10901,"Marystown","NL",47.09899,-55.19852,2018-04-24 15:00:00,47,1,48
"37778",10901,"Marystown","NL",47.09899,-55.19852,2018-04-24 16:00:00,47,0,47
"37779",10901,"Marystown","NL",47.09899,-55.19852,2018-04-24 17:00:00,48,1,49
"37780",10901,"Marystown","NL",47.09899,-55.19852,2018-04-24 18:00:00,48,1,49
"37781",10901,"Marystown","NL",47.09899,-55.19852,2018-04-24 19:00:00,47,1,48
"37782",10901,"Marystown","NL",47.09899,-55.19852,2018-04-24 20:00:00,45,1,46
"37783",10901,"Marystown","NL",47.09899,-55.19852,2018-04-24 21:00:00,47,1,48
"37784",10901,"Marystown","NL",47.09899,-55.19852,2018-04-24 22:00:00,47,1,48
"37785",10901,"Marystown","NL",47.09899,-55.19852,2018-04-24 23:00:00,44,1,45
"37786",10901,"Marystown","NL",47.09899,-55.19852,2018-04-25 00:00:00,35,1,36
"37787",10901,"Marystown","NL",47.09899,-55.19852,2018-04-25 01:00:00,27,1,28
"37788",10901,"Marystown","NL",47.09899,-55.19852,2018-04-25 02:00:00,26,1,27
"37789",10901,"Marystown","NL",47.09899,-55.19852,2018-04-25 03:00:00,28,1,29
"37790",10901,"Marystown","NL",47.09899,-55.19852,2018-04-25 04:00:00,26,1,27
"37791",10901,"Marystown","NL",47.09899,-55.19852,2018-04-25 05:00:00,24,1,25
"37792",10901,"Marystown","NL",47.09899,-55.19852,2018-04-25 06:00:00,21,2,23
"37793",10901,"Marystown","NL",47.09899,-55.19852,2018-04-25 07:00:00,23,3,26
"37794",10901,"Marystown","NL",47.09899,-55.19852,2018-04-25 08:00:00,37,1,38
"37795",10901,"Marystown","NL",47.09899,-55.19852,2018-04-25 09:00:00,42,1,43
"37796",10901,"Marystown","NL",47.09899,-55.19852,2018-04-25 10:00:00,47,1,48
"37797",10901,"Marystown","NL",47.09899,-55.19852,2018-04-25 11:00:00,51,1,52
"37798",10901,"Marystown","NL",47.09899,-55.19852,2018-04-25 12:00:00,54,0,54
"37799",10901,"Marystown","NL",47.09899,-55.19852,2018-04-25 13:00:00,55,1,56
"37800",10901,"Marystown","NL",47.09899,-55.19852,2018-04-25 14:00:00,54,1,55
"37801",10901,"Marystown","NL",47.09899,-55.19852,2018-04-25 15:00:00,53,0,53
"37802",10901,"Marystown","NL",47.09899,-55.19852,2018-04-25 16:00:00,52,0,52
"37803",10901,"Marystown","NL",47.09899,-55.19852,2018-04-25 17:00:00,50,0,50
"37804",10901,"Marystown","NL",47.09899,-55.19852,2018-04-25 18:00:00,49,0,49
"37805",10901,"Marystown","NL",47.09899,-55.19852,2018-04-25 19:00:00,48,0,48
"37806",10901,"Marystown","NL",47.09899,-55.19852,2018-04-25 20:00:00,46,0,46
"37807",10901,"Marystown","NL",47.09899,-55.19852,2018-04-25 21:00:00,42,0,42
"37808",10901,"Marystown","NL",47.09899,-55.19852,2018-04-25 22:00:00,40,0,40
"37809",10901,"Marystown","NL",47.09899,-55.19852,2018-04-25 23:00:00,40,0,40
"37810",10901,"Marystown","NL",47.09899,-55.19852,2018-04-26 00:00:00,32,1,33
"37811",10901,"Marystown","NL",47.09899,-55.19852,2018-04-26 01:00:00,32,0,32
"37812",10901,"Marystown","NL",47.09899,-55.19852,2018-04-26 02:00:00,31,1,32
"37813",10901,"Marystown","NL",47.09899,-55.19852,2018-04-26 03:00:00,26,0,26
"37814",10901,"Marystown","NL",47.09899,-55.19852,2018-04-26 04:00:00,36,0,36
"37815",10901,"Marystown","NL",47.09899,-55.19852,2018-04-26 05:00:00,41,0,41
"37816",10901,"Marystown","NL",47.09899,-55.19852,2018-04-26 06:00:00,35,1,36
"37817",10901,"Marystown","NL",47.09899,-55.19852,2018-04-26 07:00:00,45,0,45
"37818",10901,"Marystown","NL",47.09899,-55.19852,2018-04-26 08:00:00,44,0,44
"37819",10901,"Marystown","NL",47.09899,-55.19852,2018-04-26 09:00:00,44,0,44
"37820",10901,"Marystown","NL",47.09899,-55.19852,2018-04-26 10:00:00,44,0,44
"37821",10901,"Marystown","NL",47.09899,-55.19852,2018-04-26 11:00:00,44,0,44
"37822",10901,"Marystown","NL",47.09899,-55.19852,2018-04-26 12:00:00,43,1,44
"37823",10901,"Marystown","NL",47.09899,-55.19852,2018-04-26 13:00:00,36,1,37
"37824",10901,"Marystown","NL",47.09899,-55.19852,2018-04-26 14:00:00,37,1,38
"37825",10901,"Marystown","NL",47.09899,-55.19852,2018-04-26 15:00:00,40,1,41
"37826",10901,"Marystown","NL",47.09899,-55.19852,2018-04-26 16:00:00,40,1,41
"37827",10901,"Marystown","NL",47.09899,-55.19852,2018-04-26 17:00:00,42,1,43
"37828",10901,"Marystown","NL",47.09899,-55.19852,2018-04-26 18:00:00,42,1,43
"37829",10901,"Marystown","NL",47.09899,-55.19852,2018-04-26 19:00:00,43,1,44
"37830",10901,"Marystown","NL",47.09899,-55.19852,2018-04-26 20:00:00,43,0,43
"37831",10901,"Marystown","NL",47.09899,-55.19852,2018-04-26 21:00:00,44,1,45
"37832",10901,"Marystown","NL",47.09899,-55.19852,2018-04-26 22:00:00,44,0,44
"37833",10901,"Marystown","NL",47.09899,-55.19852,2018-04-26 23:00:00,44,0,44
"37834",10901,"Marystown","NL",47.09899,-55.19852,2018-04-27 00:00:00,44,0,44
"37835",10901,"Marystown","NL",47.09899,-55.19852,2018-04-27 01:00:00,44,0,44
"37836",10901,"Marystown","NL",47.09899,-55.19852,2018-04-27 02:00:00,44,0,44
"37837",10901,"Marystown","NL",47.09899,-55.19852,2018-04-27 03:00:00,45,0,45
"37838",10901,"Marystown","NL",47.09899,-55.19852,2018-04-27 04:00:00,46,0,46
"37839",10901,"Marystown","NL",47.09899,-55.19852,2018-04-27 05:00:00,47,0,47
"37840",10901,"Marystown","NL",47.09899,-55.19852,2018-04-27 06:00:00,47,0,47
"37841",10901,"Marystown","NL",47.09899,-55.19852,2018-04-27 07:00:00,47,1,48
"37842",10901,"Marystown","NL",47.09899,-55.19852,2018-04-27 08:00:00,45,1,46
"37843",10901,"Marystown","NL",47.09899,-55.19852,2018-04-27 09:00:00,45,1,46
"37844",10901,"Marystown","NL",47.09899,-55.19852,2018-04-27 10:00:00,45,1,46
"37845",10901,"Marystown","NL",47.09899,-55.19852,2018-04-27 11:00:00,43,1,44
"37846",10901,"Marystown","NL",47.09899,-55.19852,2018-04-27 12:00:00,46,2,48
"37847",10901,"Marystown","NL",47.09899,-55.19852,2018-04-27 13:00:00,46,1,47
"37848",10901,"Marystown","NL",47.09899,-55.19852,2018-04-27 14:00:00,43,1,44
"37849",10901,"Marystown","NL",47.09899,-55.19852,2018-04-27 15:00:00,43,1,44
"37850",10901,"Marystown","NL",47.09899,-55.19852,2018-04-27 16:00:00,42,1,43
"37851",10901,"Marystown","NL",47.09899,-55.19852,2018-04-27 17:00:00,43,0,43
"37852",10901,"Marystown","NL",47.09899,-55.19852,2018-04-27 18:00:00,43,0,43
"37853",10901,"Marystown","NL",47.09899,-55.19852,2018-04-27 19:00:00,40,0,40
"37854",10901,"Marystown","NL",47.09899,-55.19852,2018-04-27 20:00:00,38,0,38
"37855",10901,"Marystown","NL",47.09899,-55.19852,2018-04-27 21:00:00,37,1,38
"37856",10901,"Marystown","NL",47.09899,-55.19852,2018-04-27 22:00:00,34,1,35
"37857",10901,"Marystown","NL",47.09899,-55.19852,2018-04-27 23:00:00,31,0,31
"37858",10901,"Marystown","NL",47.09899,-55.19852,2018-04-28 00:00:00,33,0,33
"37859",10901,"Marystown","NL",47.09899,-55.19852,2018-04-28 01:00:00,30,1,31
"37860",10901,"Marystown","NL",47.09899,-55.19852,2018-04-28 02:00:00,25,1,26
"37861",10901,"Marystown","NL",47.09899,-55.19852,2018-04-28 03:00:00,23,1,24
"37862",10901,"Marystown","NL",47.09899,-55.19852,2018-04-28 04:00:00,31,0,31
"37863",10901,"Marystown","NL",47.09899,-55.19852,2018-04-28 05:00:00,37,0,37
"37864",10901,"Marystown","NL",47.09899,-55.19852,2018-04-28 06:00:00,35,1,36
"37865",10901,"Marystown","NL",47.09899,-55.19852,2018-04-28 07:00:00,34,0,34
"37866",10901,"Marystown","NL",47.09899,-55.19852,2018-04-28 08:00:00,35,1,36
"37867",10901,"Marystown","NL",47.09899,-55.19852,2018-04-28 09:00:00,35,1,36
"37868",10901,"Marystown","NL",47.09899,-55.19852,2018-04-28 10:00:00,35,1,36
"37869",10901,"Marystown","NL",47.09899,-55.19852,2018-04-28 11:00:00,35,1,36
"37870",10901,"Marystown","NL",47.09899,-55.19852,2018-04-28 12:00:00,32,1,33
"37871",10901,"Marystown","NL",47.09899,-55.19852,2018-04-28 13:00:00,33,1,34
"37872",10901,"Marystown","NL",47.09899,-55.19852,2018-04-28 14:00:00,32,1,33
"37873",10901,"Marystown","NL",47.09899,-55.19852,2018-04-28 15:00:00,33,1,34
"37874",10901,"Marystown","NL",47.09899,-55.19852,2018-04-28 16:00:00,33,1,34
"37875",10901,"Marystown","NL",47.09899,-55.19852,2018-04-28 17:00:00,35,0,35
"37876",10901,"Marystown","NL",47.09899,-55.19852,2018-04-28 18:00:00,36,0,36
"37877",10901,"Marystown","NL",47.09899,-55.19852,2018-04-28 19:00:00,36,0,36
"37878",10901,"Marystown","NL",47.09899,-55.19852,2018-04-28 20:00:00,37,0,37
"37879",10901,"Marystown","NL",47.09899,-55.19852,2018-04-28 21:00:00,36,0,36
"37880",10901,"Marystown","NL",47.09899,-55.19852,2018-04-28 22:00:00,35,0,35
"37881",10901,"Marystown","NL",47.09899,-55.19852,2018-04-28 23:00:00,35,0,35
"37882",10901,"Marystown","NL",47.09899,-55.19852,2018-04-29 00:00:00,33,0,33
"37883",10901,"Marystown","NL",47.09899,-55.19852,2018-04-29 01:00:00,32,0,32
"37884",10901,"Marystown","NL",47.09899,-55.19852,2018-04-29 02:00:00,32,0,32
"37885",10901,"Marystown","NL",47.09899,-55.19852,2018-04-29 03:00:00,32,0,32
"37886",10901,"Marystown","NL",47.09899,-55.19852,2018-04-29 04:00:00,31,0,31
"37887",10901,"Marystown","NL",47.09899,-55.19852,2018-04-29 05:00:00,32,0,32
"37888",10901,"Marystown","NL",47.09899,-55.19852,2018-04-29 06:00:00,33,0,33
"37889",10901,"Marystown","NL",47.09899,-55.19852,2018-04-29 07:00:00,32,0,32
"37890",10901,"Marystown","NL",47.09899,-55.19852,2018-04-29 08:00:00,32,0,32
"37891",10901,"Marystown","NL",47.09899,-55.19852,2018-04-29 09:00:00,31,0,31
"37892",10901,"Marystown","NL",47.09899,-55.19852,2018-04-29 10:00:00,31,0,31
"37893",10901,"Marystown","NL",47.09899,-55.19852,2018-04-29 11:00:00,30,0,30
"37894",10901,"Marystown","NL",47.09899,-55.19852,2018-04-29 12:00:00,29,0,29
"37895",10901,"Marystown","NL",47.09899,-55.19852,2018-04-29 13:00:00,29,0,29
"37896",10901,"Marystown","NL",47.09899,-55.19852,2018-04-29 14:00:00,29,0,29
"37897",10901,"Marystown","NL",47.09899,-55.19852,2018-04-29 15:00:00,28,1,29
"37898",10901,"Marystown","NL",47.09899,-55.19852,2018-04-29 16:00:00,29,1,30
"37899",10901,"Marystown","NL",47.09899,-55.19852,2018-04-29 17:00:00,30,0,30
"37900",10901,"Marystown","NL",47.09899,-55.19852,2018-04-29 18:00:00,30,0,30
"37901",10901,"Marystown","NL",47.09899,-55.19852,2018-04-29 19:00:00,30,0,30
"37902",10901,"Marystown","NL",47.09899,-55.19852,2018-04-29 20:00:00,30,0,30
"37903",10901,"Marystown","NL",47.09899,-55.19852,2018-04-29 21:00:00,31,0,31
"37904",10901,"Marystown","NL",47.09899,-55.19852,2018-04-29 22:00:00,33,0,33
"37905",10901,"Marystown","NL",47.09899,-55.19852,2018-04-29 23:00:00,34,0,34
"37906",10901,"Marystown","NL",47.09899,-55.19852,2018-04-30 00:00:00,34,0,34
"37907",10901,"Marystown","NL",47.09899,-55.19852,2018-04-30 01:00:00,30,0,30
"37908",10901,"Marystown","NL",47.09899,-55.19852,2018-04-30 02:00:00,29,0,29
"37909",10901,"Marystown","NL",47.09899,-55.19852,2018-04-30 03:00:00,30,0,30
"37910",10901,"Marystown","NL",47.09899,-55.19852,2018-04-30 04:00:00,30,0,30
"37911",10901,"Marystown","NL",47.09899,-55.19852,2018-04-30 05:00:00,30,0,30
"37912",10901,"Marystown","NL",47.09899,-55.19852,2018-04-30 06:00:00,31,0,31
"37913",10901,"Marystown","NL",47.09899,-55.19852,2018-04-30 07:00:00,32,0,32
"37914",10901,"Marystown","NL",47.09899,-55.19852,2018-04-30 08:00:00,31,0,31
"37915",10901,"Marystown","NL",47.09899,-55.19852,2018-04-30 09:00:00,31,0,31
"37916",10901,"Marystown","NL",47.09899,-55.19852,2018-04-30 10:00:00,32,0,32
"37917",10901,"Marystown","NL",47.09899,-55.19852,2018-04-30 11:00:00,31,0,31
"37918",10901,"Marystown","NL",47.09899,-55.19852,2018-04-30 12:00:00,30,0,30
"37919",10901,"Marystown","NL",47.09899,-55.19852,2018-04-30 13:00:00,29,0,29
"37920",10901,"Marystown","NL",47.09899,-55.19852,2018-04-30 14:00:00,29,0,29
"37921",10901,"Marystown","NL",47.09899,-55.19852,2018-04-30 15:00:00,31,1,32
"37922",10901,"Marystown","NL",47.09899,-55.19852,2018-04-30 16:00:00,31,0,31
"37923",10901,"Marystown","NL",47.09899,-55.19852,2018-04-30 17:00:00,30,0,30
"37924",10901,"Marystown","NL",47.09899,-55.19852,2018-04-30 18:00:00,30,0,30
"37925",10901,"Marystown","NL",47.09899,-55.19852,2018-04-30 19:00:00,32,0,32
"37926",10901,"Marystown","NL",47.09899,-55.19852,2018-04-30 20:00:00,31,0,31
"37927",10901,"Marystown","NL",47.09899,-55.19852,2018-04-30 21:00:00,27,0,27
"37928",10901,"Marystown","NL",47.09899,-55.19852,2018-04-30 22:00:00,28,0,28
"37929",10901,"Marystown","NL",47.09899,-55.19852,2018-04-30 23:00:00,26,0,26
"37930",10901,"Marystown","NL",47.09899,-55.19852,2018-05-01 00:00:00,27,0,27
"37931",10901,"Marystown","NL",47.09899,-55.19852,2018-05-01 01:00:00,27,1,28
"37932",10901,"Marystown","NL",47.09899,-55.19852,2018-05-01 02:00:00,26,1,27
"37933",10901,"Marystown","NL",47.09899,-55.19852,2018-05-01 03:00:00,27,0,27
"37934",10901,"Marystown","NL",47.09899,-55.19852,2018-05-01 04:00:00,26,0,26
"37935",10901,"Marystown","NL",47.09899,-55.19852,2018-05-01 05:00:00,26,0,26
"37936",10901,"Marystown","NL",47.09899,-55.19852,2018-05-01 06:00:00,26,0,26
"37937",10901,"Marystown","NL",47.09899,-55.19852,2018-05-01 07:00:00,25,0,25
"37938",10901,"Marystown","NL",47.09899,-55.19852,2018-05-01 08:00:00,25,1,26
"37939",10901,"Marystown","NL",47.09899,-55.19852,2018-05-01 09:00:00,24,0,24
"37940",10901,"Marystown","NL",47.09899,-55.19852,2018-05-01 10:00:00,24,0,24
"37941",10901,"Marystown","NL",47.09899,-55.19852,2018-05-01 11:00:00,24,0,24
"37942",10901,"Marystown","NL",47.09899,-55.19852,2018-05-01 12:00:00,24,1,25
"37943",10901,"Marystown","NL",47.09899,-55.19852,2018-05-01 13:00:00,24,1,25
"37944",10901,"Marystown","NL",47.09899,-55.19852,2018-05-01 14:00:00,25,1,26
"37945",10901,"Marystown","NL",47.09899,-55.19852,2018-05-01 15:00:00,26,1,27
"37946",10901,"Marystown","NL",47.09899,-55.19852,2018-05-01 16:00:00,27,1,28
"37947",10901,"Marystown","NL",47.09899,-55.19852,2018-05-01 17:00:00,27,1,28
"37948",10901,"Marystown","NL",47.09899,-55.19852,2018-05-01 18:00:00,28,1,29
"37949",10901,"Marystown","NL",47.09899,-55.19852,2018-05-01 19:00:00,28,1,29
"37950",10901,"Marystown","NL",47.09899,-55.19852,2018-05-01 20:00:00,27,1,28
"37951",10901,"Marystown","NL",47.09899,-55.19852,2018-05-01 21:00:00,26,1,27
"37952",10901,"Marystown","NL",47.09899,-55.19852,2018-05-01 22:00:00,25,1,26
"37953",10901,"Marystown","NL",47.09899,-55.19852,2018-05-01 23:00:00,25,1,26
"37954",10901,"Marystown","NL",47.09899,-55.19852,2018-05-02 00:00:00,31,0,31
"37955",10901,"Marystown","NL",47.09899,-55.19852,2018-05-02 01:00:00,29,0,29
"37956",10901,"Marystown","NL",47.09899,-55.19852,2018-05-02 02:00:00,28,0,28
"37957",10901,"Marystown","NL",47.09899,-55.19852,2018-05-02 03:00:00,29,0,29
"37958",10901,"Marystown","NL",47.09899,-55.19852,2018-05-02 04:00:00,29,0,29
"37959",10901,"Marystown","NL",47.09899,-55.19852,2018-05-02 05:00:00,28,0,28
"37960",10901,"Marystown","NL",47.09899,-55.19852,2018-05-02 06:00:00,28,1,29
"37961",10901,"Marystown","NL",47.09899,-55.19852,2018-05-02 07:00:00,28,1,29
"37962",10901,"Marystown","NL",47.09899,-55.19852,2018-05-02 08:00:00,31,1,32
"37963",10901,"Marystown","NL",47.09899,-55.19852,2018-05-02 09:00:00,34,0,34
"37964",10901,"Marystown","NL",47.09899,-55.19852,2018-05-02 10:00:00,29,1,30
"37965",10901,"Marystown","NL",47.09899,-55.19852,2018-05-02 11:00:00,27,1,28
"37966",10901,"Marystown","NL",47.09899,-55.19852,2018-05-02 12:00:00,28,1,29
"37967",10901,"Marystown","NL",47.09899,-55.19852,2018-05-02 13:00:00,28,1,29
"37968",10901,"Marystown","NL",47.09899,-55.19852,2018-05-02 14:00:00,28,0,28
"37969",10901,"Marystown","NL",47.09899,-55.19852,2018-05-02 15:00:00,31,0,31
"37970",10901,"Marystown","NL",47.09899,-55.19852,2018-05-02 16:00:00,38,0,38
"37971",10901,"Marystown","NL",47.09899,-55.19852,2018-05-02 17:00:00,37,0,37
"37972",10901,"Marystown","NL",47.09899,-55.19852,2018-05-02 18:00:00,37,0,37
"37973",10901,"Marystown","NL",47.09899,-55.19852,2018-05-02 19:00:00,34,0,34
"37974",10901,"Marystown","NL",47.09899,-55.19852,2018-05-02 20:00:00,36,0,36
"37975",10901,"Marystown","NL",47.09899,-55.19852,2018-05-02 21:00:00,31,0,31
"37976",10901,"Marystown","NL",47.09899,-55.19852,2018-05-02 22:00:00,29,1,30
"37977",10901,"Marystown","NL",47.09899,-55.19852,2018-05-02 23:00:00,27,0,27
"37978",10901,"Marystown","NL",47.09899,-55.19852,2018-05-03 00:00:00,28,1,29
"37979",10901,"Marystown","NL",47.09899,-55.19852,2018-05-03 01:00:00,31,1,32
"37980",10901,"Marystown","NL",47.09899,-55.19852,2018-05-03 02:00:00,33,1,34
"37981",10901,"Marystown","NL",47.09899,-55.19852,2018-05-03 03:00:00,38,0,38
"37982",10901,"Marystown","NL",47.09899,-55.19852,2018-05-03 04:00:00,36,0,36
"37983",10901,"Marystown","NL",47.09899,-55.19852,2018-05-03 05:00:00,34,0,34
"37984",10901,"Marystown","NL",47.09899,-55.19852,2018-05-03 06:00:00,33,0,33
"37985",10901,"Marystown","NL",47.09899,-55.19852,2018-05-03 07:00:00,35,0,35
"37986",10901,"Marystown","NL",47.09899,-55.19852,2018-05-03 08:00:00,38,0,38
"37987",10901,"Marystown","NL",47.09899,-55.19852,2018-05-03 09:00:00,36,0,36
"37988",10901,"Marystown","NL",47.09899,-55.19852,2018-05-03 10:00:00,32,0,32
"37989",10901,"Marystown","NL",47.09899,-55.19852,2018-05-03 11:00:00,27,1,28
"37990",10901,"Marystown","NL",47.09899,-55.19852,2018-05-03 12:00:00,23,1,24
"37991",10901,"Marystown","NL",47.09899,-55.19852,2018-05-03 13:00:00,28,1,29
"37992",10901,"Marystown","NL",47.09899,-55.19852,2018-05-03 14:00:00,32,1,33
"37993",10901,"Marystown","NL",47.09899,-55.19852,2018-05-03 15:00:00,34,1,35
"37994",10901,"Marystown","NL",47.09899,-55.19852,2018-05-03 16:00:00,35,1,36
"37995",10901,"Marystown","NL",47.09899,-55.19852,2018-05-03 17:00:00,35,1,36
"37996",10901,"Marystown","NL",47.09899,-55.19852,2018-05-03 18:00:00,34,1,35
"37997",10901,"Marystown","NL",47.09899,-55.19852,2018-05-03 19:00:00,33,1,34
"37998",10901,"Marystown","NL",47.09899,-55.19852,2018-05-03 20:00:00,35,0,35
"37999",10901,"Marystown","NL",47.09899,-55.19852,2018-05-03 21:00:00,33,1,34
"38000",10901,"Marystown","NL",47.09899,-55.19852,2018-05-03 22:00:00,33,0,33
"38001",10901,"Marystown","NL",47.09899,-55.19852,2018-05-03 23:00:00,33,0,33
"38002",10901,"Marystown","NL",47.09899,-55.19852,2018-05-04 00:00:00,32,0,32
"38003",10901,"Marystown","NL",47.09899,-55.19852,2018-05-04 01:00:00,33,0,33
"38004",10901,"Marystown","NL",47.09899,-55.19852,2018-05-04 02:00:00,33,0,33
"38005",10901,"Marystown","NL",47.09899,-55.19852,2018-05-04 03:00:00,34,0,34
"38006",10901,"Marystown","NL",47.09899,-55.19852,2018-05-04 04:00:00,35,0,35
"38007",10901,"Marystown","NL",47.09899,-55.19852,2018-05-04 05:00:00,35,0,35
"38008",10901,"Marystown","NL",47.09899,-55.19852,2018-05-04 06:00:00,34,0,34
"38009",10901,"Marystown","NL",47.09899,-55.19852,2018-05-04 07:00:00,33,0,33
"38010",10901,"Marystown","NL",47.09899,-55.19852,2018-05-04 08:00:00,33,0,33
"38011",10901,"Marystown","NL",47.09899,-55.19852,2018-05-04 09:00:00,33,0,33
"38012",10901,"Marystown","NL",47.09899,-55.19852,2018-05-04 10:00:00,33,0,33
"38013",10901,"Marystown","NL",47.09899,-55.19852,2018-05-04 11:00:00,33,0,33
"38014",10901,"Marystown","NL",47.09899,-55.19852,2018-05-04 12:00:00,33,0,33
"38015",10901,"Marystown","NL",47.09899,-55.19852,2018-05-04 13:00:00,33,0,33
"38016",10901,"Marystown","NL",47.09899,-55.19852,2018-05-04 14:00:00,34,1,35
"38017",10901,"Marystown","NL",47.09899,-55.19852,2018-05-04 15:00:00,36,0,36
"38018",10901,"Marystown","NL",47.09899,-55.19852,2018-05-04 16:00:00,36,0,36
"38019",10901,"Marystown","NL",47.09899,-55.19852,2018-05-04 17:00:00,36,0,36
"38020",10901,"Marystown","NL",47.09899,-55.19852,2018-05-04 18:00:00,36,0,36
"38021",10901,"Marystown","NL",47.09899,-55.19852,2018-05-04 19:00:00,35,0,35
"38022",10901,"Marystown","NL",47.09899,-55.19852,2018-05-04 20:00:00,35,0,35
"38023",10901,"Marystown","NL",47.09899,-55.19852,2018-05-04 21:00:00,35,0,35
"38024",10901,"Marystown","NL",47.09899,-55.19852,2018-05-04 22:00:00,35,0,35
"38025",10901,"Marystown","NL",47.09899,-55.19852,2018-05-04 23:00:00,35,0,35
"38026",10901,"Marystown","NL",47.09899,-55.19852,2018-05-05 00:00:00,36,0,36
"38027",10901,"Marystown","NL",47.09899,-55.19852,2018-05-05 01:00:00,36,0,36
"38028",10901,"Marystown","NL",47.09899,-55.19852,2018-05-05 02:00:00,38,0,38
"38029",10901,"Marystown","NL",47.09899,-55.19852,2018-05-05 03:00:00,38,0,38
"38030",10901,"Marystown","NL",47.09899,-55.19852,2018-05-05 04:00:00,38,0,38
"38031",10901,"Marystown","NL",47.09899,-55.19852,2018-05-05 05:00:00,37,0,37
"38032",10901,"Marystown","NL",47.09899,-55.19852,2018-05-05 06:00:00,37,0,37
"38033",10901,"Marystown","NL",47.09899,-55.19852,2018-05-05 07:00:00,36,0,36
"38034",10901,"Marystown","NL",47.09899,-55.19852,2018-05-05 08:00:00,36,0,36
"38035",10901,"Marystown","NL",47.09899,-55.19852,2018-05-05 09:00:00,36,0,36
"38036",10901,"Marystown","NL",47.09899,-55.19852,2018-05-05 10:00:00,36,0,36
"38037",10901,"Marystown","NL",47.09899,-55.19852,2018-05-05 11:00:00,37,0,37
"38038",10901,"Marystown","NL",47.09899,-55.19852,2018-05-05 12:00:00,39,0,39
"38039",10901,"Marystown","NL",47.09899,-55.19852,2018-05-05 13:00:00,39,0,39
"38040",10901,"Marystown","NL",47.09899,-55.19852,2018-05-05 14:00:00,41,0,41
"38041",10901,"Marystown","NL",47.09899,-55.19852,2018-05-05 15:00:00,42,0,42
"38042",10901,"Marystown","NL",47.09899,-55.19852,2018-05-05 16:00:00,42,0,42
"38043",10901,"Marystown","NL",47.09899,-55.19852,2018-05-05 17:00:00,39,0,39
"38044",10901,"Marystown","NL",47.09899,-55.19852,2018-05-05 18:00:00,30,0,30
"38045",10901,"Marystown","NL",47.09899,-55.19852,2018-05-05 19:00:00,29,0,29
"38046",10901,"Marystown","NL",47.09899,-55.19852,2018-05-05 20:00:00,29,0,29
"38047",10901,"Marystown","NL",47.09899,-55.19852,2018-05-05 21:00:00,31,0,31
"38048",10901,"Marystown","NL",47.09899,-55.19852,2018-05-05 22:00:00,30,0,30
"38049",10901,"Marystown","NL",47.09899,-55.19852,2018-05-05 23:00:00,29,0,29
"38050",10901,"Marystown","NL",47.09899,-55.19852,2018-05-06 00:00:00,30,0,30
"38051",10901,"Marystown","NL",47.09899,-55.19852,2018-05-06 01:00:00,30,0,30
"38052",10901,"Marystown","NL",47.09899,-55.19852,2018-05-06 02:00:00,31,0,31
"38053",10901,"Marystown","NL",47.09899,-55.19852,2018-05-06 03:00:00,33,0,33
"38054",10901,"Marystown","NL",47.09899,-55.19852,2018-05-06 04:00:00,34,0,34
"38055",10901,"Marystown","NL",47.09899,-55.19852,2018-05-06 05:00:00,36,0,36
"38056",10901,"Marystown","NL",47.09899,-55.19852,2018-05-06 06:00:00,35,0,35
"38057",10901,"Marystown","NL",47.09899,-55.19852,2018-05-06 07:00:00,33,0,33
"38058",10901,"Marystown","NL",47.09899,-55.19852,2018-05-06 08:00:00,32,0,32
"38059",10901,"Marystown","NL",47.09899,-55.19852,2018-05-06 09:00:00,31,0,31
"38060",10901,"Marystown","NL",47.09899,-55.19852,2018-05-06 10:00:00,31,0,31
"38061",10901,"Marystown","NL",47.09899,-55.19852,2018-05-06 11:00:00,32,0,32
"38062",10901,"Marystown","NL",47.09899,-55.19852,2018-05-06 12:00:00,32,0,32
"38063",10901,"Marystown","NL",47.09899,-55.19852,2018-05-06 13:00:00,32,0,32
"38064",10901,"Marystown","NL",47.09899,-55.19852,2018-05-06 14:00:00,32,0,32
"38065",10901,"Marystown","NL",47.09899,-55.19852,2018-05-06 15:00:00,33,0,33
"38066",10901,"Marystown","NL",47.09899,-55.19852,2018-05-06 16:00:00,34,0,34
"38067",10901,"Marystown","NL",47.09899,-55.19852,2018-05-06 17:00:00,34,0,34
"38068",10901,"Marystown","NL",47.09899,-55.19852,2018-05-06 18:00:00,34,0,34
"38069",10901,"Marystown","NL",47.09899,-55.19852,2018-05-06 19:00:00,33,0,33
"38070",10901,"Marystown","NL",47.09899,-55.19852,2018-05-06 20:00:00,33,0,33
"38071",10901,"Marystown","NL",47.09899,-55.19852,2018-05-06 21:00:00,31,0,31
"38072",10901,"Marystown","NL",47.09899,-55.19852,2018-05-06 22:00:00,30,1,31
"38073",10901,"Marystown","NL",47.09899,-55.19852,2018-05-06 23:00:00,33,1,34
"38074",10901,"Marystown","NL",47.09899,-55.19852,2018-05-07 00:00:00,37,0,37
"38075",10901,"Marystown","NL",47.09899,-55.19852,2018-05-07 01:00:00,40,1,41
"38076",10901,"Marystown","NL",47.09899,-55.19852,2018-05-07 02:00:00,39,0,39
"38077",10901,"Marystown","NL",47.09899,-55.19852,2018-05-07 03:00:00,39,0,39
"38078",10901,"Marystown","NL",47.09899,-55.19852,2018-05-07 04:00:00,38,0,38
"38079",10901,"Marystown","NL",47.09899,-55.19852,2018-05-07 05:00:00,40,0,40
"38080",10901,"Marystown","NL",47.09899,-55.19852,2018-05-07 06:00:00,40,0,40
"38081",10901,"Marystown","NL",47.09899,-55.19852,2018-05-07 07:00:00,39,1,40
"38082",10901,"Marystown","NL",47.09899,-55.19852,2018-05-07 08:00:00,38,1,39
"38083",10901,"Marystown","NL",47.09899,-55.19852,2018-05-07 09:00:00,39,1,40
"38084",10901,"Marystown","NL",47.09899,-55.19852,2018-05-07 10:00:00,39,1,40
"38085",10901,"Marystown","NL",47.09899,-55.19852,2018-05-07 11:00:00,39,1,40
"38086",10901,"Marystown","NL",47.09899,-55.19852,2018-05-07 12:00:00,41,1,42
"38087",10901,"Marystown","NL",47.09899,-55.19852,2018-05-07 13:00:00,41,0,41
"38088",10901,"Marystown","NL",47.09899,-55.19852,2018-05-07 14:00:00,38,0,38
"38089",10901,"Marystown","NL",47.09899,-55.19852,2018-05-07 15:00:00,38,0,38
"38090",10901,"Marystown","NL",47.09899,-55.19852,2018-05-07 16:00:00,42,0,42
"38091",10901,"Marystown","NL",47.09899,-55.19852,2018-05-07 17:00:00,40,0,40
"38092",10901,"Marystown","NL",47.09899,-55.19852,2018-05-07 18:00:00,35,0,35
"38093",10901,"Marystown","NL",47.09899,-55.19852,2018-05-07 19:00:00,36,0,36
"38094",10901,"Marystown","NL",47.09899,-55.19852,2018-05-07 20:00:00,38,0,38
"38095",10901,"Marystown","NL",47.09899,-55.19852,2018-05-07 21:00:00,40,0,40
"38096",10901,"Marystown","NL",47.09899,-55.19852,2018-05-07 22:00:00,41,0,41
"38097",10901,"Marystown","NL",47.09899,-55.19852,2018-05-07 23:00:00,39,0,39
"38098",10901,"Marystown","NL",47.09899,-55.19852,2018-05-08 00:00:00,34,0,34
"38099",10901,"Marystown","NL",47.09899,-55.19852,2018-05-08 01:00:00,31,0,31
"38100",10901,"Marystown","NL",47.09899,-55.19852,2018-05-08 02:00:00,25,1,26
"38101",10901,"Marystown","NL",47.09899,-55.19852,2018-05-08 03:00:00,20,1,21
"38102",10901,"Marystown","NL",47.09899,-55.19852,2018-05-08 04:00:00,21,0,21
"38103",10901,"Marystown","NL",47.09899,-55.19852,2018-05-08 05:00:00,18,0,18
"38104",10901,"Marystown","NL",47.09899,-55.19852,2018-05-08 06:00:00,24,1,25
"38105",10901,"Marystown","NL",47.09899,-55.19852,2018-05-08 07:00:00,29,0,29
"38106",10901,"Marystown","NL",47.09899,-55.19852,2018-05-08 08:00:00,34,0,34
"38107",10901,"Marystown","NL",47.09899,-55.19852,2018-05-08 09:00:00,35,0,35
"38108",10901,"Marystown","NL",47.09899,-55.19852,2018-05-08 10:00:00,37,0,37
"38109",10901,"Marystown","NL",47.09899,-55.19852,2018-05-08 11:00:00,39,0,39
"38110",10901,"Marystown","NL",47.09899,-55.19852,2018-05-08 12:00:00,37,0,37
"38111",10901,"Marystown","NL",47.09899,-55.19852,2018-05-08 13:00:00,37,1,38
"38112",10901,"Marystown","NL",47.09899,-55.19852,2018-05-08 14:00:00,39,0,39
"38113",10901,"Marystown","NL",47.09899,-55.19852,2018-05-08 15:00:00,40,0,40
"38114",10901,"Marystown","NL",47.09899,-55.19852,2018-05-08 16:00:00,41,1,42
"38115",10901,"Marystown","NL",47.09899,-55.19852,2018-05-08 17:00:00,41,0,41
"38116",10901,"Marystown","NL",47.09899,-55.19852,2018-05-08 18:00:00,40,0,40
"38117",10901,"Marystown","NL",47.09899,-55.19852,2018-05-08 19:00:00,39,0,39
"38118",10901,"Marystown","NL",47.09899,-55.19852,2018-05-08 20:00:00,39,0,39
"38119",10901,"Marystown","NL",47.09899,-55.19852,2018-05-08 21:00:00,39,0,39
"38120",10901,"Marystown","NL",47.09899,-55.19852,2018-05-08 22:00:00,39,0,39
"38121",10901,"Marystown","NL",47.09899,-55.19852,2018-05-08 23:00:00,37,1,38
"38122",10901,"Marystown","NL",47.09899,-55.19852,2018-05-09 00:00:00,36,0,36
"38123",10901,"Marystown","NL",47.09899,-55.19852,2018-05-09 01:00:00,36,1,37
"38124",10901,"Marystown","NL",47.09899,-55.19852,2018-05-09 02:00:00,42,0,42
"38125",10901,"Marystown","NL",47.09899,-55.19852,2018-05-09 03:00:00,41,0,41
"38126",10901,"Marystown","NL",47.09899,-55.19852,2018-05-09 04:00:00,41,0,41
"38127",10901,"Marystown","NL",47.09899,-55.19852,2018-05-09 05:00:00,39,0,39
"38128",10901,"Marystown","NL",47.09899,-55.19852,2018-05-09 06:00:00,40,0,40
"38129",10901,"Marystown","NL",47.09899,-55.19852,2018-05-09 07:00:00,39,0,39
"38130",10901,"Marystown","NL",47.09899,-55.19852,2018-05-09 08:00:00,37,0,37
"38131",10901,"Marystown","NL",47.09899,-55.19852,2018-05-09 09:00:00,36,0,36
"38132",10901,"Marystown","NL",47.09899,-55.19852,2018-05-09 10:00:00,36,1,37
"38133",10901,"Marystown","NL",47.09899,-55.19852,2018-05-09 11:00:00,39,0,39
"38134",10901,"Marystown","NL",47.09899,-55.19852,2018-05-09 12:00:00,35,0,35
"38135",10901,"Marystown","NL",47.09899,-55.19852,2018-05-09 13:00:00,39,0,39
"38136",10901,"Marystown","NL",47.09899,-55.19852,2018-05-09 14:00:00,42,0,42
"38137",10901,"Marystown","NL",47.09899,-55.19852,2018-05-09 15:00:00,41,0,41
"38138",10901,"Marystown","NL",47.09899,-55.19852,2018-05-09 16:00:00,42,0,42
"38139",10901,"Marystown","NL",47.09899,-55.19852,2018-05-09 17:00:00,41,0,41
"38140",10901,"Marystown","NL",47.09899,-55.19852,2018-05-09 18:00:00,41,0,41
"38141",10901,"Marystown","NL",47.09899,-55.19852,2018-05-09 19:00:00,40,0,40
"38142",10901,"Marystown","NL",47.09899,-55.19852,2018-05-09 20:00:00,37,0,37
"38143",10901,"Marystown","NL",47.09899,-55.19852,2018-05-09 21:00:00,30,1,31
"38144",10901,"Marystown","NL",47.09899,-55.19852,2018-05-09 22:00:00,26,2,28
"38145",10901,"Marystown","NL",47.09899,-55.19852,2018-05-09 23:00:00,25,1,26
"38146",10901,"Marystown","NL",47.09899,-55.19852,2018-05-10 00:00:00,27,0,27
"38147",10901,"Marystown","NL",47.09899,-55.19852,2018-05-10 01:00:00,29,0,29
"38148",10901,"Marystown","NL",47.09899,-55.19852,2018-05-10 02:00:00,29,0,29
"38149",10901,"Marystown","NL",47.09899,-55.19852,2018-05-10 03:00:00,25,0,25
"38150",10901,"Marystown","NL",47.09899,-55.19852,2018-05-10 04:00:00,21,0,21
"38151",10901,"Marystown","NL",47.09899,-55.19852,2018-05-10 05:00:00,23,0,23
"38152",10901,"Marystown","NL",47.09899,-55.19852,2018-05-10 06:00:00,22,1,23
"38153",10901,"Marystown","NL",47.09899,-55.19852,2018-05-10 07:00:00,28,0,28
"38154",10901,"Marystown","NL",47.09899,-55.19852,2018-05-10 08:00:00,30,0,30
"38155",10901,"Marystown","NL",47.09899,-55.19852,2018-05-10 09:00:00,30,2,32
"38156",10901,"Marystown","NL",47.09899,-55.19852,2018-05-10 10:00:00,31,1,32
"38157",10901,"Marystown","NL",47.09899,-55.19852,2018-05-10 11:00:00,31,0,31
"38158",10901,"Marystown","NL",47.09899,-55.19852,2018-05-10 12:00:00,33,0,33
"38159",10901,"Marystown","NL",47.09899,-55.19852,2018-05-10 13:00:00,34,0,34
"38160",10901,"Marystown","NL",47.09899,-55.19852,2018-05-10 14:00:00,34,1,35
"38161",10901,"Marystown","NL",47.09899,-55.19852,2018-05-10 15:00:00,34,0,34
"38162",10901,"Marystown","NL",47.09899,-55.19852,2018-05-10 16:00:00,34,0,34
"38163",10901,"Marystown","NL",47.09899,-55.19852,2018-05-10 17:00:00,35,0,35
"38164",10901,"Marystown","NL",47.09899,-55.19852,2018-05-10 18:00:00,35,0,35
"38165",10901,"Marystown","NL",47.09899,-55.19852,2018-05-10 19:00:00,37,0,37
"38166",10901,"Marystown","NL",47.09899,-55.19852,2018-05-10 20:00:00,37,0,37
"38167",10901,"Marystown","NL",47.09899,-55.19852,2018-05-10 21:00:00,37,0,37
"38168",10901,"Marystown","NL",47.09899,-55.19852,2018-05-10 22:00:00,38,0,38
"38169",10901,"Marystown","NL",47.09899,-55.19852,2018-05-10 23:00:00,38,0,38
"38170",10901,"Marystown","NL",47.09899,-55.19852,2018-05-11 00:00:00,NA,0,NA
"38171",10901,"Marystown","NL",47.09899,-55.19852,2018-05-11 01:00:00,41,0,41
"38172",10901,"Marystown","NL",47.09899,-55.19852,2018-05-11 02:00:00,40,0,40
"38173",10901,"Marystown","NL",47.09899,-55.19852,2018-05-11 03:00:00,38,0,38
"38174",10901,"Marystown","NL",47.09899,-55.19852,2018-05-11 04:00:00,36,1,37
"38175",10901,"Marystown","NL",47.09899,-55.19852,2018-05-11 05:00:00,36,0,36
"38176",10901,"Marystown","NL",47.09899,-55.19852,2018-05-11 06:00:00,36,0,36
"38177",10901,"Marystown","NL",47.09899,-55.19852,2018-05-11 07:00:00,36,0,36
"38178",10901,"Marystown","NL",47.09899,-55.19852,2018-05-11 08:00:00,35,1,36
"38179",10901,"Marystown","NL",47.09899,-55.19852,2018-05-11 09:00:00,34,0,34
"38180",10901,"Marystown","NL",47.09899,-55.19852,2018-05-11 10:00:00,33,0,33
"38181",10901,"Marystown","NL",47.09899,-55.19852,2018-05-11 11:00:00,30,0,30
"38182",10901,"Marystown","NL",47.09899,-55.19852,2018-05-11 12:00:00,35,0,35
"38183",10901,"Marystown","NL",47.09899,-55.19852,2018-05-11 13:00:00,38,0,38
"38184",10901,"Marystown","NL",47.09899,-55.19852,2018-05-11 14:00:00,36,0,36
"38185",10901,"Marystown","NL",47.09899,-55.19852,2018-05-11 15:00:00,35,0,35
"38186",10901,"Marystown","NL",47.09899,-55.19852,2018-05-11 16:00:00,34,0,34
"38187",10901,"Marystown","NL",47.09899,-55.19852,2018-05-11 17:00:00,32,0,32
"38188",10901,"Marystown","NL",47.09899,-55.19852,2018-05-11 18:00:00,30,0,30
"38189",10901,"Marystown","NL",47.09899,-55.19852,2018-05-11 19:00:00,28,0,28
"38190",10901,"Marystown","NL",47.09899,-55.19852,2018-05-11 20:00:00,27,0,27
"38191",10901,"Marystown","NL",47.09899,-55.19852,2018-05-11 21:00:00,29,0,29
"38192",10901,"Marystown","NL",47.09899,-55.19852,2018-05-11 22:00:00,29,0,29
"38193",10901,"Marystown","NL",47.09899,-55.19852,2018-05-11 23:00:00,29,0,29
"38194",10901,"Marystown","NL",47.09899,-55.19852,2018-05-12 00:00:00,28,0,28
"38195",10901,"Marystown","NL",47.09899,-55.19852,2018-05-12 01:00:00,26,0,26
"38196",10901,"Marystown","NL",47.09899,-55.19852,2018-05-12 02:00:00,26,0,26
"38197",10901,"Marystown","NL",47.09899,-55.19852,2018-05-12 03:00:00,25,0,25
"38198",10901,"Marystown","NL",47.09899,-55.19852,2018-05-12 04:00:00,25,0,25
"38199",10901,"Marystown","NL",47.09899,-55.19852,2018-05-12 05:00:00,25,0,25
"38200",10901,"Marystown","NL",47.09899,-55.19852,2018-05-12 06:00:00,25,0,25
"38201",10901,"Marystown","NL",47.09899,-55.19852,2018-05-12 07:00:00,27,0,27
"38202",10901,"Marystown","NL",47.09899,-55.19852,2018-05-12 08:00:00,29,0,29
"38203",10901,"Marystown","NL",47.09899,-55.19852,2018-05-12 09:00:00,29,0,29
"38204",10901,"Marystown","NL",47.09899,-55.19852,2018-05-12 10:00:00,29,0,29
"38205",10901,"Marystown","NL",47.09899,-55.19852,2018-05-12 11:00:00,25,0,25
"38206",10901,"Marystown","NL",47.09899,-55.19852,2018-05-12 12:00:00,29,0,29
"38207",10901,"Marystown","NL",47.09899,-55.19852,2018-05-12 13:00:00,32,0,32
"38208",10901,"Marystown","NL",47.09899,-55.19852,2018-05-12 14:00:00,33,0,33
"38209",10901,"Marystown","NL",47.09899,-55.19852,2018-05-12 15:00:00,35,0,35
"38210",10901,"Marystown","NL",47.09899,-55.19852,2018-05-12 16:00:00,34,0,34
"38211",10901,"Marystown","NL",47.09899,-55.19852,2018-05-12 17:00:00,35,0,35
"38212",10901,"Marystown","NL",47.09899,-55.19852,2018-05-12 18:00:00,35,0,35
"38213",10901,"Marystown","NL",47.09899,-55.19852,2018-05-12 19:00:00,34,0,34
"38214",10901,"Marystown","NL",47.09899,-55.19852,2018-05-12 20:00:00,33,0,33
"38215",10901,"Marystown","NL",47.09899,-55.19852,2018-05-12 21:00:00,32,0,32
"38216",10901,"Marystown","NL",47.09899,-55.19852,2018-05-12 22:00:00,33,0,33
"38217",10901,"Marystown","NL",47.09899,-55.19852,2018-05-12 23:00:00,33,0,33
"38218",10901,"Marystown","NL",47.09899,-55.19852,2018-05-13 00:00:00,33,0,33
"38219",10901,"Marystown","NL",47.09899,-55.19852,2018-05-13 01:00:00,33,0,33
"38220",10901,"Marystown","NL",47.09899,-55.19852,2018-05-13 02:00:00,33,0,33
"38221",10901,"Marystown","NL",47.09899,-55.19852,2018-05-13 03:00:00,28,0,28
"38222",10901,"Marystown","NL",47.09899,-55.19852,2018-05-13 04:00:00,27,0,27
"38223",10901,"Marystown","NL",47.09899,-55.19852,2018-05-13 05:00:00,22,0,22
"38224",10901,"Marystown","NL",47.09899,-55.19852,2018-05-13 06:00:00,21,0,21
"38225",10901,"Marystown","NL",47.09899,-55.19852,2018-05-13 07:00:00,28,0,28
"38226",10901,"Marystown","NL",47.09899,-55.19852,2018-05-13 08:00:00,34,0,34
"38227",10901,"Marystown","NL",47.09899,-55.19852,2018-05-13 09:00:00,36,0,36
"38228",10901,"Marystown","NL",47.09899,-55.19852,2018-05-13 10:00:00,36,0,36
"38229",10901,"Marystown","NL",47.09899,-55.19852,2018-05-13 11:00:00,37,0,37
"38230",10901,"Marystown","NL",47.09899,-55.19852,2018-05-13 12:00:00,38,0,38
"38231",10901,"Marystown","NL",47.09899,-55.19852,2018-05-13 13:00:00,38,0,38
"38232",10901,"Marystown","NL",47.09899,-55.19852,2018-05-13 14:00:00,38,0,38
"38233",10901,"Marystown","NL",47.09899,-55.19852,2018-05-13 15:00:00,39,0,39
"38234",10901,"Marystown","NL",47.09899,-55.19852,2018-05-13 16:00:00,40,0,40
"38235",10901,"Marystown","NL",47.09899,-55.19852,2018-05-13 17:00:00,40,0,40
"38236",10901,"Marystown","NL",47.09899,-55.19852,2018-05-13 18:00:00,40,0,40
"38237",10901,"Marystown","NL",47.09899,-55.19852,2018-05-13 19:00:00,41,0,41
"38238",10901,"Marystown","NL",47.09899,-55.19852,2018-05-13 20:00:00,41,0,41
"38239",10901,"Marystown","NL",47.09899,-55.19852,2018-05-13 21:00:00,40,0,40
"38240",10901,"Marystown","NL",47.09899,-55.19852,2018-05-13 22:00:00,38,0,38
"38241",10901,"Marystown","NL",47.09899,-55.19852,2018-05-13 23:00:00,32,1,33
"38242",10901,"Marystown","NL",47.09899,-55.19852,2018-05-14 00:00:00,27,1,28
"38243",10901,"Marystown","NL",47.09899,-55.19852,2018-05-14 01:00:00,27,1,28
"38244",10901,"Marystown","NL",47.09899,-55.19852,2018-05-14 02:00:00,28,1,29
"38245",10901,"Marystown","NL",47.09899,-55.19852,2018-05-14 03:00:00,30,0,30
"38246",10901,"Marystown","NL",47.09899,-55.19852,2018-05-14 04:00:00,29,2,31
"38247",10901,"Marystown","NL",47.09899,-55.19852,2018-05-14 05:00:00,33,1,34
"38248",10901,"Marystown","NL",47.09899,-55.19852,2018-05-14 06:00:00,35,1,36
"38249",10901,"Marystown","NL",47.09899,-55.19852,2018-05-14 07:00:00,36,1,37
"38250",10901,"Marystown","NL",47.09899,-55.19852,2018-05-14 08:00:00,37,1,38
"38251",10901,"Marystown","NL",47.09899,-55.19852,2018-05-14 09:00:00,37,1,38
"38252",10901,"Marystown","NL",47.09899,-55.19852,2018-05-14 10:00:00,38,1,39
"38253",10901,"Marystown","NL",47.09899,-55.19852,2018-05-14 11:00:00,39,0,39
"38254",10901,"Marystown","NL",47.09899,-55.19852,2018-05-14 12:00:00,39,1,40
"38255",10901,"Marystown","NL",47.09899,-55.19852,2018-05-14 13:00:00,40,1,41
"38256",10901,"Marystown","NL",47.09899,-55.19852,2018-05-14 14:00:00,40,1,41
"38257",10901,"Marystown","NL",47.09899,-55.19852,2018-05-14 15:00:00,40,1,41
"38258",10901,"Marystown","NL",47.09899,-55.19852,2018-05-14 16:00:00,38,1,39
"38259",10901,"Marystown","NL",47.09899,-55.19852,2018-05-14 17:00:00,39,1,40
"38260",10901,"Marystown","NL",47.09899,-55.19852,2018-05-14 18:00:00,38,1,39
"38261",10901,"Marystown","NL",47.09899,-55.19852,2018-05-14 19:00:00,35,1,36
"38262",10901,"Marystown","NL",47.09899,-55.19852,2018-05-14 20:00:00,36,0,36
"38263",10901,"Marystown","NL",47.09899,-55.19852,2018-05-14 21:00:00,37,1,38
"38264",10901,"Marystown","NL",47.09899,-55.19852,2018-05-14 22:00:00,36,1,37
"38265",10901,"Marystown","NL",47.09899,-55.19852,2018-05-14 23:00:00,37,0,37
"38266",10901,"Marystown","NL",47.09899,-55.19852,2018-05-15 00:00:00,38,0,38
"38267",10901,"Marystown","NL",47.09899,-55.19852,2018-05-15 01:00:00,37,0,37
"38268",10901,"Marystown","NL",47.09899,-55.19852,2018-05-15 02:00:00,37,0,37
"38269",10901,"Marystown","NL",47.09899,-55.19852,2018-05-15 03:00:00,34,1,35
"38270",10901,"Marystown","NL",47.09899,-55.19852,2018-05-15 04:00:00,33,0,33
"38271",10901,"Marystown","NL",47.09899,-55.19852,2018-05-15 05:00:00,35,0,35
"38272",10901,"Marystown","NL",47.09899,-55.19852,2018-05-15 06:00:00,33,1,34
"38273",10901,"Marystown","NL",47.09899,-55.19852,2018-05-15 07:00:00,32,1,33
"38274",10901,"Marystown","NL",47.09899,-55.19852,2018-05-15 08:00:00,32,2,34
"38275",10901,"Marystown","NL",47.09899,-55.19852,2018-05-15 09:00:00,31,1,32
"38276",10901,"Marystown","NL",47.09899,-55.19852,2018-05-15 10:00:00,33,1,34
"38277",10901,"Marystown","NL",47.09899,-55.19852,2018-05-15 11:00:00,33,1,34
"38278",10901,"Marystown","NL",47.09899,-55.19852,2018-05-15 12:00:00,35,0,35
"38279",10901,"Marystown","NL",47.09899,-55.19852,2018-05-15 13:00:00,38,1,39
"38280",10901,"Marystown","NL",47.09899,-55.19852,2018-05-15 14:00:00,39,0,39
"38281",10901,"Marystown","NL",47.09899,-55.19852,2018-05-15 15:00:00,38,0,38
"38282",10901,"Marystown","NL",47.09899,-55.19852,2018-05-15 16:00:00,36,0,36
"38283",10901,"Marystown","NL",47.09899,-55.19852,2018-05-15 17:00:00,36,1,37
"38284",10901,"Marystown","NL",47.09899,-55.19852,2018-05-15 18:00:00,38,0,38
"38285",10901,"Marystown","NL",47.09899,-55.19852,2018-05-15 19:00:00,40,0,40
"38286",10901,"Marystown","NL",47.09899,-55.19852,2018-05-15 20:00:00,39,0,39
"38287",10901,"Marystown","NL",47.09899,-55.19852,2018-05-15 21:00:00,36,0,36
"38288",10901,"Marystown","NL",47.09899,-55.19852,2018-05-15 22:00:00,36,0,36
"38289",10901,"Marystown","NL",47.09899,-55.19852,2018-05-15 23:00:00,36,1,37
"38290",10901,"Marystown","NL",47.09899,-55.19852,2018-05-16 00:00:00,38,0,38
"38291",10901,"Marystown","NL",47.09899,-55.19852,2018-05-16 01:00:00,39,0,39
"38292",10901,"Marystown","NL",47.09899,-55.19852,2018-05-16 02:00:00,39,0,39
"38293",10901,"Marystown","NL",47.09899,-55.19852,2018-05-16 03:00:00,39,0,39
"38294",10901,"Marystown","NL",47.09899,-55.19852,2018-05-16 04:00:00,38,0,38
"38295",10901,"Marystown","NL",47.09899,-55.19852,2018-05-16 05:00:00,38,0,38
"38296",10901,"Marystown","NL",47.09899,-55.19852,2018-05-16 06:00:00,38,0,38
"38297",10901,"Marystown","NL",47.09899,-55.19852,2018-05-16 07:00:00,36,0,36
"38298",10901,"Marystown","NL",47.09899,-55.19852,2018-05-16 08:00:00,36,0,36
"38299",10901,"Marystown","NL",47.09899,-55.19852,2018-05-16 09:00:00,35,0,35
"38300",10901,"Marystown","NL",47.09899,-55.19852,2018-05-16 10:00:00,34,0,34
"38301",10901,"Marystown","NL",47.09899,-55.19852,2018-05-16 11:00:00,35,0,35
"38302",10901,"Marystown","NL",47.09899,-55.19852,2018-05-16 12:00:00,35,0,35
"38303",10901,"Marystown","NL",47.09899,-55.19852,2018-05-16 13:00:00,36,0,36
"38304",10901,"Marystown","NL",47.09899,-55.19852,2018-05-16 14:00:00,36,0,36
"38305",10901,"Marystown","NL",47.09899,-55.19852,2018-05-16 15:00:00,37,0,37
"38306",10901,"Marystown","NL",47.09899,-55.19852,2018-05-16 16:00:00,37,0,37
"38307",10901,"Marystown","NL",47.09899,-55.19852,2018-05-16 17:00:00,35,0,35
"38308",10901,"Marystown","NL",47.09899,-55.19852,2018-05-16 18:00:00,33,0,33
"38309",10901,"Marystown","NL",47.09899,-55.19852,2018-05-16 19:00:00,32,0,32
"38310",10901,"Marystown","NL",47.09899,-55.19852,2018-05-16 20:00:00,30,0,30
"38311",10901,"Marystown","NL",47.09899,-55.19852,2018-05-16 21:00:00,28,0,28
"38312",10901,"Marystown","NL",47.09899,-55.19852,2018-05-16 22:00:00,25,0,25
"38313",10901,"Marystown","NL",47.09899,-55.19852,2018-05-16 23:00:00,24,0,24
"38314",10901,"Marystown","NL",47.09899,-55.19852,2018-05-17 00:00:00,23,0,23
"38315",10901,"Marystown","NL",47.09899,-55.19852,2018-05-17 01:00:00,19,0,19
"38316",10901,"Marystown","NL",47.09899,-55.19852,2018-05-17 02:00:00,15,0,15
"38317",10901,"Marystown","NL",47.09899,-55.19852,2018-05-17 03:00:00,14,0,14
"38318",10901,"Marystown","NL",47.09899,-55.19852,2018-05-17 04:00:00,12,1,13
"38319",10901,"Marystown","NL",47.09899,-55.19852,2018-05-17 05:00:00,16,0,16
"38320",10901,"Marystown","NL",47.09899,-55.19852,2018-05-17 06:00:00,16,1,17
"38321",10901,"Marystown","NL",47.09899,-55.19852,2018-05-17 07:00:00,23,1,24
"38322",10901,"Marystown","NL",47.09899,-55.19852,2018-05-17 08:00:00,26,2,28
"38323",10901,"Marystown","NL",47.09899,-55.19852,2018-05-17 09:00:00,28,1,29
"38324",10901,"Marystown","NL",47.09899,-55.19852,2018-05-17 10:00:00,31,0,31
"38325",10901,"Marystown","NL",47.09899,-55.19852,2018-05-17 11:00:00,33,1,34
"38326",10901,"Marystown","NL",47.09899,-55.19852,2018-05-17 12:00:00,38,0,38
"38327",10901,"Marystown","NL",47.09899,-55.19852,2018-05-17 13:00:00,40,1,41
"38328",10901,"Marystown","NL",47.09899,-55.19852,2018-05-17 14:00:00,39,1,40
"38329",10901,"Marystown","NL",47.09899,-55.19852,2018-05-17 15:00:00,40,1,41
"38330",10901,"Marystown","NL",47.09899,-55.19852,2018-05-17 16:00:00,41,1,42
"38331",10901,"Marystown","NL",47.09899,-55.19852,2018-05-17 17:00:00,40,1,41
"38332",10901,"Marystown","NL",47.09899,-55.19852,2018-05-17 18:00:00,37,0,37
"38333",10901,"Marystown","NL",47.09899,-55.19852,2018-05-17 19:00:00,35,0,35
"38334",10901,"Marystown","NL",47.09899,-55.19852,2018-05-17 20:00:00,35,0,35
"38335",10901,"Marystown","NL",47.09899,-55.19852,2018-05-17 21:00:00,36,0,36
"38336",10901,"Marystown","NL",47.09899,-55.19852,2018-05-17 22:00:00,35,0,35
"38337",10901,"Marystown","NL",47.09899,-55.19852,2018-05-17 23:00:00,34,0,34
"38338",10901,"Marystown","NL",47.09899,-55.19852,2018-05-18 00:00:00,31,0,31
"38339",10901,"Marystown","NL",47.09899,-55.19852,2018-05-18 01:00:00,28,0,28
"38340",10901,"Marystown","NL",47.09899,-55.19852,2018-05-18 02:00:00,27,0,27
"38341",10901,"Marystown","NL",47.09899,-55.19852,2018-05-18 03:00:00,24,0,24
"38342",10901,"Marystown","NL",47.09899,-55.19852,2018-05-18 04:00:00,17,0,17
"38343",10901,"Marystown","NL",47.09899,-55.19852,2018-05-18 05:00:00,16,1,17
"38344",10901,"Marystown","NL",47.09899,-55.19852,2018-05-18 06:00:00,14,2,16
"38345",10901,"Marystown","NL",47.09899,-55.19852,2018-05-18 07:00:00,19,1,20
"38346",10901,"Marystown","NL",47.09899,-55.19852,2018-05-18 08:00:00,26,0,26
"38347",10901,"Marystown","NL",47.09899,-55.19852,2018-05-18 09:00:00,28,0,28
"38348",10901,"Marystown","NL",47.09899,-55.19852,2018-05-18 10:00:00,29,0,29
"38349",10901,"Marystown","NL",47.09899,-55.19852,2018-05-18 11:00:00,30,0,30
"38350",10901,"Marystown","NL",47.09899,-55.19852,2018-05-18 12:00:00,30,0,30
"38351",10901,"Marystown","NL",47.09899,-55.19852,2018-05-18 13:00:00,30,0,30
"38352",10901,"Marystown","NL",47.09899,-55.19852,2018-05-18 14:00:00,30,0,30
"38353",10901,"Marystown","NL",47.09899,-55.19852,2018-05-18 15:00:00,32,0,32
"38354",10901,"Marystown","NL",47.09899,-55.19852,2018-05-18 16:00:00,31,0,31
"38355",10901,"Marystown","NL",47.09899,-55.19852,2018-05-18 17:00:00,31,0,31
"38356",10901,"Marystown","NL",47.09899,-55.19852,2018-05-18 18:00:00,31,0,31
"38357",10901,"Marystown","NL",47.09899,-55.19852,2018-05-18 19:00:00,31,0,31
"38358",10901,"Marystown","NL",47.09899,-55.19852,2018-05-18 20:00:00,31,0,31
"38359",10901,"Marystown","NL",47.09899,-55.19852,2018-05-18 21:00:00,31,0,31
"38360",10901,"Marystown","NL",47.09899,-55.19852,2018-05-18 22:00:00,31,0,31
"38361",10901,"Marystown","NL",47.09899,-55.19852,2018-05-18 23:00:00,31,0,31
"38362",10901,"Marystown","NL",47.09899,-55.19852,2018-05-19 00:00:00,29,0,29
"38363",10901,"Marystown","NL",47.09899,-55.19852,2018-05-19 01:00:00,28,0,28
"38364",10901,"Marystown","NL",47.09899,-55.19852,2018-05-19 02:00:00,28,0,28
"38365",10901,"Marystown","NL",47.09899,-55.19852,2018-05-19 03:00:00,27,0,27
"38366",10901,"Marystown","NL",47.09899,-55.19852,2018-05-19 04:00:00,28,0,28
"38367",10901,"Marystown","NL",47.09899,-55.19852,2018-05-19 05:00:00,29,0,29
"38368",10901,"Marystown","NL",47.09899,-55.19852,2018-05-19 06:00:00,29,0,29
"38369",10901,"Marystown","NL",47.09899,-55.19852,2018-05-19 07:00:00,29,0,29
"38370",10901,"Marystown","NL",47.09899,-55.19852,2018-05-19 08:00:00,29,0,29
"38371",10901,"Marystown","NL",47.09899,-55.19852,2018-05-19 09:00:00,29,0,29
"38372",10901,"Marystown","NL",47.09899,-55.19852,2018-05-19 10:00:00,30,0,30
"38373",10901,"Marystown","NL",47.09899,-55.19852,2018-05-19 11:00:00,31,0,31
"38374",10901,"Marystown","NL",47.09899,-55.19852,2018-05-19 12:00:00,32,0,32
"38375",10901,"Marystown","NL",47.09899,-55.19852,2018-05-19 13:00:00,32,0,32
"38376",10901,"Marystown","NL",47.09899,-55.19852,2018-05-19 14:00:00,33,0,33
"38377",10901,"Marystown","NL",47.09899,-55.19852,2018-05-19 15:00:00,33,0,33
"38378",10901,"Marystown","NL",47.09899,-55.19852,2018-05-19 16:00:00,33,0,33
"38379",10901,"Marystown","NL",47.09899,-55.19852,2018-05-19 17:00:00,34,0,34
"38380",10901,"Marystown","NL",47.09899,-55.19852,2018-05-19 18:00:00,34,0,34
"38381",10901,"Marystown","NL",47.09899,-55.19852,2018-05-19 19:00:00,34,0,34
"38382",10901,"Marystown","NL",47.09899,-55.19852,2018-05-19 20:00:00,34,0,34
"38383",10901,"Marystown","NL",47.09899,-55.19852,2018-05-19 21:00:00,34,0,34
"38384",10901,"Marystown","NL",47.09899,-55.19852,2018-05-19 22:00:00,33,0,33
"38385",10901,"Marystown","NL",47.09899,-55.19852,2018-05-19 23:00:00,33,0,33
"38386",10901,"Marystown","NL",47.09899,-55.19852,2018-05-20 00:00:00,32,0,32
"38387",10901,"Marystown","NL",47.09899,-55.19852,2018-05-20 01:00:00,30,0,30
"38388",10901,"Marystown","NL",47.09899,-55.19852,2018-05-20 02:00:00,29,0,29
"38389",10901,"Marystown","NL",47.09899,-55.19852,2018-05-20 03:00:00,25,0,25
"38390",10901,"Marystown","NL",47.09899,-55.19852,2018-05-20 04:00:00,29,0,29
"38391",10901,"Marystown","NL",47.09899,-55.19852,2018-05-20 05:00:00,29,0,29
"38392",10901,"Marystown","NL",47.09899,-55.19852,2018-05-20 06:00:00,30,0,30
"38393",10901,"Marystown","NL",47.09899,-55.19852,2018-05-20 07:00:00,32,0,32
"38394",10901,"Marystown","NL",47.09899,-55.19852,2018-05-20 08:00:00,32,0,32
"38395",10901,"Marystown","NL",47.09899,-55.19852,2018-05-20 09:00:00,33,0,33
"38396",10901,"Marystown","NL",47.09899,-55.19852,2018-05-20 10:00:00,33,0,33
"38397",10901,"Marystown","NL",47.09899,-55.19852,2018-05-20 11:00:00,35,0,35
"38398",10901,"Marystown","NL",47.09899,-55.19852,2018-05-20 12:00:00,35,0,35
"38399",10901,"Marystown","NL",47.09899,-55.19852,2018-05-20 13:00:00,36,0,36
"38400",10901,"Marystown","NL",47.09899,-55.19852,2018-05-20 14:00:00,38,0,38
"38401",10901,"Marystown","NL",47.09899,-55.19852,2018-05-20 15:00:00,39,0,39
"38402",10901,"Marystown","NL",47.09899,-55.19852,2018-05-20 16:00:00,37,0,37
"38403",10901,"Marystown","NL",47.09899,-55.19852,2018-05-20 17:00:00,33,0,33
"38404",10901,"Marystown","NL",47.09899,-55.19852,2018-05-20 18:00:00,29,0,29
"38405",10901,"Marystown","NL",47.09899,-55.19852,2018-05-20 19:00:00,27,0,27
"38406",10901,"Marystown","NL",47.09899,-55.19852,2018-05-20 20:00:00,28,0,28
"38407",10901,"Marystown","NL",47.09899,-55.19852,2018-05-20 21:00:00,28,0,28
"38408",10901,"Marystown","NL",47.09899,-55.19852,2018-05-20 22:00:00,29,0,29
"38409",10901,"Marystown","NL",47.09899,-55.19852,2018-05-20 23:00:00,30,0,30
"38410",10901,"Marystown","NL",47.09899,-55.19852,2018-05-21 00:00:00,29,0,29
"38411",10901,"Marystown","NL",47.09899,-55.19852,2018-05-21 01:00:00,29,0,29
"38412",10901,"Marystown","NL",47.09899,-55.19852,2018-05-21 02:00:00,29,0,29
"38413",10901,"Marystown","NL",47.09899,-55.19852,2018-05-21 03:00:00,29,0,29
"38414",10901,"Marystown","NL",47.09899,-55.19852,2018-05-21 04:00:00,28,0,28
"38415",10901,"Marystown","NL",47.09899,-55.19852,2018-05-21 05:00:00,28,0,28
"38416",10901,"Marystown","NL",47.09899,-55.19852,2018-05-21 06:00:00,27,0,27
"38417",10901,"Marystown","NL",47.09899,-55.19852,2018-05-21 07:00:00,27,0,27
"38418",10901,"Marystown","NL",47.09899,-55.19852,2018-05-21 08:00:00,27,0,27
"38419",10901,"Marystown","NL",47.09899,-55.19852,2018-05-21 09:00:00,27,0,27
"38420",10901,"Marystown","NL",47.09899,-55.19852,2018-05-21 10:00:00,27,0,27
"38421",10901,"Marystown","NL",47.09899,-55.19852,2018-05-21 11:00:00,27,0,27
"38422",10901,"Marystown","NL",47.09899,-55.19852,2018-05-21 12:00:00,26,0,26
"38423",10901,"Marystown","NL",47.09899,-55.19852,2018-05-21 13:00:00,26,0,26
"38424",10901,"Marystown","NL",47.09899,-55.19852,2018-05-21 14:00:00,28,0,28
"38425",10901,"Marystown","NL",47.09899,-55.19852,2018-05-21 15:00:00,31,0,31
"38426",10901,"Marystown","NL",47.09899,-55.19852,2018-05-21 16:00:00,34,0,34
"38427",10901,"Marystown","NL",47.09899,-55.19852,2018-05-21 17:00:00,36,0,36
"38428",10901,"Marystown","NL",47.09899,-55.19852,2018-05-21 18:00:00,36,0,36
"38429",10901,"Marystown","NL",47.09899,-55.19852,2018-05-21 19:00:00,34,0,34
"38430",10901,"Marystown","NL",47.09899,-55.19852,2018-05-21 20:00:00,33,0,33
"38431",10901,"Marystown","NL",47.09899,-55.19852,2018-05-21 21:00:00,34,0,34
"38432",10901,"Marystown","NL",47.09899,-55.19852,2018-05-21 22:00:00,31,0,31
"38433",10901,"Marystown","NL",47.09899,-55.19852,2018-05-21 23:00:00,29,0,29
"38434",10901,"Marystown","NL",47.09899,-55.19852,2018-05-22 00:00:00,31,1,32
"38435",10901,"Marystown","NL",47.09899,-55.19852,2018-05-22 01:00:00,31,0,31
"38436",10901,"Marystown","NL",47.09899,-55.19852,2018-05-22 02:00:00,31,0,31
"38437",10901,"Marystown","NL",47.09899,-55.19852,2018-05-22 03:00:00,33,0,33
"38438",10901,"Marystown","NL",47.09899,-55.19852,2018-05-22 04:00:00,33,0,33
"38439",10901,"Marystown","NL",47.09899,-55.19852,2018-05-22 05:00:00,31,0,31
"38440",10901,"Marystown","NL",47.09899,-55.19852,2018-05-22 06:00:00,30,0,30
"38441",10901,"Marystown","NL",47.09899,-55.19852,2018-05-22 07:00:00,31,0,31
"38442",10901,"Marystown","NL",47.09899,-55.19852,2018-05-22 08:00:00,32,0,32
"38443",10901,"Marystown","NL",47.09899,-55.19852,2018-05-22 09:00:00,31,0,31
"38444",10901,"Marystown","NL",47.09899,-55.19852,2018-05-22 10:00:00,31,0,31
"38445",10901,"Marystown","NL",47.09899,-55.19852,2018-05-22 11:00:00,30,0,30
"38446",10901,"Marystown","NL",47.09899,-55.19852,2018-05-22 12:00:00,31,0,31
"38447",10901,"Marystown","NL",47.09899,-55.19852,2018-05-22 13:00:00,31,0,31
"38448",10901,"Marystown","NL",47.09899,-55.19852,2018-05-22 14:00:00,31,0,31
"38449",10901,"Marystown","NL",47.09899,-55.19852,2018-05-22 15:00:00,31,0,31
"38450",10901,"Marystown","NL",47.09899,-55.19852,2018-05-22 16:00:00,31,0,31
"38451",10901,"Marystown","NL",47.09899,-55.19852,2018-05-22 17:00:00,31,0,31
"38452",10901,"Marystown","NL",47.09899,-55.19852,2018-05-22 18:00:00,32,0,32
"38453",10901,"Marystown","NL",47.09899,-55.19852,2018-05-22 19:00:00,33,0,33
"38454",10901,"Marystown","NL",47.09899,-55.19852,2018-05-22 20:00:00,34,0,34
"38455",10901,"Marystown","NL",47.09899,-55.19852,2018-05-22 21:00:00,34,0,34
"38456",10901,"Marystown","NL",47.09899,-55.19852,2018-05-22 22:00:00,35,0,35
"38457",10901,"Marystown","NL",47.09899,-55.19852,2018-05-22 23:00:00,37,0,37
"38458",10901,"Marystown","NL",47.09899,-55.19852,2018-05-23 00:00:00,36,0,36
"38459",10901,"Marystown","NL",47.09899,-55.19852,2018-05-23 01:00:00,38,0,38
"38460",10901,"Marystown","NL",47.09899,-55.19852,2018-05-23 02:00:00,39,0,39
"38461",10901,"Marystown","NL",47.09899,-55.19852,2018-05-23 03:00:00,40,0,40
"38462",10901,"Marystown","NL",47.09899,-55.19852,2018-05-23 04:00:00,39,0,39
"38463",10901,"Marystown","NL",47.09899,-55.19852,2018-05-23 05:00:00,40,0,40
"38464",10901,"Marystown","NL",47.09899,-55.19852,2018-05-23 06:00:00,40,0,40
"38465",10901,"Marystown","NL",47.09899,-55.19852,2018-05-23 07:00:00,39,2,41
"38466",10901,"Marystown","NL",47.09899,-55.19852,2018-05-23 08:00:00,40,1,41
"38467",10901,"Marystown","NL",47.09899,-55.19852,2018-05-23 09:00:00,40,1,41
"38468",10901,"Marystown","NL",47.09899,-55.19852,2018-05-23 10:00:00,39,1,40
"38469",10901,"Marystown","NL",47.09899,-55.19852,2018-05-23 11:00:00,39,1,40
"38470",10901,"Marystown","NL",47.09899,-55.19852,2018-05-23 12:00:00,37,1,38
"38471",10901,"Marystown","NL",47.09899,-55.19852,2018-05-23 13:00:00,37,0,37
"38472",10901,"Marystown","NL",47.09899,-55.19852,2018-05-23 14:00:00,34,2,36
"38473",10901,"Marystown","NL",47.09899,-55.19852,2018-05-23 15:00:00,35,0,35
"38474",10901,"Marystown","NL",47.09899,-55.19852,2018-05-23 16:00:00,34,1,35
"38475",10901,"Marystown","NL",47.09899,-55.19852,2018-05-23 17:00:00,34,1,35
"38476",10901,"Marystown","NL",47.09899,-55.19852,2018-05-23 18:00:00,35,1,36
"38477",10901,"Marystown","NL",47.09899,-55.19852,2018-05-23 19:00:00,34,1,35
"38478",10901,"Marystown","NL",47.09899,-55.19852,2018-05-23 20:00:00,35,0,35
"38479",10901,"Marystown","NL",47.09899,-55.19852,2018-05-23 21:00:00,36,0,36
"38480",10901,"Marystown","NL",47.09899,-55.19852,2018-05-23 22:00:00,35,0,35
"38481",10901,"Marystown","NL",47.09899,-55.19852,2018-05-23 23:00:00,33,0,33
"38482",10901,"Marystown","NL",47.09899,-55.19852,2018-05-24 00:00:00,32,0,32
"38483",10901,"Marystown","NL",47.09899,-55.19852,2018-05-24 01:00:00,33,0,33
"38484",10901,"Marystown","NL",47.09899,-55.19852,2018-05-24 02:00:00,33,0,33
"38485",10901,"Marystown","NL",47.09899,-55.19852,2018-05-24 03:00:00,32,0,32
"38486",10901,"Marystown","NL",47.09899,-55.19852,2018-05-24 04:00:00,30,0,30
"38487",10901,"Marystown","NL",47.09899,-55.19852,2018-05-24 05:00:00,30,0,30
"38488",10901,"Marystown","NL",47.09899,-55.19852,2018-05-24 06:00:00,28,0,28
"38489",10901,"Marystown","NL",47.09899,-55.19852,2018-05-24 07:00:00,30,0,30
"38490",10901,"Marystown","NL",47.09899,-55.19852,2018-05-24 08:00:00,32,0,32
"38491",10901,"Marystown","NL",47.09899,-55.19852,2018-05-24 09:00:00,32,0,32
"38492",10901,"Marystown","NL",47.09899,-55.19852,2018-05-24 10:00:00,32,0,32
"38493",10901,"Marystown","NL",47.09899,-55.19852,2018-05-24 11:00:00,31,0,31
"38494",10901,"Marystown","NL",47.09899,-55.19852,2018-05-24 12:00:00,32,0,32
"38495",10901,"Marystown","NL",47.09899,-55.19852,2018-05-24 13:00:00,32,0,32
"38496",10901,"Marystown","NL",47.09899,-55.19852,2018-05-24 14:00:00,33,0,33
"38497",10901,"Marystown","NL",47.09899,-55.19852,2018-05-24 15:00:00,33,0,33
"38498",10901,"Marystown","NL",47.09899,-55.19852,2018-05-24 16:00:00,32,0,32
"38499",10901,"Marystown","NL",47.09899,-55.19852,2018-05-24 17:00:00,32,0,32
"38500",10901,"Marystown","NL",47.09899,-55.19852,2018-05-24 18:00:00,32,0,32
"38501",10901,"Marystown","NL",47.09899,-55.19852,2018-05-24 19:00:00,32,0,32
"38502",10901,"Marystown","NL",47.09899,-55.19852,2018-05-24 20:00:00,31,0,31
"38503",10901,"Marystown","NL",47.09899,-55.19852,2018-05-24 21:00:00,28,1,29
"38504",10901,"Marystown","NL",47.09899,-55.19852,2018-05-24 22:00:00,22,1,23
"38505",10901,"Marystown","NL",47.09899,-55.19852,2018-05-24 23:00:00,20,1,21
"38506",10901,"Marystown","NL",47.09899,-55.19852,2018-05-25 00:00:00,18,1,19
"38507",10901,"Marystown","NL",47.09899,-55.19852,2018-05-25 01:00:00,18,1,19
"38508",10901,"Marystown","NL",47.09899,-55.19852,2018-05-25 02:00:00,18,1,19
"38509",10901,"Marystown","NL",47.09899,-55.19852,2018-05-25 03:00:00,18,0,18
"38510",10901,"Marystown","NL",47.09899,-55.19852,2018-05-25 04:00:00,15,0,15
"38511",10901,"Marystown","NL",47.09899,-55.19852,2018-05-25 05:00:00,18,1,19
"38512",10901,"Marystown","NL",47.09899,-55.19852,2018-05-25 06:00:00,22,1,23
"38513",10901,"Marystown","NL",47.09899,-55.19852,2018-05-25 07:00:00,25,1,26
"38514",10901,"Marystown","NL",47.09899,-55.19852,2018-05-25 08:00:00,29,1,30
"38515",10901,"Marystown","NL",47.09899,-55.19852,2018-05-25 09:00:00,31,1,32
"38516",10901,"Marystown","NL",47.09899,-55.19852,2018-05-25 10:00:00,31,1,32
"38517",10901,"Marystown","NL",47.09899,-55.19852,2018-05-25 11:00:00,31,1,32
"38518",10901,"Marystown","NL",47.09899,-55.19852,2018-05-25 12:00:00,31,0,31
"38519",10901,"Marystown","NL",47.09899,-55.19852,2018-05-25 13:00:00,31,0,31
"38520",10901,"Marystown","NL",47.09899,-55.19852,2018-05-25 14:00:00,31,0,31
"38521",10901,"Marystown","NL",47.09899,-55.19852,2018-05-25 15:00:00,32,0,32
"38522",10901,"Marystown","NL",47.09899,-55.19852,2018-05-25 16:00:00,32,1,33
"38523",10901,"Marystown","NL",47.09899,-55.19852,2018-05-25 17:00:00,32,0,32
"38524",10901,"Marystown","NL",47.09899,-55.19852,2018-05-25 18:00:00,34,0,34
"38525",10901,"Marystown","NL",47.09899,-55.19852,2018-05-25 19:00:00,36,0,36
"38526",10901,"Marystown","NL",47.09899,-55.19852,2018-05-25 20:00:00,36,0,36
"38527",10901,"Marystown","NL",47.09899,-55.19852,2018-05-25 21:00:00,37,0,37
"38528",10901,"Marystown","NL",47.09899,-55.19852,2018-05-25 22:00:00,36,0,36
"38529",10901,"Marystown","NL",47.09899,-55.19852,2018-05-25 23:00:00,36,0,36
"38530",10901,"Marystown","NL",47.09899,-55.19852,2018-05-26 00:00:00,36,0,36
"38531",10901,"Marystown","NL",47.09899,-55.19852,2018-05-26 01:00:00,36,0,36
"38532",10901,"Marystown","NL",47.09899,-55.19852,2018-05-26 02:00:00,34,0,34
"38533",10901,"Marystown","NL",47.09899,-55.19852,2018-05-26 03:00:00,30,0,30
"38534",10901,"Marystown","NL",47.09899,-55.19852,2018-05-26 04:00:00,32,0,32
"38535",10901,"Marystown","NL",47.09899,-55.19852,2018-05-26 05:00:00,31,0,31
"38536",10901,"Marystown","NL",47.09899,-55.19852,2018-05-26 06:00:00,32,0,32
"38537",10901,"Marystown","NL",47.09899,-55.19852,2018-05-26 07:00:00,33,0,33
"38538",10901,"Marystown","NL",47.09899,-55.19852,2018-05-26 08:00:00,35,0,35
"38539",10901,"Marystown","NL",47.09899,-55.19852,2018-05-26 09:00:00,36,0,36
"38540",10901,"Marystown","NL",47.09899,-55.19852,2018-05-26 10:00:00,36,0,36
"38541",10901,"Marystown","NL",47.09899,-55.19852,2018-05-26 11:00:00,34,0,34
"38542",10901,"Marystown","NL",47.09899,-55.19852,2018-05-26 12:00:00,34,0,34
"38543",10901,"Marystown","NL",47.09899,-55.19852,2018-05-26 13:00:00,33,0,33
"38544",10901,"Marystown","NL",47.09899,-55.19852,2018-05-26 14:00:00,32,0,32
"38545",10901,"Marystown","NL",47.09899,-55.19852,2018-05-26 15:00:00,32,1,33
"38546",10901,"Marystown","NL",47.09899,-55.19852,2018-05-26 16:00:00,32,1,33
"38547",10901,"Marystown","NL",47.09899,-55.19852,2018-05-26 17:00:00,32,1,33
"38548",10901,"Marystown","NL",47.09899,-55.19852,2018-05-26 18:00:00,31,1,32
"38549",10901,"Marystown","NL",47.09899,-55.19852,2018-05-26 19:00:00,31,0,31
"38550",10901,"Marystown","NL",47.09899,-55.19852,2018-05-26 20:00:00,30,0,30
"38551",10901,"Marystown","NL",47.09899,-55.19852,2018-05-26 21:00:00,29,0,29
"38552",10901,"Marystown","NL",47.09899,-55.19852,2018-05-26 22:00:00,27,0,27
"38553",10901,"Marystown","NL",47.09899,-55.19852,2018-05-26 23:00:00,27,0,27
"38554",10901,"Marystown","NL",47.09899,-55.19852,2018-05-27 00:00:00,27,0,27
"38555",10901,"Marystown","NL",47.09899,-55.19852,2018-05-27 01:00:00,26,0,26
"38556",10901,"Marystown","NL",47.09899,-55.19852,2018-05-27 02:00:00,28,0,28
"38557",10901,"Marystown","NL",47.09899,-55.19852,2018-05-27 03:00:00,27,0,27
"38558",10901,"Marystown","NL",47.09899,-55.19852,2018-05-27 04:00:00,26,0,26
"38559",10901,"Marystown","NL",47.09899,-55.19852,2018-05-27 05:00:00,25,0,25
"38560",10901,"Marystown","NL",47.09899,-55.19852,2018-05-27 06:00:00,25,0,25
"38561",10901,"Marystown","NL",47.09899,-55.19852,2018-05-27 07:00:00,25,0,25
"38562",10901,"Marystown","NL",47.09899,-55.19852,2018-05-27 08:00:00,26,0,26
"38563",10901,"Marystown","NL",47.09899,-55.19852,2018-05-27 09:00:00,28,0,28
"38564",10901,"Marystown","NL",47.09899,-55.19852,2018-05-27 10:00:00,30,0,30
"38565",10901,"Marystown","NL",47.09899,-55.19852,2018-05-27 11:00:00,31,0,31
"38566",10901,"Marystown","NL",47.09899,-55.19852,2018-05-27 12:00:00,29,0,29
"38567",10901,"Marystown","NL",47.09899,-55.19852,2018-05-27 13:00:00,30,0,30
"38568",10901,"Marystown","NL",47.09899,-55.19852,2018-05-27 14:00:00,31,0,31
"38569",10901,"Marystown","NL",47.09899,-55.19852,2018-05-27 15:00:00,32,0,32
"38570",10901,"Marystown","NL",47.09899,-55.19852,2018-05-27 16:00:00,33,0,33
"38571",10901,"Marystown","NL",47.09899,-55.19852,2018-05-27 17:00:00,32,0,32
"38572",10901,"Marystown","NL",47.09899,-55.19852,2018-05-27 18:00:00,29,0,29
"38573",10901,"Marystown","NL",47.09899,-55.19852,2018-05-27 19:00:00,27,0,27
"38574",10901,"Marystown","NL",47.09899,-55.19852,2018-05-27 20:00:00,29,0,29
"38575",10901,"Marystown","NL",47.09899,-55.19852,2018-05-27 21:00:00,28,0,28
"38576",10901,"Marystown","NL",47.09899,-55.19852,2018-05-27 22:00:00,28,0,28
"38577",10901,"Marystown","NL",47.09899,-55.19852,2018-05-27 23:00:00,27,0,27
"38578",10901,"Marystown","NL",47.09899,-55.19852,2018-05-28 00:00:00,23,0,23
"38579",10901,"Marystown","NL",47.09899,-55.19852,2018-05-28 01:00:00,19,1,20
"38580",10901,"Marystown","NL",47.09899,-55.19852,2018-05-28 02:00:00,15,1,16
"38581",10901,"Marystown","NL",47.09899,-55.19852,2018-05-28 03:00:00,15,0,15
"38582",10901,"Marystown","NL",47.09899,-55.19852,2018-05-28 04:00:00,13,0,13
"38583",10901,"Marystown","NL",47.09899,-55.19852,2018-05-28 05:00:00,11,0,11
"38584",10901,"Marystown","NL",47.09899,-55.19852,2018-05-28 06:00:00,9,1,10
"38585",10901,"Marystown","NL",47.09899,-55.19852,2018-05-28 07:00:00,18,2,20
"38586",10901,"Marystown","NL",47.09899,-55.19852,2018-05-28 08:00:00,25,0,25
"38587",10901,"Marystown","NL",47.09899,-55.19852,2018-05-28 09:00:00,28,0,28
"38588",10901,"Marystown","NL",47.09899,-55.19852,2018-05-28 10:00:00,31,0,31
"38589",10901,"Marystown","NL",47.09899,-55.19852,2018-05-28 11:00:00,33,0,33
"38590",10901,"Marystown","NL",47.09899,-55.19852,2018-05-28 12:00:00,32,0,32
"38591",10901,"Marystown","NL",47.09899,-55.19852,2018-05-28 13:00:00,31,1,32
"38592",10901,"Marystown","NL",47.09899,-55.19852,2018-05-28 14:00:00,34,0,34
"38593",10901,"Marystown","NL",47.09899,-55.19852,2018-05-28 15:00:00,33,3,36
"38594",10901,"Marystown","NL",47.09899,-55.19852,2018-05-28 16:00:00,33,1,34
"38595",10901,"Marystown","NL",47.09899,-55.19852,2018-05-28 17:00:00,34,0,34
"38596",10901,"Marystown","NL",47.09899,-55.19852,2018-05-28 18:00:00,34,0,34
"38597",10901,"Marystown","NL",47.09899,-55.19852,2018-05-28 19:00:00,33,0,33
"38598",10901,"Marystown","NL",47.09899,-55.19852,2018-05-28 20:00:00,30,0,30
"38599",10901,"Marystown","NL",47.09899,-55.19852,2018-05-28 21:00:00,27,0,27
"38600",10901,"Marystown","NL",47.09899,-55.19852,2018-05-28 22:00:00,27,0,27
"38601",10901,"Marystown","NL",47.09899,-55.19852,2018-05-28 23:00:00,28,0,28
"38602",10901,"Marystown","NL",47.09899,-55.19852,2018-05-29 00:00:00,28,1,29
"38603",10901,"Marystown","NL",47.09899,-55.19852,2018-05-29 01:00:00,30,0,30
"38604",10901,"Marystown","NL",47.09899,-55.19852,2018-05-29 02:00:00,32,0,32
"38605",10901,"Marystown","NL",47.09899,-55.19852,2018-05-29 03:00:00,33,0,33
"38606",10901,"Marystown","NL",47.09899,-55.19852,2018-05-29 04:00:00,34,0,34
"38607",10901,"Marystown","NL",47.09899,-55.19852,2018-05-29 05:00:00,33,0,33
"38608",10901,"Marystown","NL",47.09899,-55.19852,2018-05-29 06:00:00,33,0,33
"38609",10901,"Marystown","NL",47.09899,-55.19852,2018-05-29 07:00:00,32,1,33
"38610",10901,"Marystown","NL",47.09899,-55.19852,2018-05-29 08:00:00,32,1,33
"38611",10901,"Marystown","NL",47.09899,-55.19852,2018-05-29 09:00:00,33,1,34
"38612",10901,"Marystown","NL",47.09899,-55.19852,2018-05-29 10:00:00,33,1,34
"38613",10901,"Marystown","NL",47.09899,-55.19852,2018-05-29 11:00:00,32,0,32
"38614",10901,"Marystown","NL",47.09899,-55.19852,2018-05-29 12:00:00,31,1,32
"38615",10901,"Marystown","NL",47.09899,-55.19852,2018-05-29 13:00:00,31,1,32
"38616",10901,"Marystown","NL",47.09899,-55.19852,2018-05-29 14:00:00,33,1,34
"38617",10901,"Marystown","NL",47.09899,-55.19852,2018-05-29 15:00:00,32,1,33
"38618",10901,"Marystown","NL",47.09899,-55.19852,2018-05-29 16:00:00,34,1,35
"38619",10901,"Marystown","NL",47.09899,-55.19852,2018-05-29 17:00:00,34,1,35
"38620",10901,"Marystown","NL",47.09899,-55.19852,2018-05-29 18:00:00,35,0,35
"38621",10901,"Marystown","NL",47.09899,-55.19852,2018-05-29 19:00:00,36,0,36
"38622",10901,"Marystown","NL",47.09899,-55.19852,2018-05-29 20:00:00,35,1,36
"38623",10901,"Marystown","NL",47.09899,-55.19852,2018-05-29 21:00:00,35,0,35
"38624",10901,"Marystown","NL",47.09899,-55.19852,2018-05-29 22:00:00,32,1,33
"38625",10901,"Marystown","NL",47.09899,-55.19852,2018-05-29 23:00:00,30,0,30
"38626",10901,"Marystown","NL",47.09899,-55.19852,2018-05-30 00:00:00,29,0,29
"38627",10901,"Marystown","NL",47.09899,-55.19852,2018-05-30 01:00:00,31,0,31
"38628",10901,"Marystown","NL",47.09899,-55.19852,2018-05-30 02:00:00,32,0,32
"38629",10901,"Marystown","NL",47.09899,-55.19852,2018-05-30 03:00:00,26,0,26
"38630",10901,"Marystown","NL",47.09899,-55.19852,2018-05-30 04:00:00,27,0,27
"38631",10901,"Marystown","NL",47.09899,-55.19852,2018-05-30 05:00:00,29,0,29
"38632",10901,"Marystown","NL",47.09899,-55.19852,2018-05-30 06:00:00,30,0,30
"38633",10901,"Marystown","NL",47.09899,-55.19852,2018-05-30 07:00:00,29,0,29
"38634",10901,"Marystown","NL",47.09899,-55.19852,2018-05-30 08:00:00,28,0,28
"38635",10901,"Marystown","NL",47.09899,-55.19852,2018-05-30 09:00:00,27,0,27
"38636",10901,"Marystown","NL",47.09899,-55.19852,2018-05-30 10:00:00,26,0,26
"38637",10901,"Marystown","NL",47.09899,-55.19852,2018-05-30 11:00:00,26,0,26
"38638",10901,"Marystown","NL",47.09899,-55.19852,2018-05-30 12:00:00,26,0,26
"38639",10901,"Marystown","NL",47.09899,-55.19852,2018-05-30 13:00:00,26,0,26
"38640",10901,"Marystown","NL",47.09899,-55.19852,2018-05-30 14:00:00,27,0,27
"38641",10901,"Marystown","NL",47.09899,-55.19852,2018-05-30 15:00:00,28,0,28
"38642",10901,"Marystown","NL",47.09899,-55.19852,2018-05-30 16:00:00,27,0,27
"38643",10901,"Marystown","NL",47.09899,-55.19852,2018-05-30 17:00:00,27,0,27
"38644",10901,"Marystown","NL",47.09899,-55.19852,2018-05-30 18:00:00,29,0,29
"38645",10901,"Marystown","NL",47.09899,-55.19852,2018-05-30 19:00:00,29,0,29
"38646",10901,"Marystown","NL",47.09899,-55.19852,2018-05-30 20:00:00,29,0,29
"38647",10901,"Marystown","NL",47.09899,-55.19852,2018-05-30 21:00:00,28,0,28
"38648",10901,"Marystown","NL",47.09899,-55.19852,2018-05-30 22:00:00,29,0,29
"38649",10901,"Marystown","NL",47.09899,-55.19852,2018-05-30 23:00:00,28,0,28
"38650",10901,"Marystown","NL",47.09899,-55.19852,2018-05-31 00:00:00,28,0,28
"38651",10901,"Marystown","NL",47.09899,-55.19852,2018-05-31 01:00:00,28,0,28
"38652",10901,"Marystown","NL",47.09899,-55.19852,2018-05-31 02:00:00,28,0,28
"38653",10901,"Marystown","NL",47.09899,-55.19852,2018-05-31 03:00:00,29,0,29
"38654",10901,"Marystown","NL",47.09899,-55.19852,2018-05-31 04:00:00,29,0,29
"38655",10901,"Marystown","NL",47.09899,-55.19852,2018-05-31 05:00:00,30,0,30
"38656",10901,"Marystown","NL",47.09899,-55.19852,2018-05-31 06:00:00,30,0,30
"38657",10901,"Marystown","NL",47.09899,-55.19852,2018-05-31 07:00:00,31,0,31
"38658",10901,"Marystown","NL",47.09899,-55.19852,2018-05-31 08:00:00,34,0,34
"38659",10901,"Marystown","NL",47.09899,-55.19852,2018-05-31 09:00:00,36,0,36
"38660",10901,"Marystown","NL",47.09899,-55.19852,2018-05-31 10:00:00,40,0,40
"38661",10901,"Marystown","NL",47.09899,-55.19852,2018-05-31 11:00:00,39,0,39
"38662",10901,"Marystown","NL",47.09899,-55.19852,2018-05-31 12:00:00,41,0,41
"38663",10901,"Marystown","NL",47.09899,-55.19852,2018-05-31 13:00:00,42,0,42
"38664",10901,"Marystown","NL",47.09899,-55.19852,2018-05-31 14:00:00,40,0,40
"38665",10901,"Marystown","NL",47.09899,-55.19852,2018-05-31 15:00:00,38,0,38
"38666",10901,"Marystown","NL",47.09899,-55.19852,2018-05-31 16:00:00,37,0,37
"38667",10901,"Marystown","NL",47.09899,-55.19852,2018-05-31 17:00:00,36,0,36
"38668",10901,"Marystown","NL",47.09899,-55.19852,2018-05-31 18:00:00,36,0,36
"38669",10901,"Marystown","NL",47.09899,-55.19852,2018-05-31 19:00:00,36,0,36
"38670",10901,"Marystown","NL",47.09899,-55.19852,2018-05-31 20:00:00,35,0,35
"38671",10901,"Marystown","NL",47.09899,-55.19852,2018-05-31 21:00:00,33,0,33
"38672",10901,"Marystown","NL",47.09899,-55.19852,2018-05-31 22:00:00,33,0,33
"38673",10901,"Marystown","NL",47.09899,-55.19852,2018-05-31 23:00:00,34,0,34
"38674",10901,"Marystown","NL",47.09899,-55.19852,2018-06-01 00:00:00,34,0,34
"38675",10901,"Marystown","NL",47.09899,-55.19852,2018-06-01 01:00:00,33,0,33
"38676",10901,"Marystown","NL",47.09899,-55.19852,2018-06-01 02:00:00,31,0,31
"38677",10901,"Marystown","NL",47.09899,-55.19852,2018-06-01 03:00:00,31,0,31
"38678",10901,"Marystown","NL",47.09899,-55.19852,2018-06-01 04:00:00,31,0,31
"38679",10901,"Marystown","NL",47.09899,-55.19852,2018-06-01 05:00:00,30,0,30
"38680",10901,"Marystown","NL",47.09899,-55.19852,2018-06-01 06:00:00,28,0,28
"38681",10901,"Marystown","NL",47.09899,-55.19852,2018-06-01 07:00:00,27,0,27
"38682",10901,"Marystown","NL",47.09899,-55.19852,2018-06-01 08:00:00,27,0,27
"38683",10901,"Marystown","NL",47.09899,-55.19852,2018-06-01 09:00:00,26,0,26
"38684",10901,"Marystown","NL",47.09899,-55.19852,2018-06-01 10:00:00,26,0,26
"38685",10901,"Marystown","NL",47.09899,-55.19852,2018-06-01 11:00:00,27,0,27
"38686",10901,"Marystown","NL",47.09899,-55.19852,2018-06-01 12:00:00,28,0,28
"38687",10901,"Marystown","NL",47.09899,-55.19852,2018-06-01 13:00:00,25,1,26
"38688",10901,"Marystown","NL",47.09899,-55.19852,2018-06-01 14:00:00,24,0,24
"38689",10901,"Marystown","NL",47.09899,-55.19852,2018-06-01 15:00:00,25,1,26
"38690",10901,"Marystown","NL",47.09899,-55.19852,2018-06-01 16:00:00,27,1,28
"38691",10901,"Marystown","NL",47.09899,-55.19852,2018-06-01 17:00:00,28,0,28
"38692",10901,"Marystown","NL",47.09899,-55.19852,2018-06-01 18:00:00,27,0,27
"38693",10901,"Marystown","NL",47.09899,-55.19852,2018-06-01 19:00:00,27,0,27
"38694",10901,"Marystown","NL",47.09899,-55.19852,2018-06-01 20:00:00,27,0,27
"38695",10901,"Marystown","NL",47.09899,-55.19852,2018-06-01 21:00:00,26,1,27
"38696",10901,"Marystown","NL",47.09899,-55.19852,2018-06-01 22:00:00,23,1,24
"38697",10901,"Marystown","NL",47.09899,-55.19852,2018-06-01 23:00:00,22,0,22
"38698",10901,"Marystown","NL",47.09899,-55.19852,2018-06-02 00:00:00,25,0,25
"38699",10901,"Marystown","NL",47.09899,-55.19852,2018-06-02 01:00:00,24,1,25
"38700",10901,"Marystown","NL",47.09899,-55.19852,2018-06-02 02:00:00,17,0,17
"38701",10901,"Marystown","NL",47.09899,-55.19852,2018-06-02 03:00:00,21,0,21
"38702",10901,"Marystown","NL",47.09899,-55.19852,2018-06-02 04:00:00,20,0,20
"38703",10901,"Marystown","NL",47.09899,-55.19852,2018-06-02 05:00:00,17,0,17
"38704",10901,"Marystown","NL",47.09899,-55.19852,2018-06-02 06:00:00,16,0,16
"38705",10901,"Marystown","NL",47.09899,-55.19852,2018-06-02 07:00:00,16,0,16
"38706",10901,"Marystown","NL",47.09899,-55.19852,2018-06-02 08:00:00,17,0,17
"38707",10901,"Marystown","NL",47.09899,-55.19852,2018-06-02 09:00:00,22,0,22
"38708",10901,"Marystown","NL",47.09899,-55.19852,2018-06-02 10:00:00,25,0,25
"38709",10901,"Marystown","NL",47.09899,-55.19852,2018-06-02 11:00:00,29,0,29
"38710",10901,"Marystown","NL",47.09899,-55.19852,2018-06-02 12:00:00,24,0,24
"38711",10901,"Marystown","NL",47.09899,-55.19852,2018-06-02 13:00:00,24,0,24
"38712",10901,"Marystown","NL",47.09899,-55.19852,2018-06-02 14:00:00,25,1,26
"38713",10901,"Marystown","NL",47.09899,-55.19852,2018-06-02 15:00:00,27,0,27
"38714",10901,"Marystown","NL",47.09899,-55.19852,2018-06-02 16:00:00,30,0,30
"38715",10901,"Marystown","NL",47.09899,-55.19852,2018-06-02 17:00:00,32,1,33
"38716",10901,"Marystown","NL",47.09899,-55.19852,2018-06-02 18:00:00,30,0,30
"38717",10901,"Marystown","NL",47.09899,-55.19852,2018-06-02 19:00:00,29,0,29
"38718",10901,"Marystown","NL",47.09899,-55.19852,2018-06-02 20:00:00,27,1,28
"38719",10901,"Marystown","NL",47.09899,-55.19852,2018-06-02 21:00:00,25,1,26
"38720",10901,"Marystown","NL",47.09899,-55.19852,2018-06-02 22:00:00,25,0,25
"38721",10901,"Marystown","NL",47.09899,-55.19852,2018-06-02 23:00:00,28,0,28
"38722",10901,"Marystown","NL",47.09899,-55.19852,2018-06-03 00:00:00,29,0,29
"38723",10901,"Marystown","NL",47.09899,-55.19852,2018-06-03 01:00:00,27,0,27
"38724",10901,"Marystown","NL",47.09899,-55.19852,2018-06-03 02:00:00,26,0,26
"38725",10901,"Marystown","NL",47.09899,-55.19852,2018-06-03 03:00:00,26,0,26
"38726",10901,"Marystown","NL",47.09899,-55.19852,2018-06-03 04:00:00,25,0,25
"38727",10901,"Marystown","NL",47.09899,-55.19852,2018-06-03 05:00:00,25,0,25
"38728",10901,"Marystown","NL",47.09899,-55.19852,2018-06-03 06:00:00,25,0,25
"38729",10901,"Marystown","NL",47.09899,-55.19852,2018-06-03 07:00:00,25,0,25
"38730",10901,"Marystown","NL",47.09899,-55.19852,2018-06-03 08:00:00,25,0,25
"38731",10901,"Marystown","NL",47.09899,-55.19852,2018-06-03 09:00:00,24,0,24
"38732",10901,"Marystown","NL",47.09899,-55.19852,2018-06-03 10:00:00,24,0,24
"38733",10901,"Marystown","NL",47.09899,-55.19852,2018-06-03 11:00:00,24,0,24
"38734",10901,"Marystown","NL",47.09899,-55.19852,2018-06-03 12:00:00,25,0,25
"38735",10901,"Marystown","NL",47.09899,-55.19852,2018-06-03 13:00:00,25,0,25
"38736",10901,"Marystown","NL",47.09899,-55.19852,2018-06-03 14:00:00,24,0,24
"38737",10901,"Marystown","NL",47.09899,-55.19852,2018-06-03 15:00:00,23,0,23
"38738",10901,"Marystown","NL",47.09899,-55.19852,2018-06-03 16:00:00,23,0,23
"38739",10901,"Marystown","NL",47.09899,-55.19852,2018-06-03 17:00:00,23,0,23
"38740",10901,"Marystown","NL",47.09899,-55.19852,2018-06-03 18:00:00,23,0,23
"38741",10901,"Marystown","NL",47.09899,-55.19852,2018-06-03 19:00:00,24,0,24
"38742",10901,"Marystown","NL",47.09899,-55.19852,2018-06-03 20:00:00,24,0,24
"38743",10901,"Marystown","NL",47.09899,-55.19852,2018-06-03 21:00:00,24,0,24
"38744",10901,"Marystown","NL",47.09899,-55.19852,2018-06-03 22:00:00,24,0,24
"38745",10901,"Marystown","NL",47.09899,-55.19852,2018-06-03 23:00:00,24,0,24
"38746",10901,"Marystown","NL",47.09899,-55.19852,2018-06-04 00:00:00,24,0,24
"38747",10901,"Marystown","NL",47.09899,-55.19852,2018-06-04 01:00:00,24,0,24
"38748",10901,"Marystown","NL",47.09899,-55.19852,2018-06-04 02:00:00,24,0,24
"38749",10901,"Marystown","NL",47.09899,-55.19852,2018-06-04 03:00:00,24,0,24
"38750",10901,"Marystown","NL",47.09899,-55.19852,2018-06-04 04:00:00,25,0,25
"38751",10901,"Marystown","NL",47.09899,-55.19852,2018-06-04 05:00:00,26,0,26
"38752",10901,"Marystown","NL",47.09899,-55.19852,2018-06-04 06:00:00,25,0,25
"38753",10901,"Marystown","NL",47.09899,-55.19852,2018-06-04 07:00:00,25,0,25
"38754",10901,"Marystown","NL",47.09899,-55.19852,2018-06-04 08:00:00,25,0,25
"38755",10901,"Marystown","NL",47.09899,-55.19852,2018-06-04 09:00:00,25,0,25
"38756",10901,"Marystown","NL",47.09899,-55.19852,2018-06-04 10:00:00,26,0,26
"38757",10901,"Marystown","NL",47.09899,-55.19852,2018-06-04 11:00:00,26,0,26
"38758",10901,"Marystown","NL",47.09899,-55.19852,2018-06-04 12:00:00,25,0,25
"38759",10901,"Marystown","NL",47.09899,-55.19852,2018-06-04 13:00:00,25,0,25
"38760",10901,"Marystown","NL",47.09899,-55.19852,2018-06-04 14:00:00,26,0,26
"38761",10901,"Marystown","NL",47.09899,-55.19852,2018-06-04 15:00:00,26,0,26
"38762",10901,"Marystown","NL",47.09899,-55.19852,2018-06-04 16:00:00,28,0,28
"38763",10901,"Marystown","NL",47.09899,-55.19852,2018-06-04 17:00:00,28,0,28
"38764",10901,"Marystown","NL",47.09899,-55.19852,2018-06-04 18:00:00,29,0,29
"38765",10901,"Marystown","NL",47.09899,-55.19852,2018-06-04 19:00:00,30,0,30
"38766",10901,"Marystown","NL",47.09899,-55.19852,2018-06-04 20:00:00,27,0,27
"38767",10901,"Marystown","NL",47.09899,-55.19852,2018-06-04 21:00:00,21,0,21
"38768",10901,"Marystown","NL",47.09899,-55.19852,2018-06-04 22:00:00,16,1,17
"38769",10901,"Marystown","NL",47.09899,-55.19852,2018-06-04 23:00:00,13,1,14
"38770",10901,"Marystown","NL",47.09899,-55.19852,2018-06-05 00:00:00,15,1,16
"38771",10901,"Marystown","NL",47.09899,-55.19852,2018-06-05 01:00:00,14,1,15
"38772",10901,"Marystown","NL",47.09899,-55.19852,2018-06-05 02:00:00,11,1,12
"38773",10901,"Marystown","NL",47.09899,-55.19852,2018-06-05 03:00:00,11,1,12
"38774",10901,"Marystown","NL",47.09899,-55.19852,2018-06-05 04:00:00,8,0,8
"38775",10901,"Marystown","NL",47.09899,-55.19852,2018-06-05 05:00:00,9,0,9
"38776",10901,"Marystown","NL",47.09899,-55.19852,2018-06-05 06:00:00,9,1,10
"38777",10901,"Marystown","NL",47.09899,-55.19852,2018-06-05 07:00:00,13,2,15
"38778",10901,"Marystown","NL",47.09899,-55.19852,2018-06-05 08:00:00,20,1,21
"38779",10901,"Marystown","NL",47.09899,-55.19852,2018-06-05 09:00:00,26,0,26
"38780",10901,"Marystown","NL",47.09899,-55.19852,2018-06-05 10:00:00,27,0,27
"38781",10901,"Marystown","NL",47.09899,-55.19852,2018-06-05 11:00:00,27,0,27
"38782",10901,"Marystown","NL",47.09899,-55.19852,2018-06-05 12:00:00,28,0,28
"38783",10901,"Marystown","NL",47.09899,-55.19852,2018-06-05 13:00:00,28,0,28
"38784",10901,"Marystown","NL",47.09899,-55.19852,2018-06-05 14:00:00,27,0,27
"38785",10901,"Marystown","NL",47.09899,-55.19852,2018-06-05 15:00:00,28,1,29
"38786",10901,"Marystown","NL",47.09899,-55.19852,2018-06-05 16:00:00,30,1,31
"38787",10901,"Marystown","NL",47.09899,-55.19852,2018-06-05 17:00:00,30,1,31
"38788",10901,"Marystown","NL",47.09899,-55.19852,2018-06-05 18:00:00,27,0,27
"38789",10901,"Marystown","NL",47.09899,-55.19852,2018-06-05 19:00:00,27,1,28
"38790",10901,"Marystown","NL",47.09899,-55.19852,2018-06-05 20:00:00,27,2,29
"38791",10901,"Marystown","NL",47.09899,-55.19852,2018-06-05 21:00:00,33,1,34
"38792",10901,"Marystown","NL",47.09899,-55.19852,2018-06-05 22:00:00,37,0,37
"38793",10901,"Marystown","NL",47.09899,-55.19852,2018-06-05 23:00:00,37,0,37
"38794",10901,"Marystown","NL",47.09899,-55.19852,2018-06-06 00:00:00,37,0,37
"38795",10901,"Marystown","NL",47.09899,-55.19852,2018-06-06 01:00:00,38,0,38
"38796",10901,"Marystown","NL",47.09899,-55.19852,2018-06-06 02:00:00,38,0,38
"38797",10901,"Marystown","NL",47.09899,-55.19852,2018-06-06 03:00:00,42,0,42
"38798",10901,"Marystown","NL",47.09899,-55.19852,2018-06-06 04:00:00,42,0,42
"38799",10901,"Marystown","NL",47.09899,-55.19852,2018-06-06 05:00:00,40,0,40
"38800",10901,"Marystown","NL",47.09899,-55.19852,2018-06-06 06:00:00,39,0,39
"38801",10901,"Marystown","NL",47.09899,-55.19852,2018-06-06 07:00:00,39,0,39
"38802",10901,"Marystown","NL",47.09899,-55.19852,2018-06-06 08:00:00,39,2,41
"38803",10901,"Marystown","NL",47.09899,-55.19852,2018-06-06 09:00:00,39,0,39
"38804",10901,"Marystown","NL",47.09899,-55.19852,2018-06-06 10:00:00,39,0,39
"38805",10901,"Marystown","NL",47.09899,-55.19852,2018-06-06 11:00:00,40,0,40
"38806",10901,"Marystown","NL",47.09899,-55.19852,2018-06-06 12:00:00,40,0,40
"38807",10901,"Marystown","NL",47.09899,-55.19852,2018-06-06 13:00:00,39,0,39
"38808",10901,"Marystown","NL",47.09899,-55.19852,2018-06-06 14:00:00,39,0,39
"38809",10901,"Marystown","NL",47.09899,-55.19852,2018-06-06 15:00:00,40,0,40
"38810",10901,"Marystown","NL",47.09899,-55.19852,2018-06-06 16:00:00,42,0,42
"38811",10901,"Marystown","NL",47.09899,-55.19852,2018-06-06 17:00:00,45,0,45
"38812",10901,"Marystown","NL",47.09899,-55.19852,2018-06-06 18:00:00,50,0,50
"38813",10901,"Marystown","NL",47.09899,-55.19852,2018-06-06 19:00:00,44,0,44
"38814",10901,"Marystown","NL",47.09899,-55.19852,2018-06-06 20:00:00,36,0,36
"38815",10901,"Marystown","NL",47.09899,-55.19852,2018-06-06 21:00:00,33,0,33
"38816",10901,"Marystown","NL",47.09899,-55.19852,2018-06-06 22:00:00,29,0,29
"38817",10901,"Marystown","NL",47.09899,-55.19852,2018-06-06 23:00:00,27,0,27
"38818",10901,"Marystown","NL",47.09899,-55.19852,2018-06-07 00:00:00,18,0,18
"38819",10901,"Marystown","NL",47.09899,-55.19852,2018-06-07 01:00:00,14,1,15
"38820",10901,"Marystown","NL",47.09899,-55.19852,2018-06-07 02:00:00,11,0,11
"38821",10901,"Marystown","NL",47.09899,-55.19852,2018-06-07 03:00:00,10,1,11
"38822",10901,"Marystown","NL",47.09899,-55.19852,2018-06-07 04:00:00,9,1,10
"38823",10901,"Marystown","NL",47.09899,-55.19852,2018-06-07 05:00:00,10,1,11
"38824",10901,"Marystown","NL",47.09899,-55.19852,2018-06-07 06:00:00,9,1,10
"38825",10901,"Marystown","NL",47.09899,-55.19852,2018-06-07 07:00:00,24,1,25
"38826",10901,"Marystown","NL",47.09899,-55.19852,2018-06-07 08:00:00,33,1,34
"38827",10901,"Marystown","NL",47.09899,-55.19852,2018-06-07 09:00:00,33,0,33
"38828",10901,"Marystown","NL",47.09899,-55.19852,2018-06-07 10:00:00,34,0,34
"38829",10901,"Marystown","NL",47.09899,-55.19852,2018-06-07 11:00:00,36,0,36
"38830",10901,"Marystown","NL",47.09899,-55.19852,2018-06-07 12:00:00,36,0,36
"38831",10901,"Marystown","NL",47.09899,-55.19852,2018-06-07 13:00:00,34,0,34
"38832",10901,"Marystown","NL",47.09899,-55.19852,2018-06-07 14:00:00,38,1,39
"38833",10901,"Marystown","NL",47.09899,-55.19852,2018-06-07 15:00:00,39,1,40
"38834",10901,"Marystown","NL",47.09899,-55.19852,2018-06-07 16:00:00,40,1,41
"38835",10901,"Marystown","NL",47.09899,-55.19852,2018-06-07 17:00:00,36,0,36
"38836",10901,"Marystown","NL",47.09899,-55.19852,2018-06-07 18:00:00,38,0,38
"38837",10901,"Marystown","NL",47.09899,-55.19852,2018-06-07 19:00:00,40,0,40
"38838",10901,"Marystown","NL",47.09899,-55.19852,2018-06-07 20:00:00,34,0,34
"38839",10901,"Marystown","NL",47.09899,-55.19852,2018-06-07 21:00:00,29,1,30
"38840",10901,"Marystown","NL",47.09899,-55.19852,2018-06-07 22:00:00,26,1,27
"38841",10901,"Marystown","NL",47.09899,-55.19852,2018-06-07 23:00:00,23,0,23
"38842",10901,"Marystown","NL",47.09899,-55.19852,2018-06-08 00:00:00,16,0,16
"38843",10901,"Marystown","NL",47.09899,-55.19852,2018-06-08 01:00:00,12,0,12
"38844",10901,"Marystown","NL",47.09899,-55.19852,2018-06-08 02:00:00,11,0,11
"38845",10901,"Marystown","NL",47.09899,-55.19852,2018-06-08 03:00:00,10,0,10
"38846",10901,"Marystown","NL",47.09899,-55.19852,2018-06-08 04:00:00,11,0,11
"38847",10901,"Marystown","NL",47.09899,-55.19852,2018-06-08 05:00:00,11,0,11
"38848",10901,"Marystown","NL",47.09899,-55.19852,2018-06-08 06:00:00,13,1,14
"38849",10901,"Marystown","NL",47.09899,-55.19852,2018-06-08 07:00:00,23,0,23
"38850",10901,"Marystown","NL",47.09899,-55.19852,2018-06-08 08:00:00,26,1,27
"38851",10901,"Marystown","NL",47.09899,-55.19852,2018-06-08 09:00:00,30,0,30
"38852",10901,"Marystown","NL",47.09899,-55.19852,2018-06-08 10:00:00,30,1,31
"38853",10901,"Marystown","NL",47.09899,-55.19852,2018-06-08 11:00:00,30,1,31
"38854",10901,"Marystown","NL",47.09899,-55.19852,2018-06-08 12:00:00,32,1,33
"38855",10901,"Marystown","NL",47.09899,-55.19852,2018-06-08 13:00:00,34,0,34
"38856",10901,"Marystown","NL",47.09899,-55.19852,2018-06-08 14:00:00,31,0,31
"38857",10901,"Marystown","NL",47.09899,-55.19852,2018-06-08 15:00:00,34,0,34
"38858",10901,"Marystown","NL",47.09899,-55.19852,2018-06-08 16:00:00,35,0,35
"38859",10901,"Marystown","NL",47.09899,-55.19852,2018-06-08 17:00:00,33,0,33
"38860",10901,"Marystown","NL",47.09899,-55.19852,2018-06-08 18:00:00,31,0,31
"38861",10901,"Marystown","NL",47.09899,-55.19852,2018-06-08 19:00:00,31,0,31
"38862",10901,"Marystown","NL",47.09899,-55.19852,2018-06-08 20:00:00,31,0,31
"38863",10901,"Marystown","NL",47.09899,-55.19852,2018-06-08 21:00:00,32,0,32
"38864",10901,"Marystown","NL",47.09899,-55.19852,2018-06-08 22:00:00,31,0,31
"38865",10901,"Marystown","NL",47.09899,-55.19852,2018-06-08 23:00:00,29,0,29
"38866",10901,"Marystown","NL",47.09899,-55.19852,2018-06-09 00:00:00,33,0,33
"38867",10901,"Marystown","NL",47.09899,-55.19852,2018-06-09 01:00:00,36,0,36
"38868",10901,"Marystown","NL",47.09899,-55.19852,2018-06-09 02:00:00,36,0,36
"38869",10901,"Marystown","NL",47.09899,-55.19852,2018-06-09 03:00:00,36,0,36
"38870",10901,"Marystown","NL",47.09899,-55.19852,2018-06-09 04:00:00,36,0,36
"38871",10901,"Marystown","NL",47.09899,-55.19852,2018-06-09 05:00:00,37,0,37
"38872",10901,"Marystown","NL",47.09899,-55.19852,2018-06-09 06:00:00,38,0,38
"38873",10901,"Marystown","NL",47.09899,-55.19852,2018-06-09 07:00:00,37,0,37
"38874",10901,"Marystown","NL",47.09899,-55.19852,2018-06-09 08:00:00,36,0,36
"38875",10901,"Marystown","NL",47.09899,-55.19852,2018-06-09 09:00:00,36,0,36
"38876",10901,"Marystown","NL",47.09899,-55.19852,2018-06-09 10:00:00,35,0,35
"38877",10901,"Marystown","NL",47.09899,-55.19852,2018-06-09 11:00:00,35,0,35
"38878",10901,"Marystown","NL",47.09899,-55.19852,2018-06-09 12:00:00,33,0,33
"38879",10901,"Marystown","NL",47.09899,-55.19852,2018-06-09 13:00:00,32,0,32
"38880",10901,"Marystown","NL",47.09899,-55.19852,2018-06-09 14:00:00,32,0,32
"38881",10901,"Marystown","NL",47.09899,-55.19852,2018-06-09 15:00:00,32,1,33
"38882",10901,"Marystown","NL",47.09899,-55.19852,2018-06-09 16:00:00,33,1,34
"38883",10901,"Marystown","NL",47.09899,-55.19852,2018-06-09 17:00:00,32,0,32
"38884",10901,"Marystown","NL",47.09899,-55.19852,2018-06-09 18:00:00,31,1,32
"38885",10901,"Marystown","NL",47.09899,-55.19852,2018-06-09 19:00:00,33,0,33
"38886",10901,"Marystown","NL",47.09899,-55.19852,2018-06-09 20:00:00,32,0,32
"38887",10901,"Marystown","NL",47.09899,-55.19852,2018-06-09 21:00:00,31,0,31
"38888",10901,"Marystown","NL",47.09899,-55.19852,2018-06-09 22:00:00,30,0,30
"38889",10901,"Marystown","NL",47.09899,-55.19852,2018-06-09 23:00:00,26,0,26
"38890",10901,"Marystown","NL",47.09899,-55.19852,2018-06-10 00:00:00,24,0,24
"38891",10901,"Marystown","NL",47.09899,-55.19852,2018-06-10 01:00:00,27,0,27
"38892",10901,"Marystown","NL",47.09899,-55.19852,2018-06-10 02:00:00,18,1,19
"38893",10901,"Marystown","NL",47.09899,-55.19852,2018-06-10 03:00:00,19,1,20
"38894",10901,"Marystown","NL",47.09899,-55.19852,2018-06-10 04:00:00,30,0,30
"38895",10901,"Marystown","NL",47.09899,-55.19852,2018-06-10 05:00:00,29,0,29
"38896",10901,"Marystown","NL",47.09899,-55.19852,2018-06-10 06:00:00,30,0,30
"38897",10901,"Marystown","NL",47.09899,-55.19852,2018-06-10 07:00:00,32,0,32
"38898",10901,"Marystown","NL",47.09899,-55.19852,2018-06-10 08:00:00,31,0,31
"38899",10901,"Marystown","NL",47.09899,-55.19852,2018-06-10 09:00:00,29,0,29
"38900",10901,"Marystown","NL",47.09899,-55.19852,2018-06-10 10:00:00,30,0,30
"38901",10901,"Marystown","NL",47.09899,-55.19852,2018-06-10 11:00:00,31,0,31
"38902",10901,"Marystown","NL",47.09899,-55.19852,2018-06-10 12:00:00,30,0,30
"38903",10901,"Marystown","NL",47.09899,-55.19852,2018-06-10 13:00:00,32,0,32
"38904",10901,"Marystown","NL",47.09899,-55.19852,2018-06-10 14:00:00,33,0,33
"38905",10901,"Marystown","NL",47.09899,-55.19852,2018-06-10 15:00:00,35,0,35
"38906",10901,"Marystown","NL",47.09899,-55.19852,2018-06-10 16:00:00,35,0,35
"38907",10901,"Marystown","NL",47.09899,-55.19852,2018-06-10 17:00:00,35,0,35
"38908",10901,"Marystown","NL",47.09899,-55.19852,2018-06-10 18:00:00,32,0,32
"38909",10901,"Marystown","NL",47.09899,-55.19852,2018-06-10 19:00:00,29,0,29
"38910",10901,"Marystown","NL",47.09899,-55.19852,2018-06-10 20:00:00,28,0,28
"38911",10901,"Marystown","NL",47.09899,-55.19852,2018-06-10 21:00:00,29,0,29
"38912",10901,"Marystown","NL",47.09899,-55.19852,2018-06-10 22:00:00,30,0,30
"38913",10901,"Marystown","NL",47.09899,-55.19852,2018-06-10 23:00:00,32,0,32
"38914",10901,"Marystown","NL",47.09899,-55.19852,2018-06-11 00:00:00,30,0,30
"38915",10901,"Marystown","NL",47.09899,-55.19852,2018-06-11 01:00:00,26,0,26
"38916",10901,"Marystown","NL",47.09899,-55.19852,2018-06-11 02:00:00,24,0,24
"38917",10901,"Marystown","NL",47.09899,-55.19852,2018-06-11 03:00:00,20,0,20
"38918",10901,"Marystown","NL",47.09899,-55.19852,2018-06-11 04:00:00,20,1,21
"38919",10901,"Marystown","NL",47.09899,-55.19852,2018-06-11 05:00:00,17,1,18
"38920",10901,"Marystown","NL",47.09899,-55.19852,2018-06-11 06:00:00,18,0,18
"38921",10901,"Marystown","NL",47.09899,-55.19852,2018-06-11 07:00:00,19,0,19
"38922",10901,"Marystown","NL",47.09899,-55.19852,2018-06-11 08:00:00,18,0,18
"38923",10901,"Marystown","NL",47.09899,-55.19852,2018-06-11 09:00:00,18,0,18
"38924",10901,"Marystown","NL",47.09899,-55.19852,2018-06-11 10:00:00,18,0,18
"38925",10901,"Marystown","NL",47.09899,-55.19852,2018-06-11 11:00:00,19,0,19
"38926",10901,"Marystown","NL",47.09899,-55.19852,2018-06-11 12:00:00,20,0,20
"38927",10901,"Marystown","NL",47.09899,-55.19852,2018-06-11 13:00:00,21,0,21
"38928",10901,"Marystown","NL",47.09899,-55.19852,2018-06-11 14:00:00,21,0,21
"38929",10901,"Marystown","NL",47.09899,-55.19852,2018-06-11 15:00:00,21,0,21
"38930",10901,"Marystown","NL",47.09899,-55.19852,2018-06-11 16:00:00,21,0,21
"38931",10901,"Marystown","NL",47.09899,-55.19852,2018-06-11 17:00:00,22,0,22
"38932",10901,"Marystown","NL",47.09899,-55.19852,2018-06-11 18:00:00,24,0,24
"38933",10901,"Marystown","NL",47.09899,-55.19852,2018-06-11 19:00:00,26,0,26
"38934",10901,"Marystown","NL",47.09899,-55.19852,2018-06-11 20:00:00,26,0,26
"38935",10901,"Marystown","NL",47.09899,-55.19852,2018-06-11 21:00:00,26,0,26
"38936",10901,"Marystown","NL",47.09899,-55.19852,2018-06-11 22:00:00,24,0,24
"38937",10901,"Marystown","NL",47.09899,-55.19852,2018-06-11 23:00:00,20,0,20
"38938",10901,"Marystown","NL",47.09899,-55.19852,2018-06-12 00:00:00,19,0,19
"38939",10901,"Marystown","NL",47.09899,-55.19852,2018-06-12 01:00:00,20,0,20
"38940",10901,"Marystown","NL",47.09899,-55.19852,2018-06-12 02:00:00,20,0,20
"38941",10901,"Marystown","NL",47.09899,-55.19852,2018-06-12 03:00:00,19,0,19
"38942",10901,"Marystown","NL",47.09899,-55.19852,2018-06-12 04:00:00,18,0,18
"38943",10901,"Marystown","NL",47.09899,-55.19852,2018-06-12 05:00:00,14,0,14
"38944",10901,"Marystown","NL",47.09899,-55.19852,2018-06-12 06:00:00,15,0,15
"38945",10901,"Marystown","NL",47.09899,-55.19852,2018-06-12 07:00:00,15,1,16
"38946",10901,"Marystown","NL",47.09899,-55.19852,2018-06-12 08:00:00,17,0,17
"38947",10901,"Marystown","NL",47.09899,-55.19852,2018-06-12 09:00:00,18,0,18
"38948",10901,"Marystown","NL",47.09899,-55.19852,2018-06-12 10:00:00,21,0,21
"38949",10901,"Marystown","NL",47.09899,-55.19852,2018-06-12 11:00:00,23,0,23
"38950",10901,"Marystown","NL",47.09899,-55.19852,2018-06-12 12:00:00,25,0,25
"38951",10901,"Marystown","NL",47.09899,-55.19852,2018-06-12 13:00:00,25,0,25
"38952",10901,"Marystown","NL",47.09899,-55.19852,2018-06-12 14:00:00,25,0,25
"38953",10901,"Marystown","NL",47.09899,-55.19852,2018-06-12 15:00:00,24,0,24
"38954",10901,"Marystown","NL",47.09899,-55.19852,2018-06-12 16:00:00,25,0,25
"38955",10901,"Marystown","NL",47.09899,-55.19852,2018-06-12 17:00:00,24,0,24
"38956",10901,"Marystown","NL",47.09899,-55.19852,2018-06-12 18:00:00,23,0,23
"38957",10901,"Marystown","NL",47.09899,-55.19852,2018-06-12 19:00:00,22,0,22
"38958",10901,"Marystown","NL",47.09899,-55.19852,2018-06-12 20:00:00,21,0,21
"38959",10901,"Marystown","NL",47.09899,-55.19852,2018-06-12 21:00:00,21,0,21
"38960",10901,"Marystown","NL",47.09899,-55.19852,2018-06-12 22:00:00,23,0,23
"38961",10901,"Marystown","NL",47.09899,-55.19852,2018-06-12 23:00:00,26,0,26
"38962",10901,"Marystown","NL",47.09899,-55.19852,2018-06-13 00:00:00,28,0,28
"38963",10901,"Marystown","NL",47.09899,-55.19852,2018-06-13 01:00:00,30,0,30
"38964",10901,"Marystown","NL",47.09899,-55.19852,2018-06-13 02:00:00,32,0,32
"38965",10901,"Marystown","NL",47.09899,-55.19852,2018-06-13 03:00:00,32,0,32
"38966",10901,"Marystown","NL",47.09899,-55.19852,2018-06-13 04:00:00,32,0,32
"38967",10901,"Marystown","NL",47.09899,-55.19852,2018-06-13 05:00:00,32,0,32
"38968",10901,"Marystown","NL",47.09899,-55.19852,2018-06-13 06:00:00,33,0,33
"38969",10901,"Marystown","NL",47.09899,-55.19852,2018-06-13 07:00:00,34,0,34
"38970",10901,"Marystown","NL",47.09899,-55.19852,2018-06-13 08:00:00,35,0,35
"38971",10901,"Marystown","NL",47.09899,-55.19852,2018-06-13 09:00:00,36,0,36
"38972",10901,"Marystown","NL",47.09899,-55.19852,2018-06-13 10:00:00,36,0,36
"38973",10901,"Marystown","NL",47.09899,-55.19852,2018-06-13 11:00:00,35,0,35
"38974",10901,"Marystown","NL",47.09899,-55.19852,2018-06-13 12:00:00,33,0,33
"38975",10901,"Marystown","NL",47.09899,-55.19852,2018-06-13 13:00:00,33,0,33
"38976",10901,"Marystown","NL",47.09899,-55.19852,2018-06-13 14:00:00,33,0,33
"38977",10901,"Marystown","NL",47.09899,-55.19852,2018-06-13 15:00:00,31,0,31
"38978",10901,"Marystown","NL",47.09899,-55.19852,2018-06-13 16:00:00,32,0,32
"38979",10901,"Marystown","NL",47.09899,-55.19852,2018-06-13 17:00:00,30,0,30
"38980",10901,"Marystown","NL",47.09899,-55.19852,2018-06-13 18:00:00,28,0,28
"38981",10901,"Marystown","NL",47.09899,-55.19852,2018-06-13 19:00:00,27,0,27
"38982",10901,"Marystown","NL",47.09899,-55.19852,2018-06-13 20:00:00,27,0,27
"38983",10901,"Marystown","NL",47.09899,-55.19852,2018-06-13 21:00:00,26,0,26
"38984",10901,"Marystown","NL",47.09899,-55.19852,2018-06-13 22:00:00,25,0,25
"38985",10901,"Marystown","NL",47.09899,-55.19852,2018-06-13 23:00:00,25,0,25
"38986",10901,"Marystown","NL",47.09899,-55.19852,2018-06-14 00:00:00,26,0,26
"38987",10901,"Marystown","NL",47.09899,-55.19852,2018-06-14 01:00:00,27,0,27
"38988",10901,"Marystown","NL",47.09899,-55.19852,2018-06-14 02:00:00,25,0,25
"38989",10901,"Marystown","NL",47.09899,-55.19852,2018-06-14 03:00:00,23,0,23
"38990",10901,"Marystown","NL",47.09899,-55.19852,2018-06-14 04:00:00,21,0,21
"38991",10901,"Marystown","NL",47.09899,-55.19852,2018-06-14 05:00:00,21,0,21
"38992",10901,"Marystown","NL",47.09899,-55.19852,2018-06-14 06:00:00,20,1,21
"38993",10901,"Marystown","NL",47.09899,-55.19852,2018-06-14 07:00:00,23,0,23
"38994",10901,"Marystown","NL",47.09899,-55.19852,2018-06-14 08:00:00,25,1,26
"38995",10901,"Marystown","NL",47.09899,-55.19852,2018-06-14 09:00:00,26,0,26
"38996",10901,"Marystown","NL",47.09899,-55.19852,2018-06-14 10:00:00,26,0,26
"38997",10901,"Marystown","NL",47.09899,-55.19852,2018-06-14 11:00:00,26,0,26
"38998",10901,"Marystown","NL",47.09899,-55.19852,2018-06-14 12:00:00,25,0,25
"38999",10901,"Marystown","NL",47.09899,-55.19852,2018-06-14 13:00:00,26,1,27
"39000",10901,"Marystown","NL",47.09899,-55.19852,2018-06-14 14:00:00,26,1,27
"39001",10901,"Marystown","NL",47.09899,-55.19852,2018-06-14 15:00:00,26,1,27
"39002",10901,"Marystown","NL",47.09899,-55.19852,2018-06-14 16:00:00,26,0,26
"39003",10901,"Marystown","NL",47.09899,-55.19852,2018-06-14 17:00:00,26,1,27
"39004",10901,"Marystown","NL",47.09899,-55.19852,2018-06-14 18:00:00,28,0,28
"39005",10901,"Marystown","NL",47.09899,-55.19852,2018-06-14 19:00:00,29,0,29
"39006",10901,"Marystown","NL",47.09899,-55.19852,2018-06-14 20:00:00,27,0,27
"39007",10901,"Marystown","NL",47.09899,-55.19852,2018-06-14 21:00:00,25,0,25
"39008",10901,"Marystown","NL",47.09899,-55.19852,2018-06-14 22:00:00,24,0,24
"39009",10901,"Marystown","NL",47.09899,-55.19852,2018-06-14 23:00:00,25,0,25
"39010",10901,"Marystown","NL",47.09899,-55.19852,2018-06-15 00:00:00,26,0,26
"39011",10901,"Marystown","NL",47.09899,-55.19852,2018-06-15 01:00:00,26,0,26
"39012",10901,"Marystown","NL",47.09899,-55.19852,2018-06-15 02:00:00,25,0,25
"39013",10901,"Marystown","NL",47.09899,-55.19852,2018-06-15 03:00:00,25,0,25
"39014",10901,"Marystown","NL",47.09899,-55.19852,2018-06-15 04:00:00,25,0,25
"39015",10901,"Marystown","NL",47.09899,-55.19852,2018-06-15 05:00:00,25,0,25
"39016",10901,"Marystown","NL",47.09899,-55.19852,2018-06-15 06:00:00,25,0,25
"39017",10901,"Marystown","NL",47.09899,-55.19852,2018-06-15 07:00:00,24,1,25
"39018",10901,"Marystown","NL",47.09899,-55.19852,2018-06-15 08:00:00,23,1,24
"39019",10901,"Marystown","NL",47.09899,-55.19852,2018-06-15 09:00:00,24,1,25
"39020",10901,"Marystown","NL",47.09899,-55.19852,2018-06-15 10:00:00,25,1,26
"39021",10901,"Marystown","NL",47.09899,-55.19852,2018-06-15 11:00:00,26,1,27
"39022",10901,"Marystown","NL",47.09899,-55.19852,2018-06-15 12:00:00,26,1,27
"39023",10901,"Marystown","NL",47.09899,-55.19852,2018-06-15 13:00:00,26,0,26
"39024",10901,"Marystown","NL",47.09899,-55.19852,2018-06-15 14:00:00,26,2,28
"39025",10901,"Marystown","NL",47.09899,-55.19852,2018-06-15 15:00:00,25,1,26
"39026",10901,"Marystown","NL",47.09899,-55.19852,2018-06-15 16:00:00,25,1,26
"39027",10901,"Marystown","NL",47.09899,-55.19852,2018-06-15 17:00:00,29,0,29
"39028",10901,"Marystown","NL",47.09899,-55.19852,2018-06-15 18:00:00,30,0,30
"39029",10901,"Marystown","NL",47.09899,-55.19852,2018-06-15 19:00:00,28,0,28
"39030",10901,"Marystown","NL",47.09899,-55.19852,2018-06-15 20:00:00,29,1,30
"39031",10901,"Marystown","NL",47.09899,-55.19852,2018-06-15 21:00:00,22,1,23
"39032",10901,"Marystown","NL",47.09899,-55.19852,2018-06-15 22:00:00,17,1,18
"39033",10901,"Marystown","NL",47.09899,-55.19852,2018-06-15 23:00:00,17,1,18
"39034",10901,"Marystown","NL",47.09899,-55.19852,2018-06-16 00:00:00,18,0,18
"39035",10901,"Marystown","NL",47.09899,-55.19852,2018-06-16 01:00:00,20,1,21
"39036",10901,"Marystown","NL",47.09899,-55.19852,2018-06-16 02:00:00,11,0,11
"39037",10901,"Marystown","NL",47.09899,-55.19852,2018-06-16 03:00:00,14,0,14
"39038",10901,"Marystown","NL",47.09899,-55.19852,2018-06-16 04:00:00,9,1,10
"39039",10901,"Marystown","NL",47.09899,-55.19852,2018-06-16 05:00:00,11,1,12
"39040",10901,"Marystown","NL",47.09899,-55.19852,2018-06-16 06:00:00,13,0,13
"39041",10901,"Marystown","NL",47.09899,-55.19852,2018-06-16 07:00:00,18,1,19
"39042",10901,"Marystown","NL",47.09899,-55.19852,2018-06-16 08:00:00,20,0,20
"39043",10901,"Marystown","NL",47.09899,-55.19852,2018-06-16 09:00:00,21,0,21
"39044",10901,"Marystown","NL",47.09899,-55.19852,2018-06-16 10:00:00,22,1,23
"39045",10901,"Marystown","NL",47.09899,-55.19852,2018-06-16 11:00:00,23,0,23
"39046",10901,"Marystown","NL",47.09899,-55.19852,2018-06-16 12:00:00,25,1,26
"39047",10901,"Marystown","NL",47.09899,-55.19852,2018-06-16 13:00:00,26,0,26
"39048",10901,"Marystown","NL",47.09899,-55.19852,2018-06-16 14:00:00,27,0,27
"39049",10901,"Marystown","NL",47.09899,-55.19852,2018-06-16 15:00:00,29,0,29
"39050",10901,"Marystown","NL",47.09899,-55.19852,2018-06-16 16:00:00,28,1,29
"39051",10901,"Marystown","NL",47.09899,-55.19852,2018-06-16 17:00:00,29,0,29
"39052",10901,"Marystown","NL",47.09899,-55.19852,2018-06-16 18:00:00,28,1,29
"39053",10901,"Marystown","NL",47.09899,-55.19852,2018-06-16 19:00:00,27,0,27
"39054",10901,"Marystown","NL",47.09899,-55.19852,2018-06-16 20:00:00,26,0,26
"39055",10901,"Marystown","NL",47.09899,-55.19852,2018-06-16 21:00:00,27,0,27
"39056",10901,"Marystown","NL",47.09899,-55.19852,2018-06-16 22:00:00,26,1,27
"39057",10901,"Marystown","NL",47.09899,-55.19852,2018-06-16 23:00:00,26,0,26
"39058",10901,"Marystown","NL",47.09899,-55.19852,2018-06-17 00:00:00,26,0,26
"39059",10901,"Marystown","NL",47.09899,-55.19852,2018-06-17 01:00:00,25,0,25
"39060",10901,"Marystown","NL",47.09899,-55.19852,2018-06-17 02:00:00,25,0,25
"39061",10901,"Marystown","NL",47.09899,-55.19852,2018-06-17 03:00:00,24,0,24
"39062",10901,"Marystown","NL",47.09899,-55.19852,2018-06-17 04:00:00,24,0,24
"39063",10901,"Marystown","NL",47.09899,-55.19852,2018-06-17 05:00:00,25,0,25
"39064",10901,"Marystown","NL",47.09899,-55.19852,2018-06-17 06:00:00,26,0,26
"39065",10901,"Marystown","NL",47.09899,-55.19852,2018-06-17 07:00:00,27,0,27
"39066",10901,"Marystown","NL",47.09899,-55.19852,2018-06-17 08:00:00,27,0,27
"39067",10901,"Marystown","NL",47.09899,-55.19852,2018-06-17 09:00:00,28,0,28
"39068",10901,"Marystown","NL",47.09899,-55.19852,2018-06-17 10:00:00,28,0,28
"39069",10901,"Marystown","NL",47.09899,-55.19852,2018-06-17 11:00:00,29,0,29
"39070",10901,"Marystown","NL",47.09899,-55.19852,2018-06-17 12:00:00,28,0,28
"39071",10901,"Marystown","NL",47.09899,-55.19852,2018-06-17 13:00:00,28,0,28
"39072",10901,"Marystown","NL",47.09899,-55.19852,2018-06-17 14:00:00,28,0,28
"39073",10901,"Marystown","NL",47.09899,-55.19852,2018-06-17 15:00:00,29,0,29
"39074",10901,"Marystown","NL",47.09899,-55.19852,2018-06-17 16:00:00,28,0,28
"39075",10901,"Marystown","NL",47.09899,-55.19852,2018-06-17 17:00:00,27,0,27
"39076",10901,"Marystown","NL",47.09899,-55.19852,2018-06-17 18:00:00,27,0,27
"39077",10901,"Marystown","NL",47.09899,-55.19852,2018-06-17 19:00:00,27,0,27
"39078",10901,"Marystown","NL",47.09899,-55.19852,2018-06-17 20:00:00,26,0,26
"39079",10901,"Marystown","NL",47.09899,-55.19852,2018-06-17 21:00:00,23,0,23
"39080",10901,"Marystown","NL",47.09899,-55.19852,2018-06-17 22:00:00,16,1,17
"39081",10901,"Marystown","NL",47.09899,-55.19852,2018-06-17 23:00:00,12,1,13
"39082",10901,"Marystown","NL",47.09899,-55.19852,2018-06-18 00:00:00,11,1,12
"39083",10901,"Marystown","NL",47.09899,-55.19852,2018-06-18 01:00:00,8,2,10
"39084",10901,"Marystown","NL",47.09899,-55.19852,2018-06-18 02:00:00,8,1,9
"39085",10901,"Marystown","NL",47.09899,-55.19852,2018-06-18 03:00:00,8,0,8
"39086",10901,"Marystown","NL",47.09899,-55.19852,2018-06-18 04:00:00,9,0,9
"39087",10901,"Marystown","NL",47.09899,-55.19852,2018-06-18 05:00:00,8,1,9
"39088",10901,"Marystown","NL",47.09899,-55.19852,2018-06-18 06:00:00,16,1,17
"39089",10901,"Marystown","NL",47.09899,-55.19852,2018-06-18 07:00:00,20,0,20
"39090",10901,"Marystown","NL",47.09899,-55.19852,2018-06-18 08:00:00,23,1,24
"39091",10901,"Marystown","NL",47.09899,-55.19852,2018-06-18 09:00:00,23,0,23
"39092",10901,"Marystown","NL",47.09899,-55.19852,2018-06-18 10:00:00,24,1,25
"39093",10901,"Marystown","NL",47.09899,-55.19852,2018-06-18 11:00:00,25,1,26
"39094",10901,"Marystown","NL",47.09899,-55.19852,2018-06-18 12:00:00,25,1,26
"39095",10901,"Marystown","NL",47.09899,-55.19852,2018-06-18 13:00:00,26,0,26
"39096",10901,"Marystown","NL",47.09899,-55.19852,2018-06-18 14:00:00,25,1,26
"39097",10901,"Marystown","NL",47.09899,-55.19852,2018-06-18 15:00:00,26,0,26
"39098",10901,"Marystown","NL",47.09899,-55.19852,2018-06-18 16:00:00,26,1,27
"39099",10901,"Marystown","NL",47.09899,-55.19852,2018-06-18 17:00:00,26,0,26
"39100",10901,"Marystown","NL",47.09899,-55.19852,2018-06-18 18:00:00,26,0,26
"39101",10901,"Marystown","NL",47.09899,-55.19852,2018-06-18 19:00:00,28,0,28
"39102",10901,"Marystown","NL",47.09899,-55.19852,2018-06-18 20:00:00,29,0,29
"39103",10901,"Marystown","NL",47.09899,-55.19852,2018-06-18 21:00:00,27,0,27
"39104",10901,"Marystown","NL",47.09899,-55.19852,2018-06-18 22:00:00,26,1,27
"39105",10901,"Marystown","NL",47.09899,-55.19852,2018-06-18 23:00:00,25,0,25
"39106",10901,"Marystown","NL",47.09899,-55.19852,2018-06-19 00:00:00,26,0,26
"39107",10901,"Marystown","NL",47.09899,-55.19852,2018-06-19 01:00:00,27,0,27
"39108",10901,"Marystown","NL",47.09899,-55.19852,2018-06-19 02:00:00,28,0,28
"39109",10901,"Marystown","NL",47.09899,-55.19852,2018-06-19 03:00:00,29,0,29
"39110",10901,"Marystown","NL",47.09899,-55.19852,2018-06-19 04:00:00,31,0,31
"39111",10901,"Marystown","NL",47.09899,-55.19852,2018-06-19 05:00:00,33,0,33
"39112",10901,"Marystown","NL",47.09899,-55.19852,2018-06-19 06:00:00,35,0,35
"39113",10901,"Marystown","NL",47.09899,-55.19852,2018-06-19 07:00:00,36,0,36
"39114",10901,"Marystown","NL",47.09899,-55.19852,2018-06-19 08:00:00,38,0,38
"39115",10901,"Marystown","NL",47.09899,-55.19852,2018-06-19 09:00:00,40,0,40
"39116",10901,"Marystown","NL",47.09899,-55.19852,2018-06-19 10:00:00,40,1,41
"39117",10901,"Marystown","NL",47.09899,-55.19852,2018-06-19 11:00:00,40,0,40
"39118",10901,"Marystown","NL",47.09899,-55.19852,2018-06-19 12:00:00,38,1,39
"39119",10901,"Marystown","NL",47.09899,-55.19852,2018-06-19 13:00:00,37,1,38
"39120",10901,"Marystown","NL",47.09899,-55.19852,2018-06-19 14:00:00,37,1,38
"39121",10901,"Marystown","NL",47.09899,-55.19852,2018-06-19 15:00:00,36,1,37
"39122",10901,"Marystown","NL",47.09899,-55.19852,2018-06-19 16:00:00,35,1,36
"39123",10901,"Marystown","NL",47.09899,-55.19852,2018-06-19 17:00:00,NA,NA,NA
"39124",10901,"Marystown","NL",47.09899,-55.19852,2018-06-19 18:00:00,NA,NA,NA
"39125",10901,"Marystown","NL",47.09899,-55.19852,2018-06-19 19:00:00,NA,NA,NA
"39126",10901,"Marystown","NL",47.09899,-55.19852,2018-06-19 20:00:00,NA,NA,NA
"39127",10901,"Marystown","NL",47.09899,-55.19852,2018-06-19 21:00:00,NA,NA,NA
"39128",10901,"Marystown","NL",47.09899,-55.19852,2018-06-19 22:00:00,NA,NA,NA
"39129",10901,"Marystown","NL",47.09899,-55.19852,2018-06-19 23:00:00,NA,NA,NA
"39130",10901,"Marystown","NL",47.09899,-55.19852,2018-06-20 00:00:00,NA,NA,NA
"39131",10901,"Marystown","NL",47.09899,-55.19852,2018-06-20 01:00:00,NA,NA,NA
"39132",10901,"Marystown","NL",47.09899,-55.19852,2018-06-20 02:00:00,NA,NA,NA
"39133",10901,"Marystown","NL",47.09899,-55.19852,2018-06-20 03:00:00,NA,NA,NA
"39134",10901,"Marystown","NL",47.09899,-55.19852,2018-06-20 04:00:00,NA,NA,NA
"39135",10901,"Marystown","NL",47.09899,-55.19852,2018-06-20 05:00:00,NA,NA,NA
"39136",10901,"Marystown","NL",47.09899,-55.19852,2018-06-20 06:00:00,NA,NA,NA
"39137",10901,"Marystown","NL",47.09899,-55.19852,2018-06-20 07:00:00,NA,NA,NA
"39138",10901,"Marystown","NL",47.09899,-55.19852,2018-06-20 08:00:00,NA,NA,NA
"39139",10901,"Marystown","NL",47.09899,-55.19852,2018-06-20 09:00:00,NA,NA,NA
"39140",10901,"Marystown","NL",47.09899,-55.19852,2018-06-20 10:00:00,NA,NA,NA
"39141",10901,"Marystown","NL",47.09899,-55.19852,2018-06-20 11:00:00,NA,NA,NA
"39142",10901,"Marystown","NL",47.09899,-55.19852,2018-06-20 12:00:00,NA,NA,NA
"39143",10901,"Marystown","NL",47.09899,-55.19852,2018-06-20 13:00:00,NA,NA,NA
"39144",10901,"Marystown","NL",47.09899,-55.19852,2018-06-20 14:00:00,NA,NA,NA
"39145",10901,"Marystown","NL",47.09899,-55.19852,2018-06-20 15:00:00,NA,NA,NA
"39146",10901,"Marystown","NL",47.09899,-55.19852,2018-06-20 16:00:00,NA,NA,NA
"39147",10901,"Marystown","NL",47.09899,-55.19852,2018-06-20 17:00:00,NA,NA,NA
"39148",10901,"Marystown","NL",47.09899,-55.19852,2018-06-20 18:00:00,NA,NA,NA
"39149",10901,"Marystown","NL",47.09899,-55.19852,2018-06-20 19:00:00,NA,NA,NA
"39150",10901,"Marystown","NL",47.09899,-55.19852,2018-06-20 20:00:00,NA,NA,NA
"39151",10901,"Marystown","NL",47.09899,-55.19852,2018-06-20 21:00:00,NA,NA,NA
"39152",10901,"Marystown","NL",47.09899,-55.19852,2018-06-20 22:00:00,NA,NA,NA
"39153",10901,"Marystown","NL",47.09899,-55.19852,2018-06-20 23:00:00,NA,NA,NA
"39154",10901,"Marystown","NL",47.09899,-55.19852,2018-06-21 00:00:00,NA,NA,NA
"39155",10901,"Marystown","NL",47.09899,-55.19852,2018-06-21 01:00:00,NA,NA,NA
"39156",10901,"Marystown","NL",47.09899,-55.19852,2018-06-21 02:00:00,NA,NA,NA
"39157",10901,"Marystown","NL",47.09899,-55.19852,2018-06-21 03:00:00,NA,NA,NA
"39158",10901,"Marystown","NL",47.09899,-55.19852,2018-06-21 04:00:00,NA,NA,NA
"39159",10901,"Marystown","NL",47.09899,-55.19852,2018-06-21 05:00:00,NA,NA,NA
"39160",10901,"Marystown","NL",47.09899,-55.19852,2018-06-21 06:00:00,NA,NA,NA
"39161",10901,"Marystown","NL",47.09899,-55.19852,2018-06-21 07:00:00,NA,NA,NA
"39162",10901,"Marystown","NL",47.09899,-55.19852,2018-06-21 08:00:00,NA,NA,NA
"39163",10901,"Marystown","NL",47.09899,-55.19852,2018-06-21 09:00:00,NA,NA,NA
"39164",10901,"Marystown","NL",47.09899,-55.19852,2018-06-21 10:00:00,NA,NA,NA
"39165",10901,"Marystown","NL",47.09899,-55.19852,2018-06-21 11:00:00,NA,NA,NA
"39166",10901,"Marystown","NL",47.09899,-55.19852,2018-06-21 12:00:00,NA,NA,NA
"39167",10901,"Marystown","NL",47.09899,-55.19852,2018-06-21 13:00:00,NA,NA,NA
"39168",10901,"Marystown","NL",47.09899,-55.19852,2018-06-21 14:00:00,NA,NA,NA
"39169",10901,"Marystown","NL",47.09899,-55.19852,2018-06-21 15:00:00,NA,NA,NA
"39170",10901,"Marystown","NL",47.09899,-55.19852,2018-06-21 16:00:00,NA,NA,NA
"39171",10901,"Marystown","NL",47.09899,-55.19852,2018-06-21 17:00:00,NA,NA,NA
"39172",10901,"Marystown","NL",47.09899,-55.19852,2018-06-21 18:00:00,NA,NA,NA
"39173",10901,"Marystown","NL",47.09899,-55.19852,2018-06-21 19:00:00,NA,NA,NA
"39174",10901,"Marystown","NL",47.09899,-55.19852,2018-06-21 20:00:00,NA,NA,NA
"39175",10901,"Marystown","NL",47.09899,-55.19852,2018-06-21 21:00:00,NA,NA,NA
"39176",10901,"Marystown","NL",47.09899,-55.19852,2018-06-21 22:00:00,NA,NA,NA
"39177",10901,"Marystown","NL",47.09899,-55.19852,2018-06-21 23:00:00,NA,NA,NA
"39178",10901,"Marystown","NL",47.09899,-55.19852,2018-06-22 00:00:00,NA,NA,NA
"39179",10901,"Marystown","NL",47.09899,-55.19852,2018-06-22 01:00:00,NA,NA,NA
"39180",10901,"Marystown","NL",47.09899,-55.19852,2018-06-22 02:00:00,NA,NA,NA
"39181",10901,"Marystown","NL",47.09899,-55.19852,2018-06-22 03:00:00,NA,NA,NA
"39182",10901,"Marystown","NL",47.09899,-55.19852,2018-06-22 04:00:00,NA,NA,NA
"39183",10901,"Marystown","NL",47.09899,-55.19852,2018-06-22 05:00:00,NA,NA,NA
"39184",10901,"Marystown","NL",47.09899,-55.19852,2018-06-22 06:00:00,NA,NA,NA
"39185",10901,"Marystown","NL",47.09899,-55.19852,2018-06-22 07:00:00,NA,NA,NA
"39186",10901,"Marystown","NL",47.09899,-55.19852,2018-06-22 08:00:00,NA,NA,NA
"39187",10901,"Marystown","NL",47.09899,-55.19852,2018-06-22 09:00:00,NA,NA,NA
"39188",10901,"Marystown","NL",47.09899,-55.19852,2018-06-22 10:00:00,NA,NA,NA
"39189",10901,"Marystown","NL",47.09899,-55.19852,2018-06-22 11:00:00,NA,NA,NA
"39190",10901,"Marystown","NL",47.09899,-55.19852,2018-06-22 12:00:00,NA,NA,NA
"39191",10901,"Marystown","NL",47.09899,-55.19852,2018-06-22 13:00:00,NA,NA,NA
"39192",10901,"Marystown","NL",47.09899,-55.19852,2018-06-22 14:00:00,NA,NA,NA
"39193",10901,"Marystown","NL",47.09899,-55.19852,2018-06-22 15:00:00,NA,NA,NA
"39194",10901,"Marystown","NL",47.09899,-55.19852,2018-06-22 16:00:00,NA,NA,NA
"39195",10901,"Marystown","NL",47.09899,-55.19852,2018-06-22 17:00:00,NA,NA,NA
"39196",10901,"Marystown","NL",47.09899,-55.19852,2018-06-22 18:00:00,NA,NA,NA
"39197",10901,"Marystown","NL",47.09899,-55.19852,2018-06-22 19:00:00,NA,NA,NA
"39198",10901,"Marystown","NL",47.09899,-55.19852,2018-06-22 20:00:00,NA,NA,NA
"39199",10901,"Marystown","NL",47.09899,-55.19852,2018-06-22 21:00:00,NA,NA,NA
"39200",10901,"Marystown","NL",47.09899,-55.19852,2018-06-22 22:00:00,NA,NA,NA
"39201",10901,"Marystown","NL",47.09899,-55.19852,2018-06-22 23:00:00,NA,NA,NA
"39202",10901,"Marystown","NL",47.09899,-55.19852,2018-06-23 00:00:00,NA,NA,NA
"39203",10901,"Marystown","NL",47.09899,-55.19852,2018-06-23 01:00:00,NA,NA,NA
"39204",10901,"Marystown","NL",47.09899,-55.19852,2018-06-23 02:00:00,NA,NA,NA
"39205",10901,"Marystown","NL",47.09899,-55.19852,2018-06-23 03:00:00,NA,NA,NA
"39206",10901,"Marystown","NL",47.09899,-55.19852,2018-06-23 04:00:00,NA,NA,NA
"39207",10901,"Marystown","NL",47.09899,-55.19852,2018-06-23 05:00:00,NA,NA,NA
"39208",10901,"Marystown","NL",47.09899,-55.19852,2018-06-23 06:00:00,NA,NA,NA
"39209",10901,"Marystown","NL",47.09899,-55.19852,2018-06-23 07:00:00,NA,NA,NA
"39210",10901,"Marystown","NL",47.09899,-55.19852,2018-06-23 08:00:00,NA,NA,NA
"39211",10901,"Marystown","NL",47.09899,-55.19852,2018-06-23 09:00:00,NA,NA,NA
"39212",10901,"Marystown","NL",47.09899,-55.19852,2018-06-23 10:00:00,NA,NA,NA
"39213",10901,"Marystown","NL",47.09899,-55.19852,2018-06-23 11:00:00,NA,NA,NA
"39214",10901,"Marystown","NL",47.09899,-55.19852,2018-06-23 12:00:00,NA,NA,NA
"39215",10901,"Marystown","NL",47.09899,-55.19852,2018-06-23 13:00:00,NA,NA,NA
"39216",10901,"Marystown","NL",47.09899,-55.19852,2018-06-23 14:00:00,NA,NA,NA
"39217",10901,"Marystown","NL",47.09899,-55.19852,2018-06-23 15:00:00,NA,NA,NA
"39218",10901,"Marystown","NL",47.09899,-55.19852,2018-06-23 16:00:00,NA,NA,NA
"39219",10901,"Marystown","NL",47.09899,-55.19852,2018-06-23 17:00:00,NA,NA,NA
"39220",10901,"Marystown","NL",47.09899,-55.19852,2018-06-23 18:00:00,NA,NA,NA
"39221",10901,"Marystown","NL",47.09899,-55.19852,2018-06-23 19:00:00,NA,NA,NA
"39222",10901,"Marystown","NL",47.09899,-55.19852,2018-06-23 20:00:00,NA,NA,NA
"39223",10901,"Marystown","NL",47.09899,-55.19852,2018-06-23 21:00:00,NA,NA,NA
"39224",10901,"Marystown","NL",47.09899,-55.19852,2018-06-23 22:00:00,NA,NA,NA
"39225",10901,"Marystown","NL",47.09899,-55.19852,2018-06-23 23:00:00,NA,NA,NA
"39226",10901,"Marystown","NL",47.09899,-55.19852,2018-06-24 00:00:00,NA,NA,NA
"39227",10901,"Marystown","NL",47.09899,-55.19852,2018-06-24 01:00:00,NA,NA,NA
"39228",10901,"Marystown","NL",47.09899,-55.19852,2018-06-24 02:00:00,NA,NA,NA
"39229",10901,"Marystown","NL",47.09899,-55.19852,2018-06-24 03:00:00,NA,NA,NA
"39230",10901,"Marystown","NL",47.09899,-55.19852,2018-06-24 04:00:00,NA,NA,NA
"39231",10901,"Marystown","NL",47.09899,-55.19852,2018-06-24 05:00:00,NA,NA,NA
"39232",10901,"Marystown","NL",47.09899,-55.19852,2018-06-24 06:00:00,NA,NA,NA
"39233",10901,"Marystown","NL",47.09899,-55.19852,2018-06-24 07:00:00,NA,NA,NA
"39234",10901,"Marystown","NL",47.09899,-55.19852,2018-06-24 08:00:00,NA,NA,NA
"39235",10901,"Marystown","NL",47.09899,-55.19852,2018-06-24 09:00:00,NA,NA,NA
"39236",10901,"Marystown","NL",47.09899,-55.19852,2018-06-24 10:00:00,NA,NA,NA
"39237",10901,"Marystown","NL",47.09899,-55.19852,2018-06-24 11:00:00,NA,NA,NA
"39238",10901,"Marystown","NL",47.09899,-55.19852,2018-06-24 12:00:00,NA,NA,NA
"39239",10901,"Marystown","NL",47.09899,-55.19852,2018-06-24 13:00:00,NA,NA,NA
"39240",10901,"Marystown","NL",47.09899,-55.19852,2018-06-24 14:00:00,NA,NA,NA
"39241",10901,"Marystown","NL",47.09899,-55.19852,2018-06-24 15:00:00,NA,NA,NA
"39242",10901,"Marystown","NL",47.09899,-55.19852,2018-06-24 16:00:00,NA,NA,NA
"39243",10901,"Marystown","NL",47.09899,-55.19852,2018-06-24 17:00:00,NA,NA,NA
"39244",10901,"Marystown","NL",47.09899,-55.19852,2018-06-24 18:00:00,NA,NA,NA
"39245",10901,"Marystown","NL",47.09899,-55.19852,2018-06-24 19:00:00,NA,NA,NA
"39246",10901,"Marystown","NL",47.09899,-55.19852,2018-06-24 20:00:00,NA,NA,NA
"39247",10901,"Marystown","NL",47.09899,-55.19852,2018-06-24 21:00:00,NA,NA,NA
"39248",10901,"Marystown","NL",47.09899,-55.19852,2018-06-24 22:00:00,NA,NA,NA
"39249",10901,"Marystown","NL",47.09899,-55.19852,2018-06-24 23:00:00,NA,NA,NA
"39250",10901,"Marystown","NL",47.09899,-55.19852,2018-06-25 00:00:00,NA,NA,NA
"39251",10901,"Marystown","NL",47.09899,-55.19852,2018-06-25 01:00:00,NA,NA,NA
"39252",10901,"Marystown","NL",47.09899,-55.19852,2018-06-25 02:00:00,NA,NA,NA
"39253",10901,"Marystown","NL",47.09899,-55.19852,2018-06-25 03:00:00,NA,NA,NA
"39254",10901,"Marystown","NL",47.09899,-55.19852,2018-06-25 04:00:00,NA,NA,NA
"39255",10901,"Marystown","NL",47.09899,-55.19852,2018-06-25 05:00:00,NA,NA,NA
"39256",10901,"Marystown","NL",47.09899,-55.19852,2018-06-25 06:00:00,NA,NA,NA
"39257",10901,"Marystown","NL",47.09899,-55.19852,2018-06-25 07:00:00,NA,NA,NA
"39258",10901,"Marystown","NL",47.09899,-55.19852,2018-06-25 08:00:00,NA,NA,NA
"39259",10901,"Marystown","NL",47.09899,-55.19852,2018-06-25 09:00:00,NA,NA,NA
"39260",10901,"Marystown","NL",47.09899,-55.19852,2018-06-25 10:00:00,NA,NA,NA
"39261",10901,"Marystown","NL",47.09899,-55.19852,2018-06-25 11:00:00,NA,NA,NA
"39262",10901,"Marystown","NL",47.09899,-55.19852,2018-06-25 12:00:00,NA,NA,NA
"39263",10901,"Marystown","NL",47.09899,-55.19852,2018-06-25 13:00:00,NA,NA,NA
"39264",10901,"Marystown","NL",47.09899,-55.19852,2018-06-25 14:00:00,NA,NA,NA
"39265",10901,"Marystown","NL",47.09899,-55.19852,2018-06-25 15:00:00,NA,NA,NA
"39266",10901,"Marystown","NL",47.09899,-55.19852,2018-06-25 16:00:00,NA,NA,NA
"39267",10901,"Marystown","NL",47.09899,-55.19852,2018-06-25 17:00:00,NA,NA,NA
"39268",10901,"Marystown","NL",47.09899,-55.19852,2018-06-25 18:00:00,NA,NA,NA
"39269",10901,"Marystown","NL",47.09899,-55.19852,2018-06-25 19:00:00,NA,NA,NA
"39270",10901,"Marystown","NL",47.09899,-55.19852,2018-06-25 20:00:00,NA,NA,NA
"39271",10901,"Marystown","NL",47.09899,-55.19852,2018-06-25 21:00:00,NA,NA,NA
"39272",10901,"Marystown","NL",47.09899,-55.19852,2018-06-25 22:00:00,NA,NA,NA
"39273",10901,"Marystown","NL",47.09899,-55.19852,2018-06-25 23:00:00,NA,NA,NA
"39274",10901,"Marystown","NL",47.09899,-55.19852,2018-06-26 00:00:00,NA,NA,NA
"39275",10901,"Marystown","NL",47.09899,-55.19852,2018-06-26 01:00:00,NA,NA,NA
"39276",10901,"Marystown","NL",47.09899,-55.19852,2018-06-26 02:00:00,NA,NA,NA
"39277",10901,"Marystown","NL",47.09899,-55.19852,2018-06-26 03:00:00,NA,NA,NA
"39278",10901,"Marystown","NL",47.09899,-55.19852,2018-06-26 04:00:00,NA,NA,NA
"39279",10901,"Marystown","NL",47.09899,-55.19852,2018-06-26 05:00:00,NA,NA,NA
"39280",10901,"Marystown","NL",47.09899,-55.19852,2018-06-26 06:00:00,NA,NA,NA
"39281",10901,"Marystown","NL",47.09899,-55.19852,2018-06-26 07:00:00,NA,NA,NA
"39282",10901,"Marystown","NL",47.09899,-55.19852,2018-06-26 08:00:00,NA,NA,NA
"39283",10901,"Marystown","NL",47.09899,-55.19852,2018-06-26 09:00:00,NA,NA,NA
"39284",10901,"Marystown","NL",47.09899,-55.19852,2018-06-26 10:00:00,NA,NA,NA
"39285",10901,"Marystown","NL",47.09899,-55.19852,2018-06-26 11:00:00,NA,NA,NA
"39286",10901,"Marystown","NL",47.09899,-55.19852,2018-06-26 12:00:00,NA,NA,NA
"39287",10901,"Marystown","NL",47.09899,-55.19852,2018-06-26 13:00:00,NA,NA,NA
"39288",10901,"Marystown","NL",47.09899,-55.19852,2018-06-26 14:00:00,NA,NA,NA
"39289",10901,"Marystown","NL",47.09899,-55.19852,2018-06-26 15:00:00,NA,NA,NA
"39290",10901,"Marystown","NL",47.09899,-55.19852,2018-06-26 16:00:00,NA,NA,NA
"39291",10901,"Marystown","NL",47.09899,-55.19852,2018-06-26 17:00:00,NA,NA,NA
"39292",10901,"Marystown","NL",47.09899,-55.19852,2018-06-26 18:00:00,NA,NA,NA
"39293",10901,"Marystown","NL",47.09899,-55.19852,2018-06-26 19:00:00,NA,NA,NA
"39294",10901,"Marystown","NL",47.09899,-55.19852,2018-06-26 20:00:00,NA,NA,NA
"39295",10901,"Marystown","NL",47.09899,-55.19852,2018-06-26 21:00:00,NA,NA,NA
"39296",10901,"Marystown","NL",47.09899,-55.19852,2018-06-26 22:00:00,NA,NA,NA
"39297",10901,"Marystown","NL",47.09899,-55.19852,2018-06-26 23:00:00,NA,NA,NA
"39298",10901,"Marystown","NL",47.09899,-55.19852,2018-06-27 00:00:00,NA,NA,NA
"39299",10901,"Marystown","NL",47.09899,-55.19852,2018-06-27 01:00:00,NA,NA,NA
"39300",10901,"Marystown","NL",47.09899,-55.19852,2018-06-27 02:00:00,NA,NA,NA
"39301",10901,"Marystown","NL",47.09899,-55.19852,2018-06-27 03:00:00,NA,NA,NA
"39302",10901,"Marystown","NL",47.09899,-55.19852,2018-06-27 04:00:00,NA,NA,NA
"39303",10901,"Marystown","NL",47.09899,-55.19852,2018-06-27 05:00:00,NA,NA,NA
"39304",10901,"Marystown","NL",47.09899,-55.19852,2018-06-27 06:00:00,NA,NA,NA
"39305",10901,"Marystown","NL",47.09899,-55.19852,2018-06-27 07:00:00,NA,NA,NA
"39306",10901,"Marystown","NL",47.09899,-55.19852,2018-06-27 08:00:00,NA,NA,NA
"39307",10901,"Marystown","NL",47.09899,-55.19852,2018-06-27 09:00:00,NA,NA,NA
"39308",10901,"Marystown","NL",47.09899,-55.19852,2018-06-27 10:00:00,18,1,19
"39309",10901,"Marystown","NL",47.09899,-55.19852,2018-06-27 11:00:00,20,1,21
"39310",10901,"Marystown","NL",47.09899,-55.19852,2018-06-27 12:00:00,22,0,22
"39311",10901,"Marystown","NL",47.09899,-55.19852,2018-06-27 13:00:00,22,0,22
"39312",10901,"Marystown","NL",47.09899,-55.19852,2018-06-27 14:00:00,24,0,24
"39313",10901,"Marystown","NL",47.09899,-55.19852,2018-06-27 15:00:00,25,0,25
"39314",10901,"Marystown","NL",47.09899,-55.19852,2018-06-27 16:00:00,26,0,26
"39315",10901,"Marystown","NL",47.09899,-55.19852,2018-06-27 17:00:00,27,0,27
"39316",10901,"Marystown","NL",47.09899,-55.19852,2018-06-27 18:00:00,28,0,28
"39317",10901,"Marystown","NL",47.09899,-55.19852,2018-06-27 19:00:00,30,0,30
"39318",10901,"Marystown","NL",47.09899,-55.19852,2018-06-27 20:00:00,31,0,31
"39319",10901,"Marystown","NL",47.09899,-55.19852,2018-06-27 21:00:00,33,0,33
"39320",10901,"Marystown","NL",47.09899,-55.19852,2018-06-27 22:00:00,31,0,31
"39321",10901,"Marystown","NL",47.09899,-55.19852,2018-06-27 23:00:00,22,2,24
"39322",10901,"Marystown","NL",47.09899,-55.19852,2018-06-28 00:00:00,20,1,21
"39323",10901,"Marystown","NL",47.09899,-55.19852,2018-06-28 01:00:00,19,0,19
"39324",10901,"Marystown","NL",47.09899,-55.19852,2018-06-28 02:00:00,14,0,14
"39325",10901,"Marystown","NL",47.09899,-55.19852,2018-06-28 03:00:00,9,0,9
"39326",10901,"Marystown","NL",47.09899,-55.19852,2018-06-28 04:00:00,9,0,9
"39327",10901,"Marystown","NL",47.09899,-55.19852,2018-06-28 05:00:00,12,0,12
"39328",10901,"Marystown","NL",47.09899,-55.19852,2018-06-28 06:00:00,14,0,14
"39329",10901,"Marystown","NL",47.09899,-55.19852,2018-06-28 07:00:00,21,1,22
"39330",10901,"Marystown","NL",47.09899,-55.19852,2018-06-28 08:00:00,23,4,27
"39331",10901,"Marystown","NL",47.09899,-55.19852,2018-06-28 09:00:00,27,1,28
"39332",10901,"Marystown","NL",47.09899,-55.19852,2018-06-28 10:00:00,29,1,30
"39333",10901,"Marystown","NL",47.09899,-55.19852,2018-06-28 11:00:00,32,0,32
"39334",10901,"Marystown","NL",47.09899,-55.19852,2018-06-28 12:00:00,NA,1,NA
"39335",10901,"Marystown","NL",47.09899,-55.19852,2018-06-28 13:00:00,NA,1,NA
"39336",10901,"Marystown","NL",47.09899,-55.19852,2018-06-28 14:00:00,NA,1,NA
"39337",10901,"Marystown","NL",47.09899,-55.19852,2018-06-28 15:00:00,NA,0,NA
"39338",10901,"Marystown","NL",47.09899,-55.19852,2018-06-28 16:00:00,NA,0,NA
"39339",10901,"Marystown","NL",47.09899,-55.19852,2018-06-28 17:00:00,NA,0,NA
"39340",10901,"Marystown","NL",47.09899,-55.19852,2018-06-28 18:00:00,NA,0,NA
"39341",10901,"Marystown","NL",47.09899,-55.19852,2018-06-28 19:00:00,NA,0,NA
"39342",10901,"Marystown","NL",47.09899,-55.19852,2018-06-28 20:00:00,NA,0,NA
"39343",10901,"Marystown","NL",47.09899,-55.19852,2018-06-28 21:00:00,NA,0,NA
"39344",10901,"Marystown","NL",47.09899,-55.19852,2018-06-28 22:00:00,NA,0,NA
"39345",10901,"Marystown","NL",47.09899,-55.19852,2018-06-28 23:00:00,NA,0,NA
"39346",10901,"Marystown","NL",47.09899,-55.19852,2018-06-29 00:00:00,NA,1,NA
"39347",10901,"Marystown","NL",47.09899,-55.19852,2018-06-29 01:00:00,NA,0,NA
"39348",10901,"Marystown","NL",47.09899,-55.19852,2018-06-29 02:00:00,NA,0,NA
"39349",10901,"Marystown","NL",47.09899,-55.19852,2018-06-29 03:00:00,NA,0,NA
"39350",10901,"Marystown","NL",47.09899,-55.19852,2018-06-29 04:00:00,NA,0,NA
"39351",10901,"Marystown","NL",47.09899,-55.19852,2018-06-29 05:00:00,NA,0,NA
"39352",10901,"Marystown","NL",47.09899,-55.19852,2018-06-29 06:00:00,NA,0,NA
"39353",10901,"Marystown","NL",47.09899,-55.19852,2018-06-29 07:00:00,NA,1,NA
"39354",10901,"Marystown","NL",47.09899,-55.19852,2018-06-29 08:00:00,NA,1,NA
"39355",10901,"Marystown","NL",47.09899,-55.19852,2018-06-29 09:00:00,NA,1,NA
"39356",10901,"Marystown","NL",47.09899,-55.19852,2018-06-29 10:00:00,NA,1,NA
"39357",10901,"Marystown","NL",47.09899,-55.19852,2018-06-29 11:00:00,NA,1,NA
"39358",10901,"Marystown","NL",47.09899,-55.19852,2018-06-29 12:00:00,NA,0,NA
"39359",10901,"Marystown","NL",47.09899,-55.19852,2018-06-29 13:00:00,NA,0,NA
"39360",10901,"Marystown","NL",47.09899,-55.19852,2018-06-29 14:00:00,NA,0,NA
"39361",10901,"Marystown","NL",47.09899,-55.19852,2018-06-29 15:00:00,NA,0,NA
"39362",10901,"Marystown","NL",47.09899,-55.19852,2018-06-29 16:00:00,NA,0,NA
"39363",10901,"Marystown","NL",47.09899,-55.19852,2018-06-29 17:00:00,NA,0,NA
"39364",10901,"Marystown","NL",47.09899,-55.19852,2018-06-29 18:00:00,NA,0,NA
"39365",10901,"Marystown","NL",47.09899,-55.19852,2018-06-29 19:00:00,NA,0,NA
"39366",10901,"Marystown","NL",47.09899,-55.19852,2018-06-29 20:00:00,NA,0,NA
"39367",10901,"Marystown","NL",47.09899,-55.19852,2018-06-29 21:00:00,NA,0,NA
"39368",10901,"Marystown","NL",47.09899,-55.19852,2018-06-29 22:00:00,NA,0,NA
"39369",10901,"Marystown","NL",47.09899,-55.19852,2018-06-29 23:00:00,NA,0,NA
"39370",10901,"Marystown","NL",47.09899,-55.19852,2018-06-30 00:00:00,NA,0,NA
"39371",10901,"Marystown","NL",47.09899,-55.19852,2018-06-30 01:00:00,NA,0,NA
"39372",10901,"Marystown","NL",47.09899,-55.19852,2018-06-30 02:00:00,NA,0,NA
"39373",10901,"Marystown","NL",47.09899,-55.19852,2018-06-30 03:00:00,NA,0,NA
"39374",10901,"Marystown","NL",47.09899,-55.19852,2018-06-30 04:00:00,NA,0,NA
"39375",10901,"Marystown","NL",47.09899,-55.19852,2018-06-30 05:00:00,NA,0,NA
"39376",10901,"Marystown","NL",47.09899,-55.19852,2018-06-30 06:00:00,NA,0,NA
"39377",10901,"Marystown","NL",47.09899,-55.19852,2018-06-30 07:00:00,NA,0,NA
"39378",10901,"Marystown","NL",47.09899,-55.19852,2018-06-30 08:00:00,NA,0,NA
"39379",10901,"Marystown","NL",47.09899,-55.19852,2018-06-30 09:00:00,NA,0,NA
"39380",10901,"Marystown","NL",47.09899,-55.19852,2018-06-30 10:00:00,NA,0,NA
"39381",10901,"Marystown","NL",47.09899,-55.19852,2018-06-30 11:00:00,NA,0,NA
"39382",10901,"Marystown","NL",47.09899,-55.19852,2018-06-30 12:00:00,NA,0,NA
"39383",10901,"Marystown","NL",47.09899,-55.19852,2018-06-30 13:00:00,NA,0,NA
"39384",10901,"Marystown","NL",47.09899,-55.19852,2018-06-30 14:00:00,NA,1,NA
"39385",10901,"Marystown","NL",47.09899,-55.19852,2018-06-30 15:00:00,NA,1,NA
"39386",10901,"Marystown","NL",47.09899,-55.19852,2018-06-30 16:00:00,NA,0,NA
"39387",10901,"Marystown","NL",47.09899,-55.19852,2018-06-30 17:00:00,NA,0,NA
"39388",10901,"Marystown","NL",47.09899,-55.19852,2018-06-30 18:00:00,NA,0,NA
"39389",10901,"Marystown","NL",47.09899,-55.19852,2018-06-30 19:00:00,NA,0,NA
"39390",10901,"Marystown","NL",47.09899,-55.19852,2018-06-30 20:00:00,NA,0,NA
"39391",10901,"Marystown","NL",47.09899,-55.19852,2018-06-30 21:00:00,NA,0,NA
"39392",10901,"Marystown","NL",47.09899,-55.19852,2018-06-30 22:00:00,NA,1,NA
"39393",10901,"Marystown","NL",47.09899,-55.19852,2018-06-30 23:00:00,NA,1,NA
"39394",10901,"Marystown","NL",47.09899,-55.19852,2018-07-01 00:00:00,NA,1,NA
"39395",10901,"Marystown","NL",47.09899,-55.19852,2018-07-01 01:00:00,NA,0,NA
"39396",10901,"Marystown","NL",47.09899,-55.19852,2018-07-01 02:00:00,NA,0,NA
"39397",10901,"Marystown","NL",47.09899,-55.19852,2018-07-01 03:00:00,NA,1,NA
"39398",10901,"Marystown","NL",47.09899,-55.19852,2018-07-01 04:00:00,NA,1,NA
"39399",10901,"Marystown","NL",47.09899,-55.19852,2018-07-01 05:00:00,NA,1,NA
"39400",10901,"Marystown","NL",47.09899,-55.19852,2018-07-01 06:00:00,NA,1,NA
"39401",10901,"Marystown","NL",47.09899,-55.19852,2018-07-01 07:00:00,NA,1,NA
"39402",10901,"Marystown","NL",47.09899,-55.19852,2018-07-01 08:00:00,NA,1,NA
"39403",10901,"Marystown","NL",47.09899,-55.19852,2018-07-01 09:00:00,NA,1,NA
"39404",10901,"Marystown","NL",47.09899,-55.19852,2018-07-01 10:00:00,NA,1,NA
"39405",10901,"Marystown","NL",47.09899,-55.19852,2018-07-01 11:00:00,NA,1,NA
"39406",10901,"Marystown","NL",47.09899,-55.19852,2018-07-01 12:00:00,NA,0,NA
"39407",10901,"Marystown","NL",47.09899,-55.19852,2018-07-01 13:00:00,NA,0,NA
"39408",10901,"Marystown","NL",47.09899,-55.19852,2018-07-01 14:00:00,NA,0,NA
"39409",10901,"Marystown","NL",47.09899,-55.19852,2018-07-01 15:00:00,NA,0,NA
"39410",10901,"Marystown","NL",47.09899,-55.19852,2018-07-01 16:00:00,NA,0,NA
"39411",10901,"Marystown","NL",47.09899,-55.19852,2018-07-01 17:00:00,NA,0,NA
"39412",10901,"Marystown","NL",47.09899,-55.19852,2018-07-01 18:00:00,NA,1,NA
"39413",10901,"Marystown","NL",47.09899,-55.19852,2018-07-01 19:00:00,NA,0,NA
"39414",10901,"Marystown","NL",47.09899,-55.19852,2018-07-01 20:00:00,NA,0,NA
"39415",10901,"Marystown","NL",47.09899,-55.19852,2018-07-01 21:00:00,NA,0,NA
"39416",10901,"Marystown","NL",47.09899,-55.19852,2018-07-01 22:00:00,NA,1,NA
"39417",10901,"Marystown","NL",47.09899,-55.19852,2018-07-01 23:00:00,NA,1,NA
"39418",10901,"Marystown","NL",47.09899,-55.19852,2018-07-02 00:00:00,NA,1,NA
"39419",10901,"Marystown","NL",47.09899,-55.19852,2018-07-02 01:00:00,NA,1,NA
"39420",10901,"Marystown","NL",47.09899,-55.19852,2018-07-02 02:00:00,NA,2,NA
"39421",10901,"Marystown","NL",47.09899,-55.19852,2018-07-02 03:00:00,NA,2,NA
"39422",10901,"Marystown","NL",47.09899,-55.19852,2018-07-02 04:00:00,NA,1,NA
"39423",10901,"Marystown","NL",47.09899,-55.19852,2018-07-02 05:00:00,NA,1,NA
"39424",10901,"Marystown","NL",47.09899,-55.19852,2018-07-02 06:00:00,NA,0,NA
"39425",10901,"Marystown","NL",47.09899,-55.19852,2018-07-02 07:00:00,NA,0,NA
"39426",10901,"Marystown","NL",47.09899,-55.19852,2018-07-02 08:00:00,NA,0,NA
"39427",10901,"Marystown","NL",47.09899,-55.19852,2018-07-02 09:00:00,NA,0,NA
"39428",10901,"Marystown","NL",47.09899,-55.19852,2018-07-02 10:00:00,NA,0,NA
"39429",10901,"Marystown","NL",47.09899,-55.19852,2018-07-02 11:00:00,NA,0,NA
"39430",10901,"Marystown","NL",47.09899,-55.19852,2018-07-02 12:00:00,NA,0,NA
"39431",10901,"Marystown","NL",47.09899,-55.19852,2018-07-02 13:00:00,NA,1,NA
"39432",10901,"Marystown","NL",47.09899,-55.19852,2018-07-02 14:00:00,NA,1,NA
"39433",10901,"Marystown","NL",47.09899,-55.19852,2018-07-02 15:00:00,NA,0,NA
"39434",10901,"Marystown","NL",47.09899,-55.19852,2018-07-02 16:00:00,NA,0,NA
"39435",10901,"Marystown","NL",47.09899,-55.19852,2018-07-02 17:00:00,NA,1,NA
"39436",10901,"Marystown","NL",47.09899,-55.19852,2018-07-02 18:00:00,NA,1,NA
"39437",10901,"Marystown","NL",47.09899,-55.19852,2018-07-02 19:00:00,NA,0,NA
"39438",10901,"Marystown","NL",47.09899,-55.19852,2018-07-02 20:00:00,NA,1,NA
"39439",10901,"Marystown","NL",47.09899,-55.19852,2018-07-02 21:00:00,NA,1,NA
"39440",10901,"Marystown","NL",47.09899,-55.19852,2018-07-02 22:00:00,NA,1,NA
"39441",10901,"Marystown","NL",47.09899,-55.19852,2018-07-02 23:00:00,NA,1,NA
"39442",10901,"Marystown","NL",47.09899,-55.19852,2018-07-03 00:00:00,NA,1,NA
"39443",10901,"Marystown","NL",47.09899,-55.19852,2018-07-03 01:00:00,NA,1,NA
"39444",10901,"Marystown","NL",47.09899,-55.19852,2018-07-03 02:00:00,NA,0,NA
"39445",10901,"Marystown","NL",47.09899,-55.19852,2018-07-03 03:00:00,NA,1,NA
"39446",10901,"Marystown","NL",47.09899,-55.19852,2018-07-03 04:00:00,NA,0,NA
"39447",10901,"Marystown","NL",47.09899,-55.19852,2018-07-03 05:00:00,NA,0,NA
"39448",10901,"Marystown","NL",47.09899,-55.19852,2018-07-03 06:00:00,NA,0,NA
"39449",10901,"Marystown","NL",47.09899,-55.19852,2018-07-03 07:00:00,NA,1,NA
"39450",10901,"Marystown","NL",47.09899,-55.19852,2018-07-03 08:00:00,NA,1,NA
"39451",10901,"Marystown","NL",47.09899,-55.19852,2018-07-03 09:00:00,NA,1,NA
"39452",10901,"Marystown","NL",47.09899,-55.19852,2018-07-03 10:00:00,NA,1,NA
"39453",10901,"Marystown","NL",47.09899,-55.19852,2018-07-03 11:00:00,NA,1,NA
"39454",10901,"Marystown","NL",47.09899,-55.19852,2018-07-03 12:00:00,NA,1,NA
"39455",10901,"Marystown","NL",47.09899,-55.19852,2018-07-03 13:00:00,NA,0,NA
"39456",10901,"Marystown","NL",47.09899,-55.19852,2018-07-03 14:00:00,NA,0,NA
"39457",10901,"Marystown","NL",47.09899,-55.19852,2018-07-03 15:00:00,NA,1,NA
"39458",10901,"Marystown","NL",47.09899,-55.19852,2018-07-03 16:00:00,NA,0,NA
"39459",10901,"Marystown","NL",47.09899,-55.19852,2018-07-03 17:00:00,NA,0,NA
"39460",10901,"Marystown","NL",47.09899,-55.19852,2018-07-03 18:00:00,NA,0,NA
"39461",10901,"Marystown","NL",47.09899,-55.19852,2018-07-03 19:00:00,NA,0,NA
"39462",10901,"Marystown","NL",47.09899,-55.19852,2018-07-03 20:00:00,NA,0,NA
"39463",10901,"Marystown","NL",47.09899,-55.19852,2018-07-03 21:00:00,NA,0,NA
"39464",10901,"Marystown","NL",47.09899,-55.19852,2018-07-03 22:00:00,NA,0,NA
"39465",10901,"Marystown","NL",47.09899,-55.19852,2018-07-03 23:00:00,NA,0,NA
"39466",10901,"Marystown","NL",47.09899,-55.19852,2018-07-04 00:00:00,NA,0,NA
"39467",10901,"Marystown","NL",47.09899,-55.19852,2018-07-04 01:00:00,NA,0,NA
"39468",10901,"Marystown","NL",47.09899,-55.19852,2018-07-04 02:00:00,NA,0,NA
"39469",10901,"Marystown","NL",47.09899,-55.19852,2018-07-04 03:00:00,NA,0,NA
"39470",10901,"Marystown","NL",47.09899,-55.19852,2018-07-04 04:00:00,NA,0,NA
"39471",10901,"Marystown","NL",47.09899,-55.19852,2018-07-04 05:00:00,NA,0,NA
"39472",10901,"Marystown","NL",47.09899,-55.19852,2018-07-04 06:00:00,NA,0,NA
"39473",10901,"Marystown","NL",47.09899,-55.19852,2018-07-04 07:00:00,NA,0,NA
"39474",10901,"Marystown","NL",47.09899,-55.19852,2018-07-04 08:00:00,NA,0,NA
"39475",10901,"Marystown","NL",47.09899,-55.19852,2018-07-04 09:00:00,NA,0,NA
"39476",10901,"Marystown","NL",47.09899,-55.19852,2018-07-04 10:00:00,NA,0,NA
"39477",10901,"Marystown","NL",47.09899,-55.19852,2018-07-04 11:00:00,NA,0,NA
"39478",10901,"Marystown","NL",47.09899,-55.19852,2018-07-04 12:00:00,NA,0,NA
"39479",10901,"Marystown","NL",47.09899,-55.19852,2018-07-04 13:00:00,NA,0,NA
"39480",10901,"Marystown","NL",47.09899,-55.19852,2018-07-04 14:00:00,NA,0,NA
"39481",10901,"Marystown","NL",47.09899,-55.19852,2018-07-04 15:00:00,NA,0,NA
"39482",10901,"Marystown","NL",47.09899,-55.19852,2018-07-04 16:00:00,NA,0,NA
"39483",10901,"Marystown","NL",47.09899,-55.19852,2018-07-04 17:00:00,NA,0,NA
"39484",10901,"Marystown","NL",47.09899,-55.19852,2018-07-04 18:00:00,NA,0,NA
"39485",10901,"Marystown","NL",47.09899,-55.19852,2018-07-04 19:00:00,NA,0,NA
"39486",10901,"Marystown","NL",47.09899,-55.19852,2018-07-04 20:00:00,NA,0,NA
"39487",10901,"Marystown","NL",47.09899,-55.19852,2018-07-04 21:00:00,NA,0,NA
"39488",10901,"Marystown","NL",47.09899,-55.19852,2018-07-04 22:00:00,NA,0,NA
"39489",10901,"Marystown","NL",47.09899,-55.19852,2018-07-04 23:00:00,NA,0,NA
"39490",10901,"Marystown","NL",47.09899,-55.19852,2018-07-05 00:00:00,NA,0,NA
"39491",10901,"Marystown","NL",47.09899,-55.19852,2018-07-05 01:00:00,NA,0,NA
"39492",10901,"Marystown","NL",47.09899,-55.19852,2018-07-05 02:00:00,NA,0,NA
"39493",10901,"Marystown","NL",47.09899,-55.19852,2018-07-05 03:00:00,NA,0,NA
"39494",10901,"Marystown","NL",47.09899,-55.19852,2018-07-05 04:00:00,NA,0,NA
"39495",10901,"Marystown","NL",47.09899,-55.19852,2018-07-05 05:00:00,NA,0,NA
"39496",10901,"Marystown","NL",47.09899,-55.19852,2018-07-05 06:00:00,NA,1,NA
"39497",10901,"Marystown","NL",47.09899,-55.19852,2018-07-05 07:00:00,NA,1,NA
"39498",10901,"Marystown","NL",47.09899,-55.19852,2018-07-05 08:00:00,NA,2,NA
"39499",10901,"Marystown","NL",47.09899,-55.19852,2018-07-05 09:00:00,NA,1,NA
"39500",10901,"Marystown","NL",47.09899,-55.19852,2018-07-05 10:00:00,NA,1,NA
"39501",10901,"Marystown","NL",47.09899,-55.19852,2018-07-05 11:00:00,NA,1,NA
"39502",10901,"Marystown","NL",47.09899,-55.19852,2018-07-05 12:00:00,NA,1,NA
"39503",10901,"Marystown","NL",47.09899,-55.19852,2018-07-05 13:00:00,NA,1,NA
"39504",10901,"Marystown","NL",47.09899,-55.19852,2018-07-05 14:00:00,NA,1,NA
"39505",10901,"Marystown","NL",47.09899,-55.19852,2018-07-05 15:00:00,NA,0,NA
"39506",10901,"Marystown","NL",47.09899,-55.19852,2018-07-05 16:00:00,NA,1,NA
"39507",10901,"Marystown","NL",47.09899,-55.19852,2018-07-05 17:00:00,NA,1,NA
"39508",10901,"Marystown","NL",47.09899,-55.19852,2018-07-05 18:00:00,NA,1,NA
"39509",10901,"Marystown","NL",47.09899,-55.19852,2018-07-05 19:00:00,NA,1,NA
"39510",10901,"Marystown","NL",47.09899,-55.19852,2018-07-05 20:00:00,NA,1,NA
"39511",10901,"Marystown","NL",47.09899,-55.19852,2018-07-05 21:00:00,NA,1,NA
"39512",10901,"Marystown","NL",47.09899,-55.19852,2018-07-05 22:00:00,NA,1,NA
"39513",10901,"Marystown","NL",47.09899,-55.19852,2018-07-05 23:00:00,NA,1,NA
"39514",10901,"Marystown","NL",47.09899,-55.19852,2018-07-06 00:00:00,NA,1,NA
"39515",10901,"Marystown","NL",47.09899,-55.19852,2018-07-06 01:00:00,NA,0,NA
"39516",10901,"Marystown","NL",47.09899,-55.19852,2018-07-06 02:00:00,NA,0,NA
"39517",10901,"Marystown","NL",47.09899,-55.19852,2018-07-06 03:00:00,NA,0,NA
"39518",10901,"Marystown","NL",47.09899,-55.19852,2018-07-06 04:00:00,NA,0,NA
"39519",10901,"Marystown","NL",47.09899,-55.19852,2018-07-06 05:00:00,NA,0,NA
"39520",10901,"Marystown","NL",47.09899,-55.19852,2018-07-06 06:00:00,NA,0,NA
"39521",10901,"Marystown","NL",47.09899,-55.19852,2018-07-06 07:00:00,NA,0,NA
"39522",10901,"Marystown","NL",47.09899,-55.19852,2018-07-06 08:00:00,NA,0,NA
"39523",10901,"Marystown","NL",47.09899,-55.19852,2018-07-06 09:00:00,NA,0,NA
"39524",10901,"Marystown","NL",47.09899,-55.19852,2018-07-06 10:00:00,NA,0,NA
"39525",10901,"Marystown","NL",47.09899,-55.19852,2018-07-06 11:00:00,NA,1,NA
"39526",10901,"Marystown","NL",47.09899,-55.19852,2018-07-06 12:00:00,NA,0,NA
"39527",10901,"Marystown","NL",47.09899,-55.19852,2018-07-06 13:00:00,NA,0,NA
"39528",10901,"Marystown","NL",47.09899,-55.19852,2018-07-06 14:00:00,NA,0,NA
"39529",10901,"Marystown","NL",47.09899,-55.19852,2018-07-06 15:00:00,NA,0,NA
"39530",10901,"Marystown","NL",47.09899,-55.19852,2018-07-06 16:00:00,NA,0,NA
"39531",10901,"Marystown","NL",47.09899,-55.19852,2018-07-06 17:00:00,NA,0,NA
"39532",10901,"Marystown","NL",47.09899,-55.19852,2018-07-06 18:00:00,NA,0,NA
"39533",10901,"Marystown","NL",47.09899,-55.19852,2018-07-06 19:00:00,NA,0,NA
"39534",10901,"Marystown","NL",47.09899,-55.19852,2018-07-06 20:00:00,NA,0,NA
"39535",10901,"Marystown","NL",47.09899,-55.19852,2018-07-06 21:00:00,NA,0,NA
"39536",10901,"Marystown","NL",47.09899,-55.19852,2018-07-06 22:00:00,NA,0,NA
"39537",10901,"Marystown","NL",47.09899,-55.19852,2018-07-06 23:00:00,NA,0,NA
"39538",10901,"Marystown","NL",47.09899,-55.19852,2018-07-07 00:00:00,NA,0,NA
"39539",10901,"Marystown","NL",47.09899,-55.19852,2018-07-07 01:00:00,NA,0,NA
"39540",10901,"Marystown","NL",47.09899,-55.19852,2018-07-07 02:00:00,NA,0,NA
"39541",10901,"Marystown","NL",47.09899,-55.19852,2018-07-07 03:00:00,NA,0,NA
"39542",10901,"Marystown","NL",47.09899,-55.19852,2018-07-07 04:00:00,NA,0,NA
"39543",10901,"Marystown","NL",47.09899,-55.19852,2018-07-07 05:00:00,NA,0,NA
"39544",10901,"Marystown","NL",47.09899,-55.19852,2018-07-07 06:00:00,NA,0,NA
"39545",10901,"Marystown","NL",47.09899,-55.19852,2018-07-07 07:00:00,NA,0,NA
"39546",10901,"Marystown","NL",47.09899,-55.19852,2018-07-07 08:00:00,NA,0,NA
"39547",10901,"Marystown","NL",47.09899,-55.19852,2018-07-07 09:00:00,NA,0,NA
"39548",10901,"Marystown","NL",47.09899,-55.19852,2018-07-07 10:00:00,NA,0,NA
"39549",10901,"Marystown","NL",47.09899,-55.19852,2018-07-07 11:00:00,NA,0,NA
"39550",10901,"Marystown","NL",47.09899,-55.19852,2018-07-07 12:00:00,NA,0,NA
"39551",10901,"Marystown","NL",47.09899,-55.19852,2018-07-07 13:00:00,NA,0,NA
"39552",10901,"Marystown","NL",47.09899,-55.19852,2018-07-07 14:00:00,NA,0,NA
"39553",10901,"Marystown","NL",47.09899,-55.19852,2018-07-07 15:00:00,NA,0,NA
"39554",10901,"Marystown","NL",47.09899,-55.19852,2018-07-07 16:00:00,NA,0,NA
"39555",10901,"Marystown","NL",47.09899,-55.19852,2018-07-07 17:00:00,NA,0,NA
"39556",10901,"Marystown","NL",47.09899,-55.19852,2018-07-07 18:00:00,NA,0,NA
"39557",10901,"Marystown","NL",47.09899,-55.19852,2018-07-07 19:00:00,NA,0,NA
"39558",10901,"Marystown","NL",47.09899,-55.19852,2018-07-07 20:00:00,NA,0,NA
"39559",10901,"Marystown","NL",47.09899,-55.19852,2018-07-07 21:00:00,NA,0,NA
"39560",10901,"Marystown","NL",47.09899,-55.19852,2018-07-07 22:00:00,NA,0,NA
"39561",10901,"Marystown","NL",47.09899,-55.19852,2018-07-07 23:00:00,NA,0,NA
"39562",10901,"Marystown","NL",47.09899,-55.19852,2018-07-08 00:00:00,NA,0,NA
"39563",10901,"Marystown","NL",47.09899,-55.19852,2018-07-08 01:00:00,NA,0,NA
"39564",10901,"Marystown","NL",47.09899,-55.19852,2018-07-08 02:00:00,NA,0,NA
"39565",10901,"Marystown","NL",47.09899,-55.19852,2018-07-08 03:00:00,NA,0,NA
"39566",10901,"Marystown","NL",47.09899,-55.19852,2018-07-08 04:00:00,NA,0,NA
"39567",10901,"Marystown","NL",47.09899,-55.19852,2018-07-08 05:00:00,NA,1,NA
"39568",10901,"Marystown","NL",47.09899,-55.19852,2018-07-08 06:00:00,NA,0,NA
"39569",10901,"Marystown","NL",47.09899,-55.19852,2018-07-08 07:00:00,NA,0,NA
"39570",10901,"Marystown","NL",47.09899,-55.19852,2018-07-08 08:00:00,NA,0,NA
"39571",10901,"Marystown","NL",47.09899,-55.19852,2018-07-08 09:00:00,NA,0,NA
"39572",10901,"Marystown","NL",47.09899,-55.19852,2018-07-08 10:00:00,NA,0,NA
"39573",10901,"Marystown","NL",47.09899,-55.19852,2018-07-08 11:00:00,NA,0,NA
"39574",10901,"Marystown","NL",47.09899,-55.19852,2018-07-08 12:00:00,NA,0,NA
"39575",10901,"Marystown","NL",47.09899,-55.19852,2018-07-08 13:00:00,NA,0,NA
"39576",10901,"Marystown","NL",47.09899,-55.19852,2018-07-08 14:00:00,NA,0,NA
"39577",10901,"Marystown","NL",47.09899,-55.19852,2018-07-08 15:00:00,NA,0,NA
"39578",10901,"Marystown","NL",47.09899,-55.19852,2018-07-08 16:00:00,NA,0,NA
"39579",10901,"Marystown","NL",47.09899,-55.19852,2018-07-08 17:00:00,NA,0,NA
"39580",10901,"Marystown","NL",47.09899,-55.19852,2018-07-08 18:00:00,NA,0,NA
"39581",10901,"Marystown","NL",47.09899,-55.19852,2018-07-08 19:00:00,NA,0,NA
"39582",10901,"Marystown","NL",47.09899,-55.19852,2018-07-08 20:00:00,NA,0,NA
"39583",10901,"Marystown","NL",47.09899,-55.19852,2018-07-08 21:00:00,NA,0,NA
"39584",10901,"Marystown","NL",47.09899,-55.19852,2018-07-08 22:00:00,NA,0,NA
"39585",10901,"Marystown","NL",47.09899,-55.19852,2018-07-08 23:00:00,NA,0,NA
"39586",10901,"Marystown","NL",47.09899,-55.19852,2018-07-09 00:00:00,NA,0,NA
"39587",10901,"Marystown","NL",47.09899,-55.19852,2018-07-09 01:00:00,NA,0,NA
"39588",10901,"Marystown","NL",47.09899,-55.19852,2018-07-09 02:00:00,NA,0,NA
"39589",10901,"Marystown","NL",47.09899,-55.19852,2018-07-09 03:00:00,NA,0,NA
"39590",10901,"Marystown","NL",47.09899,-55.19852,2018-07-09 04:00:00,NA,0,NA
"39591",10901,"Marystown","NL",47.09899,-55.19852,2018-07-09 05:00:00,NA,0,NA
"39592",10901,"Marystown","NL",47.09899,-55.19852,2018-07-09 06:00:00,NA,0,NA
"39593",10901,"Marystown","NL",47.09899,-55.19852,2018-07-09 07:00:00,NA,0,NA
"39594",10901,"Marystown","NL",47.09899,-55.19852,2018-07-09 08:00:00,NA,0,NA
"39595",10901,"Marystown","NL",47.09899,-55.19852,2018-07-09 09:00:00,NA,0,NA
"39596",10901,"Marystown","NL",47.09899,-55.19852,2018-07-09 10:00:00,NA,0,NA
"39597",10901,"Marystown","NL",47.09899,-55.19852,2018-07-09 11:00:00,NA,0,NA
"39598",10901,"Marystown","NL",47.09899,-55.19852,2018-07-09 12:00:00,NA,0,NA
"39599",10901,"Marystown","NL",47.09899,-55.19852,2018-07-09 13:00:00,NA,0,NA
"39600",10901,"Marystown","NL",47.09899,-55.19852,2018-07-09 14:00:00,NA,0,NA
"39601",10901,"Marystown","NL",47.09899,-55.19852,2018-07-09 15:00:00,NA,0,NA
"39602",10901,"Marystown","NL",47.09899,-55.19852,2018-07-09 16:00:00,NA,0,NA
"39603",10901,"Marystown","NL",47.09899,-55.19852,2018-07-09 17:00:00,NA,0,NA
"39604",10901,"Marystown","NL",47.09899,-55.19852,2018-07-09 18:00:00,NA,0,NA
"39605",10901,"Marystown","NL",47.09899,-55.19852,2018-07-09 19:00:00,NA,0,NA
"39606",10901,"Marystown","NL",47.09899,-55.19852,2018-07-09 20:00:00,NA,0,NA
"39607",10901,"Marystown","NL",47.09899,-55.19852,2018-07-09 21:00:00,NA,0,NA
"39608",10901,"Marystown","NL",47.09899,-55.19852,2018-07-09 22:00:00,NA,0,NA
"39609",10901,"Marystown","NL",47.09899,-55.19852,2018-07-09 23:00:00,NA,0,NA
"39610",10901,"Marystown","NL",47.09899,-55.19852,2018-07-10 00:00:00,NA,0,NA
"39611",10901,"Marystown","NL",47.09899,-55.19852,2018-07-10 01:00:00,NA,0,NA
"39612",10901,"Marystown","NL",47.09899,-55.19852,2018-07-10 02:00:00,NA,0,NA
"39613",10901,"Marystown","NL",47.09899,-55.19852,2018-07-10 03:00:00,NA,0,NA
"39614",10901,"Marystown","NL",47.09899,-55.19852,2018-07-10 04:00:00,NA,0,NA
"39615",10901,"Marystown","NL",47.09899,-55.19852,2018-07-10 05:00:00,NA,0,NA
"39616",10901,"Marystown","NL",47.09899,-55.19852,2018-07-10 06:00:00,NA,0,NA
"39617",10901,"Marystown","NL",47.09899,-55.19852,2018-07-10 07:00:00,NA,0,NA
"39618",10901,"Marystown","NL",47.09899,-55.19852,2018-07-10 08:00:00,NA,1,NA
"39619",10901,"Marystown","NL",47.09899,-55.19852,2018-07-10 09:00:00,NA,1,NA
"39620",10901,"Marystown","NL",47.09899,-55.19852,2018-07-10 10:00:00,NA,1,NA
"39621",10901,"Marystown","NL",47.09899,-55.19852,2018-07-10 11:00:00,NA,1,NA
"39622",10901,"Marystown","NL",47.09899,-55.19852,2018-07-10 12:00:00,NA,1,NA
"39623",10901,"Marystown","NL",47.09899,-55.19852,2018-07-10 13:00:00,NA,1,NA
"39624",10901,"Marystown","NL",47.09899,-55.19852,2018-07-10 14:00:00,NA,1,NA
"39625",10901,"Marystown","NL",47.09899,-55.19852,2018-07-10 15:00:00,NA,0,NA
"39626",10901,"Marystown","NL",47.09899,-55.19852,2018-07-10 16:00:00,NA,0,NA
"39627",10901,"Marystown","NL",47.09899,-55.19852,2018-07-10 17:00:00,NA,0,NA
"39628",10901,"Marystown","NL",47.09899,-55.19852,2018-07-10 18:00:00,NA,0,NA
"39629",10901,"Marystown","NL",47.09899,-55.19852,2018-07-10 19:00:00,NA,0,NA
"39630",10901,"Marystown","NL",47.09899,-55.19852,2018-07-10 20:00:00,NA,0,NA
"39631",10901,"Marystown","NL",47.09899,-55.19852,2018-07-10 21:00:00,NA,0,NA
"39632",10901,"Marystown","NL",47.09899,-55.19852,2018-07-10 22:00:00,NA,0,NA
"39633",10901,"Marystown","NL",47.09899,-55.19852,2018-07-10 23:00:00,NA,0,NA
"39634",10901,"Marystown","NL",47.09899,-55.19852,2018-07-11 00:00:00,NA,0,NA
"39635",10901,"Marystown","NL",47.09899,-55.19852,2018-07-11 01:00:00,NA,0,NA
"39636",10901,"Marystown","NL",47.09899,-55.19852,2018-07-11 02:00:00,NA,0,NA
"39637",10901,"Marystown","NL",47.09899,-55.19852,2018-07-11 03:00:00,NA,0,NA
"39638",10901,"Marystown","NL",47.09899,-55.19852,2018-07-11 04:00:00,NA,0,NA
"39639",10901,"Marystown","NL",47.09899,-55.19852,2018-07-11 05:00:00,NA,0,NA
"39640",10901,"Marystown","NL",47.09899,-55.19852,2018-07-11 06:00:00,NA,0,NA
"39641",10901,"Marystown","NL",47.09899,-55.19852,2018-07-11 07:00:00,NA,1,NA
"39642",10901,"Marystown","NL",47.09899,-55.19852,2018-07-11 08:00:00,NA,1,NA
"39643",10901,"Marystown","NL",47.09899,-55.19852,2018-07-11 09:00:00,NA,1,NA
"39644",10901,"Marystown","NL",47.09899,-55.19852,2018-07-11 10:00:00,NA,1,NA
"39645",10901,"Marystown","NL",47.09899,-55.19852,2018-07-11 11:00:00,NA,0,NA
"39646",10901,"Marystown","NL",47.09899,-55.19852,2018-07-11 12:00:00,NA,0,NA
"39647",10901,"Marystown","NL",47.09899,-55.19852,2018-07-11 13:00:00,NA,0,NA
"39648",10901,"Marystown","NL",47.09899,-55.19852,2018-07-11 14:00:00,NA,0,NA
"39649",10901,"Marystown","NL",47.09899,-55.19852,2018-07-11 15:00:00,NA,0,NA
"39650",10901,"Marystown","NL",47.09899,-55.19852,2018-07-11 16:00:00,NA,0,NA
"39651",10901,"Marystown","NL",47.09899,-55.19852,2018-07-11 17:00:00,NA,1,NA
"39652",10901,"Marystown","NL",47.09899,-55.19852,2018-07-11 18:00:00,NA,0,NA
"39653",10901,"Marystown","NL",47.09899,-55.19852,2018-07-11 19:00:00,NA,0,NA
"39654",10901,"Marystown","NL",47.09899,-55.19852,2018-07-11 20:00:00,NA,1,NA
"39655",10901,"Marystown","NL",47.09899,-55.19852,2018-07-11 21:00:00,NA,0,NA
"39656",10901,"Marystown","NL",47.09899,-55.19852,2018-07-11 22:00:00,NA,0,NA
"39657",10901,"Marystown","NL",47.09899,-55.19852,2018-07-11 23:00:00,NA,0,NA
"39658",10901,"Marystown","NL",47.09899,-55.19852,2018-07-12 00:00:00,NA,1,NA
"39659",10901,"Marystown","NL",47.09899,-55.19852,2018-07-12 01:00:00,NA,0,NA
"39660",10901,"Marystown","NL",47.09899,-55.19852,2018-07-12 02:00:00,NA,0,NA
"39661",10901,"Marystown","NL",47.09899,-55.19852,2018-07-12 03:00:00,NA,0,NA
"39662",10901,"Marystown","NL",47.09899,-55.19852,2018-07-12 04:00:00,NA,0,NA
"39663",10901,"Marystown","NL",47.09899,-55.19852,2018-07-12 05:00:00,NA,0,NA
"39664",10901,"Marystown","NL",47.09899,-55.19852,2018-07-12 06:00:00,NA,0,NA
"39665",10901,"Marystown","NL",47.09899,-55.19852,2018-07-12 07:00:00,NA,0,NA
"39666",10901,"Marystown","NL",47.09899,-55.19852,2018-07-12 08:00:00,NA,1,NA
"39667",10901,"Marystown","NL",47.09899,-55.19852,2018-07-12 09:00:00,NA,1,NA
"39668",10901,"Marystown","NL",47.09899,-55.19852,2018-07-12 10:00:00,19,1,20
"39669",10901,"Marystown","NL",47.09899,-55.19852,2018-07-12 11:00:00,18,1,19
"39670",10901,"Marystown","NL",47.09899,-55.19852,2018-07-12 12:00:00,19,0,19
"39671",10901,"Marystown","NL",47.09899,-55.19852,2018-07-12 13:00:00,20,0,20
"39672",10901,"Marystown","NL",47.09899,-55.19852,2018-07-12 14:00:00,20,0,20
"39673",10901,"Marystown","NL",47.09899,-55.19852,2018-07-12 15:00:00,16,0,16
"39674",10901,"Marystown","NL",47.09899,-55.19852,2018-07-12 16:00:00,19,0,19
"39675",10901,"Marystown","NL",47.09899,-55.19852,2018-07-12 17:00:00,34,0,34
"39676",10901,"Marystown","NL",47.09899,-55.19852,2018-07-12 18:00:00,31,0,31
"39677",10901,"Marystown","NL",47.09899,-55.19852,2018-07-12 19:00:00,31,0,31
"39678",10901,"Marystown","NL",47.09899,-55.19852,2018-07-12 20:00:00,30,0,30
"39679",10901,"Marystown","NL",47.09899,-55.19852,2018-07-12 21:00:00,26,0,26
"39680",10901,"Marystown","NL",47.09899,-55.19852,2018-07-12 22:00:00,24,0,24
"39681",10901,"Marystown","NL",47.09899,-55.19852,2018-07-12 23:00:00,22,0,22
"39682",10901,"Marystown","NL",47.09899,-55.19852,2018-07-13 00:00:00,21,0,21
"39683",10901,"Marystown","NL",47.09899,-55.19852,2018-07-13 01:00:00,20,0,20
"39684",10901,"Marystown","NL",47.09899,-55.19852,2018-07-13 02:00:00,18,0,18
"39685",10901,"Marystown","NL",47.09899,-55.19852,2018-07-13 03:00:00,16,0,16
"39686",10901,"Marystown","NL",47.09899,-55.19852,2018-07-13 04:00:00,14,0,14
"39687",10901,"Marystown","NL",47.09899,-55.19852,2018-07-13 05:00:00,14,0,14
"39688",10901,"Marystown","NL",47.09899,-55.19852,2018-07-13 06:00:00,12,0,12
"39689",10901,"Marystown","NL",47.09899,-55.19852,2018-07-13 07:00:00,16,0,16
"39690",10901,"Marystown","NL",47.09899,-55.19852,2018-07-13 08:00:00,17,0,17
"39691",10901,"Marystown","NL",47.09899,-55.19852,2018-07-13 09:00:00,17,0,17
"39692",10901,"Marystown","NL",47.09899,-55.19852,2018-07-13 10:00:00,16,0,16
"39693",10901,"Marystown","NL",47.09899,-55.19852,2018-07-13 11:00:00,15,0,15
"39694",10901,"Marystown","NL",47.09899,-55.19852,2018-07-13 12:00:00,15,0,15
"39695",10901,"Marystown","NL",47.09899,-55.19852,2018-07-13 13:00:00,15,0,15
"39696",10901,"Marystown","NL",47.09899,-55.19852,2018-07-13 14:00:00,16,0,16
"39697",10901,"Marystown","NL",47.09899,-55.19852,2018-07-13 15:00:00,16,0,16
"39698",10901,"Marystown","NL",47.09899,-55.19852,2018-07-13 16:00:00,18,1,19
"39699",10901,"Marystown","NL",47.09899,-55.19852,2018-07-13 17:00:00,20,0,20
"39700",10901,"Marystown","NL",47.09899,-55.19852,2018-07-13 18:00:00,21,0,21
"39701",10901,"Marystown","NL",47.09899,-55.19852,2018-07-13 19:00:00,21,0,21
"39702",10901,"Marystown","NL",47.09899,-55.19852,2018-07-13 20:00:00,21,0,21
"39703",10901,"Marystown","NL",47.09899,-55.19852,2018-07-13 21:00:00,20,0,20
"39704",10901,"Marystown","NL",47.09899,-55.19852,2018-07-13 22:00:00,19,1,20
"39705",10901,"Marystown","NL",47.09899,-55.19852,2018-07-13 23:00:00,19,1,20
"39706",10901,"Marystown","NL",47.09899,-55.19852,2018-07-14 00:00:00,18,1,19
"39707",10901,"Marystown","NL",47.09899,-55.19852,2018-07-14 01:00:00,19,1,20
"39708",10901,"Marystown","NL",47.09899,-55.19852,2018-07-14 02:00:00,18,0,18
"39709",10901,"Marystown","NL",47.09899,-55.19852,2018-07-14 03:00:00,18,0,18
"39710",10901,"Marystown","NL",47.09899,-55.19852,2018-07-14 04:00:00,17,0,17
"39711",10901,"Marystown","NL",47.09899,-55.19852,2018-07-14 05:00:00,16,0,16
"39712",10901,"Marystown","NL",47.09899,-55.19852,2018-07-14 06:00:00,17,0,17
"39713",10901,"Marystown","NL",47.09899,-55.19852,2018-07-14 07:00:00,18,0,18
"39714",10901,"Marystown","NL",47.09899,-55.19852,2018-07-14 08:00:00,18,1,19
"39715",10901,"Marystown","NL",47.09899,-55.19852,2018-07-14 09:00:00,18,1,19
"39716",10901,"Marystown","NL",47.09899,-55.19852,2018-07-14 10:00:00,20,1,21
"39717",10901,"Marystown","NL",47.09899,-55.19852,2018-07-14 11:00:00,20,1,21
"39718",10901,"Marystown","NL",47.09899,-55.19852,2018-07-14 12:00:00,21,0,21
"39719",10901,"Marystown","NL",47.09899,-55.19852,2018-07-14 13:00:00,20,1,21
"39720",10901,"Marystown","NL",47.09899,-55.19852,2018-07-14 14:00:00,21,1,22
"39721",10901,"Marystown","NL",47.09899,-55.19852,2018-07-14 15:00:00,21,1,22
"39722",10901,"Marystown","NL",47.09899,-55.19852,2018-07-14 16:00:00,23,0,23
"39723",10901,"Marystown","NL",47.09899,-55.19852,2018-07-14 17:00:00,22,0,22
"39724",10901,"Marystown","NL",47.09899,-55.19852,2018-07-14 18:00:00,23,0,23
"39725",10901,"Marystown","NL",47.09899,-55.19852,2018-07-14 19:00:00,22,0,22
"39726",10901,"Marystown","NL",47.09899,-55.19852,2018-07-14 20:00:00,21,0,21
"39727",10901,"Marystown","NL",47.09899,-55.19852,2018-07-14 21:00:00,20,1,21
"39728",10901,"Marystown","NL",47.09899,-55.19852,2018-07-14 22:00:00,20,1,21
"39729",10901,"Marystown","NL",47.09899,-55.19852,2018-07-14 23:00:00,20,0,20
"39730",10901,"Marystown","NL",47.09899,-55.19852,2018-07-15 00:00:00,20,0,20
"39731",10901,"Marystown","NL",47.09899,-55.19852,2018-07-15 01:00:00,19,0,19
"39732",10901,"Marystown","NL",47.09899,-55.19852,2018-07-15 02:00:00,18,0,18
"39733",10901,"Marystown","NL",47.09899,-55.19852,2018-07-15 03:00:00,18,0,18
"39734",10901,"Marystown","NL",47.09899,-55.19852,2018-07-15 04:00:00,16,0,16
"39735",10901,"Marystown","NL",47.09899,-55.19852,2018-07-15 05:00:00,15,0,15
"39736",10901,"Marystown","NL",47.09899,-55.19852,2018-07-15 06:00:00,16,0,16
"39737",10901,"Marystown","NL",47.09899,-55.19852,2018-07-15 07:00:00,16,0,16
"39738",10901,"Marystown","NL",47.09899,-55.19852,2018-07-15 08:00:00,15,0,15
"39739",10901,"Marystown","NL",47.09899,-55.19852,2018-07-15 09:00:00,15,0,15
"39740",10901,"Marystown","NL",47.09899,-55.19852,2018-07-15 10:00:00,15,0,15
"39741",10901,"Marystown","NL",47.09899,-55.19852,2018-07-15 11:00:00,16,0,16
"39742",10901,"Marystown","NL",47.09899,-55.19852,2018-07-15 12:00:00,15,1,16
"39743",10901,"Marystown","NL",47.09899,-55.19852,2018-07-15 13:00:00,15,1,16
"39744",10901,"Marystown","NL",47.09899,-55.19852,2018-07-15 14:00:00,14,1,15
"39745",10901,"Marystown","NL",47.09899,-55.19852,2018-07-15 15:00:00,14,1,15
"39746",10901,"Marystown","NL",47.09899,-55.19852,2018-07-15 16:00:00,13,1,14
"39747",10901,"Marystown","NL",47.09899,-55.19852,2018-07-15 17:00:00,13,1,14
"39748",10901,"Marystown","NL",47.09899,-55.19852,2018-07-15 18:00:00,15,0,15
"39749",10901,"Marystown","NL",47.09899,-55.19852,2018-07-15 19:00:00,17,1,18
"39750",10901,"Marystown","NL",47.09899,-55.19852,2018-07-15 20:00:00,16,1,17
"39751",10901,"Marystown","NL",47.09899,-55.19852,2018-07-15 21:00:00,16,1,17
"39752",10901,"Marystown","NL",47.09899,-55.19852,2018-07-15 22:00:00,17,1,18
"39753",10901,"Marystown","NL",47.09899,-55.19852,2018-07-15 23:00:00,20,1,21
"39754",10901,"Marystown","NL",47.09899,-55.19852,2018-07-16 00:00:00,22,0,22
"39755",10901,"Marystown","NL",47.09899,-55.19852,2018-07-16 01:00:00,22,0,22
"39756",10901,"Marystown","NL",47.09899,-55.19852,2018-07-16 02:00:00,21,0,21
"39757",10901,"Marystown","NL",47.09899,-55.19852,2018-07-16 03:00:00,22,0,22
"39758",10901,"Marystown","NL",47.09899,-55.19852,2018-07-16 04:00:00,22,0,22
"39759",10901,"Marystown","NL",47.09899,-55.19852,2018-07-16 05:00:00,21,0,21
"39760",10901,"Marystown","NL",47.09899,-55.19852,2018-07-16 06:00:00,21,1,22
"39761",10901,"Marystown","NL",47.09899,-55.19852,2018-07-16 07:00:00,19,1,20
"39762",10901,"Marystown","NL",47.09899,-55.19852,2018-07-16 08:00:00,17,2,19
"39763",10901,"Marystown","NL",47.09899,-55.19852,2018-07-16 09:00:00,17,2,19
"39764",10901,"Marystown","NL",47.09899,-55.19852,2018-07-16 10:00:00,18,1,19
"39765",10901,"Marystown","NL",47.09899,-55.19852,2018-07-16 11:00:00,20,1,21
"39766",10901,"Marystown","NL",47.09899,-55.19852,2018-07-16 12:00:00,19,1,20
"39767",10901,"Marystown","NL",47.09899,-55.19852,2018-07-16 13:00:00,18,2,20
"39768",10901,"Marystown","NL",47.09899,-55.19852,2018-07-16 14:00:00,18,1,19
"39769",10901,"Marystown","NL",47.09899,-55.19852,2018-07-16 15:00:00,17,1,18
"39770",10901,"Marystown","NL",47.09899,-55.19852,2018-07-16 16:00:00,17,1,18
"39771",10901,"Marystown","NL",47.09899,-55.19852,2018-07-16 17:00:00,17,0,17
"39772",10901,"Marystown","NL",47.09899,-55.19852,2018-07-16 18:00:00,16,0,16
"39773",10901,"Marystown","NL",47.09899,-55.19852,2018-07-16 19:00:00,17,0,17
"39774",10901,"Marystown","NL",47.09899,-55.19852,2018-07-16 20:00:00,18,0,18
"39775",10901,"Marystown","NL",47.09899,-55.19852,2018-07-16 21:00:00,19,1,20
"39776",10901,"Marystown","NL",47.09899,-55.19852,2018-07-16 22:00:00,16,1,17
"39777",10901,"Marystown","NL",47.09899,-55.19852,2018-07-16 23:00:00,18,0,18
"39778",10901,"Marystown","NL",47.09899,-55.19852,2018-07-17 00:00:00,18,1,19
"39779",10901,"Marystown","NL",47.09899,-55.19852,2018-07-17 01:00:00,19,0,19
"39780",10901,"Marystown","NL",47.09899,-55.19852,2018-07-17 02:00:00,17,0,17
"39781",10901,"Marystown","NL",47.09899,-55.19852,2018-07-17 03:00:00,19,0,19
"39782",10901,"Marystown","NL",47.09899,-55.19852,2018-07-17 04:00:00,18,0,18
"39783",10901,"Marystown","NL",47.09899,-55.19852,2018-07-17 05:00:00,18,0,18
"39784",10901,"Marystown","NL",47.09899,-55.19852,2018-07-17 06:00:00,18,0,18
"39785",10901,"Marystown","NL",47.09899,-55.19852,2018-07-17 07:00:00,15,0,15
"39786",10901,"Marystown","NL",47.09899,-55.19852,2018-07-17 08:00:00,16,0,16
"39787",10901,"Marystown","NL",47.09899,-55.19852,2018-07-17 09:00:00,15,1,16
"39788",10901,"Marystown","NL",47.09899,-55.19852,2018-07-17 10:00:00,14,0,14
"39789",10901,"Marystown","NL",47.09899,-55.19852,2018-07-17 11:00:00,15,0,15
"39790",10901,"Marystown","NL",47.09899,-55.19852,2018-07-17 12:00:00,14,1,15
"39791",10901,"Marystown","NL",47.09899,-55.19852,2018-07-17 13:00:00,15,1,16
"39792",10901,"Marystown","NL",47.09899,-55.19852,2018-07-17 14:00:00,18,1,19
"39793",10901,"Marystown","NL",47.09899,-55.19852,2018-07-17 15:00:00,19,0,19
"39794",10901,"Marystown","NL",47.09899,-55.19852,2018-07-17 16:00:00,25,1,26
"39795",10901,"Marystown","NL",47.09899,-55.19852,2018-07-17 17:00:00,26,0,26
"39796",10901,"Marystown","NL",47.09899,-55.19852,2018-07-17 18:00:00,24,0,24
"39797",10901,"Marystown","NL",47.09899,-55.19852,2018-07-17 19:00:00,26,0,26
"39798",10901,"Marystown","NL",47.09899,-55.19852,2018-07-17 20:00:00,27,0,27
"39799",10901,"Marystown","NL",47.09899,-55.19852,2018-07-17 21:00:00,25,0,25
"39800",10901,"Marystown","NL",47.09899,-55.19852,2018-07-17 22:00:00,22,0,22
"39801",10901,"Marystown","NL",47.09899,-55.19852,2018-07-17 23:00:00,22,0,22
"39802",10901,"Marystown","NL",47.09899,-55.19852,2018-07-18 00:00:00,28,0,28
"39803",10901,"Marystown","NL",47.09899,-55.19852,2018-07-18 01:00:00,34,0,34
"39804",10901,"Marystown","NL",47.09899,-55.19852,2018-07-18 02:00:00,34,0,34
"39805",10901,"Marystown","NL",47.09899,-55.19852,2018-07-18 03:00:00,32,0,32
"39806",10901,"Marystown","NL",47.09899,-55.19852,2018-07-18 04:00:00,30,0,30
"39807",10901,"Marystown","NL",47.09899,-55.19852,2018-07-18 05:00:00,30,0,30
"39808",10901,"Marystown","NL",47.09899,-55.19852,2018-07-18 06:00:00,27,0,27
"39809",10901,"Marystown","NL",47.09899,-55.19852,2018-07-18 07:00:00,24,0,24
"39810",10901,"Marystown","NL",47.09899,-55.19852,2018-07-18 08:00:00,23,1,24
"39811",10901,"Marystown","NL",47.09899,-55.19852,2018-07-18 09:00:00,23,1,24
"39812",10901,"Marystown","NL",47.09899,-55.19852,2018-07-18 10:00:00,20,1,21
"39813",10901,"Marystown","NL",47.09899,-55.19852,2018-07-18 11:00:00,20,1,21
"39814",10901,"Marystown","NL",47.09899,-55.19852,2018-07-18 12:00:00,21,0,21
"39815",10901,"Marystown","NL",47.09899,-55.19852,2018-07-18 13:00:00,21,0,21
"39816",10901,"Marystown","NL",47.09899,-55.19852,2018-07-18 14:00:00,20,0,20
"39817",10901,"Marystown","NL",47.09899,-55.19852,2018-07-18 15:00:00,22,1,23
"39818",10901,"Marystown","NL",47.09899,-55.19852,2018-07-18 16:00:00,23,1,24
"39819",10901,"Marystown","NL",47.09899,-55.19852,2018-07-18 17:00:00,22,0,22
"39820",10901,"Marystown","NL",47.09899,-55.19852,2018-07-18 18:00:00,23,0,23
"39821",10901,"Marystown","NL",47.09899,-55.19852,2018-07-18 19:00:00,24,0,24
"39822",10901,"Marystown","NL",47.09899,-55.19852,2018-07-18 20:00:00,24,0,24
"39823",10901,"Marystown","NL",47.09899,-55.19852,2018-07-18 21:00:00,25,0,25
"39824",10901,"Marystown","NL",47.09899,-55.19852,2018-07-18 22:00:00,26,0,26
"39825",10901,"Marystown","NL",47.09899,-55.19852,2018-07-18 23:00:00,27,0,27
"39826",10901,"Marystown","NL",47.09899,-55.19852,2018-07-19 00:00:00,28,0,28
"39827",10901,"Marystown","NL",47.09899,-55.19852,2018-07-19 01:00:00,28,0,28
"39828",10901,"Marystown","NL",47.09899,-55.19852,2018-07-19 02:00:00,28,0,28
"39829",10901,"Marystown","NL",47.09899,-55.19852,2018-07-19 03:00:00,27,0,27
"39830",10901,"Marystown","NL",47.09899,-55.19852,2018-07-19 04:00:00,29,0,29
"39831",10901,"Marystown","NL",47.09899,-55.19852,2018-07-19 05:00:00,28,0,28
"39832",10901,"Marystown","NL",47.09899,-55.19852,2018-07-19 06:00:00,28,0,28
"39833",10901,"Marystown","NL",47.09899,-55.19852,2018-07-19 07:00:00,28,0,28
"39834",10901,"Marystown","NL",47.09899,-55.19852,2018-07-19 08:00:00,25,0,25
"39835",10901,"Marystown","NL",47.09899,-55.19852,2018-07-19 09:00:00,22,0,22
"39836",10901,"Marystown","NL",47.09899,-55.19852,2018-07-19 10:00:00,18,2,20
"39837",10901,"Marystown","NL",47.09899,-55.19852,2018-07-19 11:00:00,17,3,20
"39838",10901,"Marystown","NL",47.09899,-55.19852,2018-07-19 12:00:00,19,5,24
"39839",10901,"Marystown","NL",47.09899,-55.19852,2018-07-19 13:00:00,20,4,24
"39840",10901,"Marystown","NL",47.09899,-55.19852,2018-07-19 14:00:00,18,3,21
"39841",10901,"Marystown","NL",47.09899,-55.19852,2018-07-19 15:00:00,15,5,20
"39842",10901,"Marystown","NL",47.09899,-55.19852,2018-07-19 16:00:00,14,5,19
"39843",10901,"Marystown","NL",47.09899,-55.19852,2018-07-19 17:00:00,15,1,16
"39844",10901,"Marystown","NL",47.09899,-55.19852,2018-07-19 18:00:00,14,0,14
"39845",10901,"Marystown","NL",47.09899,-55.19852,2018-07-19 19:00:00,11,1,12
"39846",10901,"Marystown","NL",47.09899,-55.19852,2018-07-19 20:00:00,10,1,11
"39847",10901,"Marystown","NL",47.09899,-55.19852,2018-07-19 21:00:00,9,1,10
"39848",10901,"Marystown","NL",47.09899,-55.19852,2018-07-19 22:00:00,9,0,9
"39849",10901,"Marystown","NL",47.09899,-55.19852,2018-07-19 23:00:00,8,0,8
"39850",10901,"Marystown","NL",47.09899,-55.19852,2018-07-20 00:00:00,14,0,14
"39851",10901,"Marystown","NL",47.09899,-55.19852,2018-07-20 01:00:00,18,0,18
"39852",10901,"Marystown","NL",47.09899,-55.19852,2018-07-20 02:00:00,17,0,17
"39853",10901,"Marystown","NL",47.09899,-55.19852,2018-07-20 03:00:00,10,0,10
"39854",10901,"Marystown","NL",47.09899,-55.19852,2018-07-20 04:00:00,8,0,8
"39855",10901,"Marystown","NL",47.09899,-55.19852,2018-07-20 05:00:00,8,1,9
"39856",10901,"Marystown","NL",47.09899,-55.19852,2018-07-20 06:00:00,9,1,10
"39857",10901,"Marystown","NL",47.09899,-55.19852,2018-07-20 07:00:00,11,0,11
"39858",10901,"Marystown","NL",47.09899,-55.19852,2018-07-20 08:00:00,11,0,11
"39859",10901,"Marystown","NL",47.09899,-55.19852,2018-07-20 09:00:00,13,0,13
"39860",10901,"Marystown","NL",47.09899,-55.19852,2018-07-20 10:00:00,13,0,13
"39861",10901,"Marystown","NL",47.09899,-55.19852,2018-07-20 11:00:00,13,0,13
"39862",10901,"Marystown","NL",47.09899,-55.19852,2018-07-20 12:00:00,13,0,13
"39863",10901,"Marystown","NL",47.09899,-55.19852,2018-07-20 13:00:00,18,0,18
"39864",10901,"Marystown","NL",47.09899,-55.19852,2018-07-20 14:00:00,20,0,20
"39865",10901,"Marystown","NL",47.09899,-55.19852,2018-07-20 15:00:00,18,0,18
"39866",10901,"Marystown","NL",47.09899,-55.19852,2018-07-20 16:00:00,19,0,19
"39867",10901,"Marystown","NL",47.09899,-55.19852,2018-07-20 17:00:00,23,0,23
"39868",10901,"Marystown","NL",47.09899,-55.19852,2018-07-20 18:00:00,23,0,23
"39869",10901,"Marystown","NL",47.09899,-55.19852,2018-07-20 19:00:00,24,0,24
"39870",10901,"Marystown","NL",47.09899,-55.19852,2018-07-20 20:00:00,25,0,25
"39871",10901,"Marystown","NL",47.09899,-55.19852,2018-07-20 21:00:00,25,0,25
"39872",10901,"Marystown","NL",47.09899,-55.19852,2018-07-20 22:00:00,19,1,20
"39873",10901,"Marystown","NL",47.09899,-55.19852,2018-07-20 23:00:00,16,1,17
"39874",10901,"Marystown","NL",47.09899,-55.19852,2018-07-21 00:00:00,15,1,16
"39875",10901,"Marystown","NL",47.09899,-55.19852,2018-07-21 01:00:00,16,1,17
"39876",10901,"Marystown","NL",47.09899,-55.19852,2018-07-21 02:00:00,17,1,18
"39877",10901,"Marystown","NL",47.09899,-55.19852,2018-07-21 03:00:00,17,1,18
"39878",10901,"Marystown","NL",47.09899,-55.19852,2018-07-21 04:00:00,13,1,14
"39879",10901,"Marystown","NL",47.09899,-55.19852,2018-07-21 05:00:00,16,1,17
"39880",10901,"Marystown","NL",47.09899,-55.19852,2018-07-21 06:00:00,18,0,18
"39881",10901,"Marystown","NL",47.09899,-55.19852,2018-07-21 07:00:00,19,1,20
"39882",10901,"Marystown","NL",47.09899,-55.19852,2018-07-21 08:00:00,20,0,20
"39883",10901,"Marystown","NL",47.09899,-55.19852,2018-07-21 09:00:00,25,0,25
"39884",10901,"Marystown","NL",47.09899,-55.19852,2018-07-21 10:00:00,27,0,27
"39885",10901,"Marystown","NL",47.09899,-55.19852,2018-07-21 11:00:00,27,0,27
"39886",10901,"Marystown","NL",47.09899,-55.19852,2018-07-21 12:00:00,28,0,28
"39887",10901,"Marystown","NL",47.09899,-55.19852,2018-07-21 13:00:00,26,1,27
"39888",10901,"Marystown","NL",47.09899,-55.19852,2018-07-21 14:00:00,26,0,26
"39889",10901,"Marystown","NL",47.09899,-55.19852,2018-07-21 15:00:00,28,0,28
"39890",10901,"Marystown","NL",47.09899,-55.19852,2018-07-21 16:00:00,27,0,27
"39891",10901,"Marystown","NL",47.09899,-55.19852,2018-07-21 17:00:00,25,0,25
"39892",10901,"Marystown","NL",47.09899,-55.19852,2018-07-21 18:00:00,26,1,27
"39893",10901,"Marystown","NL",47.09899,-55.19852,2018-07-21 19:00:00,23,1,24
"39894",10901,"Marystown","NL",47.09899,-55.19852,2018-07-21 20:00:00,19,1,20
"39895",10901,"Marystown","NL",47.09899,-55.19852,2018-07-21 21:00:00,21,1,22
"39896",10901,"Marystown","NL",47.09899,-55.19852,2018-07-21 22:00:00,24,1,25
"39897",10901,"Marystown","NL",47.09899,-55.19852,2018-07-21 23:00:00,26,1,27
"39898",10901,"Marystown","NL",47.09899,-55.19852,2018-07-22 00:00:00,29,0,29
"39899",10901,"Marystown","NL",47.09899,-55.19852,2018-07-22 01:00:00,28,0,28
"39900",10901,"Marystown","NL",47.09899,-55.19852,2018-07-22 02:00:00,25,0,25
"39901",10901,"Marystown","NL",47.09899,-55.19852,2018-07-22 03:00:00,23,0,23
"39902",10901,"Marystown","NL",47.09899,-55.19852,2018-07-22 04:00:00,21,0,21
"39903",10901,"Marystown","NL",47.09899,-55.19852,2018-07-22 05:00:00,20,0,20
"39904",10901,"Marystown","NL",47.09899,-55.19852,2018-07-22 06:00:00,17,0,17
"39905",10901,"Marystown","NL",47.09899,-55.19852,2018-07-22 07:00:00,16,0,16
"39906",10901,"Marystown","NL",47.09899,-55.19852,2018-07-22 08:00:00,16,0,16
"39907",10901,"Marystown","NL",47.09899,-55.19852,2018-07-22 09:00:00,16,1,17
"39908",10901,"Marystown","NL",47.09899,-55.19852,2018-07-22 10:00:00,18,0,18
"39909",10901,"Marystown","NL",47.09899,-55.19852,2018-07-22 11:00:00,24,0,24
"39910",10901,"Marystown","NL",47.09899,-55.19852,2018-07-22 12:00:00,28,0,28
"39911",10901,"Marystown","NL",47.09899,-55.19852,2018-07-22 13:00:00,25,0,25
"39912",10901,"Marystown","NL",47.09899,-55.19852,2018-07-22 14:00:00,29,0,29
"39913",10901,"Marystown","NL",47.09899,-55.19852,2018-07-22 15:00:00,29,0,29
"39914",10901,"Marystown","NL",47.09899,-55.19852,2018-07-22 16:00:00,25,0,25
"39915",10901,"Marystown","NL",47.09899,-55.19852,2018-07-22 17:00:00,18,0,18
"39916",10901,"Marystown","NL",47.09899,-55.19852,2018-07-22 18:00:00,17,0,17
"39917",10901,"Marystown","NL",47.09899,-55.19852,2018-07-22 19:00:00,15,0,15
"39918",10901,"Marystown","NL",47.09899,-55.19852,2018-07-22 20:00:00,14,0,14
"39919",10901,"Marystown","NL",47.09899,-55.19852,2018-07-22 21:00:00,14,0,14
"39920",10901,"Marystown","NL",47.09899,-55.19852,2018-07-22 22:00:00,15,0,15
"39921",10901,"Marystown","NL",47.09899,-55.19852,2018-07-22 23:00:00,16,0,16
"39922",10901,"Marystown","NL",47.09899,-55.19852,2018-07-23 00:00:00,16,0,16
"39923",10901,"Marystown","NL",47.09899,-55.19852,2018-07-23 01:00:00,15,0,15
"39924",10901,"Marystown","NL",47.09899,-55.19852,2018-07-23 02:00:00,15,0,15
"39925",10901,"Marystown","NL",47.09899,-55.19852,2018-07-23 03:00:00,13,0,13
"39926",10901,"Marystown","NL",47.09899,-55.19852,2018-07-23 04:00:00,10,0,10
"39927",10901,"Marystown","NL",47.09899,-55.19852,2018-07-23 05:00:00,10,0,10
"39928",10901,"Marystown","NL",47.09899,-55.19852,2018-07-23 06:00:00,11,0,11
"39929",10901,"Marystown","NL",47.09899,-55.19852,2018-07-23 07:00:00,11,0,11
"39930",10901,"Marystown","NL",47.09899,-55.19852,2018-07-23 08:00:00,11,0,11
"39931",10901,"Marystown","NL",47.09899,-55.19852,2018-07-23 09:00:00,10,0,10
"39932",10901,"Marystown","NL",47.09899,-55.19852,2018-07-23 10:00:00,10,0,10
"39933",10901,"Marystown","NL",47.09899,-55.19852,2018-07-23 11:00:00,11,0,11
"39934",10901,"Marystown","NL",47.09899,-55.19852,2018-07-23 12:00:00,11,0,11
"39935",10901,"Marystown","NL",47.09899,-55.19852,2018-07-23 13:00:00,11,0,11
"39936",10901,"Marystown","NL",47.09899,-55.19852,2018-07-23 14:00:00,12,0,12
"39937",10901,"Marystown","NL",47.09899,-55.19852,2018-07-23 15:00:00,12,0,12
"39938",10901,"Marystown","NL",47.09899,-55.19852,2018-07-23 16:00:00,12,0,12
"39939",10901,"Marystown","NL",47.09899,-55.19852,2018-07-23 17:00:00,13,0,13
"39940",10901,"Marystown","NL",47.09899,-55.19852,2018-07-23 18:00:00,12,0,12
"39941",10901,"Marystown","NL",47.09899,-55.19852,2018-07-23 19:00:00,11,0,11
"39942",10901,"Marystown","NL",47.09899,-55.19852,2018-07-23 20:00:00,12,0,12
"39943",10901,"Marystown","NL",47.09899,-55.19852,2018-07-23 21:00:00,12,0,12
"39944",10901,"Marystown","NL",47.09899,-55.19852,2018-07-23 22:00:00,11,0,11
"39945",10901,"Marystown","NL",47.09899,-55.19852,2018-07-23 23:00:00,14,0,14
"39946",10901,"Marystown","NL",47.09899,-55.19852,2018-07-24 00:00:00,14,0,14
"39947",10901,"Marystown","NL",47.09899,-55.19852,2018-07-24 01:00:00,14,0,14
"39948",10901,"Marystown","NL",47.09899,-55.19852,2018-07-24 02:00:00,13,0,13
"39949",10901,"Marystown","NL",47.09899,-55.19852,2018-07-24 03:00:00,13,0,13
"39950",10901,"Marystown","NL",47.09899,-55.19852,2018-07-24 04:00:00,15,0,15
"39951",10901,"Marystown","NL",47.09899,-55.19852,2018-07-24 05:00:00,17,0,17
"39952",10901,"Marystown","NL",47.09899,-55.19852,2018-07-24 06:00:00,16,0,16
"39953",10901,"Marystown","NL",47.09899,-55.19852,2018-07-24 07:00:00,15,0,15
"39954",10901,"Marystown","NL",47.09899,-55.19852,2018-07-24 08:00:00,16,0,16
"39955",10901,"Marystown","NL",47.09899,-55.19852,2018-07-24 09:00:00,16,0,16
"39956",10901,"Marystown","NL",47.09899,-55.19852,2018-07-24 10:00:00,17,0,17
"39957",10901,"Marystown","NL",47.09899,-55.19852,2018-07-24 11:00:00,18,0,18
"39958",10901,"Marystown","NL",47.09899,-55.19852,2018-07-24 12:00:00,20,0,20
"39959",10901,"Marystown","NL",47.09899,-55.19852,2018-07-24 13:00:00,19,1,20
"39960",10901,"Marystown","NL",47.09899,-55.19852,2018-07-24 14:00:00,18,4,22
"39961",10901,"Marystown","NL",47.09899,-55.19852,2018-07-24 15:00:00,19,1,20
"39962",10901,"Marystown","NL",47.09899,-55.19852,2018-07-24 16:00:00,17,1,18
"39963",10901,"Marystown","NL",47.09899,-55.19852,2018-07-24 17:00:00,17,1,18
"39964",10901,"Marystown","NL",47.09899,-55.19852,2018-07-24 18:00:00,16,1,17
"39965",10901,"Marystown","NL",47.09899,-55.19852,2018-07-24 19:00:00,14,1,15
"39966",10901,"Marystown","NL",47.09899,-55.19852,2018-07-24 20:00:00,14,1,15
"39967",10901,"Marystown","NL",47.09899,-55.19852,2018-07-24 21:00:00,11,1,12
"39968",10901,"Marystown","NL",47.09899,-55.19852,2018-07-24 22:00:00,11,1,12
"39969",10901,"Marystown","NL",47.09899,-55.19852,2018-07-24 23:00:00,7,1,8
"39970",10901,"Marystown","NL",47.09899,-55.19852,2018-07-25 00:00:00,4,0,4
"39971",10901,"Marystown","NL",47.09899,-55.19852,2018-07-25 01:00:00,8,0,8
"39972",10901,"Marystown","NL",47.09899,-55.19852,2018-07-25 02:00:00,11,0,11
"39973",10901,"Marystown","NL",47.09899,-55.19852,2018-07-25 03:00:00,12,0,12
"39974",10901,"Marystown","NL",47.09899,-55.19852,2018-07-25 04:00:00,12,0,12
"39975",10901,"Marystown","NL",47.09899,-55.19852,2018-07-25 05:00:00,13,0,13
"39976",10901,"Marystown","NL",47.09899,-55.19852,2018-07-25 06:00:00,11,0,11
"39977",10901,"Marystown","NL",47.09899,-55.19852,2018-07-25 07:00:00,10,0,10
"39978",10901,"Marystown","NL",47.09899,-55.19852,2018-07-25 08:00:00,11,0,11
"39979",10901,"Marystown","NL",47.09899,-55.19852,2018-07-25 09:00:00,13,0,13
"39980",10901,"Marystown","NL",47.09899,-55.19852,2018-07-25 10:00:00,13,0,13
"39981",10901,"Marystown","NL",47.09899,-55.19852,2018-07-25 11:00:00,9,0,9
"39982",10901,"Marystown","NL",47.09899,-55.19852,2018-07-25 12:00:00,NA,4,NA
"39983",10901,"Marystown","NL",47.09899,-55.19852,2018-07-25 13:00:00,NA,4,NA
"39984",10901,"Marystown","NL",47.09899,-55.19852,2018-07-25 14:00:00,12,NA,NA
"39985",10901,"Marystown","NL",47.09899,-55.19852,2018-07-25 15:00:00,13,2,15
"39986",10901,"Marystown","NL",47.09899,-55.19852,2018-07-25 16:00:00,15,0,15
"39987",10901,"Marystown","NL",47.09899,-55.19852,2018-07-25 17:00:00,15,0,15
"39988",10901,"Marystown","NL",47.09899,-55.19852,2018-07-25 18:00:00,16,0,16
"39989",10901,"Marystown","NL",47.09899,-55.19852,2018-07-25 19:00:00,17,0,17
"39990",10901,"Marystown","NL",47.09899,-55.19852,2018-07-25 20:00:00,15,0,15
"39991",10901,"Marystown","NL",47.09899,-55.19852,2018-07-25 21:00:00,12,0,12
"39992",10901,"Marystown","NL",47.09899,-55.19852,2018-07-25 22:00:00,12,0,12
"39993",10901,"Marystown","NL",47.09899,-55.19852,2018-07-25 23:00:00,11,0,11
"39994",10901,"Marystown","NL",47.09899,-55.19852,2018-07-26 00:00:00,11,0,11
"39995",10901,"Marystown","NL",47.09899,-55.19852,2018-07-26 01:00:00,11,0,11
"39996",10901,"Marystown","NL",47.09899,-55.19852,2018-07-26 02:00:00,12,0,12
"39997",10901,"Marystown","NL",47.09899,-55.19852,2018-07-26 03:00:00,13,0,13
"39998",10901,"Marystown","NL",47.09899,-55.19852,2018-07-26 04:00:00,13,0,13
"39999",10901,"Marystown","NL",47.09899,-55.19852,2018-07-26 05:00:00,13,0,13
"40000",10901,"Marystown","NL",47.09899,-55.19852,2018-07-26 06:00:00,16,0,16
"40001",10901,"Marystown","NL",47.09899,-55.19852,2018-07-26 07:00:00,17,0,17
"40002",10901,"Marystown","NL",47.09899,-55.19852,2018-07-26 08:00:00,18,0,18
"40003",10901,"Marystown","NL",47.09899,-55.19852,2018-07-26 09:00:00,18,0,18
"40004",10901,"Marystown","NL",47.09899,-55.19852,2018-07-26 10:00:00,17,0,17
"40005",10901,"Marystown","NL",47.09899,-55.19852,2018-07-26 11:00:00,17,0,17
"40006",10901,"Marystown","NL",47.09899,-55.19852,2018-07-26 12:00:00,16,0,16
"40007",10901,"Marystown","NL",47.09899,-55.19852,2018-07-26 13:00:00,15,0,15
"40008",10901,"Marystown","NL",47.09899,-55.19852,2018-07-26 14:00:00,14,0,14
"40009",10901,"Marystown","NL",47.09899,-55.19852,2018-07-26 15:00:00,15,0,15
"40010",10901,"Marystown","NL",47.09899,-55.19852,2018-07-26 16:00:00,14,0,14
"40011",10901,"Marystown","NL",47.09899,-55.19852,2018-07-26 17:00:00,14,0,14
"40012",10901,"Marystown","NL",47.09899,-55.19852,2018-07-26 18:00:00,15,0,15
"40013",10901,"Marystown","NL",47.09899,-55.19852,2018-07-26 19:00:00,16,0,16
"40014",10901,"Marystown","NL",47.09899,-55.19852,2018-07-26 20:00:00,17,0,17
"40015",10901,"Marystown","NL",47.09899,-55.19852,2018-07-26 21:00:00,17,0,17
"40016",10901,"Marystown","NL",47.09899,-55.19852,2018-07-26 22:00:00,18,0,18
"40017",10901,"Marystown","NL",47.09899,-55.19852,2018-07-26 23:00:00,18,0,18
"40018",10901,"Marystown","NL",47.09899,-55.19852,2018-07-27 00:00:00,17,0,17
"40019",10901,"Marystown","NL",47.09899,-55.19852,2018-07-27 01:00:00,17,0,17
"40020",10901,"Marystown","NL",47.09899,-55.19852,2018-07-27 02:00:00,18,0,18
"40021",10901,"Marystown","NL",47.09899,-55.19852,2018-07-27 03:00:00,18,0,18
"40022",10901,"Marystown","NL",47.09899,-55.19852,2018-07-27 04:00:00,18,0,18
"40023",10901,"Marystown","NL",47.09899,-55.19852,2018-07-27 05:00:00,19,0,19
"40024",10901,"Marystown","NL",47.09899,-55.19852,2018-07-27 06:00:00,19,0,19
"40025",10901,"Marystown","NL",47.09899,-55.19852,2018-07-27 07:00:00,18,0,18
"40026",10901,"Marystown","NL",47.09899,-55.19852,2018-07-27 08:00:00,17,0,17
"40027",10901,"Marystown","NL",47.09899,-55.19852,2018-07-27 09:00:00,17,0,17
"40028",10901,"Marystown","NL",47.09899,-55.19852,2018-07-27 10:00:00,17,0,17
"40029",10901,"Marystown","NL",47.09899,-55.19852,2018-07-27 11:00:00,17,0,17
"40030",10901,"Marystown","NL",47.09899,-55.19852,2018-07-27 12:00:00,19,0,19
"40031",10901,"Marystown","NL",47.09899,-55.19852,2018-07-27 13:00:00,18,0,18
"40032",10901,"Marystown","NL",47.09899,-55.19852,2018-07-27 14:00:00,19,0,19
"40033",10901,"Marystown","NL",47.09899,-55.19852,2018-07-27 15:00:00,23,0,23
"40034",10901,"Marystown","NL",47.09899,-55.19852,2018-07-27 16:00:00,29,0,29
"40035",10901,"Marystown","NL",47.09899,-55.19852,2018-07-27 17:00:00,31,0,31
"40036",10901,"Marystown","NL",47.09899,-55.19852,2018-07-27 18:00:00,30,0,30
"40037",10901,"Marystown","NL",47.09899,-55.19852,2018-07-27 19:00:00,32,0,32
"40038",10901,"Marystown","NL",47.09899,-55.19852,2018-07-27 20:00:00,30,0,30
"40039",10901,"Marystown","NL",47.09899,-55.19852,2018-07-27 21:00:00,27,0,27
"40040",10901,"Marystown","NL",47.09899,-55.19852,2018-07-27 22:00:00,24,0,24
"40041",10901,"Marystown","NL",47.09899,-55.19852,2018-07-27 23:00:00,25,0,25
"40042",10901,"Marystown","NL",47.09899,-55.19852,2018-07-28 00:00:00,24,0,24
"40043",10901,"Marystown","NL",47.09899,-55.19852,2018-07-28 01:00:00,21,0,21
"40044",10901,"Marystown","NL",47.09899,-55.19852,2018-07-28 02:00:00,16,0,16
"40045",10901,"Marystown","NL",47.09899,-55.19852,2018-07-28 03:00:00,17,0,17
"40046",10901,"Marystown","NL",47.09899,-55.19852,2018-07-28 04:00:00,14,0,14
"40047",10901,"Marystown","NL",47.09899,-55.19852,2018-07-28 05:00:00,13,0,13
"40048",10901,"Marystown","NL",47.09899,-55.19852,2018-07-28 06:00:00,13,0,13
"40049",10901,"Marystown","NL",47.09899,-55.19852,2018-07-28 07:00:00,12,0,12
"40050",10901,"Marystown","NL",47.09899,-55.19852,2018-07-28 08:00:00,14,0,14
"40051",10901,"Marystown","NL",47.09899,-55.19852,2018-07-28 09:00:00,14,1,15
"40052",10901,"Marystown","NL",47.09899,-55.19852,2018-07-28 10:00:00,14,0,14
"40053",10901,"Marystown","NL",47.09899,-55.19852,2018-07-28 11:00:00,16,0,16
"40054",10901,"Marystown","NL",47.09899,-55.19852,2018-07-28 12:00:00,16,0,16
"40055",10901,"Marystown","NL",47.09899,-55.19852,2018-07-28 13:00:00,16,0,16
"40056",10901,"Marystown","NL",47.09899,-55.19852,2018-07-28 14:00:00,15,0,15
"40057",10901,"Marystown","NL",47.09899,-55.19852,2018-07-28 15:00:00,15,0,15
"40058",10901,"Marystown","NL",47.09899,-55.19852,2018-07-28 16:00:00,15,0,15
"40059",10901,"Marystown","NL",47.09899,-55.19852,2018-07-28 17:00:00,15,0,15
"40060",10901,"Marystown","NL",47.09899,-55.19852,2018-07-28 18:00:00,15,0,15
"40061",10901,"Marystown","NL",47.09899,-55.19852,2018-07-28 19:00:00,15,0,15
"40062",10901,"Marystown","NL",47.09899,-55.19852,2018-07-28 20:00:00,14,0,14
"40063",10901,"Marystown","NL",47.09899,-55.19852,2018-07-28 21:00:00,16,1,17
"40064",10901,"Marystown","NL",47.09899,-55.19852,2018-07-28 22:00:00,16,1,17
"40065",10901,"Marystown","NL",47.09899,-55.19852,2018-07-28 23:00:00,14,1,15
"40066",10901,"Marystown","NL",47.09899,-55.19852,2018-07-29 00:00:00,14,1,15
"40067",10901,"Marystown","NL",47.09899,-55.19852,2018-07-29 01:00:00,14,1,15
"40068",10901,"Marystown","NL",47.09899,-55.19852,2018-07-29 02:00:00,14,0,14
"40069",10901,"Marystown","NL",47.09899,-55.19852,2018-07-29 03:00:00,13,0,13
"40070",10901,"Marystown","NL",47.09899,-55.19852,2018-07-29 04:00:00,12,0,12
"40071",10901,"Marystown","NL",47.09899,-55.19852,2018-07-29 05:00:00,11,0,11
"40072",10901,"Marystown","NL",47.09899,-55.19852,2018-07-29 06:00:00,11,0,11
"40073",10901,"Marystown","NL",47.09899,-55.19852,2018-07-29 07:00:00,10,0,10
"40074",10901,"Marystown","NL",47.09899,-55.19852,2018-07-29 08:00:00,10,0,10
"40075",10901,"Marystown","NL",47.09899,-55.19852,2018-07-29 09:00:00,10,0,10
"40076",10901,"Marystown","NL",47.09899,-55.19852,2018-07-29 10:00:00,10,0,10
"40077",10901,"Marystown","NL",47.09899,-55.19852,2018-07-29 11:00:00,14,0,14
"40078",10901,"Marystown","NL",47.09899,-55.19852,2018-07-29 12:00:00,18,0,18
"40079",10901,"Marystown","NL",47.09899,-55.19852,2018-07-29 13:00:00,19,0,19
"40080",10901,"Marystown","NL",47.09899,-55.19852,2018-07-29 14:00:00,18,0,18
"40081",10901,"Marystown","NL",47.09899,-55.19852,2018-07-29 15:00:00,17,0,17
"40082",10901,"Marystown","NL",47.09899,-55.19852,2018-07-29 16:00:00,19,0,19
"40083",10901,"Marystown","NL",47.09899,-55.19852,2018-07-29 17:00:00,16,0,16
"40084",10901,"Marystown","NL",47.09899,-55.19852,2018-07-29 18:00:00,22,0,22
"40085",10901,"Marystown","NL",47.09899,-55.19852,2018-07-29 19:00:00,25,0,25
"40086",10901,"Marystown","NL",47.09899,-55.19852,2018-07-29 20:00:00,25,0,25
"40087",10901,"Marystown","NL",47.09899,-55.19852,2018-07-29 21:00:00,24,0,24
"40088",10901,"Marystown","NL",47.09899,-55.19852,2018-07-29 22:00:00,24,0,24
"40089",10901,"Marystown","NL",47.09899,-55.19852,2018-07-29 23:00:00,22,0,22
"40090",10901,"Marystown","NL",47.09899,-55.19852,2018-07-30 00:00:00,23,0,23
"40091",10901,"Marystown","NL",47.09899,-55.19852,2018-07-30 01:00:00,27,0,27
"40092",10901,"Marystown","NL",47.09899,-55.19852,2018-07-30 02:00:00,29,0,29
"40093",10901,"Marystown","NL",47.09899,-55.19852,2018-07-30 03:00:00,29,0,29
"40094",10901,"Marystown","NL",47.09899,-55.19852,2018-07-30 04:00:00,28,0,28
"40095",10901,"Marystown","NL",47.09899,-55.19852,2018-07-30 05:00:00,26,0,26
"40096",10901,"Marystown","NL",47.09899,-55.19852,2018-07-30 06:00:00,23,0,23
"40097",10901,"Marystown","NL",47.09899,-55.19852,2018-07-30 07:00:00,20,0,20
"40098",10901,"Marystown","NL",47.09899,-55.19852,2018-07-30 08:00:00,23,0,23
"40099",10901,"Marystown","NL",47.09899,-55.19852,2018-07-30 09:00:00,23,0,23
"40100",10901,"Marystown","NL",47.09899,-55.19852,2018-07-30 10:00:00,24,0,24
"40101",10901,"Marystown","NL",47.09899,-55.19852,2018-07-30 11:00:00,24,0,24
"40102",10901,"Marystown","NL",47.09899,-55.19852,2018-07-30 12:00:00,23,0,23
"40103",10901,"Marystown","NL",47.09899,-55.19852,2018-07-30 13:00:00,23,1,24
"40104",10901,"Marystown","NL",47.09899,-55.19852,2018-07-30 14:00:00,26,0,26
"40105",10901,"Marystown","NL",47.09899,-55.19852,2018-07-30 15:00:00,25,0,25
"40106",10901,"Marystown","NL",47.09899,-55.19852,2018-07-30 16:00:00,25,0,25
"40107",10901,"Marystown","NL",47.09899,-55.19852,2018-07-30 17:00:00,28,0,28
"40108",10901,"Marystown","NL",47.09899,-55.19852,2018-07-30 18:00:00,29,0,29
"40109",10901,"Marystown","NL",47.09899,-55.19852,2018-07-30 19:00:00,25,0,25
"40110",10901,"Marystown","NL",47.09899,-55.19852,2018-07-30 20:00:00,22,0,22
"40111",10901,"Marystown","NL",47.09899,-55.19852,2018-07-30 21:00:00,21,0,21
"40112",10901,"Marystown","NL",47.09899,-55.19852,2018-07-30 22:00:00,24,0,24
"40113",10901,"Marystown","NL",47.09899,-55.19852,2018-07-30 23:00:00,22,0,22
"40114",10901,"Marystown","NL",47.09899,-55.19852,2018-07-31 00:00:00,20,0,20
"40115",10901,"Marystown","NL",47.09899,-55.19852,2018-07-31 01:00:00,19,0,19
"40116",10901,"Marystown","NL",47.09899,-55.19852,2018-07-31 02:00:00,18,0,18
"40117",10901,"Marystown","NL",47.09899,-55.19852,2018-07-31 03:00:00,17,0,17
"40118",10901,"Marystown","NL",47.09899,-55.19852,2018-07-31 04:00:00,19,0,19
"40119",10901,"Marystown","NL",47.09899,-55.19852,2018-07-31 05:00:00,17,0,17
"40120",10901,"Marystown","NL",47.09899,-55.19852,2018-07-31 06:00:00,17,0,17
"40121",10901,"Marystown","NL",47.09899,-55.19852,2018-07-31 07:00:00,18,0,18
"40122",10901,"Marystown","NL",47.09899,-55.19852,2018-07-31 08:00:00,18,0,18
"40123",10901,"Marystown","NL",47.09899,-55.19852,2018-07-31 09:00:00,19,0,19
"40124",10901,"Marystown","NL",47.09899,-55.19852,2018-07-31 10:00:00,20,0,20
"40125",10901,"Marystown","NL",47.09899,-55.19852,2018-07-31 11:00:00,21,0,21
"40126",10901,"Marystown","NL",47.09899,-55.19852,2018-07-31 12:00:00,22,0,22
"40127",10901,"Marystown","NL",47.09899,-55.19852,2018-07-31 13:00:00,23,0,23
"40128",10901,"Marystown","NL",47.09899,-55.19852,2018-07-31 14:00:00,22,0,22
"40129",10901,"Marystown","NL",47.09899,-55.19852,2018-07-31 15:00:00,23,0,23
"40130",10901,"Marystown","NL",47.09899,-55.19852,2018-07-31 16:00:00,24,0,24
"40131",10901,"Marystown","NL",47.09899,-55.19852,2018-07-31 17:00:00,24,0,24
"40132",10901,"Marystown","NL",47.09899,-55.19852,2018-07-31 18:00:00,23,0,23
"40133",10901,"Marystown","NL",47.09899,-55.19852,2018-07-31 19:00:00,25,0,25
"40134",10901,"Marystown","NL",47.09899,-55.19852,2018-07-31 20:00:00,25,0,25
"40135",10901,"Marystown","NL",47.09899,-55.19852,2018-07-31 21:00:00,26,0,26
"40136",10901,"Marystown","NL",47.09899,-55.19852,2018-07-31 22:00:00,29,1,30
"40137",10901,"Marystown","NL",47.09899,-55.19852,2018-07-31 23:00:00,26,0,26
"40138",10901,"Marystown","NL",47.09899,-55.19852,2018-08-01 00:00:00,24,0,24
"40139",10901,"Marystown","NL",47.09899,-55.19852,2018-08-01 01:00:00,24,0,24
"40140",10901,"Marystown","NL",47.09899,-55.19852,2018-08-01 02:00:00,21,0,21
"40141",10901,"Marystown","NL",47.09899,-55.19852,2018-08-01 03:00:00,19,1,20
"40142",10901,"Marystown","NL",47.09899,-55.19852,2018-08-01 04:00:00,17,0,17
"40143",10901,"Marystown","NL",47.09899,-55.19852,2018-08-01 05:00:00,16,0,16
"40144",10901,"Marystown","NL",47.09899,-55.19852,2018-08-01 06:00:00,14,0,14
"40145",10901,"Marystown","NL",47.09899,-55.19852,2018-08-01 07:00:00,17,0,17
"40146",10901,"Marystown","NL",47.09899,-55.19852,2018-08-01 08:00:00,17,0,17
"40147",10901,"Marystown","NL",47.09899,-55.19852,2018-08-01 09:00:00,17,0,17
"40148",10901,"Marystown","NL",47.09899,-55.19852,2018-08-01 10:00:00,20,0,20
"40149",10901,"Marystown","NL",47.09899,-55.19852,2018-08-01 11:00:00,20,0,20
"40150",10901,"Marystown","NL",47.09899,-55.19852,2018-08-01 12:00:00,23,0,23
"40151",10901,"Marystown","NL",47.09899,-55.19852,2018-08-01 13:00:00,26,0,26
"40152",10901,"Marystown","NL",47.09899,-55.19852,2018-08-01 14:00:00,26,0,26
"40153",10901,"Marystown","NL",47.09899,-55.19852,2018-08-01 15:00:00,27,0,27
"40154",10901,"Marystown","NL",47.09899,-55.19852,2018-08-01 16:00:00,27,1,28
"40155",10901,"Marystown","NL",47.09899,-55.19852,2018-08-01 17:00:00,28,0,28
"40156",10901,"Marystown","NL",47.09899,-55.19852,2018-08-01 18:00:00,27,0,27
"40157",10901,"Marystown","NL",47.09899,-55.19852,2018-08-01 19:00:00,27,0,27
"40158",10901,"Marystown","NL",47.09899,-55.19852,2018-08-01 20:00:00,29,0,29
"40159",10901,"Marystown","NL",47.09899,-55.19852,2018-08-01 21:00:00,28,0,28
"40160",10901,"Marystown","NL",47.09899,-55.19852,2018-08-01 22:00:00,29,1,30
"40161",10901,"Marystown","NL",47.09899,-55.19852,2018-08-01 23:00:00,25,0,25
"40162",10901,"Marystown","NL",47.09899,-55.19852,2018-08-02 00:00:00,24,0,24
"40163",10901,"Marystown","NL",47.09899,-55.19852,2018-08-02 01:00:00,23,0,23
"40164",10901,"Marystown","NL",47.09899,-55.19852,2018-08-02 02:00:00,17,0,17
"40165",10901,"Marystown","NL",47.09899,-55.19852,2018-08-02 03:00:00,15,0,15
"40166",10901,"Marystown","NL",47.09899,-55.19852,2018-08-02 04:00:00,13,0,13
"40167",10901,"Marystown","NL",47.09899,-55.19852,2018-08-02 05:00:00,11,0,11
"40168",10901,"Marystown","NL",47.09899,-55.19852,2018-08-02 06:00:00,18,1,19
"40169",10901,"Marystown","NL",47.09899,-55.19852,2018-08-02 07:00:00,22,1,23
"40170",10901,"Marystown","NL",47.09899,-55.19852,2018-08-02 08:00:00,24,1,25
"40171",10901,"Marystown","NL",47.09899,-55.19852,2018-08-02 09:00:00,27,0,27
"40172",10901,"Marystown","NL",47.09899,-55.19852,2018-08-02 10:00:00,30,0,30
"40173",10901,"Marystown","NL",47.09899,-55.19852,2018-08-02 11:00:00,29,0,29
"40174",10901,"Marystown","NL",47.09899,-55.19852,2018-08-02 12:00:00,27,0,27
"40175",10901,"Marystown","NL",47.09899,-55.19852,2018-08-02 13:00:00,26,0,26
"40176",10901,"Marystown","NL",47.09899,-55.19852,2018-08-02 14:00:00,25,0,25
"40177",10901,"Marystown","NL",47.09899,-55.19852,2018-08-02 15:00:00,26,0,26
"40178",10901,"Marystown","NL",47.09899,-55.19852,2018-08-02 16:00:00,25,0,25
"40179",10901,"Marystown","NL",47.09899,-55.19852,2018-08-02 17:00:00,26,0,26
"40180",10901,"Marystown","NL",47.09899,-55.19852,2018-08-02 18:00:00,26,0,26
"40181",10901,"Marystown","NL",47.09899,-55.19852,2018-08-02 19:00:00,26,0,26
"40182",10901,"Marystown","NL",47.09899,-55.19852,2018-08-02 20:00:00,26,0,26
"40183",10901,"Marystown","NL",47.09899,-55.19852,2018-08-02 21:00:00,25,0,25
"40184",10901,"Marystown","NL",47.09899,-55.19852,2018-08-02 22:00:00,25,0,25
"40185",10901,"Marystown","NL",47.09899,-55.19852,2018-08-02 23:00:00,23,1,24
"40186",10901,"Marystown","NL",47.09899,-55.19852,2018-08-03 00:00:00,24,0,24
"40187",10901,"Marystown","NL",47.09899,-55.19852,2018-08-03 01:00:00,23,0,23
"40188",10901,"Marystown","NL",47.09899,-55.19852,2018-08-03 02:00:00,21,0,21
"40189",10901,"Marystown","NL",47.09899,-55.19852,2018-08-03 03:00:00,20,0,20
"40190",10901,"Marystown","NL",47.09899,-55.19852,2018-08-03 04:00:00,19,0,19
"40191",10901,"Marystown","NL",47.09899,-55.19852,2018-08-03 05:00:00,16,0,16
"40192",10901,"Marystown","NL",47.09899,-55.19852,2018-08-03 06:00:00,16,0,16
"40193",10901,"Marystown","NL",47.09899,-55.19852,2018-08-03 07:00:00,14,0,14
"40194",10901,"Marystown","NL",47.09899,-55.19852,2018-08-03 08:00:00,15,0,15
"40195",10901,"Marystown","NL",47.09899,-55.19852,2018-08-03 09:00:00,15,0,15
"40196",10901,"Marystown","NL",47.09899,-55.19852,2018-08-03 10:00:00,14,0,14
"40197",10901,"Marystown","NL",47.09899,-55.19852,2018-08-03 11:00:00,14,0,14
"40198",10901,"Marystown","NL",47.09899,-55.19852,2018-08-03 12:00:00,15,0,15
"40199",10901,"Marystown","NL",47.09899,-55.19852,2018-08-03 13:00:00,16,0,16
"40200",10901,"Marystown","NL",47.09899,-55.19852,2018-08-03 14:00:00,18,0,18
"40201",10901,"Marystown","NL",47.09899,-55.19852,2018-08-03 15:00:00,20,0,20
"40202",10901,"Marystown","NL",47.09899,-55.19852,2018-08-03 16:00:00,22,0,22
"40203",10901,"Marystown","NL",47.09899,-55.19852,2018-08-03 17:00:00,23,0,23
"40204",10901,"Marystown","NL",47.09899,-55.19852,2018-08-03 18:00:00,24,0,24
"40205",10901,"Marystown","NL",47.09899,-55.19852,2018-08-03 19:00:00,26,0,26
"40206",10901,"Marystown","NL",47.09899,-55.19852,2018-08-03 20:00:00,26,0,26
"40207",10901,"Marystown","NL",47.09899,-55.19852,2018-08-03 21:00:00,23,0,23
"40208",10901,"Marystown","NL",47.09899,-55.19852,2018-08-03 22:00:00,17,0,17
"40209",10901,"Marystown","NL",47.09899,-55.19852,2018-08-03 23:00:00,16,0,16
"40210",10901,"Marystown","NL",47.09899,-55.19852,2018-08-04 00:00:00,15,0,15
"40211",10901,"Marystown","NL",47.09899,-55.19852,2018-08-04 01:00:00,15,0,15
"40212",10901,"Marystown","NL",47.09899,-55.19852,2018-08-04 02:00:00,16,0,16
"40213",10901,"Marystown","NL",47.09899,-55.19852,2018-08-04 03:00:00,16,0,16
"40214",10901,"Marystown","NL",47.09899,-55.19852,2018-08-04 04:00:00,15,0,15
"40215",10901,"Marystown","NL",47.09899,-55.19852,2018-08-04 05:00:00,15,0,15
"40216",10901,"Marystown","NL",47.09899,-55.19852,2018-08-04 06:00:00,15,0,15
"40217",10901,"Marystown","NL",47.09899,-55.19852,2018-08-04 07:00:00,14,0,14
"40218",10901,"Marystown","NL",47.09899,-55.19852,2018-08-04 08:00:00,15,0,15
"40219",10901,"Marystown","NL",47.09899,-55.19852,2018-08-04 09:00:00,14,0,14
"40220",10901,"Marystown","NL",47.09899,-55.19852,2018-08-04 10:00:00,13,0,13
"40221",10901,"Marystown","NL",47.09899,-55.19852,2018-08-04 11:00:00,14,0,14
"40222",10901,"Marystown","NL",47.09899,-55.19852,2018-08-04 12:00:00,14,0,14
"40223",10901,"Marystown","NL",47.09899,-55.19852,2018-08-04 13:00:00,15,0,15
"40224",10901,"Marystown","NL",47.09899,-55.19852,2018-08-04 14:00:00,14,0,14
"40225",10901,"Marystown","NL",47.09899,-55.19852,2018-08-04 15:00:00,14,0,14
"40226",10901,"Marystown","NL",47.09899,-55.19852,2018-08-04 16:00:00,15,0,15
"40227",10901,"Marystown","NL",47.09899,-55.19852,2018-08-04 17:00:00,16,0,16
"40228",10901,"Marystown","NL",47.09899,-55.19852,2018-08-04 18:00:00,18,0,18
"40229",10901,"Marystown","NL",47.09899,-55.19852,2018-08-04 19:00:00,17,0,17
"40230",10901,"Marystown","NL",47.09899,-55.19852,2018-08-04 20:00:00,17,0,17
"40231",10901,"Marystown","NL",47.09899,-55.19852,2018-08-04 21:00:00,17,0,17
"40232",10901,"Marystown","NL",47.09899,-55.19852,2018-08-04 22:00:00,17,0,17
"40233",10901,"Marystown","NL",47.09899,-55.19852,2018-08-04 23:00:00,16,0,16
"40234",10901,"Marystown","NL",47.09899,-55.19852,2018-08-05 00:00:00,17,0,17
"40235",10901,"Marystown","NL",47.09899,-55.19852,2018-08-05 01:00:00,16,0,16
"40236",10901,"Marystown","NL",47.09899,-55.19852,2018-08-05 02:00:00,17,0,17
"40237",10901,"Marystown","NL",47.09899,-55.19852,2018-08-05 03:00:00,16,0,16
"40238",10901,"Marystown","NL",47.09899,-55.19852,2018-08-05 04:00:00,16,1,17
"40239",10901,"Marystown","NL",47.09899,-55.19852,2018-08-05 05:00:00,16,0,16
"40240",10901,"Marystown","NL",47.09899,-55.19852,2018-08-05 06:00:00,18,0,18
"40241",10901,"Marystown","NL",47.09899,-55.19852,2018-08-05 07:00:00,16,0,16
"40242",10901,"Marystown","NL",47.09899,-55.19852,2018-08-05 08:00:00,16,0,16
"40243",10901,"Marystown","NL",47.09899,-55.19852,2018-08-05 09:00:00,16,0,16
"40244",10901,"Marystown","NL",47.09899,-55.19852,2018-08-05 10:00:00,16,0,16
"40245",10901,"Marystown","NL",47.09899,-55.19852,2018-08-05 11:00:00,16,1,17
"40246",10901,"Marystown","NL",47.09899,-55.19852,2018-08-05 12:00:00,17,0,17
"40247",10901,"Marystown","NL",47.09899,-55.19852,2018-08-05 13:00:00,18,0,18
"40248",10901,"Marystown","NL",47.09899,-55.19852,2018-08-05 14:00:00,19,1,20
"40249",10901,"Marystown","NL",47.09899,-55.19852,2018-08-05 15:00:00,20,1,21
"40250",10901,"Marystown","NL",47.09899,-55.19852,2018-08-05 16:00:00,20,0,20
"40251",10901,"Marystown","NL",47.09899,-55.19852,2018-08-05 17:00:00,20,0,20
"40252",10901,"Marystown","NL",47.09899,-55.19852,2018-08-05 18:00:00,19,0,19
"40253",10901,"Marystown","NL",47.09899,-55.19852,2018-08-05 19:00:00,20,0,20
"40254",10901,"Marystown","NL",47.09899,-55.19852,2018-08-05 20:00:00,20,0,20
"40255",10901,"Marystown","NL",47.09899,-55.19852,2018-08-05 21:00:00,20,0,20
"40256",10901,"Marystown","NL",47.09899,-55.19852,2018-08-05 22:00:00,20,0,20
"40257",10901,"Marystown","NL",47.09899,-55.19852,2018-08-05 23:00:00,20,0,20
"40258",10901,"Marystown","NL",47.09899,-55.19852,2018-08-06 00:00:00,20,0,20
"40259",10901,"Marystown","NL",47.09899,-55.19852,2018-08-06 01:00:00,19,0,19
"40260",10901,"Marystown","NL",47.09899,-55.19852,2018-08-06 02:00:00,20,0,20
"40261",10901,"Marystown","NL",47.09899,-55.19852,2018-08-06 03:00:00,20,0,20
"40262",10901,"Marystown","NL",47.09899,-55.19852,2018-08-06 04:00:00,21,0,21
"40263",10901,"Marystown","NL",47.09899,-55.19852,2018-08-06 05:00:00,21,0,21
"40264",10901,"Marystown","NL",47.09899,-55.19852,2018-08-06 06:00:00,21,1,22
"40265",10901,"Marystown","NL",47.09899,-55.19852,2018-08-06 07:00:00,22,1,23
"40266",10901,"Marystown","NL",47.09899,-55.19852,2018-08-06 08:00:00,22,0,22
"40267",10901,"Marystown","NL",47.09899,-55.19852,2018-08-06 09:00:00,21,0,21
"40268",10901,"Marystown","NL",47.09899,-55.19852,2018-08-06 10:00:00,22,0,22
"40269",10901,"Marystown","NL",47.09899,-55.19852,2018-08-06 11:00:00,22,0,22
"40270",10901,"Marystown","NL",47.09899,-55.19852,2018-08-06 12:00:00,23,0,23
"40271",10901,"Marystown","NL",47.09899,-55.19852,2018-08-06 13:00:00,23,0,23
"40272",10901,"Marystown","NL",47.09899,-55.19852,2018-08-06 14:00:00,25,0,25
"40273",10901,"Marystown","NL",47.09899,-55.19852,2018-08-06 15:00:00,25,1,26
"40274",10901,"Marystown","NL",47.09899,-55.19852,2018-08-06 16:00:00,26,1,27
"40275",10901,"Marystown","NL",47.09899,-55.19852,2018-08-06 17:00:00,24,0,24
"40276",10901,"Marystown","NL",47.09899,-55.19852,2018-08-06 18:00:00,23,0,23
"40277",10901,"Marystown","NL",47.09899,-55.19852,2018-08-06 19:00:00,24,0,24
"40278",10901,"Marystown","NL",47.09899,-55.19852,2018-08-06 20:00:00,24,0,24
"40279",10901,"Marystown","NL",47.09899,-55.19852,2018-08-06 21:00:00,23,0,23
"40280",10901,"Marystown","NL",47.09899,-55.19852,2018-08-06 22:00:00,22,0,22
"40281",10901,"Marystown","NL",47.09899,-55.19852,2018-08-06 23:00:00,21,0,21
"40282",10901,"Marystown","NL",47.09899,-55.19852,2018-08-07 00:00:00,21,0,21
"40283",10901,"Marystown","NL",47.09899,-55.19852,2018-08-07 01:00:00,21,0,21
"40284",10901,"Marystown","NL",47.09899,-55.19852,2018-08-07 02:00:00,20,1,21
"40285",10901,"Marystown","NL",47.09899,-55.19852,2018-08-07 03:00:00,21,0,21
"40286",10901,"Marystown","NL",47.09899,-55.19852,2018-08-07 04:00:00,20,0,20
"40287",10901,"Marystown","NL",47.09899,-55.19852,2018-08-07 05:00:00,20,0,20
"40288",10901,"Marystown","NL",47.09899,-55.19852,2018-08-07 06:00:00,20,0,20
"40289",10901,"Marystown","NL",47.09899,-55.19852,2018-08-07 07:00:00,20,0,20
"40290",10901,"Marystown","NL",47.09899,-55.19852,2018-08-07 08:00:00,19,0,19
"40291",10901,"Marystown","NL",47.09899,-55.19852,2018-08-07 09:00:00,19,0,19
"40292",10901,"Marystown","NL",47.09899,-55.19852,2018-08-07 10:00:00,19,1,20
"40293",10901,"Marystown","NL",47.09899,-55.19852,2018-08-07 11:00:00,19,1,20
"40294",10901,"Marystown","NL",47.09899,-55.19852,2018-08-07 12:00:00,19,0,19
"40295",10901,"Marystown","NL",47.09899,-55.19852,2018-08-07 13:00:00,19,0,19
"40296",10901,"Marystown","NL",47.09899,-55.19852,2018-08-07 14:00:00,19,0,19
"40297",10901,"Marystown","NL",47.09899,-55.19852,2018-08-07 15:00:00,18,0,18
"40298",10901,"Marystown","NL",47.09899,-55.19852,2018-08-07 16:00:00,18,0,18
"40299",10901,"Marystown","NL",47.09899,-55.19852,2018-08-07 17:00:00,18,1,19
"40300",10901,"Marystown","NL",47.09899,-55.19852,2018-08-07 18:00:00,19,0,19
"40301",10901,"Marystown","NL",47.09899,-55.19852,2018-08-07 19:00:00,19,0,19
"40302",10901,"Marystown","NL",47.09899,-55.19852,2018-08-07 20:00:00,19,0,19
"40303",10901,"Marystown","NL",47.09899,-55.19852,2018-08-07 21:00:00,19,0,19
"40304",10901,"Marystown","NL",47.09899,-55.19852,2018-08-07 22:00:00,17,0,17
"40305",10901,"Marystown","NL",47.09899,-55.19852,2018-08-07 23:00:00,18,0,18
"40306",10901,"Marystown","NL",47.09899,-55.19852,2018-08-08 00:00:00,20,0,20
"40307",10901,"Marystown","NL",47.09899,-55.19852,2018-08-08 01:00:00,20,0,20
"40308",10901,"Marystown","NL",47.09899,-55.19852,2018-08-08 02:00:00,19,0,19
"40309",10901,"Marystown","NL",47.09899,-55.19852,2018-08-08 03:00:00,20,0,20
"40310",10901,"Marystown","NL",47.09899,-55.19852,2018-08-08 04:00:00,20,0,20
"40311",10901,"Marystown","NL",47.09899,-55.19852,2018-08-08 05:00:00,20,0,20
"40312",10901,"Marystown","NL",47.09899,-55.19852,2018-08-08 06:00:00,19,0,19
"40313",10901,"Marystown","NL",47.09899,-55.19852,2018-08-08 07:00:00,19,0,19
"40314",10901,"Marystown","NL",47.09899,-55.19852,2018-08-08 08:00:00,18,1,19
"40315",10901,"Marystown","NL",47.09899,-55.19852,2018-08-08 09:00:00,17,1,18
"40316",10901,"Marystown","NL",47.09899,-55.19852,2018-08-08 10:00:00,17,0,17
"40317",10901,"Marystown","NL",47.09899,-55.19852,2018-08-08 11:00:00,16,1,17
"40318",10901,"Marystown","NL",47.09899,-55.19852,2018-08-08 12:00:00,14,0,14
"40319",10901,"Marystown","NL",47.09899,-55.19852,2018-08-08 13:00:00,15,0,15
"40320",10901,"Marystown","NL",47.09899,-55.19852,2018-08-08 14:00:00,20,1,21
"40321",10901,"Marystown","NL",47.09899,-55.19852,2018-08-08 15:00:00,22,1,23
"40322",10901,"Marystown","NL",47.09899,-55.19852,2018-08-08 16:00:00,24,0,24
"40323",10901,"Marystown","NL",47.09899,-55.19852,2018-08-08 17:00:00,26,0,26
"40324",10901,"Marystown","NL",47.09899,-55.19852,2018-08-08 18:00:00,28,0,28
"40325",10901,"Marystown","NL",47.09899,-55.19852,2018-08-08 19:00:00,27,0,27
"40326",10901,"Marystown","NL",47.09899,-55.19852,2018-08-08 20:00:00,27,0,27
"40327",10901,"Marystown","NL",47.09899,-55.19852,2018-08-08 21:00:00,21,0,21
"40328",10901,"Marystown","NL",47.09899,-55.19852,2018-08-08 22:00:00,20,0,20
"40329",10901,"Marystown","NL",47.09899,-55.19852,2018-08-08 23:00:00,20,0,20
"40330",10901,"Marystown","NL",47.09899,-55.19852,2018-08-09 00:00:00,20,0,20
"40331",10901,"Marystown","NL",47.09899,-55.19852,2018-08-09 01:00:00,18,0,18
"40332",10901,"Marystown","NL",47.09899,-55.19852,2018-08-09 02:00:00,19,0,19
"40333",10901,"Marystown","NL",47.09899,-55.19852,2018-08-09 03:00:00,19,0,19
"40334",10901,"Marystown","NL",47.09899,-55.19852,2018-08-09 04:00:00,18,0,18
"40335",10901,"Marystown","NL",47.09899,-55.19852,2018-08-09 05:00:00,16,0,16
"40336",10901,"Marystown","NL",47.09899,-55.19852,2018-08-09 06:00:00,13,0,13
"40337",10901,"Marystown","NL",47.09899,-55.19852,2018-08-09 07:00:00,10,0,10
"40338",10901,"Marystown","NL",47.09899,-55.19852,2018-08-09 08:00:00,11,0,11
"40339",10901,"Marystown","NL",47.09899,-55.19852,2018-08-09 09:00:00,12,0,12
"40340",10901,"Marystown","NL",47.09899,-55.19852,2018-08-09 10:00:00,13,0,13
"40341",10901,"Marystown","NL",47.09899,-55.19852,2018-08-09 11:00:00,14,0,14
"40342",10901,"Marystown","NL",47.09899,-55.19852,2018-08-09 12:00:00,14,0,14
"40343",10901,"Marystown","NL",47.09899,-55.19852,2018-08-09 13:00:00,15,0,15
"40344",10901,"Marystown","NL",47.09899,-55.19852,2018-08-09 14:00:00,16,0,16
"40345",10901,"Marystown","NL",47.09899,-55.19852,2018-08-09 15:00:00,16,0,16
"40346",10901,"Marystown","NL",47.09899,-55.19852,2018-08-09 16:00:00,16,0,16
"40347",10901,"Marystown","NL",47.09899,-55.19852,2018-08-09 17:00:00,17,0,17
"40348",10901,"Marystown","NL",47.09899,-55.19852,2018-08-09 18:00:00,16,0,16
"40349",10901,"Marystown","NL",47.09899,-55.19852,2018-08-09 19:00:00,15,0,15
"40350",10901,"Marystown","NL",47.09899,-55.19852,2018-08-09 20:00:00,16,0,16
"40351",10901,"Marystown","NL",47.09899,-55.19852,2018-08-09 21:00:00,16,1,17
"40352",10901,"Marystown","NL",47.09899,-55.19852,2018-08-09 22:00:00,17,0,17
"40353",10901,"Marystown","NL",47.09899,-55.19852,2018-08-09 23:00:00,17,0,17
"40354",10901,"Marystown","NL",47.09899,-55.19852,2018-08-10 00:00:00,18,1,19
"40355",10901,"Marystown","NL",47.09899,-55.19852,2018-08-10 01:00:00,21,0,21
"40356",10901,"Marystown","NL",47.09899,-55.19852,2018-08-10 02:00:00,25,0,25
"40357",10901,"Marystown","NL",47.09899,-55.19852,2018-08-10 03:00:00,25,0,25
"40358",10901,"Marystown","NL",47.09899,-55.19852,2018-08-10 04:00:00,23,0,23
"40359",10901,"Marystown","NL",47.09899,-55.19852,2018-08-10 05:00:00,26,0,26
"40360",10901,"Marystown","NL",47.09899,-55.19852,2018-08-10 06:00:00,26,0,26
"40361",10901,"Marystown","NL",47.09899,-55.19852,2018-08-10 07:00:00,25,0,25
"40362",10901,"Marystown","NL",47.09899,-55.19852,2018-08-10 08:00:00,25,0,25
"40363",10901,"Marystown","NL",47.09899,-55.19852,2018-08-10 09:00:00,24,0,24
"40364",10901,"Marystown","NL",47.09899,-55.19852,2018-08-10 10:00:00,22,1,23
"40365",10901,"Marystown","NL",47.09899,-55.19852,2018-08-10 11:00:00,23,0,23
"40366",10901,"Marystown","NL",47.09899,-55.19852,2018-08-10 12:00:00,24,0,24
"40367",10901,"Marystown","NL",47.09899,-55.19852,2018-08-10 13:00:00,25,1,26
"40368",10901,"Marystown","NL",47.09899,-55.19852,2018-08-10 14:00:00,28,1,29
"40369",10901,"Marystown","NL",47.09899,-55.19852,2018-08-10 15:00:00,32,1,33
"40370",10901,"Marystown","NL",47.09899,-55.19852,2018-08-10 16:00:00,32,1,33
"40371",10901,"Marystown","NL",47.09899,-55.19852,2018-08-10 17:00:00,31,1,32
"40372",10901,"Marystown","NL",47.09899,-55.19852,2018-08-10 18:00:00,31,1,32
"40373",10901,"Marystown","NL",47.09899,-55.19852,2018-08-10 19:00:00,28,1,29
"40374",10901,"Marystown","NL",47.09899,-55.19852,2018-08-10 20:00:00,28,1,29
"40375",10901,"Marystown","NL",47.09899,-55.19852,2018-08-10 21:00:00,28,1,29
"40376",10901,"Marystown","NL",47.09899,-55.19852,2018-08-10 22:00:00,31,1,32
"40377",10901,"Marystown","NL",47.09899,-55.19852,2018-08-10 23:00:00,32,1,33
"40378",10901,"Marystown","NL",47.09899,-55.19852,2018-08-11 00:00:00,31,1,32
"40379",10901,"Marystown","NL",47.09899,-55.19852,2018-08-11 01:00:00,30,1,31
"40380",10901,"Marystown","NL",47.09899,-55.19852,2018-08-11 02:00:00,31,1,32
"40381",10901,"Marystown","NL",47.09899,-55.19852,2018-08-11 03:00:00,31,1,32
"40382",10901,"Marystown","NL",47.09899,-55.19852,2018-08-11 04:00:00,31,1,32
"40383",10901,"Marystown","NL",47.09899,-55.19852,2018-08-11 05:00:00,33,1,34
"40384",10901,"Marystown","NL",47.09899,-55.19852,2018-08-11 06:00:00,31,1,32
"40385",10901,"Marystown","NL",47.09899,-55.19852,2018-08-11 07:00:00,29,1,30
"40386",10901,"Marystown","NL",47.09899,-55.19852,2018-08-11 08:00:00,23,1,24
"40387",10901,"Marystown","NL",47.09899,-55.19852,2018-08-11 09:00:00,16,1,17
"40388",10901,"Marystown","NL",47.09899,-55.19852,2018-08-11 10:00:00,15,1,16
"40389",10901,"Marystown","NL",47.09899,-55.19852,2018-08-11 11:00:00,15,1,16
"40390",10901,"Marystown","NL",47.09899,-55.19852,2018-08-11 12:00:00,17,0,17
"40391",10901,"Marystown","NL",47.09899,-55.19852,2018-08-11 13:00:00,19,0,19
"40392",10901,"Marystown","NL",47.09899,-55.19852,2018-08-11 14:00:00,19,0,19
"40393",10901,"Marystown","NL",47.09899,-55.19852,2018-08-11 15:00:00,20,0,20
"40394",10901,"Marystown","NL",47.09899,-55.19852,2018-08-11 16:00:00,19,0,19
"40395",10901,"Marystown","NL",47.09899,-55.19852,2018-08-11 17:00:00,20,0,20
"40396",10901,"Marystown","NL",47.09899,-55.19852,2018-08-11 18:00:00,22,0,22
"40397",10901,"Marystown","NL",47.09899,-55.19852,2018-08-11 19:00:00,22,0,22
"40398",10901,"Marystown","NL",47.09899,-55.19852,2018-08-11 20:00:00,23,0,23
"40399",10901,"Marystown","NL",47.09899,-55.19852,2018-08-11 21:00:00,21,0,21
"40400",10901,"Marystown","NL",47.09899,-55.19852,2018-08-11 22:00:00,20,0,20
"40401",10901,"Marystown","NL",47.09899,-55.19852,2018-08-11 23:00:00,20,0,20
"40402",10901,"Marystown","NL",47.09899,-55.19852,2018-08-12 00:00:00,NA,1,NA
"40403",10901,"Marystown","NL",47.09899,-55.19852,2018-08-12 01:00:00,21,1,22
"40404",10901,"Marystown","NL",47.09899,-55.19852,2018-08-12 02:00:00,19,1,20
"40405",10901,"Marystown","NL",47.09899,-55.19852,2018-08-12 03:00:00,18,1,19
"40406",10901,"Marystown","NL",47.09899,-55.19852,2018-08-12 04:00:00,18,1,19
"40407",10901,"Marystown","NL",47.09899,-55.19852,2018-08-12 05:00:00,17,1,18
"40408",10901,"Marystown","NL",47.09899,-55.19852,2018-08-12 06:00:00,16,1,17
"40409",10901,"Marystown","NL",47.09899,-55.19852,2018-08-12 07:00:00,14,1,15
"40410",10901,"Marystown","NL",47.09899,-55.19852,2018-08-12 08:00:00,12,0,12
"40411",10901,"Marystown","NL",47.09899,-55.19852,2018-08-12 09:00:00,12,1,13
"40412",10901,"Marystown","NL",47.09899,-55.19852,2018-08-12 10:00:00,12,1,13
"40413",10901,"Marystown","NL",47.09899,-55.19852,2018-08-12 11:00:00,12,1,13
"40414",10901,"Marystown","NL",47.09899,-55.19852,2018-08-12 12:00:00,14,1,15
"40415",10901,"Marystown","NL",47.09899,-55.19852,2018-08-12 13:00:00,17,1,18
"40416",10901,"Marystown","NL",47.09899,-55.19852,2018-08-12 14:00:00,17,1,18
"40417",10901,"Marystown","NL",47.09899,-55.19852,2018-08-12 15:00:00,17,1,18
"40418",10901,"Marystown","NL",47.09899,-55.19852,2018-08-12 16:00:00,16,1,17
"40419",10901,"Marystown","NL",47.09899,-55.19852,2018-08-12 17:00:00,17,1,18
"40420",10901,"Marystown","NL",47.09899,-55.19852,2018-08-12 18:00:00,17,1,18
"40421",10901,"Marystown","NL",47.09899,-55.19852,2018-08-12 19:00:00,19,1,20
"40422",10901,"Marystown","NL",47.09899,-55.19852,2018-08-12 20:00:00,20,1,21
"40423",10901,"Marystown","NL",47.09899,-55.19852,2018-08-12 21:00:00,17,1,18
"40424",10901,"Marystown","NL",47.09899,-55.19852,2018-08-12 22:00:00,19,1,20
"40425",10901,"Marystown","NL",47.09899,-55.19852,2018-08-12 23:00:00,18,1,19
"40426",10901,"Marystown","NL",47.09899,-55.19852,2018-08-13 00:00:00,13,1,14
"40427",10901,"Marystown","NL",47.09899,-55.19852,2018-08-13 01:00:00,10,1,11
"40428",10901,"Marystown","NL",47.09899,-55.19852,2018-08-13 02:00:00,12,1,13
"40429",10901,"Marystown","NL",47.09899,-55.19852,2018-08-13 03:00:00,12,1,13
"40430",10901,"Marystown","NL",47.09899,-55.19852,2018-08-13 04:00:00,10,1,11
"40431",10901,"Marystown","NL",47.09899,-55.19852,2018-08-13 05:00:00,12,1,13
"40432",10901,"Marystown","NL",47.09899,-55.19852,2018-08-13 06:00:00,9,1,10
"40433",10901,"Marystown","NL",47.09899,-55.19852,2018-08-13 07:00:00,11,1,12
"40434",10901,"Marystown","NL",47.09899,-55.19852,2018-08-13 08:00:00,15,1,16
"40435",10901,"Marystown","NL",47.09899,-55.19852,2018-08-13 09:00:00,17,1,18
"40436",10901,"Marystown","NL",47.09899,-55.19852,2018-08-13 10:00:00,20,1,21
"40437",10901,"Marystown","NL",47.09899,-55.19852,2018-08-13 11:00:00,17,1,18
"40438",10901,"Marystown","NL",47.09899,-55.19852,2018-08-13 12:00:00,16,1,17
"40439",10901,"Marystown","NL",47.09899,-55.19852,2018-08-13 13:00:00,18,1,19
"40440",10901,"Marystown","NL",47.09899,-55.19852,2018-08-13 14:00:00,19,1,20
"40441",10901,"Marystown","NL",47.09899,-55.19852,2018-08-13 15:00:00,19,0,19
"40442",10901,"Marystown","NL",47.09899,-55.19852,2018-08-13 16:00:00,20,0,20
"40443",10901,"Marystown","NL",47.09899,-55.19852,2018-08-13 17:00:00,19,0,19
"40444",10901,"Marystown","NL",47.09899,-55.19852,2018-08-13 18:00:00,21,0,21
"40445",10901,"Marystown","NL",47.09899,-55.19852,2018-08-13 19:00:00,21,0,21
"40446",10901,"Marystown","NL",47.09899,-55.19852,2018-08-13 20:00:00,22,1,23
"40447",10901,"Marystown","NL",47.09899,-55.19852,2018-08-13 21:00:00,21,0,21
"40448",10901,"Marystown","NL",47.09899,-55.19852,2018-08-13 22:00:00,21,0,21
"40449",10901,"Marystown","NL",47.09899,-55.19852,2018-08-13 23:00:00,23,0,23
"40450",10901,"Marystown","NL",47.09899,-55.19852,2018-08-14 00:00:00,20,0,20
"40451",10901,"Marystown","NL",47.09899,-55.19852,2018-08-14 01:00:00,15,1,16
"40452",10901,"Marystown","NL",47.09899,-55.19852,2018-08-14 02:00:00,11,1,12
"40453",10901,"Marystown","NL",47.09899,-55.19852,2018-08-14 03:00:00,8,0,8
"40454",10901,"Marystown","NL",47.09899,-55.19852,2018-08-14 04:00:00,7,0,7
"40455",10901,"Marystown","NL",47.09899,-55.19852,2018-08-14 05:00:00,5,0,5
"40456",10901,"Marystown","NL",47.09899,-55.19852,2018-08-14 06:00:00,3,1,4
"40457",10901,"Marystown","NL",47.09899,-55.19852,2018-08-14 07:00:00,5,1,6
"40458",10901,"Marystown","NL",47.09899,-55.19852,2018-08-14 08:00:00,8,2,10
"40459",10901,"Marystown","NL",47.09899,-55.19852,2018-08-14 09:00:00,14,1,15
"40460",10901,"Marystown","NL",47.09899,-55.19852,2018-08-14 10:00:00,16,1,17
"40461",10901,"Marystown","NL",47.09899,-55.19852,2018-08-14 11:00:00,16,1,17
"40462",10901,"Marystown","NL",47.09899,-55.19852,2018-08-14 12:00:00,14,1,15
"40463",10901,"Marystown","NL",47.09899,-55.19852,2018-08-14 13:00:00,NA,1,NA
"40464",10901,"Marystown","NL",47.09899,-55.19852,2018-08-14 14:00:00,NA,1,NA
"40465",10901,"Marystown","NL",47.09899,-55.19852,2018-08-14 15:00:00,NA,1,NA
"40466",10901,"Marystown","NL",47.09899,-55.19852,2018-08-14 16:00:00,NA,1,NA
"40467",10901,"Marystown","NL",47.09899,-55.19852,2018-08-14 17:00:00,NA,1,NA
"40468",10901,"Marystown","NL",47.09899,-55.19852,2018-08-14 18:00:00,NA,1,NA
"40469",10901,"Marystown","NL",47.09899,-55.19852,2018-08-14 19:00:00,NA,1,NA
"40470",10901,"Marystown","NL",47.09899,-55.19852,2018-08-14 20:00:00,NA,1,NA
"40471",10901,"Marystown","NL",47.09899,-55.19852,2018-08-14 21:00:00,NA,1,NA
"40472",10901,"Marystown","NL",47.09899,-55.19852,2018-08-14 22:00:00,NA,1,NA
"40473",10901,"Marystown","NL",47.09899,-55.19852,2018-08-14 23:00:00,NA,1,NA
"40474",10901,"Marystown","NL",47.09899,-55.19852,2018-08-15 00:00:00,NA,1,NA
"40475",10901,"Marystown","NL",47.09899,-55.19852,2018-08-15 01:00:00,17,1,18
"40476",10901,"Marystown","NL",47.09899,-55.19852,2018-08-15 02:00:00,17,1,18
"40477",10901,"Marystown","NL",47.09899,-55.19852,2018-08-15 03:00:00,16,1,17
"40478",10901,"Marystown","NL",47.09899,-55.19852,2018-08-15 04:00:00,17,0,17
"40479",10901,"Marystown","NL",47.09899,-55.19852,2018-08-15 05:00:00,16,0,16
"40480",10901,"Marystown","NL",47.09899,-55.19852,2018-08-15 06:00:00,17,0,17
"40481",10901,"Marystown","NL",47.09899,-55.19852,2018-08-15 07:00:00,17,1,18
"40482",10901,"Marystown","NL",47.09899,-55.19852,2018-08-15 08:00:00,18,0,18
"40483",10901,"Marystown","NL",47.09899,-55.19852,2018-08-15 09:00:00,17,1,18
"40484",10901,"Marystown","NL",47.09899,-55.19852,2018-08-15 10:00:00,18,1,19
"40485",10901,"Marystown","NL",47.09899,-55.19852,2018-08-15 11:00:00,16,1,17
"40486",10901,"Marystown","NL",47.09899,-55.19852,2018-08-15 12:00:00,19,1,20
"40487",10901,"Marystown","NL",47.09899,-55.19852,2018-08-15 13:00:00,20,1,21
"40488",10901,"Marystown","NL",47.09899,-55.19852,2018-08-15 14:00:00,22,1,23
"40489",10901,"Marystown","NL",47.09899,-55.19852,2018-08-15 15:00:00,20,1,21
"40490",10901,"Marystown","NL",47.09899,-55.19852,2018-08-15 16:00:00,19,1,20
"40491",10901,"Marystown","NL",47.09899,-55.19852,2018-08-15 17:00:00,17,1,18
"40492",10901,"Marystown","NL",47.09899,-55.19852,2018-08-15 18:00:00,17,1,18
"40493",10901,"Marystown","NL",47.09899,-55.19852,2018-08-15 19:00:00,16,1,17
"40494",10901,"Marystown","NL",47.09899,-55.19852,2018-08-15 20:00:00,16,1,17
"40495",10901,"Marystown","NL",47.09899,-55.19852,2018-08-15 21:00:00,15,0,15
"40496",10901,"Marystown","NL",47.09899,-55.19852,2018-08-15 22:00:00,14,0,14
"40497",10901,"Marystown","NL",47.09899,-55.19852,2018-08-15 23:00:00,15,0,15
"40498",10901,"Marystown","NL",47.09899,-55.19852,2018-08-16 00:00:00,17,0,17
"40499",10901,"Marystown","NL",47.09899,-55.19852,2018-08-16 01:00:00,20,0,20
"40500",10901,"Marystown","NL",47.09899,-55.19852,2018-08-16 02:00:00,24,0,24
"40501",10901,"Marystown","NL",47.09899,-55.19852,2018-08-16 03:00:00,25,0,25
"40502",10901,"Marystown","NL",47.09899,-55.19852,2018-08-16 04:00:00,23,0,23
"40503",10901,"Marystown","NL",47.09899,-55.19852,2018-08-16 05:00:00,23,0,23
"40504",10901,"Marystown","NL",47.09899,-55.19852,2018-08-16 06:00:00,24,0,24
"40505",10901,"Marystown","NL",47.09899,-55.19852,2018-08-16 07:00:00,24,1,25
"40506",10901,"Marystown","NL",47.09899,-55.19852,2018-08-16 08:00:00,24,1,25
"40507",10901,"Marystown","NL",47.09899,-55.19852,2018-08-16 09:00:00,21,1,22
"40508",10901,"Marystown","NL",47.09899,-55.19852,2018-08-16 10:00:00,21,1,22
"40509",10901,"Marystown","NL",47.09899,-55.19852,2018-08-16 11:00:00,21,0,21
"40510",10901,"Marystown","NL",47.09899,-55.19852,2018-08-16 12:00:00,18,0,18
"40511",10901,"Marystown","NL",47.09899,-55.19852,2018-08-16 13:00:00,20,0,20
"40512",10901,"Marystown","NL",47.09899,-55.19852,2018-08-16 14:00:00,38,1,39
"40513",10901,"Marystown","NL",47.09899,-55.19852,2018-08-16 15:00:00,40,2,42
"40514",10901,"Marystown","NL",47.09899,-55.19852,2018-08-16 16:00:00,39,1,40
"40515",10901,"Marystown","NL",47.09899,-55.19852,2018-08-16 17:00:00,37,1,38
"40516",10901,"Marystown","NL",47.09899,-55.19852,2018-08-16 18:00:00,34,0,34
"40517",10901,"Marystown","NL",47.09899,-55.19852,2018-08-16 19:00:00,31,1,32
"40518",10901,"Marystown","NL",47.09899,-55.19852,2018-08-16 20:00:00,35,0,35
"40519",10901,"Marystown","NL",47.09899,-55.19852,2018-08-16 21:00:00,34,0,34
"40520",10901,"Marystown","NL",47.09899,-55.19852,2018-08-16 22:00:00,21,0,21
"40521",10901,"Marystown","NL",47.09899,-55.19852,2018-08-16 23:00:00,14,0,14
"40522",10901,"Marystown","NL",47.09899,-55.19852,2018-08-17 00:00:00,14,0,14
"40523",10901,"Marystown","NL",47.09899,-55.19852,2018-08-17 01:00:00,14,0,14
"40524",10901,"Marystown","NL",47.09899,-55.19852,2018-08-17 02:00:00,14,0,14
"40525",10901,"Marystown","NL",47.09899,-55.19852,2018-08-17 03:00:00,14,0,14
"40526",10901,"Marystown","NL",47.09899,-55.19852,2018-08-17 04:00:00,15,0,15
"40527",10901,"Marystown","NL",47.09899,-55.19852,2018-08-17 05:00:00,14,0,14
"40528",10901,"Marystown","NL",47.09899,-55.19852,2018-08-17 06:00:00,13,0,13
"40529",10901,"Marystown","NL",47.09899,-55.19852,2018-08-17 07:00:00,12,0,12
"40530",10901,"Marystown","NL",47.09899,-55.19852,2018-08-17 08:00:00,13,0,13
"40531",10901,"Marystown","NL",47.09899,-55.19852,2018-08-17 09:00:00,13,0,13
"40532",10901,"Marystown","NL",47.09899,-55.19852,2018-08-17 10:00:00,13,0,13
"40533",10901,"Marystown","NL",47.09899,-55.19852,2018-08-17 11:00:00,12,0,12
"40534",10901,"Marystown","NL",47.09899,-55.19852,2018-08-17 12:00:00,16,0,16
"40535",10901,"Marystown","NL",47.09899,-55.19852,2018-08-17 13:00:00,18,0,18
"40536",10901,"Marystown","NL",47.09899,-55.19852,2018-08-17 14:00:00,18,0,18
"40537",10901,"Marystown","NL",47.09899,-55.19852,2018-08-17 15:00:00,18,0,18
"40538",10901,"Marystown","NL",47.09899,-55.19852,2018-08-17 16:00:00,17,1,18
"40539",10901,"Marystown","NL",47.09899,-55.19852,2018-08-17 17:00:00,17,0,17
"40540",10901,"Marystown","NL",47.09899,-55.19852,2018-08-17 18:00:00,18,0,18
"40541",10901,"Marystown","NL",47.09899,-55.19852,2018-08-17 19:00:00,17,0,17
"40542",10901,"Marystown","NL",47.09899,-55.19852,2018-08-17 20:00:00,16,0,16
"40543",10901,"Marystown","NL",47.09899,-55.19852,2018-08-17 21:00:00,16,0,16
"40544",10901,"Marystown","NL",47.09899,-55.19852,2018-08-17 22:00:00,16,0,16
"40545",10901,"Marystown","NL",47.09899,-55.19852,2018-08-17 23:00:00,22,0,22
"40546",10901,"Marystown","NL",47.09899,-55.19852,2018-08-18 00:00:00,NA,0,NA
"40547",10901,"Marystown","NL",47.09899,-55.19852,2018-08-18 01:00:00,15,0,15
"40548",10901,"Marystown","NL",47.09899,-55.19852,2018-08-18 02:00:00,14,0,14
"40549",10901,"Marystown","NL",47.09899,-55.19852,2018-08-18 03:00:00,14,0,14
"40550",10901,"Marystown","NL",47.09899,-55.19852,2018-08-18 04:00:00,17,0,17
"40551",10901,"Marystown","NL",47.09899,-55.19852,2018-08-18 05:00:00,16,0,16
"40552",10901,"Marystown","NL",47.09899,-55.19852,2018-08-18 06:00:00,15,0,15
"40553",10901,"Marystown","NL",47.09899,-55.19852,2018-08-18 07:00:00,16,0,16
"40554",10901,"Marystown","NL",47.09899,-55.19852,2018-08-18 08:00:00,16,0,16
"40555",10901,"Marystown","NL",47.09899,-55.19852,2018-08-18 09:00:00,17,0,17
"40556",10901,"Marystown","NL",47.09899,-55.19852,2018-08-18 10:00:00,18,0,18
"40557",10901,"Marystown","NL",47.09899,-55.19852,2018-08-18 11:00:00,16,0,16
"40558",10901,"Marystown","NL",47.09899,-55.19852,2018-08-18 12:00:00,16,0,16
"40559",10901,"Marystown","NL",47.09899,-55.19852,2018-08-18 13:00:00,17,0,17
"40560",10901,"Marystown","NL",47.09899,-55.19852,2018-08-18 14:00:00,18,0,18
"40561",10901,"Marystown","NL",47.09899,-55.19852,2018-08-18 15:00:00,18,0,18
"40562",10901,"Marystown","NL",47.09899,-55.19852,2018-08-18 16:00:00,18,0,18
"40563",10901,"Marystown","NL",47.09899,-55.19852,2018-08-18 17:00:00,17,1,18
"40564",10901,"Marystown","NL",47.09899,-55.19852,2018-08-18 18:00:00,17,0,17
"40565",10901,"Marystown","NL",47.09899,-55.19852,2018-08-18 19:00:00,14,0,14
"40566",10901,"Marystown","NL",47.09899,-55.19852,2018-08-18 20:00:00,6,0,6
"40567",10901,"Marystown","NL",47.09899,-55.19852,2018-08-18 21:00:00,4,0,4
"40568",10901,"Marystown","NL",47.09899,-55.19852,2018-08-18 22:00:00,5,0,5
"40569",10901,"Marystown","NL",47.09899,-55.19852,2018-08-18 23:00:00,7,0,7
"40570",10901,"Marystown","NL",47.09899,-55.19852,2018-08-19 00:00:00,7,0,7
"40571",10901,"Marystown","NL",47.09899,-55.19852,2018-08-19 01:00:00,5,0,5
"40572",10901,"Marystown","NL",47.09899,-55.19852,2018-08-19 02:00:00,11,0,11
"40573",10901,"Marystown","NL",47.09899,-55.19852,2018-08-19 03:00:00,16,0,16
"40574",10901,"Marystown","NL",47.09899,-55.19852,2018-08-19 04:00:00,18,0,18
"40575",10901,"Marystown","NL",47.09899,-55.19852,2018-08-19 05:00:00,21,0,21
"40576",10901,"Marystown","NL",47.09899,-55.19852,2018-08-19 06:00:00,20,0,20
"40577",10901,"Marystown","NL",47.09899,-55.19852,2018-08-19 07:00:00,20,0,20
"40578",10901,"Marystown","NL",47.09899,-55.19852,2018-08-19 08:00:00,25,0,25
"40579",10901,"Marystown","NL",47.09899,-55.19852,2018-08-19 09:00:00,19,0,19
"40580",10901,"Marystown","NL",47.09899,-55.19852,2018-08-19 10:00:00,20,0,20
"40581",10901,"Marystown","NL",47.09899,-55.19852,2018-08-19 11:00:00,15,0,15
"40582",10901,"Marystown","NL",47.09899,-55.19852,2018-08-19 12:00:00,16,0,16
"40583",10901,"Marystown","NL",47.09899,-55.19852,2018-08-19 13:00:00,19,0,19
"40584",10901,"Marystown","NL",47.09899,-55.19852,2018-08-19 14:00:00,19,0,19
"40585",10901,"Marystown","NL",47.09899,-55.19852,2018-08-19 15:00:00,19,0,19
"40586",10901,"Marystown","NL",47.09899,-55.19852,2018-08-19 16:00:00,19,0,19
"40587",10901,"Marystown","NL",47.09899,-55.19852,2018-08-19 17:00:00,23,0,23
"40588",10901,"Marystown","NL",47.09899,-55.19852,2018-08-19 18:00:00,29,0,29
"40589",10901,"Marystown","NL",47.09899,-55.19852,2018-08-19 19:00:00,32,0,32
"40590",10901,"Marystown","NL",47.09899,-55.19852,2018-08-19 20:00:00,25,0,25
"40591",10901,"Marystown","NL",47.09899,-55.19852,2018-08-19 21:00:00,11,1,12
"40592",10901,"Marystown","NL",47.09899,-55.19852,2018-08-19 22:00:00,8,0,8
"40593",10901,"Marystown","NL",47.09899,-55.19852,2018-08-19 23:00:00,6,1,7
"40594",10901,"Marystown","NL",47.09899,-55.19852,2018-08-20 00:00:00,6,1,7
"40595",10901,"Marystown","NL",47.09899,-55.19852,2018-08-20 01:00:00,5,0,5
"40596",10901,"Marystown","NL",47.09899,-55.19852,2018-08-20 02:00:00,5,0,5
"40597",10901,"Marystown","NL",47.09899,-55.19852,2018-08-20 03:00:00,5,0,5
"40598",10901,"Marystown","NL",47.09899,-55.19852,2018-08-20 04:00:00,4,0,4
"40599",10901,"Marystown","NL",47.09899,-55.19852,2018-08-20 05:00:00,4,0,4
"40600",10901,"Marystown","NL",47.09899,-55.19852,2018-08-20 06:00:00,10,0,10
"40601",10901,"Marystown","NL",47.09899,-55.19852,2018-08-20 07:00:00,12,0,12
"40602",10901,"Marystown","NL",47.09899,-55.19852,2018-08-20 08:00:00,13,0,13
"40603",10901,"Marystown","NL",47.09899,-55.19852,2018-08-20 09:00:00,15,0,15
"40604",10901,"Marystown","NL",47.09899,-55.19852,2018-08-20 10:00:00,15,0,15
"40605",10901,"Marystown","NL",47.09899,-55.19852,2018-08-20 11:00:00,13,1,14
"40606",10901,"Marystown","NL",47.09899,-55.19852,2018-08-20 12:00:00,13,0,13
"40607",10901,"Marystown","NL",47.09899,-55.19852,2018-08-20 13:00:00,16,0,16
"40608",10901,"Marystown","NL",47.09899,-55.19852,2018-08-20 14:00:00,15,0,15
"40609",10901,"Marystown","NL",47.09899,-55.19852,2018-08-20 15:00:00,15,0,15
"40610",10901,"Marystown","NL",47.09899,-55.19852,2018-08-20 16:00:00,18,0,18
"40611",10901,"Marystown","NL",47.09899,-55.19852,2018-08-20 17:00:00,17,0,17
"40612",10901,"Marystown","NL",47.09899,-55.19852,2018-08-20 18:00:00,17,0,17
"40613",10901,"Marystown","NL",47.09899,-55.19852,2018-08-20 19:00:00,18,0,18
"40614",10901,"Marystown","NL",47.09899,-55.19852,2018-08-20 20:00:00,19,0,19
"40615",10901,"Marystown","NL",47.09899,-55.19852,2018-08-20 21:00:00,20,0,20
"40616",10901,"Marystown","NL",47.09899,-55.19852,2018-08-20 22:00:00,19,0,19
"40617",10901,"Marystown","NL",47.09899,-55.19852,2018-08-20 23:00:00,21,0,21
"40618",10901,"Marystown","NL",47.09899,-55.19852,2018-08-21 00:00:00,NA,0,NA
"40619",10901,"Marystown","NL",47.09899,-55.19852,2018-08-21 01:00:00,19,0,19
"40620",10901,"Marystown","NL",47.09899,-55.19852,2018-08-21 02:00:00,20,0,20
"40621",10901,"Marystown","NL",47.09899,-55.19852,2018-08-21 03:00:00,20,0,20
"40622",10901,"Marystown","NL",47.09899,-55.19852,2018-08-21 04:00:00,20,0,20
"40623",10901,"Marystown","NL",47.09899,-55.19852,2018-08-21 05:00:00,19,0,19
"40624",10901,"Marystown","NL",47.09899,-55.19852,2018-08-21 06:00:00,19,0,19
"40625",10901,"Marystown","NL",47.09899,-55.19852,2018-08-21 07:00:00,21,0,21
"40626",10901,"Marystown","NL",47.09899,-55.19852,2018-08-21 08:00:00,21,0,21
"40627",10901,"Marystown","NL",47.09899,-55.19852,2018-08-21 09:00:00,21,0,21
"40628",10901,"Marystown","NL",47.09899,-55.19852,2018-08-21 10:00:00,21,0,21
"40629",10901,"Marystown","NL",47.09899,-55.19852,2018-08-21 11:00:00,18,0,18
"40630",10901,"Marystown","NL",47.09899,-55.19852,2018-08-21 12:00:00,20,0,20
"40631",10901,"Marystown","NL",47.09899,-55.19852,2018-08-21 13:00:00,22,0,22
"40632",10901,"Marystown","NL",47.09899,-55.19852,2018-08-21 14:00:00,20,0,20
"40633",10901,"Marystown","NL",47.09899,-55.19852,2018-08-21 15:00:00,21,0,21
"40634",10901,"Marystown","NL",47.09899,-55.19852,2018-08-21 16:00:00,22,0,22
"40635",10901,"Marystown","NL",47.09899,-55.19852,2018-08-21 17:00:00,23,0,23
"40636",10901,"Marystown","NL",47.09899,-55.19852,2018-08-21 18:00:00,23,0,23
"40637",10901,"Marystown","NL",47.09899,-55.19852,2018-08-21 19:00:00,23,0,23
"40638",10901,"Marystown","NL",47.09899,-55.19852,2018-08-21 20:00:00,23,0,23
"40639",10901,"Marystown","NL",47.09899,-55.19852,2018-08-21 21:00:00,23,0,23
"40640",10901,"Marystown","NL",47.09899,-55.19852,2018-08-21 22:00:00,22,0,22
"40641",10901,"Marystown","NL",47.09899,-55.19852,2018-08-21 23:00:00,22,0,22
"40642",10901,"Marystown","NL",47.09899,-55.19852,2018-08-22 00:00:00,22,0,22
"40643",10901,"Marystown","NL",47.09899,-55.19852,2018-08-22 01:00:00,22,0,22
"40644",10901,"Marystown","NL",47.09899,-55.19852,2018-08-22 02:00:00,24,0,24
"40645",10901,"Marystown","NL",47.09899,-55.19852,2018-08-22 03:00:00,25,0,25
"40646",10901,"Marystown","NL",47.09899,-55.19852,2018-08-22 04:00:00,26,0,26
"40647",10901,"Marystown","NL",47.09899,-55.19852,2018-08-22 05:00:00,26,0,26
"40648",10901,"Marystown","NL",47.09899,-55.19852,2018-08-22 06:00:00,24,0,24
"40649",10901,"Marystown","NL",47.09899,-55.19852,2018-08-22 07:00:00,22,0,22
"40650",10901,"Marystown","NL",47.09899,-55.19852,2018-08-22 08:00:00,22,0,22
"40651",10901,"Marystown","NL",47.09899,-55.19852,2018-08-22 09:00:00,23,0,23
"40652",10901,"Marystown","NL",47.09899,-55.19852,2018-08-22 10:00:00,26,0,26
"40653",10901,"Marystown","NL",47.09899,-55.19852,2018-08-22 11:00:00,24,0,24
"40654",10901,"Marystown","NL",47.09899,-55.19852,2018-08-22 12:00:00,21,1,22
"40655",10901,"Marystown","NL",47.09899,-55.19852,2018-08-22 13:00:00,23,1,24
"40656",10901,"Marystown","NL",47.09899,-55.19852,2018-08-22 14:00:00,22,0,22
"40657",10901,"Marystown","NL",47.09899,-55.19852,2018-08-22 15:00:00,22,0,22
"40658",10901,"Marystown","NL",47.09899,-55.19852,2018-08-22 16:00:00,21,1,22
"40659",10901,"Marystown","NL",47.09899,-55.19852,2018-08-22 17:00:00,20,1,21
"40660",10901,"Marystown","NL",47.09899,-55.19852,2018-08-22 18:00:00,22,0,22
"40661",10901,"Marystown","NL",47.09899,-55.19852,2018-08-22 19:00:00,20,0,20
"40662",10901,"Marystown","NL",47.09899,-55.19852,2018-08-22 20:00:00,21,0,21
"40663",10901,"Marystown","NL",47.09899,-55.19852,2018-08-22 21:00:00,20,0,20
"40664",10901,"Marystown","NL",47.09899,-55.19852,2018-08-22 22:00:00,23,0,23
"40665",10901,"Marystown","NL",47.09899,-55.19852,2018-08-22 23:00:00,23,0,23
"40666",10901,"Marystown","NL",47.09899,-55.19852,2018-08-23 00:00:00,22,0,22
"40667",10901,"Marystown","NL",47.09899,-55.19852,2018-08-23 01:00:00,20,0,20
"40668",10901,"Marystown","NL",47.09899,-55.19852,2018-08-23 02:00:00,20,0,20
"40669",10901,"Marystown","NL",47.09899,-55.19852,2018-08-23 03:00:00,21,0,21
"40670",10901,"Marystown","NL",47.09899,-55.19852,2018-08-23 04:00:00,23,0,23
"40671",10901,"Marystown","NL",47.09899,-55.19852,2018-08-23 05:00:00,26,0,26
"40672",10901,"Marystown","NL",47.09899,-55.19852,2018-08-23 06:00:00,25,0,25
"40673",10901,"Marystown","NL",47.09899,-55.19852,2018-08-23 07:00:00,22,1,23
"40674",10901,"Marystown","NL",47.09899,-55.19852,2018-08-23 08:00:00,22,0,22
"40675",10901,"Marystown","NL",47.09899,-55.19852,2018-08-23 09:00:00,21,0,21
"40676",10901,"Marystown","NL",47.09899,-55.19852,2018-08-23 10:00:00,20,0,20
"40677",10901,"Marystown","NL",47.09899,-55.19852,2018-08-23 11:00:00,19,0,19
"40678",10901,"Marystown","NL",47.09899,-55.19852,2018-08-23 12:00:00,17,0,17
"40679",10901,"Marystown","NL",47.09899,-55.19852,2018-08-23 13:00:00,19,0,19
"40680",10901,"Marystown","NL",47.09899,-55.19852,2018-08-23 14:00:00,22,0,22
"40681",10901,"Marystown","NL",47.09899,-55.19852,2018-08-23 15:00:00,23,0,23
"40682",10901,"Marystown","NL",47.09899,-55.19852,2018-08-23 16:00:00,24,0,24
"40683",10901,"Marystown","NL",47.09899,-55.19852,2018-08-23 17:00:00,24,0,24
"40684",10901,"Marystown","NL",47.09899,-55.19852,2018-08-23 18:00:00,25,0,25
"40685",10901,"Marystown","NL",47.09899,-55.19852,2018-08-23 19:00:00,27,0,27
"40686",10901,"Marystown","NL",47.09899,-55.19852,2018-08-23 20:00:00,30,0,30
"40687",10901,"Marystown","NL",47.09899,-55.19852,2018-08-23 21:00:00,34,0,34
"40688",10901,"Marystown","NL",47.09899,-55.19852,2018-08-23 22:00:00,35,0,35
"40689",10901,"Marystown","NL",47.09899,-55.19852,2018-08-23 23:00:00,36,0,36
"40690",10901,"Marystown","NL",47.09899,-55.19852,2018-08-24 00:00:00,35,0,35
"40691",10901,"Marystown","NL",47.09899,-55.19852,2018-08-24 01:00:00,34,0,34
"40692",10901,"Marystown","NL",47.09899,-55.19852,2018-08-24 02:00:00,33,0,33
"40693",10901,"Marystown","NL",47.09899,-55.19852,2018-08-24 03:00:00,31,0,31
"40694",10901,"Marystown","NL",47.09899,-55.19852,2018-08-24 04:00:00,27,0,27
"40695",10901,"Marystown","NL",47.09899,-55.19852,2018-08-24 05:00:00,23,0,23
"40696",10901,"Marystown","NL",47.09899,-55.19852,2018-08-24 06:00:00,25,0,25
"40697",10901,"Marystown","NL",47.09899,-55.19852,2018-08-24 07:00:00,25,0,25
"40698",10901,"Marystown","NL",47.09899,-55.19852,2018-08-24 08:00:00,23,0,23
"40699",10901,"Marystown","NL",47.09899,-55.19852,2018-08-24 09:00:00,23,0,23
"40700",10901,"Marystown","NL",47.09899,-55.19852,2018-08-24 10:00:00,20,0,20
"40701",10901,"Marystown","NL",47.09899,-55.19852,2018-08-24 11:00:00,21,0,21
"40702",10901,"Marystown","NL",47.09899,-55.19852,2018-08-24 12:00:00,20,0,20
"40703",10901,"Marystown","NL",47.09899,-55.19852,2018-08-24 13:00:00,21,0,21
"40704",10901,"Marystown","NL",47.09899,-55.19852,2018-08-24 14:00:00,20,0,20
"40705",10901,"Marystown","NL",47.09899,-55.19852,2018-08-24 15:00:00,21,0,21
"40706",10901,"Marystown","NL",47.09899,-55.19852,2018-08-24 16:00:00,22,0,22
"40707",10901,"Marystown","NL",47.09899,-55.19852,2018-08-24 17:00:00,22,0,22
"40708",10901,"Marystown","NL",47.09899,-55.19852,2018-08-24 18:00:00,21,0,21
"40709",10901,"Marystown","NL",47.09899,-55.19852,2018-08-24 19:00:00,22,0,22
"40710",10901,"Marystown","NL",47.09899,-55.19852,2018-08-24 20:00:00,22,0,22
"40711",10901,"Marystown","NL",47.09899,-55.19852,2018-08-24 21:00:00,22,0,22
"40712",10901,"Marystown","NL",47.09899,-55.19852,2018-08-24 22:00:00,19,0,19
"40713",10901,"Marystown","NL",47.09899,-55.19852,2018-08-24 23:00:00,13,0,13
"40714",10901,"Marystown","NL",47.09899,-55.19852,2018-08-25 00:00:00,8,0,8
"40715",10901,"Marystown","NL",47.09899,-55.19852,2018-08-25 01:00:00,7,0,7
"40716",10901,"Marystown","NL",47.09899,-55.19852,2018-08-25 02:00:00,7,0,7
"40717",10901,"Marystown","NL",47.09899,-55.19852,2018-08-25 03:00:00,6,0,6
"40718",10901,"Marystown","NL",47.09899,-55.19852,2018-08-25 04:00:00,5,0,5
"40719",10901,"Marystown","NL",47.09899,-55.19852,2018-08-25 05:00:00,5,0,5
"40720",10901,"Marystown","NL",47.09899,-55.19852,2018-08-25 06:00:00,4,0,4
"40721",10901,"Marystown","NL",47.09899,-55.19852,2018-08-25 07:00:00,3,0,3
"40722",10901,"Marystown","NL",47.09899,-55.19852,2018-08-25 08:00:00,4,1,5
"40723",10901,"Marystown","NL",47.09899,-55.19852,2018-08-25 09:00:00,13,0,13
"40724",10901,"Marystown","NL",47.09899,-55.19852,2018-08-25 10:00:00,17,0,17
"40725",10901,"Marystown","NL",47.09899,-55.19852,2018-08-25 11:00:00,19,0,19
"40726",10901,"Marystown","NL",47.09899,-55.19852,2018-08-25 12:00:00,20,0,20
"40727",10901,"Marystown","NL",47.09899,-55.19852,2018-08-25 13:00:00,20,0,20
"40728",10901,"Marystown","NL",47.09899,-55.19852,2018-08-25 14:00:00,22,0,22
"40729",10901,"Marystown","NL",47.09899,-55.19852,2018-08-25 15:00:00,24,0,24
"40730",10901,"Marystown","NL",47.09899,-55.19852,2018-08-25 16:00:00,24,0,24
"40731",10901,"Marystown","NL",47.09899,-55.19852,2018-08-25 17:00:00,23,0,23
"40732",10901,"Marystown","NL",47.09899,-55.19852,2018-08-25 18:00:00,22,0,22
"40733",10901,"Marystown","NL",47.09899,-55.19852,2018-08-25 19:00:00,21,0,21
"40734",10901,"Marystown","NL",47.09899,-55.19852,2018-08-25 20:00:00,22,0,22
"40735",10901,"Marystown","NL",47.09899,-55.19852,2018-08-25 21:00:00,21,1,22
"40736",10901,"Marystown","NL",47.09899,-55.19852,2018-08-25 22:00:00,24,0,24
"40737",10901,"Marystown","NL",47.09899,-55.19852,2018-08-25 23:00:00,24,0,24
"40738",10901,"Marystown","NL",47.09899,-55.19852,2018-08-26 00:00:00,21,0,21
"40739",10901,"Marystown","NL",47.09899,-55.19852,2018-08-26 01:00:00,14,0,14
"40740",10901,"Marystown","NL",47.09899,-55.19852,2018-08-26 02:00:00,13,0,13
"40741",10901,"Marystown","NL",47.09899,-55.19852,2018-08-26 03:00:00,9,0,9
"40742",10901,"Marystown","NL",47.09899,-55.19852,2018-08-26 04:00:00,7,0,7
"40743",10901,"Marystown","NL",47.09899,-55.19852,2018-08-26 05:00:00,6,0,6
"40744",10901,"Marystown","NL",47.09899,-55.19852,2018-08-26 06:00:00,6,0,6
"40745",10901,"Marystown","NL",47.09899,-55.19852,2018-08-26 07:00:00,9,0,9
"40746",10901,"Marystown","NL",47.09899,-55.19852,2018-08-26 08:00:00,15,0,15
"40747",10901,"Marystown","NL",47.09899,-55.19852,2018-08-26 09:00:00,17,0,17
"40748",10901,"Marystown","NL",47.09899,-55.19852,2018-08-26 10:00:00,18,0,18
"40749",10901,"Marystown","NL",47.09899,-55.19852,2018-08-26 11:00:00,22,0,22
"40750",10901,"Marystown","NL",47.09899,-55.19852,2018-08-26 12:00:00,24,0,24
"40751",10901,"Marystown","NL",47.09899,-55.19852,2018-08-26 13:00:00,25,0,25
"40752",10901,"Marystown","NL",47.09899,-55.19852,2018-08-26 14:00:00,25,0,25
"40753",10901,"Marystown","NL",47.09899,-55.19852,2018-08-26 15:00:00,26,0,26
"40754",10901,"Marystown","NL",47.09899,-55.19852,2018-08-26 16:00:00,26,0,26
"40755",10901,"Marystown","NL",47.09899,-55.19852,2018-08-26 17:00:00,26,0,26
"40756",10901,"Marystown","NL",47.09899,-55.19852,2018-08-26 18:00:00,25,0,25
"40757",10901,"Marystown","NL",47.09899,-55.19852,2018-08-26 19:00:00,22,0,22
"40758",10901,"Marystown","NL",47.09899,-55.19852,2018-08-26 20:00:00,23,0,23
"40759",10901,"Marystown","NL",47.09899,-55.19852,2018-08-26 21:00:00,23,0,23
"40760",10901,"Marystown","NL",47.09899,-55.19852,2018-08-26 22:00:00,21,0,21
"40761",10901,"Marystown","NL",47.09899,-55.19852,2018-08-26 23:00:00,21,0,21
"40762",10901,"Marystown","NL",47.09899,-55.19852,2018-08-27 00:00:00,19,0,19
"40763",10901,"Marystown","NL",47.09899,-55.19852,2018-08-27 01:00:00,17,0,17
"40764",10901,"Marystown","NL",47.09899,-55.19852,2018-08-27 02:00:00,14,0,14
"40765",10901,"Marystown","NL",47.09899,-55.19852,2018-08-27 03:00:00,13,0,13
"40766",10901,"Marystown","NL",47.09899,-55.19852,2018-08-27 04:00:00,11,0,11
"40767",10901,"Marystown","NL",47.09899,-55.19852,2018-08-27 05:00:00,11,0,11
"40768",10901,"Marystown","NL",47.09899,-55.19852,2018-08-27 06:00:00,12,0,12
"40769",10901,"Marystown","NL",47.09899,-55.19852,2018-08-27 07:00:00,17,1,18
"40770",10901,"Marystown","NL",47.09899,-55.19852,2018-08-27 08:00:00,22,1,23
"40771",10901,"Marystown","NL",47.09899,-55.19852,2018-08-27 09:00:00,22,0,22
"40772",10901,"Marystown","NL",47.09899,-55.19852,2018-08-27 10:00:00,23,1,24
"40773",10901,"Marystown","NL",47.09899,-55.19852,2018-08-27 11:00:00,24,1,25
"40774",10901,"Marystown","NL",47.09899,-55.19852,2018-08-27 12:00:00,26,0,26
"40775",10901,"Marystown","NL",47.09899,-55.19852,2018-08-27 13:00:00,25,0,25
"40776",10901,"Marystown","NL",47.09899,-55.19852,2018-08-27 14:00:00,25,0,25
"40777",10901,"Marystown","NL",47.09899,-55.19852,2018-08-27 15:00:00,25,0,25
"40778",10901,"Marystown","NL",47.09899,-55.19852,2018-08-27 16:00:00,26,0,26
"40779",10901,"Marystown","NL",47.09899,-55.19852,2018-08-27 17:00:00,26,0,26
"40780",10901,"Marystown","NL",47.09899,-55.19852,2018-08-27 18:00:00,25,1,26
"40781",10901,"Marystown","NL",47.09899,-55.19852,2018-08-27 19:00:00,24,1,25
"40782",10901,"Marystown","NL",47.09899,-55.19852,2018-08-27 20:00:00,20,0,20
"40783",10901,"Marystown","NL",47.09899,-55.19852,2018-08-27 21:00:00,20,0,20
"40784",10901,"Marystown","NL",47.09899,-55.19852,2018-08-27 22:00:00,20,0,20
"40785",10901,"Marystown","NL",47.09899,-55.19852,2018-08-27 23:00:00,20,0,20
"40786",10901,"Marystown","NL",47.09899,-55.19852,2018-08-28 00:00:00,17,0,17
"40787",10901,"Marystown","NL",47.09899,-55.19852,2018-08-28 01:00:00,15,0,15
"40788",10901,"Marystown","NL",47.09899,-55.19852,2018-08-28 02:00:00,15,0,15
"40789",10901,"Marystown","NL",47.09899,-55.19852,2018-08-28 03:00:00,19,0,19
"40790",10901,"Marystown","NL",47.09899,-55.19852,2018-08-28 04:00:00,22,0,22
"40791",10901,"Marystown","NL",47.09899,-55.19852,2018-08-28 05:00:00,18,0,18
"40792",10901,"Marystown","NL",47.09899,-55.19852,2018-08-28 06:00:00,12,1,13
"40793",10901,"Marystown","NL",47.09899,-55.19852,2018-08-28 07:00:00,13,0,13
"40794",10901,"Marystown","NL",47.09899,-55.19852,2018-08-28 08:00:00,21,0,21
"40795",10901,"Marystown","NL",47.09899,-55.19852,2018-08-28 09:00:00,25,0,25
"40796",10901,"Marystown","NL",47.09899,-55.19852,2018-08-28 10:00:00,26,0,26
"40797",10901,"Marystown","NL",47.09899,-55.19852,2018-08-28 11:00:00,27,0,27
"40798",10901,"Marystown","NL",47.09899,-55.19852,2018-08-28 12:00:00,28,0,28
"40799",10901,"Marystown","NL",47.09899,-55.19852,2018-08-28 13:00:00,28,0,28
"40800",10901,"Marystown","NL",47.09899,-55.19852,2018-08-28 14:00:00,27,0,27
"40801",10901,"Marystown","NL",47.09899,-55.19852,2018-08-28 15:00:00,26,0,26
"40802",10901,"Marystown","NL",47.09899,-55.19852,2018-08-28 16:00:00,27,0,27
"40803",10901,"Marystown","NL",47.09899,-55.19852,2018-08-28 17:00:00,29,0,29
"40804",10901,"Marystown","NL",47.09899,-55.19852,2018-08-28 18:00:00,27,0,27
"40805",10901,"Marystown","NL",47.09899,-55.19852,2018-08-28 19:00:00,25,0,25
"40806",10901,"Marystown","NL",47.09899,-55.19852,2018-08-28 20:00:00,20,1,21
"40807",10901,"Marystown","NL",47.09899,-55.19852,2018-08-28 21:00:00,22,0,22
"40808",10901,"Marystown","NL",47.09899,-55.19852,2018-08-28 22:00:00,25,0,25
"40809",10901,"Marystown","NL",47.09899,-55.19852,2018-08-28 23:00:00,24,0,24
"40810",10901,"Marystown","NL",47.09899,-55.19852,2018-08-29 00:00:00,26,0,26
"40811",10901,"Marystown","NL",47.09899,-55.19852,2018-08-29 01:00:00,29,0,29
"40812",10901,"Marystown","NL",47.09899,-55.19852,2018-08-29 02:00:00,27,0,27
"40813",10901,"Marystown","NL",47.09899,-55.19852,2018-08-29 03:00:00,30,0,30
"40814",10901,"Marystown","NL",47.09899,-55.19852,2018-08-29 04:00:00,30,0,30
"40815",10901,"Marystown","NL",47.09899,-55.19852,2018-08-29 05:00:00,31,0,31
"40816",10901,"Marystown","NL",47.09899,-55.19852,2018-08-29 06:00:00,30,0,30
"40817",10901,"Marystown","NL",47.09899,-55.19852,2018-08-29 07:00:00,29,0,29
"40818",10901,"Marystown","NL",47.09899,-55.19852,2018-08-29 08:00:00,28,0,28
"40819",10901,"Marystown","NL",47.09899,-55.19852,2018-08-29 09:00:00,30,0,30
"40820",10901,"Marystown","NL",47.09899,-55.19852,2018-08-29 10:00:00,31,0,31
"40821",10901,"Marystown","NL",47.09899,-55.19852,2018-08-29 11:00:00,34,0,34
"40822",10901,"Marystown","NL",47.09899,-55.19852,2018-08-29 12:00:00,38,0,38
"40823",10901,"Marystown","NL",47.09899,-55.19852,2018-08-29 13:00:00,34,0,34
"40824",10901,"Marystown","NL",47.09899,-55.19852,2018-08-29 14:00:00,28,0,28
"40825",10901,"Marystown","NL",47.09899,-55.19852,2018-08-29 15:00:00,26,0,26
"40826",10901,"Marystown","NL",47.09899,-55.19852,2018-08-29 16:00:00,27,0,27
"40827",10901,"Marystown","NL",47.09899,-55.19852,2018-08-29 17:00:00,28,0,28
"40828",10901,"Marystown","NL",47.09899,-55.19852,2018-08-29 18:00:00,29,0,29
"40829",10901,"Marystown","NL",47.09899,-55.19852,2018-08-29 19:00:00,29,0,29
"40830",10901,"Marystown","NL",47.09899,-55.19852,2018-08-29 20:00:00,23,0,23
"40831",10901,"Marystown","NL",47.09899,-55.19852,2018-08-29 21:00:00,20,0,20
"40832",10901,"Marystown","NL",47.09899,-55.19852,2018-08-29 22:00:00,18,0,18
"40833",10901,"Marystown","NL",47.09899,-55.19852,2018-08-29 23:00:00,17,0,17
"40834",10901,"Marystown","NL",47.09899,-55.19852,2018-08-30 00:00:00,18,0,18
"40835",10901,"Marystown","NL",47.09899,-55.19852,2018-08-30 01:00:00,19,0,19
"40836",10901,"Marystown","NL",47.09899,-55.19852,2018-08-30 02:00:00,20,0,20
"40837",10901,"Marystown","NL",47.09899,-55.19852,2018-08-30 03:00:00,19,0,19
"40838",10901,"Marystown","NL",47.09899,-55.19852,2018-08-30 04:00:00,19,0,19
"40839",10901,"Marystown","NL",47.09899,-55.19852,2018-08-30 05:00:00,18,0,18
"40840",10901,"Marystown","NL",47.09899,-55.19852,2018-08-30 06:00:00,19,0,19
"40841",10901,"Marystown","NL",47.09899,-55.19852,2018-08-30 07:00:00,18,1,19
"40842",10901,"Marystown","NL",47.09899,-55.19852,2018-08-30 08:00:00,19,0,19
"40843",10901,"Marystown","NL",47.09899,-55.19852,2018-08-30 09:00:00,20,0,20
"40844",10901,"Marystown","NL",47.09899,-55.19852,2018-08-30 10:00:00,20,0,20
"40845",10901,"Marystown","NL",47.09899,-55.19852,2018-08-30 11:00:00,19,2,21
"40846",10901,"Marystown","NL",47.09899,-55.19852,2018-08-30 12:00:00,18,0,18
"40847",10901,"Marystown","NL",47.09899,-55.19852,2018-08-30 13:00:00,18,0,18
"40848",10901,"Marystown","NL",47.09899,-55.19852,2018-08-30 14:00:00,19,0,19
"40849",10901,"Marystown","NL",47.09899,-55.19852,2018-08-30 15:00:00,20,0,20
"40850",10901,"Marystown","NL",47.09899,-55.19852,2018-08-30 16:00:00,21,0,21
"40851",10901,"Marystown","NL",47.09899,-55.19852,2018-08-30 17:00:00,23,0,23
"40852",10901,"Marystown","NL",47.09899,-55.19852,2018-08-30 18:00:00,23,0,23
"40853",10901,"Marystown","NL",47.09899,-55.19852,2018-08-30 19:00:00,23,0,23
"40854",10901,"Marystown","NL",47.09899,-55.19852,2018-08-30 20:00:00,24,0,24
"40855",10901,"Marystown","NL",47.09899,-55.19852,2018-08-30 21:00:00,27,0,27
"40856",10901,"Marystown","NL",47.09899,-55.19852,2018-08-30 22:00:00,25,0,25
"40857",10901,"Marystown","NL",47.09899,-55.19852,2018-08-30 23:00:00,24,0,24
"40858",10901,"Marystown","NL",47.09899,-55.19852,2018-08-31 00:00:00,22,0,22
"40859",10901,"Marystown","NL",47.09899,-55.19852,2018-08-31 01:00:00,21,0,21
"40860",10901,"Marystown","NL",47.09899,-55.19852,2018-08-31 02:00:00,21,0,21
"40861",10901,"Marystown","NL",47.09899,-55.19852,2018-08-31 03:00:00,16,0,16
"40862",10901,"Marystown","NL",47.09899,-55.19852,2018-08-31 04:00:00,12,0,12
"40863",10901,"Marystown","NL",47.09899,-55.19852,2018-08-31 05:00:00,13,0,13
"40864",10901,"Marystown","NL",47.09899,-55.19852,2018-08-31 06:00:00,14,0,14
"40865",10901,"Marystown","NL",47.09899,-55.19852,2018-08-31 07:00:00,14,0,14
"40866",10901,"Marystown","NL",47.09899,-55.19852,2018-08-31 08:00:00,15,0,15
"40867",10901,"Marystown","NL",47.09899,-55.19852,2018-08-31 09:00:00,17,0,17
"40868",10901,"Marystown","NL",47.09899,-55.19852,2018-08-31 10:00:00,17,0,17
"40869",10901,"Marystown","NL",47.09899,-55.19852,2018-08-31 11:00:00,17,0,17
"40870",10901,"Marystown","NL",47.09899,-55.19852,2018-08-31 12:00:00,18,0,18
"40871",10901,"Marystown","NL",47.09899,-55.19852,2018-08-31 13:00:00,18,0,18
"40872",10901,"Marystown","NL",47.09899,-55.19852,2018-08-31 14:00:00,19,0,19
"40873",10901,"Marystown","NL",47.09899,-55.19852,2018-08-31 15:00:00,19,0,19
"40874",10901,"Marystown","NL",47.09899,-55.19852,2018-08-31 16:00:00,20,0,20
"40875",10901,"Marystown","NL",47.09899,-55.19852,2018-08-31 17:00:00,20,0,20
"40876",10901,"Marystown","NL",47.09899,-55.19852,2018-08-31 18:00:00,21,0,21
"40877",10901,"Marystown","NL",47.09899,-55.19852,2018-08-31 19:00:00,22,0,22
"40878",10901,"Marystown","NL",47.09899,-55.19852,2018-08-31 20:00:00,22,0,22
"40879",10901,"Marystown","NL",47.09899,-55.19852,2018-08-31 21:00:00,21,0,21
"40880",10901,"Marystown","NL",47.09899,-55.19852,2018-08-31 22:00:00,18,0,18
"40881",10901,"Marystown","NL",47.09899,-55.19852,2018-08-31 23:00:00,18,0,18
"40882",10901,"Marystown","NL",47.09899,-55.19852,2018-09-01 00:00:00,17,0,17
"40883",10901,"Marystown","NL",47.09899,-55.19852,2018-09-01 01:00:00,11,0,11
"40884",10901,"Marystown","NL",47.09899,-55.19852,2018-09-01 02:00:00,9,0,9
"40885",10901,"Marystown","NL",47.09899,-55.19852,2018-09-01 03:00:00,7,0,7
"40886",10901,"Marystown","NL",47.09899,-55.19852,2018-09-01 04:00:00,7,0,7
"40887",10901,"Marystown","NL",47.09899,-55.19852,2018-09-01 05:00:00,5,0,5
"40888",10901,"Marystown","NL",47.09899,-55.19852,2018-09-01 06:00:00,6,0,6
"40889",10901,"Marystown","NL",47.09899,-55.19852,2018-09-01 07:00:00,5,0,5
"40890",10901,"Marystown","NL",47.09899,-55.19852,2018-09-01 08:00:00,14,0,14
"40891",10901,"Marystown","NL",47.09899,-55.19852,2018-09-01 09:00:00,21,0,21
"40892",10901,"Marystown","NL",47.09899,-55.19852,2018-09-01 10:00:00,21,0,21
"40893",10901,"Marystown","NL",47.09899,-55.19852,2018-09-01 11:00:00,21,0,21
"40894",10901,"Marystown","NL",47.09899,-55.19852,2018-09-01 12:00:00,22,0,22
"40895",10901,"Marystown","NL",47.09899,-55.19852,2018-09-01 13:00:00,22,0,22
"40896",10901,"Marystown","NL",47.09899,-55.19852,2018-09-01 14:00:00,23,0,23
"40897",10901,"Marystown","NL",47.09899,-55.19852,2018-09-01 15:00:00,24,0,24
"40898",10901,"Marystown","NL",47.09899,-55.19852,2018-09-01 16:00:00,25,0,25
"40899",10901,"Marystown","NL",47.09899,-55.19852,2018-09-01 17:00:00,25,0,25
"40900",10901,"Marystown","NL",47.09899,-55.19852,2018-09-01 18:00:00,26,0,26
"40901",10901,"Marystown","NL",47.09899,-55.19852,2018-09-01 19:00:00,25,0,25
"40902",10901,"Marystown","NL",47.09899,-55.19852,2018-09-01 20:00:00,24,0,24
"40903",10901,"Marystown","NL",47.09899,-55.19852,2018-09-01 21:00:00,19,0,19
"40904",10901,"Marystown","NL",47.09899,-55.19852,2018-09-01 22:00:00,17,0,17
"40905",10901,"Marystown","NL",47.09899,-55.19852,2018-09-01 23:00:00,13,0,13
"40906",10901,"Marystown","NL",47.09899,-55.19852,2018-09-02 00:00:00,10,0,10
"40907",10901,"Marystown","NL",47.09899,-55.19852,2018-09-02 01:00:00,11,0,11
"40908",10901,"Marystown","NL",47.09899,-55.19852,2018-09-02 02:00:00,12,0,12
"40909",10901,"Marystown","NL",47.09899,-55.19852,2018-09-02 03:00:00,10,0,10
"40910",10901,"Marystown","NL",47.09899,-55.19852,2018-09-02 04:00:00,18,0,18
"40911",10901,"Marystown","NL",47.09899,-55.19852,2018-09-02 05:00:00,16,0,16
"40912",10901,"Marystown","NL",47.09899,-55.19852,2018-09-02 06:00:00,13,0,13
"40913",10901,"Marystown","NL",47.09899,-55.19852,2018-09-02 07:00:00,18,0,18
"40914",10901,"Marystown","NL",47.09899,-55.19852,2018-09-02 08:00:00,20,0,20
"40915",10901,"Marystown","NL",47.09899,-55.19852,2018-09-02 09:00:00,24,0,24
"40916",10901,"Marystown","NL",47.09899,-55.19852,2018-09-02 10:00:00,27,0,27
"40917",10901,"Marystown","NL",47.09899,-55.19852,2018-09-02 11:00:00,27,0,27
"40918",10901,"Marystown","NL",47.09899,-55.19852,2018-09-02 12:00:00,29,0,29
"40919",10901,"Marystown","NL",47.09899,-55.19852,2018-09-02 13:00:00,29,0,29
"40920",10901,"Marystown","NL",47.09899,-55.19852,2018-09-02 14:00:00,28,0,28
"40921",10901,"Marystown","NL",47.09899,-55.19852,2018-09-02 15:00:00,28,0,28
"40922",10901,"Marystown","NL",47.09899,-55.19852,2018-09-02 16:00:00,29,0,29
"40923",10901,"Marystown","NL",47.09899,-55.19852,2018-09-02 17:00:00,28,0,28
"40924",10901,"Marystown","NL",47.09899,-55.19852,2018-09-02 18:00:00,27,0,27
"40925",10901,"Marystown","NL",47.09899,-55.19852,2018-09-02 19:00:00,26,0,26
"40926",10901,"Marystown","NL",47.09899,-55.19852,2018-09-02 20:00:00,25,0,25
"40927",10901,"Marystown","NL",47.09899,-55.19852,2018-09-02 21:00:00,25,0,25
"40928",10901,"Marystown","NL",47.09899,-55.19852,2018-09-02 22:00:00,24,0,24
"40929",10901,"Marystown","NL",47.09899,-55.19852,2018-09-02 23:00:00,25,0,25
"40930",10901,"Marystown","NL",47.09899,-55.19852,2018-09-03 00:00:00,25,0,25
"40931",10901,"Marystown","NL",47.09899,-55.19852,2018-09-03 01:00:00,22,0,22
"40932",10901,"Marystown","NL",47.09899,-55.19852,2018-09-03 02:00:00,10,0,10
"40933",10901,"Marystown","NL",47.09899,-55.19852,2018-09-03 03:00:00,7,0,7
"40934",10901,"Marystown","NL",47.09899,-55.19852,2018-09-03 04:00:00,5,0,5
"40935",10901,"Marystown","NL",47.09899,-55.19852,2018-09-03 05:00:00,8,0,8
"40936",10901,"Marystown","NL",47.09899,-55.19852,2018-09-03 06:00:00,10,0,10
"40937",10901,"Marystown","NL",47.09899,-55.19852,2018-09-03 07:00:00,13,0,13
"40938",10901,"Marystown","NL",47.09899,-55.19852,2018-09-03 08:00:00,19,0,19
"40939",10901,"Marystown","NL",47.09899,-55.19852,2018-09-03 09:00:00,23,0,23
"40940",10901,"Marystown","NL",47.09899,-55.19852,2018-09-03 10:00:00,23,0,23
"40941",10901,"Marystown","NL",47.09899,-55.19852,2018-09-03 11:00:00,23,0,23
"40942",10901,"Marystown","NL",47.09899,-55.19852,2018-09-03 12:00:00,24,0,24
"40943",10901,"Marystown","NL",47.09899,-55.19852,2018-09-03 13:00:00,25,0,25
"40944",10901,"Marystown","NL",47.09899,-55.19852,2018-09-03 14:00:00,24,0,24
"40945",10901,"Marystown","NL",47.09899,-55.19852,2018-09-03 15:00:00,25,0,25
"40946",10901,"Marystown","NL",47.09899,-55.19852,2018-09-03 16:00:00,25,0,25
"40947",10901,"Marystown","NL",47.09899,-55.19852,2018-09-03 17:00:00,25,0,25
"40948",10901,"Marystown","NL",47.09899,-55.19852,2018-09-03 18:00:00,26,0,26
"40949",10901,"Marystown","NL",47.09899,-55.19852,2018-09-03 19:00:00,24,0,24
"40950",10901,"Marystown","NL",47.09899,-55.19852,2018-09-03 20:00:00,22,0,22
"40951",10901,"Marystown","NL",47.09899,-55.19852,2018-09-03 21:00:00,23,0,23
"40952",10901,"Marystown","NL",47.09899,-55.19852,2018-09-03 22:00:00,25,0,25
"40953",10901,"Marystown","NL",47.09899,-55.19852,2018-09-03 23:00:00,27,0,27
"40954",10901,"Marystown","NL",47.09899,-55.19852,2018-09-04 00:00:00,24,0,24
"40955",10901,"Marystown","NL",47.09899,-55.19852,2018-09-04 01:00:00,26,0,26
"40956",10901,"Marystown","NL",47.09899,-55.19852,2018-09-04 02:00:00,27,0,27
"40957",10901,"Marystown","NL",47.09899,-55.19852,2018-09-04 03:00:00,28,0,28
"40958",10901,"Marystown","NL",47.09899,-55.19852,2018-09-04 04:00:00,28,0,28
"40959",10901,"Marystown","NL",47.09899,-55.19852,2018-09-04 05:00:00,28,0,28
"40960",10901,"Marystown","NL",47.09899,-55.19852,2018-09-04 06:00:00,28,0,28
"40961",10901,"Marystown","NL",47.09899,-55.19852,2018-09-04 07:00:00,27,0,27
"40962",10901,"Marystown","NL",47.09899,-55.19852,2018-09-04 08:00:00,28,0,28
"40963",10901,"Marystown","NL",47.09899,-55.19852,2018-09-04 09:00:00,28,0,28
"40964",10901,"Marystown","NL",47.09899,-55.19852,2018-09-04 10:00:00,27,0,27
"40965",10901,"Marystown","NL",47.09899,-55.19852,2018-09-04 11:00:00,27,0,27
"40966",10901,"Marystown","NL",47.09899,-55.19852,2018-09-04 12:00:00,28,0,28
"40967",10901,"Marystown","NL",47.09899,-55.19852,2018-09-04 13:00:00,27,0,27
"40968",10901,"Marystown","NL",47.09899,-55.19852,2018-09-04 14:00:00,26,0,26
"40969",10901,"Marystown","NL",47.09899,-55.19852,2018-09-04 15:00:00,24,0,24
"40970",10901,"Marystown","NL",47.09899,-55.19852,2018-09-04 16:00:00,23,0,23
"40971",10901,"Marystown","NL",47.09899,-55.19852,2018-09-04 17:00:00,24,0,24
"40972",10901,"Marystown","NL",47.09899,-55.19852,2018-09-04 18:00:00,25,0,25
"40973",10901,"Marystown","NL",47.09899,-55.19852,2018-09-04 19:00:00,25,0,25
"40974",10901,"Marystown","NL",47.09899,-55.19852,2018-09-04 20:00:00,27,0,27
"40975",10901,"Marystown","NL",47.09899,-55.19852,2018-09-04 21:00:00,26,0,26
"40976",10901,"Marystown","NL",47.09899,-55.19852,2018-09-04 22:00:00,23,0,23
"40977",10901,"Marystown","NL",47.09899,-55.19852,2018-09-04 23:00:00,21,0,21
"40978",10901,"Marystown","NL",47.09899,-55.19852,2018-09-05 00:00:00,18,0,18
"40979",10901,"Marystown","NL",47.09899,-55.19852,2018-09-05 01:00:00,13,0,13
"40980",10901,"Marystown","NL",47.09899,-55.19852,2018-09-05 02:00:00,17,0,17
"40981",10901,"Marystown","NL",47.09899,-55.19852,2018-09-05 03:00:00,14,0,14
"40982",10901,"Marystown","NL",47.09899,-55.19852,2018-09-05 04:00:00,8,0,8
"40983",10901,"Marystown","NL",47.09899,-55.19852,2018-09-05 05:00:00,7,0,7
"40984",10901,"Marystown","NL",47.09899,-55.19852,2018-09-05 06:00:00,6,0,6
"40985",10901,"Marystown","NL",47.09899,-55.19852,2018-09-05 07:00:00,4,1,5
"40986",10901,"Marystown","NL",47.09899,-55.19852,2018-09-05 08:00:00,13,0,13
"40987",10901,"Marystown","NL",47.09899,-55.19852,2018-09-05 09:00:00,17,0,17
"40988",10901,"Marystown","NL",47.09899,-55.19852,2018-09-05 10:00:00,18,0,18
"40989",10901,"Marystown","NL",47.09899,-55.19852,2018-09-05 11:00:00,18,0,18
"40990",10901,"Marystown","NL",47.09899,-55.19852,2018-09-05 12:00:00,19,0,19
"40991",10901,"Marystown","NL",47.09899,-55.19852,2018-09-05 13:00:00,19,0,19
"40992",10901,"Marystown","NL",47.09899,-55.19852,2018-09-05 14:00:00,19,0,19
"40993",10901,"Marystown","NL",47.09899,-55.19852,2018-09-05 15:00:00,19,0,19
"40994",10901,"Marystown","NL",47.09899,-55.19852,2018-09-05 16:00:00,19,0,19
"40995",10901,"Marystown","NL",47.09899,-55.19852,2018-09-05 17:00:00,19,0,19
"40996",10901,"Marystown","NL",47.09899,-55.19852,2018-09-05 18:00:00,18,0,18
"40997",10901,"Marystown","NL",47.09899,-55.19852,2018-09-05 19:00:00,18,0,18
"40998",10901,"Marystown","NL",47.09899,-55.19852,2018-09-05 20:00:00,15,0,15
"40999",10901,"Marystown","NL",47.09899,-55.19852,2018-09-05 21:00:00,13,0,13
"41000",10901,"Marystown","NL",47.09899,-55.19852,2018-09-05 22:00:00,15,0,15
"41001",10901,"Marystown","NL",47.09899,-55.19852,2018-09-05 23:00:00,17,0,17
"41002",10901,"Marystown","NL",47.09899,-55.19852,2018-09-06 00:00:00,18,0,18
"41003",10901,"Marystown","NL",47.09899,-55.19852,2018-09-06 01:00:00,17,0,17
"41004",10901,"Marystown","NL",47.09899,-55.19852,2018-09-06 02:00:00,17,0,17
"41005",10901,"Marystown","NL",47.09899,-55.19852,2018-09-06 03:00:00,13,0,13
"41006",10901,"Marystown","NL",47.09899,-55.19852,2018-09-06 04:00:00,16,0,16
"41007",10901,"Marystown","NL",47.09899,-55.19852,2018-09-06 05:00:00,18,0,18
"41008",10901,"Marystown","NL",47.09899,-55.19852,2018-09-06 06:00:00,15,0,15
"41009",10901,"Marystown","NL",47.09899,-55.19852,2018-09-06 07:00:00,14,0,14
"41010",10901,"Marystown","NL",47.09899,-55.19852,2018-09-06 08:00:00,18,0,18
"41011",10901,"Marystown","NL",47.09899,-55.19852,2018-09-06 09:00:00,18,0,18
"41012",10901,"Marystown","NL",47.09899,-55.19852,2018-09-06 10:00:00,20,0,20
"41013",10901,"Marystown","NL",47.09899,-55.19852,2018-09-06 11:00:00,21,0,21
"41014",10901,"Marystown","NL",47.09899,-55.19852,2018-09-06 12:00:00,21,0,21
"41015",10901,"Marystown","NL",47.09899,-55.19852,2018-09-06 13:00:00,22,0,22
"41016",10901,"Marystown","NL",47.09899,-55.19852,2018-09-06 14:00:00,23,0,23
"41017",10901,"Marystown","NL",47.09899,-55.19852,2018-09-06 15:00:00,23,0,23
"41018",10901,"Marystown","NL",47.09899,-55.19852,2018-09-06 16:00:00,24,0,24
"41019",10901,"Marystown","NL",47.09899,-55.19852,2018-09-06 17:00:00,24,0,24
"41020",10901,"Marystown","NL",47.09899,-55.19852,2018-09-06 18:00:00,24,0,24
"41021",10901,"Marystown","NL",47.09899,-55.19852,2018-09-06 19:00:00,25,0,25
"41022",10901,"Marystown","NL",47.09899,-55.19852,2018-09-06 20:00:00,26,0,26
"41023",10901,"Marystown","NL",47.09899,-55.19852,2018-09-06 21:00:00,23,0,23
"41024",10901,"Marystown","NL",47.09899,-55.19852,2018-09-06 22:00:00,20,0,20
"41025",10901,"Marystown","NL",47.09899,-55.19852,2018-09-06 23:00:00,18,0,18
"41026",10901,"Marystown","NL",47.09899,-55.19852,2018-09-07 00:00:00,17,0,17
"41027",10901,"Marystown","NL",47.09899,-55.19852,2018-09-07 01:00:00,15,0,15
"41028",10901,"Marystown","NL",47.09899,-55.19852,2018-09-07 02:00:00,14,0,14
"41029",10901,"Marystown","NL",47.09899,-55.19852,2018-09-07 03:00:00,13,0,13
"41030",10901,"Marystown","NL",47.09899,-55.19852,2018-09-07 04:00:00,11,0,11
"41031",10901,"Marystown","NL",47.09899,-55.19852,2018-09-07 05:00:00,10,0,10
"41032",10901,"Marystown","NL",47.09899,-55.19852,2018-09-07 06:00:00,8,0,8
"41033",10901,"Marystown","NL",47.09899,-55.19852,2018-09-07 07:00:00,6,0,6
"41034",10901,"Marystown","NL",47.09899,-55.19852,2018-09-07 08:00:00,7,0,7
"41035",10901,"Marystown","NL",47.09899,-55.19852,2018-09-07 09:00:00,13,0,13
"41036",10901,"Marystown","NL",47.09899,-55.19852,2018-09-07 10:00:00,17,0,17
"41037",10901,"Marystown","NL",47.09899,-55.19852,2018-09-07 11:00:00,23,0,23
"41038",10901,"Marystown","NL",47.09899,-55.19852,2018-09-07 12:00:00,23,0,23
"41039",10901,"Marystown","NL",47.09899,-55.19852,2018-09-07 13:00:00,24,0,24
"41040",10901,"Marystown","NL",47.09899,-55.19852,2018-09-07 14:00:00,23,0,23
"41041",10901,"Marystown","NL",47.09899,-55.19852,2018-09-07 15:00:00,23,0,23
"41042",10901,"Marystown","NL",47.09899,-55.19852,2018-09-07 16:00:00,23,0,23
"41043",10901,"Marystown","NL",47.09899,-55.19852,2018-09-07 17:00:00,23,0,23
"41044",10901,"Marystown","NL",47.09899,-55.19852,2018-09-07 18:00:00,21,0,21
"41045",10901,"Marystown","NL",47.09899,-55.19852,2018-09-07 19:00:00,19,0,19
"41046",10901,"Marystown","NL",47.09899,-55.19852,2018-09-07 20:00:00,13,0,13
"41047",10901,"Marystown","NL",47.09899,-55.19852,2018-09-07 21:00:00,7,0,7
"41048",10901,"Marystown","NL",47.09899,-55.19852,2018-09-07 22:00:00,10,0,10
"41049",10901,"Marystown","NL",47.09899,-55.19852,2018-09-07 23:00:00,14,0,14
"41050",10901,"Marystown","NL",47.09899,-55.19852,2018-09-08 00:00:00,15,0,15
"41051",10901,"Marystown","NL",47.09899,-55.19852,2018-09-08 01:00:00,13,0,13
"41052",10901,"Marystown","NL",47.09899,-55.19852,2018-09-08 02:00:00,14,0,14
"41053",10901,"Marystown","NL",47.09899,-55.19852,2018-09-08 03:00:00,15,0,15
"41054",10901,"Marystown","NL",47.09899,-55.19852,2018-09-08 04:00:00,22,0,22
"41055",10901,"Marystown","NL",47.09899,-55.19852,2018-09-08 05:00:00,22,0,22
"41056",10901,"Marystown","NL",47.09899,-55.19852,2018-09-08 06:00:00,20,0,20
"41057",10901,"Marystown","NL",47.09899,-55.19852,2018-09-08 07:00:00,20,0,20
"41058",10901,"Marystown","NL",47.09899,-55.19852,2018-09-08 08:00:00,24,0,24
"41059",10901,"Marystown","NL",47.09899,-55.19852,2018-09-08 09:00:00,26,0,26
"41060",10901,"Marystown","NL",47.09899,-55.19852,2018-09-08 10:00:00,27,0,27
"41061",10901,"Marystown","NL",47.09899,-55.19852,2018-09-08 11:00:00,27,0,27
"41062",10901,"Marystown","NL",47.09899,-55.19852,2018-09-08 12:00:00,25,0,25
"41063",10901,"Marystown","NL",47.09899,-55.19852,2018-09-08 13:00:00,27,0,27
"41064",10901,"Marystown","NL",47.09899,-55.19852,2018-09-08 14:00:00,28,0,28
"41065",10901,"Marystown","NL",47.09899,-55.19852,2018-09-08 15:00:00,26,0,26
"41066",10901,"Marystown","NL",47.09899,-55.19852,2018-09-08 16:00:00,25,0,25
"41067",10901,"Marystown","NL",47.09899,-55.19852,2018-09-08 17:00:00,26,0,26
"41068",10901,"Marystown","NL",47.09899,-55.19852,2018-09-08 18:00:00,25,0,25
"41069",10901,"Marystown","NL",47.09899,-55.19852,2018-09-08 19:00:00,25,0,25
"41070",10901,"Marystown","NL",47.09899,-55.19852,2018-09-08 20:00:00,23,0,23
"41071",10901,"Marystown","NL",47.09899,-55.19852,2018-09-08 21:00:00,16,0,16
"41072",10901,"Marystown","NL",47.09899,-55.19852,2018-09-08 22:00:00,12,0,12
"41073",10901,"Marystown","NL",47.09899,-55.19852,2018-09-08 23:00:00,11,0,11
"41074",10901,"Marystown","NL",47.09899,-55.19852,2018-09-09 00:00:00,9,0,9
"41075",10901,"Marystown","NL",47.09899,-55.19852,2018-09-09 01:00:00,9,0,9
"41076",10901,"Marystown","NL",47.09899,-55.19852,2018-09-09 02:00:00,8,0,8
"41077",10901,"Marystown","NL",47.09899,-55.19852,2018-09-09 03:00:00,6,0,6
"41078",10901,"Marystown","NL",47.09899,-55.19852,2018-09-09 04:00:00,6,0,6
"41079",10901,"Marystown","NL",47.09899,-55.19852,2018-09-09 05:00:00,6,0,6
"41080",10901,"Marystown","NL",47.09899,-55.19852,2018-09-09 06:00:00,4,0,4
"41081",10901,"Marystown","NL",47.09899,-55.19852,2018-09-09 07:00:00,3,0,3
"41082",10901,"Marystown","NL",47.09899,-55.19852,2018-09-09 08:00:00,6,0,6
"41083",10901,"Marystown","NL",47.09899,-55.19852,2018-09-09 09:00:00,13,0,13
"41084",10901,"Marystown","NL",47.09899,-55.19852,2018-09-09 10:00:00,16,0,16
"41085",10901,"Marystown","NL",47.09899,-55.19852,2018-09-09 11:00:00,19,0,19
"41086",10901,"Marystown","NL",47.09899,-55.19852,2018-09-09 12:00:00,21,0,21
"41087",10901,"Marystown","NL",47.09899,-55.19852,2018-09-09 13:00:00,21,0,21
"41088",10901,"Marystown","NL",47.09899,-55.19852,2018-09-09 14:00:00,20,0,20
"41089",10901,"Marystown","NL",47.09899,-55.19852,2018-09-09 15:00:00,20,0,20
"41090",10901,"Marystown","NL",47.09899,-55.19852,2018-09-09 16:00:00,20,0,20
"41091",10901,"Marystown","NL",47.09899,-55.19852,2018-09-09 17:00:00,19,0,19
"41092",10901,"Marystown","NL",47.09899,-55.19852,2018-09-09 18:00:00,19,0,19
"41093",10901,"Marystown","NL",47.09899,-55.19852,2018-09-09 19:00:00,18,0,18
"41094",10901,"Marystown","NL",47.09899,-55.19852,2018-09-09 20:00:00,11,0,11
"41095",10901,"Marystown","NL",47.09899,-55.19852,2018-09-09 21:00:00,10,0,10
"41096",10901,"Marystown","NL",47.09899,-55.19852,2018-09-09 22:00:00,9,0,9
"41097",10901,"Marystown","NL",47.09899,-55.19852,2018-09-09 23:00:00,7,1,8
"41098",10901,"Marystown","NL",47.09899,-55.19852,2018-09-10 00:00:00,5,0,5
"41099",10901,"Marystown","NL",47.09899,-55.19852,2018-09-10 01:00:00,6,0,6
"41100",10901,"Marystown","NL",47.09899,-55.19852,2018-09-10 02:00:00,5,0,5
"41101",10901,"Marystown","NL",47.09899,-55.19852,2018-09-10 03:00:00,4,0,4
"41102",10901,"Marystown","NL",47.09899,-55.19852,2018-09-10 04:00:00,4,0,4
"41103",10901,"Marystown","NL",47.09899,-55.19852,2018-09-10 05:00:00,3,0,3
"41104",10901,"Marystown","NL",47.09899,-55.19852,2018-09-10 06:00:00,2,0,2
"41105",10901,"Marystown","NL",47.09899,-55.19852,2018-09-10 07:00:00,4,1,5
"41106",10901,"Marystown","NL",47.09899,-55.19852,2018-09-10 08:00:00,5,1,6
"41107",10901,"Marystown","NL",47.09899,-55.19852,2018-09-10 09:00:00,9,0,9
"41108",10901,"Marystown","NL",47.09899,-55.19852,2018-09-10 10:00:00,17,0,17
"41109",10901,"Marystown","NL",47.09899,-55.19852,2018-09-10 11:00:00,19,0,19
"41110",10901,"Marystown","NL",47.09899,-55.19852,2018-09-10 12:00:00,20,0,20
"41111",10901,"Marystown","NL",47.09899,-55.19852,2018-09-10 13:00:00,19,1,20
"41112",10901,"Marystown","NL",47.09899,-55.19852,2018-09-10 14:00:00,20,0,20
"41113",10901,"Marystown","NL",47.09899,-55.19852,2018-09-10 15:00:00,21,0,21
"41114",10901,"Marystown","NL",47.09899,-55.19852,2018-09-10 16:00:00,21,0,21
"41115",10901,"Marystown","NL",47.09899,-55.19852,2018-09-10 17:00:00,21,0,21
"41116",10901,"Marystown","NL",47.09899,-55.19852,2018-09-10 18:00:00,21,0,21
"41117",10901,"Marystown","NL",47.09899,-55.19852,2018-09-10 19:00:00,20,0,20
"41118",10901,"Marystown","NL",47.09899,-55.19852,2018-09-10 20:00:00,18,0,18
"41119",10901,"Marystown","NL",47.09899,-55.19852,2018-09-10 21:00:00,13,0,13
"41120",10901,"Marystown","NL",47.09899,-55.19852,2018-09-10 22:00:00,13,0,13
"41121",10901,"Marystown","NL",47.09899,-55.19852,2018-09-10 23:00:00,12,0,12
"41122",10901,"Marystown","NL",47.09899,-55.19852,2018-09-11 00:00:00,10,0,10
"41123",10901,"Marystown","NL",47.09899,-55.19852,2018-09-11 01:00:00,11,0,11
"41124",10901,"Marystown","NL",47.09899,-55.19852,2018-09-11 02:00:00,11,0,11
"41125",10901,"Marystown","NL",47.09899,-55.19852,2018-09-11 03:00:00,13,0,13
"41126",10901,"Marystown","NL",47.09899,-55.19852,2018-09-11 04:00:00,14,0,14
"41127",10901,"Marystown","NL",47.09899,-55.19852,2018-09-11 05:00:00,13,0,13
"41128",10901,"Marystown","NL",47.09899,-55.19852,2018-09-11 06:00:00,9,0,9
"41129",10901,"Marystown","NL",47.09899,-55.19852,2018-09-11 07:00:00,8,0,8
"41130",10901,"Marystown","NL",47.09899,-55.19852,2018-09-11 08:00:00,15,1,16
"41131",10901,"Marystown","NL",47.09899,-55.19852,2018-09-11 09:00:00,20,0,20
"41132",10901,"Marystown","NL",47.09899,-55.19852,2018-09-11 10:00:00,22,0,22
"41133",10901,"Marystown","NL",47.09899,-55.19852,2018-09-11 11:00:00,22,0,22
"41134",10901,"Marystown","NL",47.09899,-55.19852,2018-09-11 12:00:00,23,0,23
"41135",10901,"Marystown","NL",47.09899,-55.19852,2018-09-11 13:00:00,23,0,23
"41136",10901,"Marystown","NL",47.09899,-55.19852,2018-09-11 14:00:00,24,0,24
"41137",10901,"Marystown","NL",47.09899,-55.19852,2018-09-11 15:00:00,24,0,24
"41138",10901,"Marystown","NL",47.09899,-55.19852,2018-09-11 16:00:00,23,0,23
"41139",10901,"Marystown","NL",47.09899,-55.19852,2018-09-11 17:00:00,24,0,24
"41140",10901,"Marystown","NL",47.09899,-55.19852,2018-09-11 18:00:00,24,0,24
"41141",10901,"Marystown","NL",47.09899,-55.19852,2018-09-11 19:00:00,24,0,24
"41142",10901,"Marystown","NL",47.09899,-55.19852,2018-09-11 20:00:00,22,0,22
"41143",10901,"Marystown","NL",47.09899,-55.19852,2018-09-11 21:00:00,21,0,21
"41144",10901,"Marystown","NL",47.09899,-55.19852,2018-09-11 22:00:00,21,0,21
"41145",10901,"Marystown","NL",47.09899,-55.19852,2018-09-11 23:00:00,22,0,22
"41146",10901,"Marystown","NL",47.09899,-55.19852,2018-09-12 00:00:00,23,0,23
"41147",10901,"Marystown","NL",47.09899,-55.19852,2018-09-12 01:00:00,25,0,25
"41148",10901,"Marystown","NL",47.09899,-55.19852,2018-09-12 02:00:00,27,0,27
"41149",10901,"Marystown","NL",47.09899,-55.19852,2018-09-12 03:00:00,27,0,27
"41150",10901,"Marystown","NL",47.09899,-55.19852,2018-09-12 04:00:00,29,0,29
"41151",10901,"Marystown","NL",47.09899,-55.19852,2018-09-12 05:00:00,30,0,30
"41152",10901,"Marystown","NL",47.09899,-55.19852,2018-09-12 06:00:00,30,0,30
"41153",10901,"Marystown","NL",47.09899,-55.19852,2018-09-12 07:00:00,30,0,30
"41154",10901,"Marystown","NL",47.09899,-55.19852,2018-09-12 08:00:00,29,0,29
"41155",10901,"Marystown","NL",47.09899,-55.19852,2018-09-12 09:00:00,29,0,29
"41156",10901,"Marystown","NL",47.09899,-55.19852,2018-09-12 10:00:00,29,0,29
"41157",10901,"Marystown","NL",47.09899,-55.19852,2018-09-12 11:00:00,30,0,30
"41158",10901,"Marystown","NL",47.09899,-55.19852,2018-09-12 12:00:00,31,0,31
"41159",10901,"Marystown","NL",47.09899,-55.19852,2018-09-12 13:00:00,32,0,32
"41160",10901,"Marystown","NL",47.09899,-55.19852,2018-09-12 14:00:00,30,0,30
"41161",10901,"Marystown","NL",47.09899,-55.19852,2018-09-12 15:00:00,27,0,27
"41162",10901,"Marystown","NL",47.09899,-55.19852,2018-09-12 16:00:00,27,0,27
"41163",10901,"Marystown","NL",47.09899,-55.19852,2018-09-12 17:00:00,26,0,26
"41164",10901,"Marystown","NL",47.09899,-55.19852,2018-09-12 18:00:00,23,0,23
"41165",10901,"Marystown","NL",47.09899,-55.19852,2018-09-12 19:00:00,22,0,22
"41166",10901,"Marystown","NL",47.09899,-55.19852,2018-09-12 20:00:00,18,0,18
"41167",10901,"Marystown","NL",47.09899,-55.19852,2018-09-12 21:00:00,14,0,14
"41168",10901,"Marystown","NL",47.09899,-55.19852,2018-09-12 22:00:00,8,1,9
"41169",10901,"Marystown","NL",47.09899,-55.19852,2018-09-12 23:00:00,6,1,7
"41170",10901,"Marystown","NL",47.09899,-55.19852,2018-09-13 00:00:00,5,1,6
"41171",10901,"Marystown","NL",47.09899,-55.19852,2018-09-13 01:00:00,4,0,4
"41172",10901,"Marystown","NL",47.09899,-55.19852,2018-09-13 02:00:00,8,0,8
"41173",10901,"Marystown","NL",47.09899,-55.19852,2018-09-13 03:00:00,11,0,11
"41174",10901,"Marystown","NL",47.09899,-55.19852,2018-09-13 04:00:00,6,0,6
"41175",10901,"Marystown","NL",47.09899,-55.19852,2018-09-13 05:00:00,4,0,4
"41176",10901,"Marystown","NL",47.09899,-55.19852,2018-09-13 06:00:00,3,0,3
"41177",10901,"Marystown","NL",47.09899,-55.19852,2018-09-13 07:00:00,4,0,4
"41178",10901,"Marystown","NL",47.09899,-55.19852,2018-09-13 08:00:00,12,1,13
"41179",10901,"Marystown","NL",47.09899,-55.19852,2018-09-13 09:00:00,18,0,18
"41180",10901,"Marystown","NL",47.09899,-55.19852,2018-09-13 10:00:00,19,0,19
"41181",10901,"Marystown","NL",47.09899,-55.19852,2018-09-13 11:00:00,19,0,19
"41182",10901,"Marystown","NL",47.09899,-55.19852,2018-09-13 12:00:00,19,0,19
"41183",10901,"Marystown","NL",47.09899,-55.19852,2018-09-13 13:00:00,19,0,19
"41184",10901,"Marystown","NL",47.09899,-55.19852,2018-09-13 14:00:00,19,0,19
"41185",10901,"Marystown","NL",47.09899,-55.19852,2018-09-13 15:00:00,18,0,18
"41186",10901,"Marystown","NL",47.09899,-55.19852,2018-09-13 16:00:00,18,0,18
"41187",10901,"Marystown","NL",47.09899,-55.19852,2018-09-13 17:00:00,17,0,17
"41188",10901,"Marystown","NL",47.09899,-55.19852,2018-09-13 18:00:00,18,0,18
"41189",10901,"Marystown","NL",47.09899,-55.19852,2018-09-13 19:00:00,16,0,16
"41190",10901,"Marystown","NL",47.09899,-55.19852,2018-09-13 20:00:00,14,0,14
"41191",10901,"Marystown","NL",47.09899,-55.19852,2018-09-13 21:00:00,7,1,8
"41192",10901,"Marystown","NL",47.09899,-55.19852,2018-09-13 22:00:00,9,0,9
"41193",10901,"Marystown","NL",47.09899,-55.19852,2018-09-13 23:00:00,6,0,6
"41194",10901,"Marystown","NL",47.09899,-55.19852,2018-09-14 00:00:00,3,0,3
"41195",10901,"Marystown","NL",47.09899,-55.19852,2018-09-14 01:00:00,2,0,2
"41196",10901,"Marystown","NL",47.09899,-55.19852,2018-09-14 02:00:00,3,0,3
"41197",10901,"Marystown","NL",47.09899,-55.19852,2018-09-14 03:00:00,4,0,4
"41198",10901,"Marystown","NL",47.09899,-55.19852,2018-09-14 04:00:00,5,0,5
"41199",10901,"Marystown","NL",47.09899,-55.19852,2018-09-14 05:00:00,6,0,6
"41200",10901,"Marystown","NL",47.09899,-55.19852,2018-09-14 06:00:00,13,0,13
"41201",10901,"Marystown","NL",47.09899,-55.19852,2018-09-14 07:00:00,14,0,14
"41202",10901,"Marystown","NL",47.09899,-55.19852,2018-09-14 08:00:00,13,0,13
"41203",10901,"Marystown","NL",47.09899,-55.19852,2018-09-14 09:00:00,13,0,13
"41204",10901,"Marystown","NL",47.09899,-55.19852,2018-09-14 10:00:00,14,0,14
"41205",10901,"Marystown","NL",47.09899,-55.19852,2018-09-14 11:00:00,15,0,15
"41206",10901,"Marystown","NL",47.09899,-55.19852,2018-09-14 12:00:00,13,0,13
"41207",10901,"Marystown","NL",47.09899,-55.19852,2018-09-14 13:00:00,14,0,14
"41208",10901,"Marystown","NL",47.09899,-55.19852,2018-09-14 14:00:00,15,0,15
"41209",10901,"Marystown","NL",47.09899,-55.19852,2018-09-14 15:00:00,16,0,16
"41210",10901,"Marystown","NL",47.09899,-55.19852,2018-09-14 16:00:00,17,0,17
"41211",10901,"Marystown","NL",47.09899,-55.19852,2018-09-14 17:00:00,16,0,16
"41212",10901,"Marystown","NL",47.09899,-55.19852,2018-09-14 18:00:00,16,0,16
"41213",10901,"Marystown","NL",47.09899,-55.19852,2018-09-14 19:00:00,13,0,13
"41214",10901,"Marystown","NL",47.09899,-55.19852,2018-09-14 20:00:00,11,0,11
"41215",10901,"Marystown","NL",47.09899,-55.19852,2018-09-14 21:00:00,10,0,10
"41216",10901,"Marystown","NL",47.09899,-55.19852,2018-09-14 22:00:00,11,0,11
"41217",10901,"Marystown","NL",47.09899,-55.19852,2018-09-14 23:00:00,12,0,12
"41218",10901,"Marystown","NL",47.09899,-55.19852,2018-09-15 00:00:00,14,0,14
"41219",10901,"Marystown","NL",47.09899,-55.19852,2018-09-15 01:00:00,15,0,15
"41220",10901,"Marystown","NL",47.09899,-55.19852,2018-09-15 02:00:00,16,0,16
"41221",10901,"Marystown","NL",47.09899,-55.19852,2018-09-15 03:00:00,17,0,17
"41222",10901,"Marystown","NL",47.09899,-55.19852,2018-09-15 04:00:00,18,0,18
"41223",10901,"Marystown","NL",47.09899,-55.19852,2018-09-15 05:00:00,19,0,19
"41224",10901,"Marystown","NL",47.09899,-55.19852,2018-09-15 06:00:00,20,0,20
"41225",10901,"Marystown","NL",47.09899,-55.19852,2018-09-15 07:00:00,21,0,21
"41226",10901,"Marystown","NL",47.09899,-55.19852,2018-09-15 08:00:00,22,0,22
"41227",10901,"Marystown","NL",47.09899,-55.19852,2018-09-15 09:00:00,22,0,22
"41228",10901,"Marystown","NL",47.09899,-55.19852,2018-09-15 10:00:00,23,0,23
"41229",10901,"Marystown","NL",47.09899,-55.19852,2018-09-15 11:00:00,24,0,24
"41230",10901,"Marystown","NL",47.09899,-55.19852,2018-09-15 12:00:00,24,0,24
"41231",10901,"Marystown","NL",47.09899,-55.19852,2018-09-15 13:00:00,25,0,25
"41232",10901,"Marystown","NL",47.09899,-55.19852,2018-09-15 14:00:00,24,0,24
"41233",10901,"Marystown","NL",47.09899,-55.19852,2018-09-15 15:00:00,24,0,24
"41234",10901,"Marystown","NL",47.09899,-55.19852,2018-09-15 16:00:00,24,0,24
"41235",10901,"Marystown","NL",47.09899,-55.19852,2018-09-15 17:00:00,24,0,24
"41236",10901,"Marystown","NL",47.09899,-55.19852,2018-09-15 18:00:00,26,0,26
"41237",10901,"Marystown","NL",47.09899,-55.19852,2018-09-15 19:00:00,25,0,25
"41238",10901,"Marystown","NL",47.09899,-55.19852,2018-09-15 20:00:00,24,0,24
"41239",10901,"Marystown","NL",47.09899,-55.19852,2018-09-15 21:00:00,22,0,22
"41240",10901,"Marystown","NL",47.09899,-55.19852,2018-09-15 22:00:00,22,0,22
"41241",10901,"Marystown","NL",47.09899,-55.19852,2018-09-15 23:00:00,21,0,21
"41242",10901,"Marystown","NL",47.09899,-55.19852,2018-09-16 00:00:00,18,0,18
"41243",10901,"Marystown","NL",47.09899,-55.19852,2018-09-16 01:00:00,16,0,16
"41244",10901,"Marystown","NL",47.09899,-55.19852,2018-09-16 02:00:00,13,0,13
"41245",10901,"Marystown","NL",47.09899,-55.19852,2018-09-16 03:00:00,15,0,15
"41246",10901,"Marystown","NL",47.09899,-55.19852,2018-09-16 04:00:00,12,0,12
"41247",10901,"Marystown","NL",47.09899,-55.19852,2018-09-16 05:00:00,17,0,17
"41248",10901,"Marystown","NL",47.09899,-55.19852,2018-09-16 06:00:00,17,0,17
"41249",10901,"Marystown","NL",47.09899,-55.19852,2018-09-16 07:00:00,18,0,18
"41250",10901,"Marystown","NL",47.09899,-55.19852,2018-09-16 08:00:00,21,0,21
"41251",10901,"Marystown","NL",47.09899,-55.19852,2018-09-16 09:00:00,19,0,19
"41252",10901,"Marystown","NL",47.09899,-55.19852,2018-09-16 10:00:00,19,0,19
"41253",10901,"Marystown","NL",47.09899,-55.19852,2018-09-16 11:00:00,19,0,19
"41254",10901,"Marystown","NL",47.09899,-55.19852,2018-09-16 12:00:00,19,0,19
"41255",10901,"Marystown","NL",47.09899,-55.19852,2018-09-16 13:00:00,18,0,18
"41256",10901,"Marystown","NL",47.09899,-55.19852,2018-09-16 14:00:00,19,0,19
"41257",10901,"Marystown","NL",47.09899,-55.19852,2018-09-16 15:00:00,20,0,20
"41258",10901,"Marystown","NL",47.09899,-55.19852,2018-09-16 16:00:00,20,0,20
"41259",10901,"Marystown","NL",47.09899,-55.19852,2018-09-16 17:00:00,18,0,18
"41260",10901,"Marystown","NL",47.09899,-55.19852,2018-09-16 18:00:00,18,0,18
"41261",10901,"Marystown","NL",47.09899,-55.19852,2018-09-16 19:00:00,15,0,15
"41262",10901,"Marystown","NL",47.09899,-55.19852,2018-09-16 20:00:00,15,0,15
"41263",10901,"Marystown","NL",47.09899,-55.19852,2018-09-16 21:00:00,15,0,15
"41264",10901,"Marystown","NL",47.09899,-55.19852,2018-09-16 22:00:00,12,0,12
"41265",10901,"Marystown","NL",47.09899,-55.19852,2018-09-16 23:00:00,11,0,11
"41266",10901,"Marystown","NL",47.09899,-55.19852,2018-09-17 00:00:00,11,0,11
"41267",10901,"Marystown","NL",47.09899,-55.19852,2018-09-17 01:00:00,12,0,12
"41268",10901,"Marystown","NL",47.09899,-55.19852,2018-09-17 02:00:00,13,0,13
"41269",10901,"Marystown","NL",47.09899,-55.19852,2018-09-17 03:00:00,12,0,12
"41270",10901,"Marystown","NL",47.09899,-55.19852,2018-09-17 04:00:00,9,0,9
"41271",10901,"Marystown","NL",47.09899,-55.19852,2018-09-17 05:00:00,8,0,8
"41272",10901,"Marystown","NL",47.09899,-55.19852,2018-09-17 06:00:00,6,0,6
"41273",10901,"Marystown","NL",47.09899,-55.19852,2018-09-17 07:00:00,7,0,7
"41274",10901,"Marystown","NL",47.09899,-55.19852,2018-09-17 08:00:00,12,0,12
"41275",10901,"Marystown","NL",47.09899,-55.19852,2018-09-17 09:00:00,15,0,15
"41276",10901,"Marystown","NL",47.09899,-55.19852,2018-09-17 10:00:00,18,1,19
"41277",10901,"Marystown","NL",47.09899,-55.19852,2018-09-17 11:00:00,18,1,19
"41278",10901,"Marystown","NL",47.09899,-55.19852,2018-09-17 12:00:00,20,1,21
"41279",10901,"Marystown","NL",47.09899,-55.19852,2018-09-17 13:00:00,22,0,22
"41280",10901,"Marystown","NL",47.09899,-55.19852,2018-09-17 14:00:00,24,0,24
"41281",10901,"Marystown","NL",47.09899,-55.19852,2018-09-17 15:00:00,28,0,28
"41282",10901,"Marystown","NL",47.09899,-55.19852,2018-09-17 16:00:00,25,1,26
"41283",10901,"Marystown","NL",47.09899,-55.19852,2018-09-17 17:00:00,25,0,25
"41284",10901,"Marystown","NL",47.09899,-55.19852,2018-09-17 18:00:00,23,0,23
"41285",10901,"Marystown","NL",47.09899,-55.19852,2018-09-17 19:00:00,22,0,22
"41286",10901,"Marystown","NL",47.09899,-55.19852,2018-09-17 20:00:00,22,0,22
"41287",10901,"Marystown","NL",47.09899,-55.19852,2018-09-17 21:00:00,23,0,23
"41288",10901,"Marystown","NL",47.09899,-55.19852,2018-09-17 22:00:00,16,0,16
"41289",10901,"Marystown","NL",47.09899,-55.19852,2018-09-17 23:00:00,18,0,18
"41290",10901,"Marystown","NL",47.09899,-55.19852,2018-09-18 00:00:00,19,0,19
"41291",10901,"Marystown","NL",47.09899,-55.19852,2018-09-18 01:00:00,21,0,21
"41292",10901,"Marystown","NL",47.09899,-55.19852,2018-09-18 02:00:00,22,0,22
"41293",10901,"Marystown","NL",47.09899,-55.19852,2018-09-18 03:00:00,24,0,24
"41294",10901,"Marystown","NL",47.09899,-55.19852,2018-09-18 04:00:00,26,0,26
"41295",10901,"Marystown","NL",47.09899,-55.19852,2018-09-18 05:00:00,27,0,27
"41296",10901,"Marystown","NL",47.09899,-55.19852,2018-09-18 06:00:00,27,0,27
"41297",10901,"Marystown","NL",47.09899,-55.19852,2018-09-18 07:00:00,25,0,25
"41298",10901,"Marystown","NL",47.09899,-55.19852,2018-09-18 08:00:00,25,0,25
"41299",10901,"Marystown","NL",47.09899,-55.19852,2018-09-18 09:00:00,24,0,24
"41300",10901,"Marystown","NL",47.09899,-55.19852,2018-09-18 10:00:00,24,0,24
"41301",10901,"Marystown","NL",47.09899,-55.19852,2018-09-18 11:00:00,24,0,24
"41302",10901,"Marystown","NL",47.09899,-55.19852,2018-09-18 12:00:00,23,0,23
"41303",10901,"Marystown","NL",47.09899,-55.19852,2018-09-18 13:00:00,24,0,24
"41304",10901,"Marystown","NL",47.09899,-55.19852,2018-09-18 14:00:00,24,0,24
"41305",10901,"Marystown","NL",47.09899,-55.19852,2018-09-18 15:00:00,24,0,24
"41306",10901,"Marystown","NL",47.09899,-55.19852,2018-09-18 16:00:00,24,0,24
"41307",10901,"Marystown","NL",47.09899,-55.19852,2018-09-18 17:00:00,24,0,24
"41308",10901,"Marystown","NL",47.09899,-55.19852,2018-09-18 18:00:00,24,0,24
"41309",10901,"Marystown","NL",47.09899,-55.19852,2018-09-18 19:00:00,25,0,25
"41310",10901,"Marystown","NL",47.09899,-55.19852,2018-09-18 20:00:00,27,0,27
"41311",10901,"Marystown","NL",47.09899,-55.19852,2018-09-18 21:00:00,25,0,25
"41312",10901,"Marystown","NL",47.09899,-55.19852,2018-09-18 22:00:00,24,0,24
"41313",10901,"Marystown","NL",47.09899,-55.19852,2018-09-18 23:00:00,23,0,23
"41314",10901,"Marystown","NL",47.09899,-55.19852,2018-09-19 00:00:00,23,0,23
"41315",10901,"Marystown","NL",47.09899,-55.19852,2018-09-19 01:00:00,22,0,22
"41316",10901,"Marystown","NL",47.09899,-55.19852,2018-09-19 02:00:00,20,0,20
"41317",10901,"Marystown","NL",47.09899,-55.19852,2018-09-19 03:00:00,20,0,20
"41318",10901,"Marystown","NL",47.09899,-55.19852,2018-09-19 04:00:00,20,0,20
"41319",10901,"Marystown","NL",47.09899,-55.19852,2018-09-19 05:00:00,20,0,20
"41320",10901,"Marystown","NL",47.09899,-55.19852,2018-09-19 06:00:00,21,0,21
"41321",10901,"Marystown","NL",47.09899,-55.19852,2018-09-19 07:00:00,20,0,20
"41322",10901,"Marystown","NL",47.09899,-55.19852,2018-09-19 08:00:00,19,0,19
"41323",10901,"Marystown","NL",47.09899,-55.19852,2018-09-19 09:00:00,19,0,19
"41324",10901,"Marystown","NL",47.09899,-55.19852,2018-09-19 10:00:00,20,0,20
"41325",10901,"Marystown","NL",47.09899,-55.19852,2018-09-19 11:00:00,22,0,22
"41326",10901,"Marystown","NL",47.09899,-55.19852,2018-09-19 12:00:00,22,0,22
"41327",10901,"Marystown","NL",47.09899,-55.19852,2018-09-19 13:00:00,22,0,22
"41328",10901,"Marystown","NL",47.09899,-55.19852,2018-09-19 14:00:00,22,0,22
"41329",10901,"Marystown","NL",47.09899,-55.19852,2018-09-19 15:00:00,23,0,23
"41330",10901,"Marystown","NL",47.09899,-55.19852,2018-09-19 16:00:00,24,0,24
"41331",10901,"Marystown","NL",47.09899,-55.19852,2018-09-19 17:00:00,25,0,25
"41332",10901,"Marystown","NL",47.09899,-55.19852,2018-09-19 18:00:00,26,0,26
"41333",10901,"Marystown","NL",47.09899,-55.19852,2018-09-19 19:00:00,26,0,26
"41334",10901,"Marystown","NL",47.09899,-55.19852,2018-09-19 20:00:00,26,0,26
"41335",10901,"Marystown","NL",47.09899,-55.19852,2018-09-19 21:00:00,27,0,27
"41336",10901,"Marystown","NL",47.09899,-55.19852,2018-09-19 22:00:00,28,0,28
"41337",10901,"Marystown","NL",47.09899,-55.19852,2018-09-19 23:00:00,26,0,26
"41338",10901,"Marystown","NL",47.09899,-55.19852,2018-09-20 00:00:00,26,0,26
"41339",10901,"Marystown","NL",47.09899,-55.19852,2018-09-20 01:00:00,24,0,24
"41340",10901,"Marystown","NL",47.09899,-55.19852,2018-09-20 02:00:00,24,0,24
"41341",10901,"Marystown","NL",47.09899,-55.19852,2018-09-20 03:00:00,23,0,23
"41342",10901,"Marystown","NL",47.09899,-55.19852,2018-09-20 04:00:00,22,0,22
"41343",10901,"Marystown","NL",47.09899,-55.19852,2018-09-20 05:00:00,23,0,23
"41344",10901,"Marystown","NL",47.09899,-55.19852,2018-09-20 06:00:00,24,0,24
"41345",10901,"Marystown","NL",47.09899,-55.19852,2018-09-20 07:00:00,24,0,24
"41346",10901,"Marystown","NL",47.09899,-55.19852,2018-09-20 08:00:00,25,0,25
"41347",10901,"Marystown","NL",47.09899,-55.19852,2018-09-20 09:00:00,27,0,27
"41348",10901,"Marystown","NL",47.09899,-55.19852,2018-09-20 10:00:00,28,0,28
"41349",10901,"Marystown","NL",47.09899,-55.19852,2018-09-20 11:00:00,30,0,30
"41350",10901,"Marystown","NL",47.09899,-55.19852,2018-09-20 12:00:00,28,0,28
"41351",10901,"Marystown","NL",47.09899,-55.19852,2018-09-20 13:00:00,28,0,28
"41352",10901,"Marystown","NL",47.09899,-55.19852,2018-09-20 14:00:00,28,0,28
"41353",10901,"Marystown","NL",47.09899,-55.19852,2018-09-20 15:00:00,28,0,28
"41354",10901,"Marystown","NL",47.09899,-55.19852,2018-09-20 16:00:00,29,0,29
"41355",10901,"Marystown","NL",47.09899,-55.19852,2018-09-20 17:00:00,29,0,29
"41356",10901,"Marystown","NL",47.09899,-55.19852,2018-09-20 18:00:00,27,0,27
"41357",10901,"Marystown","NL",47.09899,-55.19852,2018-09-20 19:00:00,25,0,25
"41358",10901,"Marystown","NL",47.09899,-55.19852,2018-09-20 20:00:00,26,0,26
"41359",10901,"Marystown","NL",47.09899,-55.19852,2018-09-20 21:00:00,26,0,26
"41360",10901,"Marystown","NL",47.09899,-55.19852,2018-09-20 22:00:00,26,0,26
"41361",10901,"Marystown","NL",47.09899,-55.19852,2018-09-20 23:00:00,24,0,24
"41362",10901,"Marystown","NL",47.09899,-55.19852,2018-09-21 00:00:00,23,0,23
"41363",10901,"Marystown","NL",47.09899,-55.19852,2018-09-21 01:00:00,24,0,24
"41364",10901,"Marystown","NL",47.09899,-55.19852,2018-09-21 02:00:00,18,0,18
"41365",10901,"Marystown","NL",47.09899,-55.19852,2018-09-21 03:00:00,14,0,14
"41366",10901,"Marystown","NL",47.09899,-55.19852,2018-09-21 04:00:00,12,0,12
"41367",10901,"Marystown","NL",47.09899,-55.19852,2018-09-21 05:00:00,10,0,10
"41368",10901,"Marystown","NL",47.09899,-55.19852,2018-09-21 06:00:00,9,1,10
"41369",10901,"Marystown","NL",47.09899,-55.19852,2018-09-21 07:00:00,8,1,9
"41370",10901,"Marystown","NL",47.09899,-55.19852,2018-09-21 08:00:00,14,2,16
"41371",10901,"Marystown","NL",47.09899,-55.19852,2018-09-21 09:00:00,22,0,22
"41372",10901,"Marystown","NL",47.09899,-55.19852,2018-09-21 10:00:00,23,0,23
"41373",10901,"Marystown","NL",47.09899,-55.19852,2018-09-21 11:00:00,24,0,24
"41374",10901,"Marystown","NL",47.09899,-55.19852,2018-09-21 12:00:00,25,0,25
"41375",10901,"Marystown","NL",47.09899,-55.19852,2018-09-21 13:00:00,25,0,25
"41376",10901,"Marystown","NL",47.09899,-55.19852,2018-09-21 14:00:00,25,0,25
"41377",10901,"Marystown","NL",47.09899,-55.19852,2018-09-21 15:00:00,25,0,25
"41378",10901,"Marystown","NL",47.09899,-55.19852,2018-09-21 16:00:00,25,0,25
"41379",10901,"Marystown","NL",47.09899,-55.19852,2018-09-21 17:00:00,25,0,25
"41380",10901,"Marystown","NL",47.09899,-55.19852,2018-09-21 18:00:00,25,0,25
"41381",10901,"Marystown","NL",47.09899,-55.19852,2018-09-21 19:00:00,17,0,17
"41382",10901,"Marystown","NL",47.09899,-55.19852,2018-09-21 20:00:00,13,0,13
"41383",10901,"Marystown","NL",47.09899,-55.19852,2018-09-21 21:00:00,10,0,10
"41384",10901,"Marystown","NL",47.09899,-55.19852,2018-09-21 22:00:00,10,0,10
"41385",10901,"Marystown","NL",47.09899,-55.19852,2018-09-21 23:00:00,14,0,14
"41386",10901,"Marystown","NL",47.09899,-55.19852,2018-09-22 00:00:00,10,0,10
"41387",10901,"Marystown","NL",47.09899,-55.19852,2018-09-22 01:00:00,20,0,20
"41388",10901,"Marystown","NL",47.09899,-55.19852,2018-09-22 02:00:00,26,0,26
"41389",10901,"Marystown","NL",47.09899,-55.19852,2018-09-22 03:00:00,26,0,26
"41390",10901,"Marystown","NL",47.09899,-55.19852,2018-09-22 04:00:00,27,0,27
"41391",10901,"Marystown","NL",47.09899,-55.19852,2018-09-22 05:00:00,27,0,27
"41392",10901,"Marystown","NL",47.09899,-55.19852,2018-09-22 06:00:00,28,0,28
"41393",10901,"Marystown","NL",47.09899,-55.19852,2018-09-22 07:00:00,28,0,28
"41394",10901,"Marystown","NL",47.09899,-55.19852,2018-09-22 08:00:00,28,0,28
"41395",10901,"Marystown","NL",47.09899,-55.19852,2018-09-22 09:00:00,28,0,28
"41396",10901,"Marystown","NL",47.09899,-55.19852,2018-09-22 10:00:00,31,0,31
"41397",10901,"Marystown","NL",47.09899,-55.19852,2018-09-22 11:00:00,32,0,32
"41398",10901,"Marystown","NL",47.09899,-55.19852,2018-09-22 12:00:00,32,0,32
"41399",10901,"Marystown","NL",47.09899,-55.19852,2018-09-22 13:00:00,32,0,32
"41400",10901,"Marystown","NL",47.09899,-55.19852,2018-09-22 14:00:00,33,0,33
"41401",10901,"Marystown","NL",47.09899,-55.19852,2018-09-22 15:00:00,34,0,34
"41402",10901,"Marystown","NL",47.09899,-55.19852,2018-09-22 16:00:00,35,0,35
"41403",10901,"Marystown","NL",47.09899,-55.19852,2018-09-22 17:00:00,34,0,34
"41404",10901,"Marystown","NL",47.09899,-55.19852,2018-09-22 18:00:00,31,0,31
"41405",10901,"Marystown","NL",47.09899,-55.19852,2018-09-22 19:00:00,18,0,18
"41406",10901,"Marystown","NL",47.09899,-55.19852,2018-09-22 20:00:00,20,0,20
"41407",10901,"Marystown","NL",47.09899,-55.19852,2018-09-22 21:00:00,22,0,22
"41408",10901,"Marystown","NL",47.09899,-55.19852,2018-09-22 22:00:00,25,0,25
"41409",10901,"Marystown","NL",47.09899,-55.19852,2018-09-22 23:00:00,25,0,25
"41410",10901,"Marystown","NL",47.09899,-55.19852,2018-09-23 00:00:00,24,0,24
"41411",10901,"Marystown","NL",47.09899,-55.19852,2018-09-23 01:00:00,25,0,25
"41412",10901,"Marystown","NL",47.09899,-55.19852,2018-09-23 02:00:00,21,0,21
"41413",10901,"Marystown","NL",47.09899,-55.19852,2018-09-23 03:00:00,18,0,18
"41414",10901,"Marystown","NL",47.09899,-55.19852,2018-09-23 04:00:00,25,0,25
"41415",10901,"Marystown","NL",47.09899,-55.19852,2018-09-23 05:00:00,25,0,25
"41416",10901,"Marystown","NL",47.09899,-55.19852,2018-09-23 06:00:00,24,0,24
"41417",10901,"Marystown","NL",47.09899,-55.19852,2018-09-23 07:00:00,19,0,19
"41418",10901,"Marystown","NL",47.09899,-55.19852,2018-09-23 08:00:00,21,0,21
"41419",10901,"Marystown","NL",47.09899,-55.19852,2018-09-23 09:00:00,26,0,26
"41420",10901,"Marystown","NL",47.09899,-55.19852,2018-09-23 10:00:00,26,0,26
"41421",10901,"Marystown","NL",47.09899,-55.19852,2018-09-23 11:00:00,27,0,27
"41422",10901,"Marystown","NL",47.09899,-55.19852,2018-09-23 12:00:00,26,0,26
"41423",10901,"Marystown","NL",47.09899,-55.19852,2018-09-23 13:00:00,27,0,27
"41424",10901,"Marystown","NL",47.09899,-55.19852,2018-09-23 14:00:00,27,0,27
"41425",10901,"Marystown","NL",47.09899,-55.19852,2018-09-23 15:00:00,27,0,27
"41426",10901,"Marystown","NL",47.09899,-55.19852,2018-09-23 16:00:00,27,0,27
"41427",10901,"Marystown","NL",47.09899,-55.19852,2018-09-23 17:00:00,28,0,28
"41428",10901,"Marystown","NL",47.09899,-55.19852,2018-09-23 18:00:00,29,0,29
"41429",10901,"Marystown","NL",47.09899,-55.19852,2018-09-23 19:00:00,27,0,27
"41430",10901,"Marystown","NL",47.09899,-55.19852,2018-09-23 20:00:00,27,0,27
"41431",10901,"Marystown","NL",47.09899,-55.19852,2018-09-23 21:00:00,26,0,26
"41432",10901,"Marystown","NL",47.09899,-55.19852,2018-09-23 22:00:00,27,0,27
"41433",10901,"Marystown","NL",47.09899,-55.19852,2018-09-23 23:00:00,25,0,25
"41434",10901,"Marystown","NL",47.09899,-55.19852,2018-09-24 00:00:00,25,0,25
"41435",10901,"Marystown","NL",47.09899,-55.19852,2018-09-24 01:00:00,24,0,24
"41436",10901,"Marystown","NL",47.09899,-55.19852,2018-09-24 02:00:00,24,0,24
"41437",10901,"Marystown","NL",47.09899,-55.19852,2018-09-24 03:00:00,23,0,23
"41438",10901,"Marystown","NL",47.09899,-55.19852,2018-09-24 04:00:00,20,0,20
"41439",10901,"Marystown","NL",47.09899,-55.19852,2018-09-24 05:00:00,21,0,21
"41440",10901,"Marystown","NL",47.09899,-55.19852,2018-09-24 06:00:00,24,0,24
"41441",10901,"Marystown","NL",47.09899,-55.19852,2018-09-24 07:00:00,25,0,25
"41442",10901,"Marystown","NL",47.09899,-55.19852,2018-09-24 08:00:00,23,0,23
"41443",10901,"Marystown","NL",47.09899,-55.19852,2018-09-24 09:00:00,23,0,23
"41444",10901,"Marystown","NL",47.09899,-55.19852,2018-09-24 10:00:00,24,0,24
"41445",10901,"Marystown","NL",47.09899,-55.19852,2018-09-24 11:00:00,24,0,24
"41446",10901,"Marystown","NL",47.09899,-55.19852,2018-09-24 12:00:00,23,0,23
"41447",10901,"Marystown","NL",47.09899,-55.19852,2018-09-24 13:00:00,23,0,23
"41448",10901,"Marystown","NL",47.09899,-55.19852,2018-09-24 14:00:00,23,0,23
"41449",10901,"Marystown","NL",47.09899,-55.19852,2018-09-24 15:00:00,23,0,23
"41450",10901,"Marystown","NL",47.09899,-55.19852,2018-09-24 16:00:00,23,0,23
"41451",10901,"Marystown","NL",47.09899,-55.19852,2018-09-24 17:00:00,24,0,24
"41452",10901,"Marystown","NL",47.09899,-55.19852,2018-09-24 18:00:00,23,0,23
"41453",10901,"Marystown","NL",47.09899,-55.19852,2018-09-24 19:00:00,21,0,21
"41454",10901,"Marystown","NL",47.09899,-55.19852,2018-09-24 20:00:00,13,0,13
"41455",10901,"Marystown","NL",47.09899,-55.19852,2018-09-24 21:00:00,13,0,13
"41456",10901,"Marystown","NL",47.09899,-55.19852,2018-09-24 22:00:00,11,1,12
"41457",10901,"Marystown","NL",47.09899,-55.19852,2018-09-24 23:00:00,11,0,11
"41458",10901,"Marystown","NL",47.09899,-55.19852,2018-09-25 00:00:00,11,0,11
"41459",10901,"Marystown","NL",47.09899,-55.19852,2018-09-25 01:00:00,11,0,11
"41460",10901,"Marystown","NL",47.09899,-55.19852,2018-09-25 02:00:00,9,0,9
"41461",10901,"Marystown","NL",47.09899,-55.19852,2018-09-25 03:00:00,9,0,9
"41462",10901,"Marystown","NL",47.09899,-55.19852,2018-09-25 04:00:00,10,0,10
"41463",10901,"Marystown","NL",47.09899,-55.19852,2018-09-25 05:00:00,8,0,8
"41464",10901,"Marystown","NL",47.09899,-55.19852,2018-09-25 06:00:00,8,0,8
"41465",10901,"Marystown","NL",47.09899,-55.19852,2018-09-25 07:00:00,7,0,7
"41466",10901,"Marystown","NL",47.09899,-55.19852,2018-09-25 08:00:00,7,1,8
"41467",10901,"Marystown","NL",47.09899,-55.19852,2018-09-25 09:00:00,19,0,19
"41468",10901,"Marystown","NL",47.09899,-55.19852,2018-09-25 10:00:00,20,0,20
"41469",10901,"Marystown","NL",47.09899,-55.19852,2018-09-25 11:00:00,22,0,22
"41470",10901,"Marystown","NL",47.09899,-55.19852,2018-09-25 12:00:00,24,0,24
"41471",10901,"Marystown","NL",47.09899,-55.19852,2018-09-25 13:00:00,25,0,25
"41472",10901,"Marystown","NL",47.09899,-55.19852,2018-09-25 14:00:00,25,0,25
"41473",10901,"Marystown","NL",47.09899,-55.19852,2018-09-25 15:00:00,25,0,25
"41474",10901,"Marystown","NL",47.09899,-55.19852,2018-09-25 16:00:00,25,0,25
"41475",10901,"Marystown","NL",47.09899,-55.19852,2018-09-25 17:00:00,26,0,26
"41476",10901,"Marystown","NL",47.09899,-55.19852,2018-09-25 18:00:00,25,0,25
"41477",10901,"Marystown","NL",47.09899,-55.19852,2018-09-25 19:00:00,23,0,23
"41478",10901,"Marystown","NL",47.09899,-55.19852,2018-09-25 20:00:00,23,0,23
"41479",10901,"Marystown","NL",47.09899,-55.19852,2018-09-25 21:00:00,17,0,17
"41480",10901,"Marystown","NL",47.09899,-55.19852,2018-09-25 22:00:00,13,0,13
"41481",10901,"Marystown","NL",47.09899,-55.19852,2018-09-25 23:00:00,12,0,12
"41482",10901,"Marystown","NL",47.09899,-55.19852,2018-09-26 00:00:00,14,0,14
"41483",10901,"Marystown","NL",47.09899,-55.19852,2018-09-26 01:00:00,16,0,16
"41484",10901,"Marystown","NL",47.09899,-55.19852,2018-09-26 02:00:00,13,0,13
"41485",10901,"Marystown","NL",47.09899,-55.19852,2018-09-26 03:00:00,11,0,11
"41486",10901,"Marystown","NL",47.09899,-55.19852,2018-09-26 04:00:00,10,0,10
"41487",10901,"Marystown","NL",47.09899,-55.19852,2018-09-26 05:00:00,10,0,10
"41488",10901,"Marystown","NL",47.09899,-55.19852,2018-09-26 06:00:00,10,0,10
"41489",10901,"Marystown","NL",47.09899,-55.19852,2018-09-26 07:00:00,10,1,11
"41490",10901,"Marystown","NL",47.09899,-55.19852,2018-09-26 08:00:00,13,2,15
"41491",10901,"Marystown","NL",47.09899,-55.19852,2018-09-26 09:00:00,20,1,21
"41492",10901,"Marystown","NL",47.09899,-55.19852,2018-09-26 10:00:00,26,0,26
"41493",10901,"Marystown","NL",47.09899,-55.19852,2018-09-26 11:00:00,25,0,25
"41494",10901,"Marystown","NL",47.09899,-55.19852,2018-09-26 12:00:00,24,0,24
"41495",10901,"Marystown","NL",47.09899,-55.19852,2018-09-26 13:00:00,25,0,25
"41496",10901,"Marystown","NL",47.09899,-55.19852,2018-09-26 14:00:00,25,0,25
"41497",10901,"Marystown","NL",47.09899,-55.19852,2018-09-26 15:00:00,25,0,25
"41498",10901,"Marystown","NL",47.09899,-55.19852,2018-09-26 16:00:00,24,0,24
"41499",10901,"Marystown","NL",47.09899,-55.19852,2018-09-26 17:00:00,24,0,24
"41500",10901,"Marystown","NL",47.09899,-55.19852,2018-09-26 18:00:00,24,0,24
"41501",10901,"Marystown","NL",47.09899,-55.19852,2018-09-26 19:00:00,25,0,25
"41502",10901,"Marystown","NL",47.09899,-55.19852,2018-09-26 20:00:00,26,0,26
"41503",10901,"Marystown","NL",47.09899,-55.19852,2018-09-26 21:00:00,25,0,25
"41504",10901,"Marystown","NL",47.09899,-55.19852,2018-09-26 22:00:00,27,0,27
"41505",10901,"Marystown","NL",47.09899,-55.19852,2018-09-26 23:00:00,28,0,28
"41506",10901,"Marystown","NL",47.09899,-55.19852,2018-09-27 00:00:00,29,0,29
"41507",10901,"Marystown","NL",47.09899,-55.19852,2018-09-27 01:00:00,30,0,30
"41508",10901,"Marystown","NL",47.09899,-55.19852,2018-09-27 02:00:00,30,0,30
"41509",10901,"Marystown","NL",47.09899,-55.19852,2018-09-27 03:00:00,29,0,29
"41510",10901,"Marystown","NL",47.09899,-55.19852,2018-09-27 04:00:00,30,0,30
"41511",10901,"Marystown","NL",47.09899,-55.19852,2018-09-27 05:00:00,30,0,30
"41512",10901,"Marystown","NL",47.09899,-55.19852,2018-09-27 06:00:00,30,0,30
"41513",10901,"Marystown","NL",47.09899,-55.19852,2018-09-27 07:00:00,30,0,30
"41514",10901,"Marystown","NL",47.09899,-55.19852,2018-09-27 08:00:00,30,0,30
"41515",10901,"Marystown","NL",47.09899,-55.19852,2018-09-27 09:00:00,31,0,31
"41516",10901,"Marystown","NL",47.09899,-55.19852,2018-09-27 10:00:00,31,0,31
"41517",10901,"Marystown","NL",47.09899,-55.19852,2018-09-27 11:00:00,25,0,25
"41518",10901,"Marystown","NL",47.09899,-55.19852,2018-09-27 12:00:00,30,0,30
"41519",10901,"Marystown","NL",47.09899,-55.19852,2018-09-27 13:00:00,30,0,30
"41520",10901,"Marystown","NL",47.09899,-55.19852,2018-09-27 14:00:00,31,0,31
"41521",10901,"Marystown","NL",47.09899,-55.19852,2018-09-27 15:00:00,31,0,31
"41522",10901,"Marystown","NL",47.09899,-55.19852,2018-09-27 16:00:00,32,0,32
"41523",10901,"Marystown","NL",47.09899,-55.19852,2018-09-27 17:00:00,32,0,32
"41524",10901,"Marystown","NL",47.09899,-55.19852,2018-09-27 18:00:00,30,0,30
"41525",10901,"Marystown","NL",47.09899,-55.19852,2018-09-27 19:00:00,23,0,23
"41526",10901,"Marystown","NL",47.09899,-55.19852,2018-09-27 20:00:00,24,0,24
"41527",10901,"Marystown","NL",47.09899,-55.19852,2018-09-27 21:00:00,22,0,22
"41528",10901,"Marystown","NL",47.09899,-55.19852,2018-09-27 22:00:00,21,0,21
"41529",10901,"Marystown","NL",47.09899,-55.19852,2018-09-27 23:00:00,18,0,18
"41530",10901,"Marystown","NL",47.09899,-55.19852,2018-09-28 00:00:00,18,0,18
"41531",10901,"Marystown","NL",47.09899,-55.19852,2018-09-28 01:00:00,18,0,18
"41532",10901,"Marystown","NL",47.09899,-55.19852,2018-09-28 02:00:00,17,0,17
"41533",10901,"Marystown","NL",47.09899,-55.19852,2018-09-28 03:00:00,21,0,21
"41534",10901,"Marystown","NL",47.09899,-55.19852,2018-09-28 04:00:00,21,0,21
"41535",10901,"Marystown","NL",47.09899,-55.19852,2018-09-28 05:00:00,20,0,20
"41536",10901,"Marystown","NL",47.09899,-55.19852,2018-09-28 06:00:00,21,0,21
"41537",10901,"Marystown","NL",47.09899,-55.19852,2018-09-28 07:00:00,21,0,21
"41538",10901,"Marystown","NL",47.09899,-55.19852,2018-09-28 08:00:00,21,0,21
"41539",10901,"Marystown","NL",47.09899,-55.19852,2018-09-28 09:00:00,20,0,20
"41540",10901,"Marystown","NL",47.09899,-55.19852,2018-09-28 10:00:00,20,0,20
"41541",10901,"Marystown","NL",47.09899,-55.19852,2018-09-28 11:00:00,21,0,21
"41542",10901,"Marystown","NL",47.09899,-55.19852,2018-09-28 12:00:00,20,0,20
"41543",10901,"Marystown","NL",47.09899,-55.19852,2018-09-28 13:00:00,22,0,22
"41544",10901,"Marystown","NL",47.09899,-55.19852,2018-09-28 14:00:00,22,0,22
"41545",10901,"Marystown","NL",47.09899,-55.19852,2018-09-28 15:00:00,21,0,21
"41546",10901,"Marystown","NL",47.09899,-55.19852,2018-09-28 16:00:00,21,0,21
"41547",10901,"Marystown","NL",47.09899,-55.19852,2018-09-28 17:00:00,21,0,21
"41548",10901,"Marystown","NL",47.09899,-55.19852,2018-09-28 18:00:00,24,0,24
"41549",10901,"Marystown","NL",47.09899,-55.19852,2018-09-28 19:00:00,33,0,33
"41550",10901,"Marystown","NL",47.09899,-55.19852,2018-09-28 20:00:00,33,0,33
"41551",10901,"Marystown","NL",47.09899,-55.19852,2018-09-28 21:00:00,31,0,31
"41552",10901,"Marystown","NL",47.09899,-55.19852,2018-09-28 22:00:00,31,0,31
"41553",10901,"Marystown","NL",47.09899,-55.19852,2018-09-28 23:00:00,31,0,31
"41554",10901,"Marystown","NL",47.09899,-55.19852,2018-09-29 00:00:00,30,0,30
"41555",10901,"Marystown","NL",47.09899,-55.19852,2018-09-29 01:00:00,31,0,31
"41556",10901,"Marystown","NL",47.09899,-55.19852,2018-09-29 02:00:00,30,0,30
"41557",10901,"Marystown","NL",47.09899,-55.19852,2018-09-29 03:00:00,30,0,30
"41558",10901,"Marystown","NL",47.09899,-55.19852,2018-09-29 04:00:00,29,0,29
"41559",10901,"Marystown","NL",47.09899,-55.19852,2018-09-29 05:00:00,28,0,28
"41560",10901,"Marystown","NL",47.09899,-55.19852,2018-09-29 06:00:00,27,0,27
"41561",10901,"Marystown","NL",47.09899,-55.19852,2018-09-29 07:00:00,27,0,27
"41562",10901,"Marystown","NL",47.09899,-55.19852,2018-09-29 08:00:00,26,0,26
"41563",10901,"Marystown","NL",47.09899,-55.19852,2018-09-29 09:00:00,26,0,26
"41564",10901,"Marystown","NL",47.09899,-55.19852,2018-09-29 10:00:00,25,0,25
"41565",10901,"Marystown","NL",47.09899,-55.19852,2018-09-29 11:00:00,24,0,24
"41566",10901,"Marystown","NL",47.09899,-55.19852,2018-09-29 12:00:00,25,0,25
"41567",10901,"Marystown","NL",47.09899,-55.19852,2018-09-29 13:00:00,25,0,25
"41568",10901,"Marystown","NL",47.09899,-55.19852,2018-09-29 14:00:00,25,0,25
"41569",10901,"Marystown","NL",47.09899,-55.19852,2018-09-29 15:00:00,25,0,25
"41570",10901,"Marystown","NL",47.09899,-55.19852,2018-09-29 16:00:00,24,0,24
"41571",10901,"Marystown","NL",47.09899,-55.19852,2018-09-29 17:00:00,24,0,24
"41572",10901,"Marystown","NL",47.09899,-55.19852,2018-09-29 18:00:00,24,0,24
"41573",10901,"Marystown","NL",47.09899,-55.19852,2018-09-29 19:00:00,24,0,24
"41574",10901,"Marystown","NL",47.09899,-55.19852,2018-09-29 20:00:00,23,0,23
"41575",10901,"Marystown","NL",47.09899,-55.19852,2018-09-29 21:00:00,21,0,21
"41576",10901,"Marystown","NL",47.09899,-55.19852,2018-09-29 22:00:00,20,0,20
"41577",10901,"Marystown","NL",47.09899,-55.19852,2018-09-29 23:00:00,20,0,20
"41578",10901,"Marystown","NL",47.09899,-55.19852,2018-09-30 00:00:00,19,1,20
"41579",10901,"Marystown","NL",47.09899,-55.19852,2018-09-30 01:00:00,21,0,21
"41580",10901,"Marystown","NL",47.09899,-55.19852,2018-09-30 02:00:00,20,0,20
"41581",10901,"Marystown","NL",47.09899,-55.19852,2018-09-30 03:00:00,18,0,18
"41582",10901,"Marystown","NL",47.09899,-55.19852,2018-09-30 04:00:00,20,0,20
"41583",10901,"Marystown","NL",47.09899,-55.19852,2018-09-30 05:00:00,19,0,19
"41584",10901,"Marystown","NL",47.09899,-55.19852,2018-09-30 06:00:00,19,0,19
"41585",10901,"Marystown","NL",47.09899,-55.19852,2018-09-30 07:00:00,17,0,17
"41586",10901,"Marystown","NL",47.09899,-55.19852,2018-09-30 08:00:00,16,0,16
"41587",10901,"Marystown","NL",47.09899,-55.19852,2018-09-30 09:00:00,19,0,19
"41588",10901,"Marystown","NL",47.09899,-55.19852,2018-09-30 10:00:00,21,0,21
"41589",10901,"Marystown","NL",47.09899,-55.19852,2018-09-30 11:00:00,21,0,21
"41590",10901,"Marystown","NL",47.09899,-55.19852,2018-09-30 12:00:00,19,0,19
"41591",10901,"Marystown","NL",47.09899,-55.19852,2018-09-30 13:00:00,19,0,19
"41592",10901,"Marystown","NL",47.09899,-55.19852,2018-09-30 14:00:00,20,0,20
"41593",10901,"Marystown","NL",47.09899,-55.19852,2018-09-30 15:00:00,21,0,21
"41594",10901,"Marystown","NL",47.09899,-55.19852,2018-09-30 16:00:00,22,0,22
"41595",10901,"Marystown","NL",47.09899,-55.19852,2018-09-30 17:00:00,22,0,22
"41596",10901,"Marystown","NL",47.09899,-55.19852,2018-09-30 18:00:00,19,0,19
"41597",10901,"Marystown","NL",47.09899,-55.19852,2018-09-30 19:00:00,9,0,9
"41598",10901,"Marystown","NL",47.09899,-55.19852,2018-09-30 20:00:00,9,0,9
"41599",10901,"Marystown","NL",47.09899,-55.19852,2018-09-30 21:00:00,15,0,15
"41600",10901,"Marystown","NL",47.09899,-55.19852,2018-09-30 22:00:00,20,0,20
"41601",10901,"Marystown","NL",47.09899,-55.19852,2018-09-30 23:00:00,19,0,19
"41602",10901,"Marystown","NL",47.09899,-55.19852,2018-10-01 00:00:00,19,0,19
"41603",10901,"Marystown","NL",47.09899,-55.19852,2018-10-01 01:00:00,15,0,15
"41604",10901,"Marystown","NL",47.09899,-55.19852,2018-10-01 02:00:00,8,0,8
"41605",10901,"Marystown","NL",47.09899,-55.19852,2018-10-01 03:00:00,6,0,6
"41606",10901,"Marystown","NL",47.09899,-55.19852,2018-10-01 04:00:00,5,0,5
"41607",10901,"Marystown","NL",47.09899,-55.19852,2018-10-01 05:00:00,5,0,5
"41608",10901,"Marystown","NL",47.09899,-55.19852,2018-10-01 06:00:00,4,0,4
"41609",10901,"Marystown","NL",47.09899,-55.19852,2018-10-01 07:00:00,3,0,3
"41610",10901,"Marystown","NL",47.09899,-55.19852,2018-10-01 08:00:00,5,1,6
"41611",10901,"Marystown","NL",47.09899,-55.19852,2018-10-01 09:00:00,14,0,14
"41612",10901,"Marystown","NL",47.09899,-55.19852,2018-10-01 10:00:00,17,0,17
"41613",10901,"Marystown","NL",47.09899,-55.19852,2018-10-01 11:00:00,18,0,18
"41614",10901,"Marystown","NL",47.09899,-55.19852,2018-10-01 12:00:00,18,0,18
"41615",10901,"Marystown","NL",47.09899,-55.19852,2018-10-01 13:00:00,19,0,19
"41616",10901,"Marystown","NL",47.09899,-55.19852,2018-10-01 14:00:00,19,0,19
"41617",10901,"Marystown","NL",47.09899,-55.19852,2018-10-01 15:00:00,20,0,20
"41618",10901,"Marystown","NL",47.09899,-55.19852,2018-10-01 16:00:00,21,0,21
"41619",10901,"Marystown","NL",47.09899,-55.19852,2018-10-01 17:00:00,20,0,20
"41620",10901,"Marystown","NL",47.09899,-55.19852,2018-10-01 18:00:00,20,0,20
"41621",10901,"Marystown","NL",47.09899,-55.19852,2018-10-01 19:00:00,20,0,20
"41622",10901,"Marystown","NL",47.09899,-55.19852,2018-10-01 20:00:00,21,0,21
"41623",10901,"Marystown","NL",47.09899,-55.19852,2018-10-01 21:00:00,15,0,15
"41624",10901,"Marystown","NL",47.09899,-55.19852,2018-10-01 22:00:00,11,1,12
"41625",10901,"Marystown","NL",47.09899,-55.19852,2018-10-01 23:00:00,17,0,17
"41626",10901,"Marystown","NL",47.09899,-55.19852,2018-10-02 00:00:00,14,0,14
"41627",10901,"Marystown","NL",47.09899,-55.19852,2018-10-02 01:00:00,16,0,16
"41628",10901,"Marystown","NL",47.09899,-55.19852,2018-10-02 02:00:00,15,0,15
"41629",10901,"Marystown","NL",47.09899,-55.19852,2018-10-02 03:00:00,9,0,9
"41630",10901,"Marystown","NL",47.09899,-55.19852,2018-10-02 04:00:00,7,0,7
"41631",10901,"Marystown","NL",47.09899,-55.19852,2018-10-02 05:00:00,6,0,6
"41632",10901,"Marystown","NL",47.09899,-55.19852,2018-10-02 06:00:00,5,0,5
"41633",10901,"Marystown","NL",47.09899,-55.19852,2018-10-02 07:00:00,4,0,4
"41634",10901,"Marystown","NL",47.09899,-55.19852,2018-10-02 08:00:00,3,1,4
"41635",10901,"Marystown","NL",47.09899,-55.19852,2018-10-02 09:00:00,13,1,14
"41636",10901,"Marystown","NL",47.09899,-55.19852,2018-10-02 10:00:00,19,0,19
"41637",10901,"Marystown","NL",47.09899,-55.19852,2018-10-02 11:00:00,21,0,21
"41638",10901,"Marystown","NL",47.09899,-55.19852,2018-10-02 12:00:00,21,0,21
"41639",10901,"Marystown","NL",47.09899,-55.19852,2018-10-02 13:00:00,21,0,21
"41640",10901,"Marystown","NL",47.09899,-55.19852,2018-10-02 14:00:00,22,0,22
"41641",10901,"Marystown","NL",47.09899,-55.19852,2018-10-02 15:00:00,23,0,23
"41642",10901,"Marystown","NL",47.09899,-55.19852,2018-10-02 16:00:00,23,0,23
"41643",10901,"Marystown","NL",47.09899,-55.19852,2018-10-02 17:00:00,23,0,23
"41644",10901,"Marystown","NL",47.09899,-55.19852,2018-10-02 18:00:00,19,0,19
"41645",10901,"Marystown","NL",47.09899,-55.19852,2018-10-02 19:00:00,10,1,11
"41646",10901,"Marystown","NL",47.09899,-55.19852,2018-10-02 20:00:00,8,0,8
"41647",10901,"Marystown","NL",47.09899,-55.19852,2018-10-02 21:00:00,9,0,9
"41648",10901,"Marystown","NL",47.09899,-55.19852,2018-10-02 22:00:00,7,0,7
"41649",10901,"Marystown","NL",47.09899,-55.19852,2018-10-02 23:00:00,8,0,8
"41650",10901,"Marystown","NL",47.09899,-55.19852,2018-10-03 00:00:00,6,0,6
"41651",10901,"Marystown","NL",47.09899,-55.19852,2018-10-03 01:00:00,5,0,5
"41652",10901,"Marystown","NL",47.09899,-55.19852,2018-10-03 02:00:00,5,0,5
"41653",10901,"Marystown","NL",47.09899,-55.19852,2018-10-03 03:00:00,3,0,3
"41654",10901,"Marystown","NL",47.09899,-55.19852,2018-10-03 04:00:00,2,0,2
"41655",10901,"Marystown","NL",47.09899,-55.19852,2018-10-03 05:00:00,3,0,3
"41656",10901,"Marystown","NL",47.09899,-55.19852,2018-10-03 06:00:00,10,0,10
"41657",10901,"Marystown","NL",47.09899,-55.19852,2018-10-03 07:00:00,22,0,22
"41658",10901,"Marystown","NL",47.09899,-55.19852,2018-10-03 08:00:00,23,0,23
"41659",10901,"Marystown","NL",47.09899,-55.19852,2018-10-03 09:00:00,24,0,24
"41660",10901,"Marystown","NL",47.09899,-55.19852,2018-10-03 10:00:00,24,0,24
"41661",10901,"Marystown","NL",47.09899,-55.19852,2018-10-03 11:00:00,24,0,24
"41662",10901,"Marystown","NL",47.09899,-55.19852,2018-10-03 12:00:00,23,0,23
"41663",10901,"Marystown","NL",47.09899,-55.19852,2018-10-03 13:00:00,25,0,25
"41664",10901,"Marystown","NL",47.09899,-55.19852,2018-10-03 14:00:00,27,0,27
"41665",10901,"Marystown","NL",47.09899,-55.19852,2018-10-03 15:00:00,26,0,26
"41666",10901,"Marystown","NL",47.09899,-55.19852,2018-10-03 16:00:00,27,0,27
"41667",10901,"Marystown","NL",47.09899,-55.19852,2018-10-03 17:00:00,26,0,26
"41668",10901,"Marystown","NL",47.09899,-55.19852,2018-10-03 18:00:00,26,0,26
"41669",10901,"Marystown","NL",47.09899,-55.19852,2018-10-03 19:00:00,26,0,26
"41670",10901,"Marystown","NL",47.09899,-55.19852,2018-10-03 20:00:00,25,0,25
"41671",10901,"Marystown","NL",47.09899,-55.19852,2018-10-03 21:00:00,25,0,25
"41672",10901,"Marystown","NL",47.09899,-55.19852,2018-10-03 22:00:00,26,0,26
"41673",10901,"Marystown","NL",47.09899,-55.19852,2018-10-03 23:00:00,27,0,27
"41674",10901,"Marystown","NL",47.09899,-55.19852,2018-10-04 00:00:00,28,0,28
"41675",10901,"Marystown","NL",47.09899,-55.19852,2018-10-04 01:00:00,26,0,26
"41676",10901,"Marystown","NL",47.09899,-55.19852,2018-10-04 02:00:00,26,0,26
"41677",10901,"Marystown","NL",47.09899,-55.19852,2018-10-04 03:00:00,26,0,26
"41678",10901,"Marystown","NL",47.09899,-55.19852,2018-10-04 04:00:00,26,0,26
"41679",10901,"Marystown","NL",47.09899,-55.19852,2018-10-04 05:00:00,26,0,26
"41680",10901,"Marystown","NL",47.09899,-55.19852,2018-10-04 06:00:00,25,0,25
"41681",10901,"Marystown","NL",47.09899,-55.19852,2018-10-04 07:00:00,25,0,25
"41682",10901,"Marystown","NL",47.09899,-55.19852,2018-10-04 08:00:00,25,0,25
"41683",10901,"Marystown","NL",47.09899,-55.19852,2018-10-04 09:00:00,26,0,26
"41684",10901,"Marystown","NL",47.09899,-55.19852,2018-10-04 10:00:00,27,0,27
"41685",10901,"Marystown","NL",47.09899,-55.19852,2018-10-04 11:00:00,27,0,27
"41686",10901,"Marystown","NL",47.09899,-55.19852,2018-10-04 12:00:00,28,0,28
"41687",10901,"Marystown","NL",47.09899,-55.19852,2018-10-04 13:00:00,28,0,28
"41688",10901,"Marystown","NL",47.09899,-55.19852,2018-10-04 14:00:00,28,0,28
"41689",10901,"Marystown","NL",47.09899,-55.19852,2018-10-04 15:00:00,27,0,27
"41690",10901,"Marystown","NL",47.09899,-55.19852,2018-10-04 16:00:00,28,0,28
"41691",10901,"Marystown","NL",47.09899,-55.19852,2018-10-04 17:00:00,28,0,28
"41692",10901,"Marystown","NL",47.09899,-55.19852,2018-10-04 18:00:00,27,0,27
"41693",10901,"Marystown","NL",47.09899,-55.19852,2018-10-04 19:00:00,27,0,27
"41694",10901,"Marystown","NL",47.09899,-55.19852,2018-10-04 20:00:00,26,0,26
"41695",10901,"Marystown","NL",47.09899,-55.19852,2018-10-04 21:00:00,27,0,27
"41696",10901,"Marystown","NL",47.09899,-55.19852,2018-10-04 22:00:00,28,0,28
"41697",10901,"Marystown","NL",47.09899,-55.19852,2018-10-04 23:00:00,29,0,29
"41698",10901,"Marystown","NL",47.09899,-55.19852,2018-10-05 00:00:00,30,0,30
"41699",10901,"Marystown","NL",47.09899,-55.19852,2018-10-05 01:00:00,30,0,30
"41700",10901,"Marystown","NL",47.09899,-55.19852,2018-10-05 02:00:00,29,0,29
"41701",10901,"Marystown","NL",47.09899,-55.19852,2018-10-05 03:00:00,27,0,27
"41702",10901,"Marystown","NL",47.09899,-55.19852,2018-10-05 04:00:00,26,0,26
"41703",10901,"Marystown","NL",47.09899,-55.19852,2018-10-05 05:00:00,26,0,26
"41704",10901,"Marystown","NL",47.09899,-55.19852,2018-10-05 06:00:00,25,0,25
"41705",10901,"Marystown","NL",47.09899,-55.19852,2018-10-05 07:00:00,25,0,25
"41706",10901,"Marystown","NL",47.09899,-55.19852,2018-10-05 08:00:00,26,0,26
"41707",10901,"Marystown","NL",47.09899,-55.19852,2018-10-05 09:00:00,25,0,25
"41708",10901,"Marystown","NL",47.09899,-55.19852,2018-10-05 10:00:00,22,0,22
"41709",10901,"Marystown","NL",47.09899,-55.19852,2018-10-05 11:00:00,21,0,21
"41710",10901,"Marystown","NL",47.09899,-55.19852,2018-10-05 12:00:00,22,0,22
"41711",10901,"Marystown","NL",47.09899,-55.19852,2018-10-05 13:00:00,19,0,19
"41712",10901,"Marystown","NL",47.09899,-55.19852,2018-10-05 14:00:00,20,0,20
"41713",10901,"Marystown","NL",47.09899,-55.19852,2018-10-05 15:00:00,23,0,23
"41714",10901,"Marystown","NL",47.09899,-55.19852,2018-10-05 16:00:00,22,0,22
"41715",10901,"Marystown","NL",47.09899,-55.19852,2018-10-05 17:00:00,21,0,21
"41716",10901,"Marystown","NL",47.09899,-55.19852,2018-10-05 18:00:00,21,0,21
"41717",10901,"Marystown","NL",47.09899,-55.19852,2018-10-05 19:00:00,19,0,19
"41718",10901,"Marystown","NL",47.09899,-55.19852,2018-10-05 20:00:00,17,0,17
"41719",10901,"Marystown","NL",47.09899,-55.19852,2018-10-05 21:00:00,9,0,9
"41720",10901,"Marystown","NL",47.09899,-55.19852,2018-10-05 22:00:00,9,0,9
"41721",10901,"Marystown","NL",47.09899,-55.19852,2018-10-05 23:00:00,11,0,11
"41722",10901,"Marystown","NL",47.09899,-55.19852,2018-10-06 00:00:00,8,0,8
"41723",10901,"Marystown","NL",47.09899,-55.19852,2018-10-06 01:00:00,8,0,8
"41724",10901,"Marystown","NL",47.09899,-55.19852,2018-10-06 02:00:00,6,0,6
"41725",10901,"Marystown","NL",47.09899,-55.19852,2018-10-06 03:00:00,7,0,7
"41726",10901,"Marystown","NL",47.09899,-55.19852,2018-10-06 04:00:00,7,0,7
"41727",10901,"Marystown","NL",47.09899,-55.19852,2018-10-06 05:00:00,9,0,9
"41728",10901,"Marystown","NL",47.09899,-55.19852,2018-10-06 06:00:00,11,0,11
"41729",10901,"Marystown","NL",47.09899,-55.19852,2018-10-06 07:00:00,10,0,10
"41730",10901,"Marystown","NL",47.09899,-55.19852,2018-10-06 08:00:00,10,1,11
"41731",10901,"Marystown","NL",47.09899,-55.19852,2018-10-06 09:00:00,17,0,17
"41732",10901,"Marystown","NL",47.09899,-55.19852,2018-10-06 10:00:00,21,0,21
"41733",10901,"Marystown","NL",47.09899,-55.19852,2018-10-06 11:00:00,22,0,22
"41734",10901,"Marystown","NL",47.09899,-55.19852,2018-10-06 12:00:00,21,0,21
"41735",10901,"Marystown","NL",47.09899,-55.19852,2018-10-06 13:00:00,22,0,22
"41736",10901,"Marystown","NL",47.09899,-55.19852,2018-10-06 14:00:00,22,0,22
"41737",10901,"Marystown","NL",47.09899,-55.19852,2018-10-06 15:00:00,21,0,21
"41738",10901,"Marystown","NL",47.09899,-55.19852,2018-10-06 16:00:00,21,0,21
"41739",10901,"Marystown","NL",47.09899,-55.19852,2018-10-06 17:00:00,21,0,21
"41740",10901,"Marystown","NL",47.09899,-55.19852,2018-10-06 18:00:00,19,0,19
"41741",10901,"Marystown","NL",47.09899,-55.19852,2018-10-06 19:00:00,16,0,16
"41742",10901,"Marystown","NL",47.09899,-55.19852,2018-10-06 20:00:00,9,1,10
"41743",10901,"Marystown","NL",47.09899,-55.19852,2018-10-06 21:00:00,7,0,7
"41744",10901,"Marystown","NL",47.09899,-55.19852,2018-10-06 22:00:00,6,0,6
"41745",10901,"Marystown","NL",47.09899,-55.19852,2018-10-06 23:00:00,5,0,5
"41746",10901,"Marystown","NL",47.09899,-55.19852,2018-10-07 00:00:00,5,0,5
"41747",10901,"Marystown","NL",47.09899,-55.19852,2018-10-07 01:00:00,4,0,4
"41748",10901,"Marystown","NL",47.09899,-55.19852,2018-10-07 02:00:00,6,0,6
"41749",10901,"Marystown","NL",47.09899,-55.19852,2018-10-07 03:00:00,6,0,6
"41750",10901,"Marystown","NL",47.09899,-55.19852,2018-10-07 04:00:00,4,0,4
"41751",10901,"Marystown","NL",47.09899,-55.19852,2018-10-07 05:00:00,4,0,4
"41752",10901,"Marystown","NL",47.09899,-55.19852,2018-10-07 06:00:00,4,0,4
"41753",10901,"Marystown","NL",47.09899,-55.19852,2018-10-07 07:00:00,4,0,4
"41754",10901,"Marystown","NL",47.09899,-55.19852,2018-10-07 08:00:00,6,0,6
"41755",10901,"Marystown","NL",47.09899,-55.19852,2018-10-07 09:00:00,9,0,9
"41756",10901,"Marystown","NL",47.09899,-55.19852,2018-10-07 10:00:00,14,0,14
"41757",10901,"Marystown","NL",47.09899,-55.19852,2018-10-07 11:00:00,20,0,20
"41758",10901,"Marystown","NL",47.09899,-55.19852,2018-10-07 12:00:00,23,0,23
"41759",10901,"Marystown","NL",47.09899,-55.19852,2018-10-07 13:00:00,24,0,24
"41760",10901,"Marystown","NL",47.09899,-55.19852,2018-10-07 14:00:00,27,0,27
"41761",10901,"Marystown","NL",47.09899,-55.19852,2018-10-07 15:00:00,27,0,27
"41762",10901,"Marystown","NL",47.09899,-55.19852,2018-10-07 16:00:00,27,0,27
"41763",10901,"Marystown","NL",47.09899,-55.19852,2018-10-07 17:00:00,27,0,27
"41764",10901,"Marystown","NL",47.09899,-55.19852,2018-10-07 18:00:00,26,0,26
"41765",10901,"Marystown","NL",47.09899,-55.19852,2018-10-07 19:00:00,23,0,23
"41766",10901,"Marystown","NL",47.09899,-55.19852,2018-10-07 20:00:00,25,0,25
"41767",10901,"Marystown","NL",47.09899,-55.19852,2018-10-07 21:00:00,21,0,21
"41768",10901,"Marystown","NL",47.09899,-55.19852,2018-10-07 22:00:00,16,0,16
"41769",10901,"Marystown","NL",47.09899,-55.19852,2018-10-07 23:00:00,24,0,24
"41770",10901,"Marystown","NL",47.09899,-55.19852,2018-10-08 00:00:00,23,0,23
"41771",10901,"Marystown","NL",47.09899,-55.19852,2018-10-08 01:00:00,19,0,19
"41772",10901,"Marystown","NL",47.09899,-55.19852,2018-10-08 02:00:00,18,0,18
"41773",10901,"Marystown","NL",47.09899,-55.19852,2018-10-08 03:00:00,16,0,16
"41774",10901,"Marystown","NL",47.09899,-55.19852,2018-10-08 04:00:00,14,0,14
"41775",10901,"Marystown","NL",47.09899,-55.19852,2018-10-08 05:00:00,13,0,13
"41776",10901,"Marystown","NL",47.09899,-55.19852,2018-10-08 06:00:00,9,1,10
"41777",10901,"Marystown","NL",47.09899,-55.19852,2018-10-08 07:00:00,8,1,9
"41778",10901,"Marystown","NL",47.09899,-55.19852,2018-10-08 08:00:00,9,1,10
"41779",10901,"Marystown","NL",47.09899,-55.19852,2018-10-08 09:00:00,18,1,19
"41780",10901,"Marystown","NL",47.09899,-55.19852,2018-10-08 10:00:00,25,0,25
"41781",10901,"Marystown","NL",47.09899,-55.19852,2018-10-08 11:00:00,26,0,26
"41782",10901,"Marystown","NL",47.09899,-55.19852,2018-10-08 12:00:00,25,0,25
"41783",10901,"Marystown","NL",47.09899,-55.19852,2018-10-08 13:00:00,26,0,26
"41784",10901,"Marystown","NL",47.09899,-55.19852,2018-10-08 14:00:00,26,0,26
"41785",10901,"Marystown","NL",47.09899,-55.19852,2018-10-08 15:00:00,26,0,26
"41786",10901,"Marystown","NL",47.09899,-55.19852,2018-10-08 16:00:00,25,0,25
"41787",10901,"Marystown","NL",47.09899,-55.19852,2018-10-08 17:00:00,25,0,25
"41788",10901,"Marystown","NL",47.09899,-55.19852,2018-10-08 18:00:00,24,0,24
"41789",10901,"Marystown","NL",47.09899,-55.19852,2018-10-08 19:00:00,23,0,23
"41790",10901,"Marystown","NL",47.09899,-55.19852,2018-10-08 20:00:00,23,0,23
"41791",10901,"Marystown","NL",47.09899,-55.19852,2018-10-08 21:00:00,17,0,17
"41792",10901,"Marystown","NL",47.09899,-55.19852,2018-10-08 22:00:00,13,1,14
"41793",10901,"Marystown","NL",47.09899,-55.19852,2018-10-08 23:00:00,17,0,17
"41794",10901,"Marystown","NL",47.09899,-55.19852,2018-10-09 00:00:00,14,0,14
"41795",10901,"Marystown","NL",47.09899,-55.19852,2018-10-09 01:00:00,12,0,12
"41796",10901,"Marystown","NL",47.09899,-55.19852,2018-10-09 02:00:00,12,0,12
"41797",10901,"Marystown","NL",47.09899,-55.19852,2018-10-09 03:00:00,14,0,14
"41798",10901,"Marystown","NL",47.09899,-55.19852,2018-10-09 04:00:00,13,0,13
"41799",10901,"Marystown","NL",47.09899,-55.19852,2018-10-09 05:00:00,11,0,11
"41800",10901,"Marystown","NL",47.09899,-55.19852,2018-10-09 06:00:00,11,0,11
"41801",10901,"Marystown","NL",47.09899,-55.19852,2018-10-09 07:00:00,9,1,10
"41802",10901,"Marystown","NL",47.09899,-55.19852,2018-10-09 08:00:00,11,1,12
"41803",10901,"Marystown","NL",47.09899,-55.19852,2018-10-09 09:00:00,16,1,17
"41804",10901,"Marystown","NL",47.09899,-55.19852,2018-10-09 10:00:00,20,0,20
"41805",10901,"Marystown","NL",47.09899,-55.19852,2018-10-09 11:00:00,24,0,24
"41806",10901,"Marystown","NL",47.09899,-55.19852,2018-10-09 12:00:00,26,0,26
"41807",10901,"Marystown","NL",47.09899,-55.19852,2018-10-09 13:00:00,26,0,26
"41808",10901,"Marystown","NL",47.09899,-55.19852,2018-10-09 14:00:00,27,0,27
"41809",10901,"Marystown","NL",47.09899,-55.19852,2018-10-09 15:00:00,29,0,29
"41810",10901,"Marystown","NL",47.09899,-55.19852,2018-10-09 16:00:00,25,0,25
"41811",10901,"Marystown","NL",47.09899,-55.19852,2018-10-09 17:00:00,24,0,24
"41812",10901,"Marystown","NL",47.09899,-55.19852,2018-10-09 18:00:00,31,0,31
"41813",10901,"Marystown","NL",47.09899,-55.19852,2018-10-09 19:00:00,25,1,26
"41814",10901,"Marystown","NL",47.09899,-55.19852,2018-10-09 20:00:00,21,1,22
"41815",10901,"Marystown","NL",47.09899,-55.19852,2018-10-09 21:00:00,25,0,25
"41816",10901,"Marystown","NL",47.09899,-55.19852,2018-10-09 22:00:00,26,0,26
"41817",10901,"Marystown","NL",47.09899,-55.19852,2018-10-09 23:00:00,29,0,29
"41818",10901,"Marystown","NL",47.09899,-55.19852,2018-10-10 00:00:00,30,0,30
"41819",10901,"Marystown","NL",47.09899,-55.19852,2018-10-10 01:00:00,29,0,29
"41820",10901,"Marystown","NL",47.09899,-55.19852,2018-10-10 02:00:00,28,0,28
"41821",10901,"Marystown","NL",47.09899,-55.19852,2018-10-10 03:00:00,25,0,25
"41822",10901,"Marystown","NL",47.09899,-55.19852,2018-10-10 04:00:00,24,0,24
"41823",10901,"Marystown","NL",47.09899,-55.19852,2018-10-10 05:00:00,26,0,26
"41824",10901,"Marystown","NL",47.09899,-55.19852,2018-10-10 06:00:00,26,0,26
"41825",10901,"Marystown","NL",47.09899,-55.19852,2018-10-10 07:00:00,25,0,25
"41826",10901,"Marystown","NL",47.09899,-55.19852,2018-10-10 08:00:00,23,0,23
"41827",10901,"Marystown","NL",47.09899,-55.19852,2018-10-10 09:00:00,23,0,23
"41828",10901,"Marystown","NL",47.09899,-55.19852,2018-10-10 10:00:00,22,0,22
"41829",10901,"Marystown","NL",47.09899,-55.19852,2018-10-10 11:00:00,23,0,23
"41830",10901,"Marystown","NL",47.09899,-55.19852,2018-10-10 12:00:00,22,0,22
"41831",10901,"Marystown","NL",47.09899,-55.19852,2018-10-10 13:00:00,20,0,20
"41832",10901,"Marystown","NL",47.09899,-55.19852,2018-10-10 14:00:00,25,0,25
"41833",10901,"Marystown","NL",47.09899,-55.19852,2018-10-10 15:00:00,28,0,28
"41834",10901,"Marystown","NL",47.09899,-55.19852,2018-10-10 16:00:00,29,0,29
"41835",10901,"Marystown","NL",47.09899,-55.19852,2018-10-10 17:00:00,32,0,32
"41836",10901,"Marystown","NL",47.09899,-55.19852,2018-10-10 18:00:00,30,0,30
"41837",10901,"Marystown","NL",47.09899,-55.19852,2018-10-10 19:00:00,27,0,27
"41838",10901,"Marystown","NL",47.09899,-55.19852,2018-10-10 20:00:00,27,0,27
"41839",10901,"Marystown","NL",47.09899,-55.19852,2018-10-10 21:00:00,25,0,25
"41840",10901,"Marystown","NL",47.09899,-55.19852,2018-10-10 22:00:00,26,0,26
"41841",10901,"Marystown","NL",47.09899,-55.19852,2018-10-10 23:00:00,27,0,27
"41842",10901,"Marystown","NL",47.09899,-55.19852,2018-10-11 00:00:00,28,0,28
"41843",10901,"Marystown","NL",47.09899,-55.19852,2018-10-11 01:00:00,28,0,28
"41844",10901,"Marystown","NL",47.09899,-55.19852,2018-10-11 02:00:00,27,0,27
"41845",10901,"Marystown","NL",47.09899,-55.19852,2018-10-11 03:00:00,27,0,27
"41846",10901,"Marystown","NL",47.09899,-55.19852,2018-10-11 04:00:00,26,0,26
"41847",10901,"Marystown","NL",47.09899,-55.19852,2018-10-11 05:00:00,23,0,23
"41848",10901,"Marystown","NL",47.09899,-55.19852,2018-10-11 06:00:00,20,0,20
"41849",10901,"Marystown","NL",47.09899,-55.19852,2018-10-11 07:00:00,21,2,23
"41850",10901,"Marystown","NL",47.09899,-55.19852,2018-10-11 08:00:00,25,1,26
"41851",10901,"Marystown","NL",47.09899,-55.19852,2018-10-11 09:00:00,29,0,29
"41852",10901,"Marystown","NL",47.09899,-55.19852,2018-10-11 10:00:00,30,0,30
"41853",10901,"Marystown","NL",47.09899,-55.19852,2018-10-11 11:00:00,29,0,29
"41854",10901,"Marystown","NL",47.09899,-55.19852,2018-10-11 12:00:00,24,1,25
"41855",10901,"Marystown","NL",47.09899,-55.19852,2018-10-11 13:00:00,NA,1,NA
"41856",10901,"Marystown","NL",47.09899,-55.19852,2018-10-11 14:00:00,26,3,29
"41857",10901,"Marystown","NL",47.09899,-55.19852,2018-10-11 15:00:00,31,1,32
"41858",10901,"Marystown","NL",47.09899,-55.19852,2018-10-11 16:00:00,31,0,31
"41859",10901,"Marystown","NL",47.09899,-55.19852,2018-10-11 17:00:00,30,0,30
"41860",10901,"Marystown","NL",47.09899,-55.19852,2018-10-11 18:00:00,26,1,27
"41861",10901,"Marystown","NL",47.09899,-55.19852,2018-10-11 19:00:00,18,2,20
"41862",10901,"Marystown","NL",47.09899,-55.19852,2018-10-11 20:00:00,16,2,18
"41863",10901,"Marystown","NL",47.09899,-55.19852,2018-10-11 21:00:00,15,2,17
"41864",10901,"Marystown","NL",47.09899,-55.19852,2018-10-11 22:00:00,23,1,24
"41865",10901,"Marystown","NL",47.09899,-55.19852,2018-10-11 23:00:00,27,0,27
"41866",10901,"Marystown","NL",47.09899,-55.19852,2018-10-12 00:00:00,27,0,27
"41867",10901,"Marystown","NL",47.09899,-55.19852,2018-10-12 01:00:00,28,0,28
"41868",10901,"Marystown","NL",47.09899,-55.19852,2018-10-12 02:00:00,29,0,29
"41869",10901,"Marystown","NL",47.09899,-55.19852,2018-10-12 03:00:00,27,0,27
"41870",10901,"Marystown","NL",47.09899,-55.19852,2018-10-12 04:00:00,24,0,24
"41871",10901,"Marystown","NL",47.09899,-55.19852,2018-10-12 05:00:00,28,0,28
"41872",10901,"Marystown","NL",47.09899,-55.19852,2018-10-12 06:00:00,30,1,31
"41873",10901,"Marystown","NL",47.09899,-55.19852,2018-10-12 07:00:00,30,1,31
"41874",10901,"Marystown","NL",47.09899,-55.19852,2018-10-12 08:00:00,30,1,31
"41875",10901,"Marystown","NL",47.09899,-55.19852,2018-10-12 09:00:00,30,1,31
"41876",10901,"Marystown","NL",47.09899,-55.19852,2018-10-12 10:00:00,31,1,32
"41877",10901,"Marystown","NL",47.09899,-55.19852,2018-10-12 11:00:00,31,1,32
"41878",10901,"Marystown","NL",47.09899,-55.19852,2018-10-12 12:00:00,31,1,32
"41879",10901,"Marystown","NL",47.09899,-55.19852,2018-10-12 13:00:00,30,1,31
"41880",10901,"Marystown","NL",47.09899,-55.19852,2018-10-12 14:00:00,30,1,31
"41881",10901,"Marystown","NL",47.09899,-55.19852,2018-10-12 15:00:00,31,1,32
"41882",10901,"Marystown","NL",47.09899,-55.19852,2018-10-12 16:00:00,32,1,33
"41883",10901,"Marystown","NL",47.09899,-55.19852,2018-10-12 17:00:00,32,0,32
"41884",10901,"Marystown","NL",47.09899,-55.19852,2018-10-12 18:00:00,33,0,33
"41885",10901,"Marystown","NL",47.09899,-55.19852,2018-10-12 19:00:00,35,0,35
"41886",10901,"Marystown","NL",47.09899,-55.19852,2018-10-12 20:00:00,34,1,35
"41887",10901,"Marystown","NL",47.09899,-55.19852,2018-10-12 21:00:00,32,0,32
"41888",10901,"Marystown","NL",47.09899,-55.19852,2018-10-12 22:00:00,35,0,35
"41889",10901,"Marystown","NL",47.09899,-55.19852,2018-10-12 23:00:00,35,0,35
"41890",10901,"Marystown","NL",47.09899,-55.19852,2018-10-13 00:00:00,35,0,35
"41891",10901,"Marystown","NL",47.09899,-55.19852,2018-10-13 01:00:00,34,0,34
"41892",10901,"Marystown","NL",47.09899,-55.19852,2018-10-13 02:00:00,34,0,34
"41893",10901,"Marystown","NL",47.09899,-55.19852,2018-10-13 03:00:00,34,0,34
"41894",10901,"Marystown","NL",47.09899,-55.19852,2018-10-13 04:00:00,34,0,34
"41895",10901,"Marystown","NL",47.09899,-55.19852,2018-10-13 05:00:00,32,0,32
"41896",10901,"Marystown","NL",47.09899,-55.19852,2018-10-13 06:00:00,29,0,29
"41897",10901,"Marystown","NL",47.09899,-55.19852,2018-10-13 07:00:00,28,0,28
"41898",10901,"Marystown","NL",47.09899,-55.19852,2018-10-13 08:00:00,26,0,26
"41899",10901,"Marystown","NL",47.09899,-55.19852,2018-10-13 09:00:00,26,0,26
"41900",10901,"Marystown","NL",47.09899,-55.19852,2018-10-13 10:00:00,27,0,27
"41901",10901,"Marystown","NL",47.09899,-55.19852,2018-10-13 11:00:00,27,0,27
"41902",10901,"Marystown","NL",47.09899,-55.19852,2018-10-13 12:00:00,28,0,28
"41903",10901,"Marystown","NL",47.09899,-55.19852,2018-10-13 13:00:00,27,0,27
"41904",10901,"Marystown","NL",47.09899,-55.19852,2018-10-13 14:00:00,27,0,27
"41905",10901,"Marystown","NL",47.09899,-55.19852,2018-10-13 15:00:00,27,0,27
"41906",10901,"Marystown","NL",47.09899,-55.19852,2018-10-13 16:00:00,25,0,25
"41907",10901,"Marystown","NL",47.09899,-55.19852,2018-10-13 17:00:00,23,0,23
"41908",10901,"Marystown","NL",47.09899,-55.19852,2018-10-13 18:00:00,20,1,21
"41909",10901,"Marystown","NL",47.09899,-55.19852,2018-10-13 19:00:00,18,1,19
"41910",10901,"Marystown","NL",47.09899,-55.19852,2018-10-13 20:00:00,20,1,21
"41911",10901,"Marystown","NL",47.09899,-55.19852,2018-10-13 21:00:00,20,0,20
"41912",10901,"Marystown","NL",47.09899,-55.19852,2018-10-13 22:00:00,20,0,20
"41913",10901,"Marystown","NL",47.09899,-55.19852,2018-10-13 23:00:00,20,0,20
"41914",10901,"Marystown","NL",47.09899,-55.19852,2018-10-14 00:00:00,19,0,19
"41915",10901,"Marystown","NL",47.09899,-55.19852,2018-10-14 01:00:00,16,0,16
"41916",10901,"Marystown","NL",47.09899,-55.19852,2018-10-14 02:00:00,16,0,16
"41917",10901,"Marystown","NL",47.09899,-55.19852,2018-10-14 03:00:00,17,0,17
"41918",10901,"Marystown","NL",47.09899,-55.19852,2018-10-14 04:00:00,20,0,20
"41919",10901,"Marystown","NL",47.09899,-55.19852,2018-10-14 05:00:00,22,0,22
"41920",10901,"Marystown","NL",47.09899,-55.19852,2018-10-14 06:00:00,24,0,24
"41921",10901,"Marystown","NL",47.09899,-55.19852,2018-10-14 07:00:00,24,0,24
"41922",10901,"Marystown","NL",47.09899,-55.19852,2018-10-14 08:00:00,23,0,23
"41923",10901,"Marystown","NL",47.09899,-55.19852,2018-10-14 09:00:00,24,0,24
"41924",10901,"Marystown","NL",47.09899,-55.19852,2018-10-14 10:00:00,25,0,25
"41925",10901,"Marystown","NL",47.09899,-55.19852,2018-10-14 11:00:00,28,0,28
"41926",10901,"Marystown","NL",47.09899,-55.19852,2018-10-14 12:00:00,30,0,30
"41927",10901,"Marystown","NL",47.09899,-55.19852,2018-10-14 13:00:00,29,0,29
"41928",10901,"Marystown","NL",47.09899,-55.19852,2018-10-14 14:00:00,32,0,32
"41929",10901,"Marystown","NL",47.09899,-55.19852,2018-10-14 15:00:00,33,0,33
"41930",10901,"Marystown","NL",47.09899,-55.19852,2018-10-14 16:00:00,29,0,29
"41931",10901,"Marystown","NL",47.09899,-55.19852,2018-10-14 17:00:00,27,0,27
"41932",10901,"Marystown","NL",47.09899,-55.19852,2018-10-14 18:00:00,24,0,24
"41933",10901,"Marystown","NL",47.09899,-55.19852,2018-10-14 19:00:00,23,0,23
"41934",10901,"Marystown","NL",47.09899,-55.19852,2018-10-14 20:00:00,25,0,25
"41935",10901,"Marystown","NL",47.09899,-55.19852,2018-10-14 21:00:00,25,0,25
"41936",10901,"Marystown","NL",47.09899,-55.19852,2018-10-14 22:00:00,25,0,25
"41937",10901,"Marystown","NL",47.09899,-55.19852,2018-10-14 23:00:00,26,0,26
"41938",10901,"Marystown","NL",47.09899,-55.19852,2018-10-15 00:00:00,25,0,25
"41939",10901,"Marystown","NL",47.09899,-55.19852,2018-10-15 01:00:00,25,0,25
"41940",10901,"Marystown","NL",47.09899,-55.19852,2018-10-15 02:00:00,24,0,24
"41941",10901,"Marystown","NL",47.09899,-55.19852,2018-10-15 03:00:00,24,0,24
"41942",10901,"Marystown","NL",47.09899,-55.19852,2018-10-15 04:00:00,23,0,23
"41943",10901,"Marystown","NL",47.09899,-55.19852,2018-10-15 05:00:00,23,0,23
"41944",10901,"Marystown","NL",47.09899,-55.19852,2018-10-15 06:00:00,23,0,23
"41945",10901,"Marystown","NL",47.09899,-55.19852,2018-10-15 07:00:00,23,0,23
"41946",10901,"Marystown","NL",47.09899,-55.19852,2018-10-15 08:00:00,24,0,24
"41947",10901,"Marystown","NL",47.09899,-55.19852,2018-10-15 09:00:00,25,0,25
"41948",10901,"Marystown","NL",47.09899,-55.19852,2018-10-15 10:00:00,26,0,26
"41949",10901,"Marystown","NL",47.09899,-55.19852,2018-10-15 11:00:00,26,0,26
"41950",10901,"Marystown","NL",47.09899,-55.19852,2018-10-15 12:00:00,26,0,26
"41951",10901,"Marystown","NL",47.09899,-55.19852,2018-10-15 13:00:00,27,0,27
"41952",10901,"Marystown","NL",47.09899,-55.19852,2018-10-15 14:00:00,29,0,29
"41953",10901,"Marystown","NL",47.09899,-55.19852,2018-10-15 15:00:00,30,0,30
"41954",10901,"Marystown","NL",47.09899,-55.19852,2018-10-15 16:00:00,32,0,32
"41955",10901,"Marystown","NL",47.09899,-55.19852,2018-10-15 17:00:00,33,0,33
"41956",10901,"Marystown","NL",47.09899,-55.19852,2018-10-15 18:00:00,32,0,32
"41957",10901,"Marystown","NL",47.09899,-55.19852,2018-10-15 19:00:00,29,1,30
"41958",10901,"Marystown","NL",47.09899,-55.19852,2018-10-15 20:00:00,30,1,31
"41959",10901,"Marystown","NL",47.09899,-55.19852,2018-10-15 21:00:00,30,0,30
"41960",10901,"Marystown","NL",47.09899,-55.19852,2018-10-15 22:00:00,28,1,29
"41961",10901,"Marystown","NL",47.09899,-55.19852,2018-10-15 23:00:00,25,0,25
"41962",10901,"Marystown","NL",47.09899,-55.19852,2018-10-16 00:00:00,22,0,22
"41963",10901,"Marystown","NL",47.09899,-55.19852,2018-10-16 01:00:00,17,0,17
"41964",10901,"Marystown","NL",47.09899,-55.19852,2018-10-16 02:00:00,16,0,16
"41965",10901,"Marystown","NL",47.09899,-55.19852,2018-10-16 03:00:00,10,0,10
"41966",10901,"Marystown","NL",47.09899,-55.19852,2018-10-16 04:00:00,30,0,30
"41967",10901,"Marystown","NL",47.09899,-55.19852,2018-10-16 05:00:00,31,0,31
"41968",10901,"Marystown","NL",47.09899,-55.19852,2018-10-16 06:00:00,32,0,32
"41969",10901,"Marystown","NL",47.09899,-55.19852,2018-10-16 07:00:00,31,0,31
"41970",10901,"Marystown","NL",47.09899,-55.19852,2018-10-16 08:00:00,32,1,33
"41971",10901,"Marystown","NL",47.09899,-55.19852,2018-10-16 09:00:00,32,3,35
"41972",10901,"Marystown","NL",47.09899,-55.19852,2018-10-16 10:00:00,33,0,33
"41973",10901,"Marystown","NL",47.09899,-55.19852,2018-10-16 11:00:00,35,0,35
"41974",10901,"Marystown","NL",47.09899,-55.19852,2018-10-16 12:00:00,38,0,38
"41975",10901,"Marystown","NL",47.09899,-55.19852,2018-10-16 13:00:00,39,0,39
"41976",10901,"Marystown","NL",47.09899,-55.19852,2018-10-16 14:00:00,36,0,36
"41977",10901,"Marystown","NL",47.09899,-55.19852,2018-10-16 15:00:00,31,0,31
"41978",10901,"Marystown","NL",47.09899,-55.19852,2018-10-16 16:00:00,27,0,27
"41979",10901,"Marystown","NL",47.09899,-55.19852,2018-10-16 17:00:00,22,0,22
"41980",10901,"Marystown","NL",47.09899,-55.19852,2018-10-16 18:00:00,23,0,23
"41981",10901,"Marystown","NL",47.09899,-55.19852,2018-10-16 19:00:00,21,0,21
"41982",10901,"Marystown","NL",47.09899,-55.19852,2018-10-16 20:00:00,22,0,22
"41983",10901,"Marystown","NL",47.09899,-55.19852,2018-10-16 21:00:00,23,0,23
"41984",10901,"Marystown","NL",47.09899,-55.19852,2018-10-16 22:00:00,23,0,23
"41985",10901,"Marystown","NL",47.09899,-55.19852,2018-10-16 23:00:00,24,0,24
"41986",10901,"Marystown","NL",47.09899,-55.19852,2018-10-17 00:00:00,24,0,24
"41987",10901,"Marystown","NL",47.09899,-55.19852,2018-10-17 01:00:00,24,0,24
"41988",10901,"Marystown","NL",47.09899,-55.19852,2018-10-17 02:00:00,24,0,24
"41989",10901,"Marystown","NL",47.09899,-55.19852,2018-10-17 03:00:00,25,0,25
"41990",10901,"Marystown","NL",47.09899,-55.19852,2018-10-17 04:00:00,26,0,26
"41991",10901,"Marystown","NL",47.09899,-55.19852,2018-10-17 05:00:00,29,0,29
"41992",10901,"Marystown","NL",47.09899,-55.19852,2018-10-17 06:00:00,27,0,27
"41993",10901,"Marystown","NL",47.09899,-55.19852,2018-10-17 07:00:00,29,0,29
"41994",10901,"Marystown","NL",47.09899,-55.19852,2018-10-17 08:00:00,29,0,29
"41995",10901,"Marystown","NL",47.09899,-55.19852,2018-10-17 09:00:00,30,0,30
"41996",10901,"Marystown","NL",47.09899,-55.19852,2018-10-17 10:00:00,31,0,31
"41997",10901,"Marystown","NL",47.09899,-55.19852,2018-10-17 11:00:00,32,0,32
"41998",10901,"Marystown","NL",47.09899,-55.19852,2018-10-17 12:00:00,32,0,32
"41999",10901,"Marystown","NL",47.09899,-55.19852,2018-10-17 13:00:00,32,0,32
"42000",10901,"Marystown","NL",47.09899,-55.19852,2018-10-17 14:00:00,33,0,33
"42001",10901,"Marystown","NL",47.09899,-55.19852,2018-10-17 15:00:00,33,0,33
"42002",10901,"Marystown","NL",47.09899,-55.19852,2018-10-17 16:00:00,34,0,34
"42003",10901,"Marystown","NL",47.09899,-55.19852,2018-10-17 17:00:00,35,0,35
"42004",10901,"Marystown","NL",47.09899,-55.19852,2018-10-17 18:00:00,33,1,34
"42005",10901,"Marystown","NL",47.09899,-55.19852,2018-10-17 19:00:00,33,0,33
"42006",10901,"Marystown","NL",47.09899,-55.19852,2018-10-17 20:00:00,31,1,32
"42007",10901,"Marystown","NL",47.09899,-55.19852,2018-10-17 21:00:00,27,1,28
"42008",10901,"Marystown","NL",47.09899,-55.19852,2018-10-17 22:00:00,21,1,22
"42009",10901,"Marystown","NL",47.09899,-55.19852,2018-10-17 23:00:00,20,0,20
"42010",10901,"Marystown","NL",47.09899,-55.19852,2018-10-18 00:00:00,20,0,20
"42011",10901,"Marystown","NL",47.09899,-55.19852,2018-10-18 01:00:00,23,1,24
"42012",10901,"Marystown","NL",47.09899,-55.19852,2018-10-18 02:00:00,32,0,32
"42013",10901,"Marystown","NL",47.09899,-55.19852,2018-10-18 03:00:00,32,1,33
"42014",10901,"Marystown","NL",47.09899,-55.19852,2018-10-18 04:00:00,33,0,33
"42015",10901,"Marystown","NL",47.09899,-55.19852,2018-10-18 05:00:00,33,1,34
"42016",10901,"Marystown","NL",47.09899,-55.19852,2018-10-18 06:00:00,34,0,34
"42017",10901,"Marystown","NL",47.09899,-55.19852,2018-10-18 07:00:00,34,1,35
"42018",10901,"Marystown","NL",47.09899,-55.19852,2018-10-18 08:00:00,33,1,34
"42019",10901,"Marystown","NL",47.09899,-55.19852,2018-10-18 09:00:00,32,1,33
"42020",10901,"Marystown","NL",47.09899,-55.19852,2018-10-18 10:00:00,31,1,32
"42021",10901,"Marystown","NL",47.09899,-55.19852,2018-10-18 11:00:00,32,1,33
"42022",10901,"Marystown","NL",47.09899,-55.19852,2018-10-18 12:00:00,33,0,33
"42023",10901,"Marystown","NL",47.09899,-55.19852,2018-10-18 13:00:00,31,0,31
"42024",10901,"Marystown","NL",47.09899,-55.19852,2018-10-18 14:00:00,32,0,32
"42025",10901,"Marystown","NL",47.09899,-55.19852,2018-10-18 15:00:00,30,0,30
"42026",10901,"Marystown","NL",47.09899,-55.19852,2018-10-18 16:00:00,27,0,27
"42027",10901,"Marystown","NL",47.09899,-55.19852,2018-10-18 17:00:00,25,0,25
"42028",10901,"Marystown","NL",47.09899,-55.19852,2018-10-18 18:00:00,21,0,21
"42029",10901,"Marystown","NL",47.09899,-55.19852,2018-10-18 19:00:00,20,0,20
"42030",10901,"Marystown","NL",47.09899,-55.19852,2018-10-18 20:00:00,22,0,22
"42031",10901,"Marystown","NL",47.09899,-55.19852,2018-10-18 21:00:00,23,0,23
"42032",10901,"Marystown","NL",47.09899,-55.19852,2018-10-18 22:00:00,25,0,25
"42033",10901,"Marystown","NL",47.09899,-55.19852,2018-10-18 23:00:00,26,0,26
"42034",10901,"Marystown","NL",47.09899,-55.19852,2018-10-19 00:00:00,22,0,22
"42035",10901,"Marystown","NL",47.09899,-55.19852,2018-10-19 01:00:00,21,0,21
"42036",10901,"Marystown","NL",47.09899,-55.19852,2018-10-19 02:00:00,22,0,22
"42037",10901,"Marystown","NL",47.09899,-55.19852,2018-10-19 03:00:00,24,0,24
"42038",10901,"Marystown","NL",47.09899,-55.19852,2018-10-19 04:00:00,22,0,22
"42039",10901,"Marystown","NL",47.09899,-55.19852,2018-10-19 05:00:00,21,0,21
"42040",10901,"Marystown","NL",47.09899,-55.19852,2018-10-19 06:00:00,22,0,22
"42041",10901,"Marystown","NL",47.09899,-55.19852,2018-10-19 07:00:00,23,0,23
"42042",10901,"Marystown","NL",47.09899,-55.19852,2018-10-19 08:00:00,23,0,23
"42043",10901,"Marystown","NL",47.09899,-55.19852,2018-10-19 09:00:00,24,0,24
"42044",10901,"Marystown","NL",47.09899,-55.19852,2018-10-19 10:00:00,24,0,24
"42045",10901,"Marystown","NL",47.09899,-55.19852,2018-10-19 11:00:00,24,0,24
"42046",10901,"Marystown","NL",47.09899,-55.19852,2018-10-19 12:00:00,24,0,24
"42047",10901,"Marystown","NL",47.09899,-55.19852,2018-10-19 13:00:00,24,0,24
"42048",10901,"Marystown","NL",47.09899,-55.19852,2018-10-19 14:00:00,24,0,24
"42049",10901,"Marystown","NL",47.09899,-55.19852,2018-10-19 15:00:00,24,0,24
"42050",10901,"Marystown","NL",47.09899,-55.19852,2018-10-19 16:00:00,25,0,25
"42051",10901,"Marystown","NL",47.09899,-55.19852,2018-10-19 17:00:00,25,0,25
"42052",10901,"Marystown","NL",47.09899,-55.19852,2018-10-19 18:00:00,25,0,25
"42053",10901,"Marystown","NL",47.09899,-55.19852,2018-10-19 19:00:00,25,0,25
"42054",10901,"Marystown","NL",47.09899,-55.19852,2018-10-19 20:00:00,24,0,24
"42055",10901,"Marystown","NL",47.09899,-55.19852,2018-10-19 21:00:00,25,1,26
"42056",10901,"Marystown","NL",47.09899,-55.19852,2018-10-19 22:00:00,26,1,27
"42057",10901,"Marystown","NL",47.09899,-55.19852,2018-10-19 23:00:00,25,1,26
"42058",10901,"Marystown","NL",47.09899,-55.19852,2018-10-20 00:00:00,26,0,26
"42059",10901,"Marystown","NL",47.09899,-55.19852,2018-10-20 01:00:00,29,1,30
"42060",10901,"Marystown","NL",47.09899,-55.19852,2018-10-20 02:00:00,28,1,29
"42061",10901,"Marystown","NL",47.09899,-55.19852,2018-10-20 03:00:00,30,1,31
"42062",10901,"Marystown","NL",47.09899,-55.19852,2018-10-20 04:00:00,31,1,32
"42063",10901,"Marystown","NL",47.09899,-55.19852,2018-10-20 05:00:00,31,1,32
"42064",10901,"Marystown","NL",47.09899,-55.19852,2018-10-20 06:00:00,30,1,31
"42065",10901,"Marystown","NL",47.09899,-55.19852,2018-10-20 07:00:00,21,2,23
"42066",10901,"Marystown","NL",47.09899,-55.19852,2018-10-20 08:00:00,24,2,26
"42067",10901,"Marystown","NL",47.09899,-55.19852,2018-10-20 09:00:00,26,2,28
"42068",10901,"Marystown","NL",47.09899,-55.19852,2018-10-20 10:00:00,32,1,33
"42069",10901,"Marystown","NL",47.09899,-55.19852,2018-10-20 11:00:00,32,1,33
"42070",10901,"Marystown","NL",47.09899,-55.19852,2018-10-20 12:00:00,32,1,33
"42071",10901,"Marystown","NL",47.09899,-55.19852,2018-10-20 13:00:00,33,0,33
"42072",10901,"Marystown","NL",47.09899,-55.19852,2018-10-20 14:00:00,33,0,33
"42073",10901,"Marystown","NL",47.09899,-55.19852,2018-10-20 15:00:00,33,0,33
"42074",10901,"Marystown","NL",47.09899,-55.19852,2018-10-20 16:00:00,33,0,33
"42075",10901,"Marystown","NL",47.09899,-55.19852,2018-10-20 17:00:00,33,0,33
"42076",10901,"Marystown","NL",47.09899,-55.19852,2018-10-20 18:00:00,33,0,33
"42077",10901,"Marystown","NL",47.09899,-55.19852,2018-10-20 19:00:00,33,0,33
"42078",10901,"Marystown","NL",47.09899,-55.19852,2018-10-20 20:00:00,34,0,34
"42079",10901,"Marystown","NL",47.09899,-55.19852,2018-10-20 21:00:00,34,0,34
"42080",10901,"Marystown","NL",47.09899,-55.19852,2018-10-20 22:00:00,34,0,34
"42081",10901,"Marystown","NL",47.09899,-55.19852,2018-10-20 23:00:00,34,0,34
"42082",10901,"Marystown","NL",47.09899,-55.19852,2018-10-21 00:00:00,35,0,35
"42083",10901,"Marystown","NL",47.09899,-55.19852,2018-10-21 01:00:00,35,0,35
"42084",10901,"Marystown","NL",47.09899,-55.19852,2018-10-21 02:00:00,35,0,35
"42085",10901,"Marystown","NL",47.09899,-55.19852,2018-10-21 03:00:00,35,0,35
"42086",10901,"Marystown","NL",47.09899,-55.19852,2018-10-21 04:00:00,35,0,35
"42087",10901,"Marystown","NL",47.09899,-55.19852,2018-10-21 05:00:00,35,0,35
"42088",10901,"Marystown","NL",47.09899,-55.19852,2018-10-21 06:00:00,35,0,35
"42089",10901,"Marystown","NL",47.09899,-55.19852,2018-10-21 07:00:00,35,0,35
"42090",10901,"Marystown","NL",47.09899,-55.19852,2018-10-21 08:00:00,36,0,36
"42091",10901,"Marystown","NL",47.09899,-55.19852,2018-10-21 09:00:00,35,0,35
"42092",10901,"Marystown","NL",47.09899,-55.19852,2018-10-21 10:00:00,35,0,35
"42093",10901,"Marystown","NL",47.09899,-55.19852,2018-10-21 11:00:00,34,0,34
"42094",10901,"Marystown","NL",47.09899,-55.19852,2018-10-21 12:00:00,36,0,36
"42095",10901,"Marystown","NL",47.09899,-55.19852,2018-10-21 13:00:00,37,0,37
"42096",10901,"Marystown","NL",47.09899,-55.19852,2018-10-21 14:00:00,37,0,37
"42097",10901,"Marystown","NL",47.09899,-55.19852,2018-10-21 15:00:00,37,0,37
"42098",10901,"Marystown","NL",47.09899,-55.19852,2018-10-21 16:00:00,38,0,38
"42099",10901,"Marystown","NL",47.09899,-55.19852,2018-10-21 17:00:00,38,0,38
"42100",10901,"Marystown","NL",47.09899,-55.19852,2018-10-21 18:00:00,38,0,38
"42101",10901,"Marystown","NL",47.09899,-55.19852,2018-10-21 19:00:00,38,0,38
"42102",10901,"Marystown","NL",47.09899,-55.19852,2018-10-21 20:00:00,39,0,39
"42103",10901,"Marystown","NL",47.09899,-55.19852,2018-10-21 21:00:00,39,0,39
"42104",10901,"Marystown","NL",47.09899,-55.19852,2018-10-21 22:00:00,38,0,38
"42105",10901,"Marystown","NL",47.09899,-55.19852,2018-10-21 23:00:00,37,0,37
"42106",10901,"Marystown","NL",47.09899,-55.19852,2018-10-22 00:00:00,37,0,37
"42107",10901,"Marystown","NL",47.09899,-55.19852,2018-10-22 01:00:00,36,0,36
"42108",10901,"Marystown","NL",47.09899,-55.19852,2018-10-22 02:00:00,36,0,36
"42109",10901,"Marystown","NL",47.09899,-55.19852,2018-10-22 03:00:00,36,0,36
"42110",10901,"Marystown","NL",47.09899,-55.19852,2018-10-22 04:00:00,31,0,31
"42111",10901,"Marystown","NL",47.09899,-55.19852,2018-10-22 05:00:00,29,0,29
"42112",10901,"Marystown","NL",47.09899,-55.19852,2018-10-22 06:00:00,26,0,26
"42113",10901,"Marystown","NL",47.09899,-55.19852,2018-10-22 07:00:00,24,0,24
"42114",10901,"Marystown","NL",47.09899,-55.19852,2018-10-22 08:00:00,25,0,25
"42115",10901,"Marystown","NL",47.09899,-55.19852,2018-10-22 09:00:00,26,0,26
"42116",10901,"Marystown","NL",47.09899,-55.19852,2018-10-22 10:00:00,23,0,23
"42117",10901,"Marystown","NL",47.09899,-55.19852,2018-10-22 11:00:00,20,0,20
"42118",10901,"Marystown","NL",47.09899,-55.19852,2018-10-22 12:00:00,20,0,20
"42119",10901,"Marystown","NL",47.09899,-55.19852,2018-10-22 13:00:00,21,0,21
"42120",10901,"Marystown","NL",47.09899,-55.19852,2018-10-22 14:00:00,23,0,23
"42121",10901,"Marystown","NL",47.09899,-55.19852,2018-10-22 15:00:00,24,0,24
"42122",10901,"Marystown","NL",47.09899,-55.19852,2018-10-22 16:00:00,26,0,26
"42123",10901,"Marystown","NL",47.09899,-55.19852,2018-10-22 17:00:00,27,0,27
"42124",10901,"Marystown","NL",47.09899,-55.19852,2018-10-22 18:00:00,27,0,27
"42125",10901,"Marystown","NL",47.09899,-55.19852,2018-10-22 19:00:00,25,0,25
"42126",10901,"Marystown","NL",47.09899,-55.19852,2018-10-22 20:00:00,25,0,25
"42127",10901,"Marystown","NL",47.09899,-55.19852,2018-10-22 21:00:00,24,0,24
"42128",10901,"Marystown","NL",47.09899,-55.19852,2018-10-22 22:00:00,26,0,26
"42129",10901,"Marystown","NL",47.09899,-55.19852,2018-10-22 23:00:00,28,0,28
"42130",10901,"Marystown","NL",47.09899,-55.19852,2018-10-23 00:00:00,30,0,30
"42131",10901,"Marystown","NL",47.09899,-55.19852,2018-10-23 01:00:00,32,0,32
"42132",10901,"Marystown","NL",47.09899,-55.19852,2018-10-23 02:00:00,30,0,30
"42133",10901,"Marystown","NL",47.09899,-55.19852,2018-10-23 03:00:00,29,0,29
"42134",10901,"Marystown","NL",47.09899,-55.19852,2018-10-23 04:00:00,29,0,29
"42135",10901,"Marystown","NL",47.09899,-55.19852,2018-10-23 05:00:00,27,0,27
"42136",10901,"Marystown","NL",47.09899,-55.19852,2018-10-23 06:00:00,26,0,26
"42137",10901,"Marystown","NL",47.09899,-55.19852,2018-10-23 07:00:00,26,0,26
"42138",10901,"Marystown","NL",47.09899,-55.19852,2018-10-23 08:00:00,26,1,27
"42139",10901,"Marystown","NL",47.09899,-55.19852,2018-10-23 09:00:00,27,0,27
"42140",10901,"Marystown","NL",47.09899,-55.19852,2018-10-23 10:00:00,28,0,28
"42141",10901,"Marystown","NL",47.09899,-55.19852,2018-10-23 11:00:00,28,0,28
"42142",10901,"Marystown","NL",47.09899,-55.19852,2018-10-23 12:00:00,27,0,27
"42143",10901,"Marystown","NL",47.09899,-55.19852,2018-10-23 13:00:00,27,0,27
"42144",10901,"Marystown","NL",47.09899,-55.19852,2018-10-23 14:00:00,27,0,27
"42145",10901,"Marystown","NL",47.09899,-55.19852,2018-10-23 15:00:00,27,0,27
"42146",10901,"Marystown","NL",47.09899,-55.19852,2018-10-23 16:00:00,28,0,28
"42147",10901,"Marystown","NL",47.09899,-55.19852,2018-10-23 17:00:00,29,0,29
"42148",10901,"Marystown","NL",47.09899,-55.19852,2018-10-23 18:00:00,26,1,27
"42149",10901,"Marystown","NL",47.09899,-55.19852,2018-10-23 19:00:00,15,2,17
"42150",10901,"Marystown","NL",47.09899,-55.19852,2018-10-23 20:00:00,14,1,15
"42151",10901,"Marystown","NL",47.09899,-55.19852,2018-10-23 21:00:00,14,1,15
"42152",10901,"Marystown","NL",47.09899,-55.19852,2018-10-23 22:00:00,12,0,12
"42153",10901,"Marystown","NL",47.09899,-55.19852,2018-10-23 23:00:00,11,0,11
"42154",10901,"Marystown","NL",47.09899,-55.19852,2018-10-24 00:00:00,11,0,11
"42155",10901,"Marystown","NL",47.09899,-55.19852,2018-10-24 01:00:00,10,0,10
"42156",10901,"Marystown","NL",47.09899,-55.19852,2018-10-24 02:00:00,7,0,7
"42157",10901,"Marystown","NL",47.09899,-55.19852,2018-10-24 03:00:00,7,1,8
"42158",10901,"Marystown","NL",47.09899,-55.19852,2018-10-24 04:00:00,5,1,6
"42159",10901,"Marystown","NL",47.09899,-55.19852,2018-10-24 05:00:00,2,1,3
"42160",10901,"Marystown","NL",47.09899,-55.19852,2018-10-24 06:00:00,2,2,4
"42161",10901,"Marystown","NL",47.09899,-55.19852,2018-10-24 07:00:00,1,3,4
"42162",10901,"Marystown","NL",47.09899,-55.19852,2018-10-24 08:00:00,1,4,5
"42163",10901,"Marystown","NL",47.09899,-55.19852,2018-10-24 09:00:00,3,4,7
"42164",10901,"Marystown","NL",47.09899,-55.19852,2018-10-24 10:00:00,27,2,29
"42165",10901,"Marystown","NL",47.09899,-55.19852,2018-10-24 11:00:00,31,1,32
"42166",10901,"Marystown","NL",47.09899,-55.19852,2018-10-24 12:00:00,31,0,31
"42167",10901,"Marystown","NL",47.09899,-55.19852,2018-10-24 13:00:00,33,0,33
"42168",10901,"Marystown","NL",47.09899,-55.19852,2018-10-24 14:00:00,34,0,34
"42169",10901,"Marystown","NL",47.09899,-55.19852,2018-10-24 15:00:00,34,0,34
"42170",10901,"Marystown","NL",47.09899,-55.19852,2018-10-24 16:00:00,34,0,34
"42171",10901,"Marystown","NL",47.09899,-55.19852,2018-10-24 17:00:00,34,0,34
"42172",10901,"Marystown","NL",47.09899,-55.19852,2018-10-24 18:00:00,35,0,35
"42173",10901,"Marystown","NL",47.09899,-55.19852,2018-10-24 19:00:00,36,0,36
"42174",10901,"Marystown","NL",47.09899,-55.19852,2018-10-24 20:00:00,36,0,36
"42175",10901,"Marystown","NL",47.09899,-55.19852,2018-10-24 21:00:00,37,0,37
"42176",10901,"Marystown","NL",47.09899,-55.19852,2018-10-24 22:00:00,36,0,36
"42177",10901,"Marystown","NL",47.09899,-55.19852,2018-10-24 23:00:00,36,0,36
"42178",10901,"Marystown","NL",47.09899,-55.19852,2018-10-25 00:00:00,36,0,36
"42179",10901,"Marystown","NL",47.09899,-55.19852,2018-10-25 01:00:00,36,0,36
"42180",10901,"Marystown","NL",47.09899,-55.19852,2018-10-25 02:00:00,36,0,36
"42181",10901,"Marystown","NL",47.09899,-55.19852,2018-10-25 03:00:00,37,0,37
"42182",10901,"Marystown","NL",47.09899,-55.19852,2018-10-25 04:00:00,36,0,36
"42183",10901,"Marystown","NL",47.09899,-55.19852,2018-10-25 05:00:00,35,0,35
"42184",10901,"Marystown","NL",47.09899,-55.19852,2018-10-25 06:00:00,33,0,33
"42185",10901,"Marystown","NL",47.09899,-55.19852,2018-10-25 07:00:00,32,0,32
"42186",10901,"Marystown","NL",47.09899,-55.19852,2018-10-25 08:00:00,31,0,31
"42187",10901,"Marystown","NL",47.09899,-55.19852,2018-10-25 09:00:00,31,0,31
"42188",10901,"Marystown","NL",47.09899,-55.19852,2018-10-25 10:00:00,31,0,31
"42189",10901,"Marystown","NL",47.09899,-55.19852,2018-10-25 11:00:00,31,0,31
"42190",10901,"Marystown","NL",47.09899,-55.19852,2018-10-25 12:00:00,31,1,32
"42191",10901,"Marystown","NL",47.09899,-55.19852,2018-10-25 13:00:00,30,1,31
"42192",10901,"Marystown","NL",47.09899,-55.19852,2018-10-25 14:00:00,31,1,32
"42193",10901,"Marystown","NL",47.09899,-55.19852,2018-10-25 15:00:00,34,1,35
"42194",10901,"Marystown","NL",47.09899,-55.19852,2018-10-25 16:00:00,30,1,31
"42195",10901,"Marystown","NL",47.09899,-55.19852,2018-10-25 17:00:00,27,2,29
"42196",10901,"Marystown","NL",47.09899,-55.19852,2018-10-25 18:00:00,24,3,27
"42197",10901,"Marystown","NL",47.09899,-55.19852,2018-10-25 19:00:00,27,2,29
"42198",10901,"Marystown","NL",47.09899,-55.19852,2018-10-25 20:00:00,25,2,27
"42199",10901,"Marystown","NL",47.09899,-55.19852,2018-10-25 21:00:00,29,1,30
"42200",10901,"Marystown","NL",47.09899,-55.19852,2018-10-25 22:00:00,33,1,34
"42201",10901,"Marystown","NL",47.09899,-55.19852,2018-10-25 23:00:00,29,0,29
"42202",10901,"Marystown","NL",47.09899,-55.19852,2018-10-26 00:00:00,28,0,28
"42203",10901,"Marystown","NL",47.09899,-55.19852,2018-10-26 01:00:00,29,0,29
"42204",10901,"Marystown","NL",47.09899,-55.19852,2018-10-26 02:00:00,28,0,28
"42205",10901,"Marystown","NL",47.09899,-55.19852,2018-10-26 03:00:00,25,0,25
"42206",10901,"Marystown","NL",47.09899,-55.19852,2018-10-26 04:00:00,22,0,22
"42207",10901,"Marystown","NL",47.09899,-55.19852,2018-10-26 05:00:00,22,0,22
"42208",10901,"Marystown","NL",47.09899,-55.19852,2018-10-26 06:00:00,22,0,22
"42209",10901,"Marystown","NL",47.09899,-55.19852,2018-10-26 07:00:00,23,0,23
"42210",10901,"Marystown","NL",47.09899,-55.19852,2018-10-26 08:00:00,23,1,24
"42211",10901,"Marystown","NL",47.09899,-55.19852,2018-10-26 09:00:00,23,0,23
"42212",10901,"Marystown","NL",47.09899,-55.19852,2018-10-26 10:00:00,26,0,26
"42213",10901,"Marystown","NL",47.09899,-55.19852,2018-10-26 11:00:00,26,1,27
"42214",10901,"Marystown","NL",47.09899,-55.19852,2018-10-26 12:00:00,28,0,28
"42215",10901,"Marystown","NL",47.09899,-55.19852,2018-10-26 13:00:00,29,0,29
"42216",10901,"Marystown","NL",47.09899,-55.19852,2018-10-26 14:00:00,29,0,29
"42217",10901,"Marystown","NL",47.09899,-55.19852,2018-10-26 15:00:00,29,0,29
"42218",10901,"Marystown","NL",47.09899,-55.19852,2018-10-26 16:00:00,31,0,31
"42219",10901,"Marystown","NL",47.09899,-55.19852,2018-10-26 17:00:00,32,0,32
"42220",10901,"Marystown","NL",47.09899,-55.19852,2018-10-26 18:00:00,31,0,31
"42221",10901,"Marystown","NL",47.09899,-55.19852,2018-10-26 19:00:00,27,0,27
"42222",10901,"Marystown","NL",47.09899,-55.19852,2018-10-26 20:00:00,27,0,27
"42223",10901,"Marystown","NL",47.09899,-55.19852,2018-10-26 21:00:00,27,0,27
"42224",10901,"Marystown","NL",47.09899,-55.19852,2018-10-26 22:00:00,28,0,28
"42225",10901,"Marystown","NL",47.09899,-55.19852,2018-10-26 23:00:00,29,0,29
"42226",10901,"Marystown","NL",47.09899,-55.19852,2018-10-27 00:00:00,29,0,29
"42227",10901,"Marystown","NL",47.09899,-55.19852,2018-10-27 01:00:00,29,0,29
"42228",10901,"Marystown","NL",47.09899,-55.19852,2018-10-27 02:00:00,30,0,30
"42229",10901,"Marystown","NL",47.09899,-55.19852,2018-10-27 03:00:00,30,0,30
"42230",10901,"Marystown","NL",47.09899,-55.19852,2018-10-27 04:00:00,26,0,26
"42231",10901,"Marystown","NL",47.09899,-55.19852,2018-10-27 05:00:00,28,0,28
"42232",10901,"Marystown","NL",47.09899,-55.19852,2018-10-27 06:00:00,29,0,29
"42233",10901,"Marystown","NL",47.09899,-55.19852,2018-10-27 07:00:00,31,0,31
"42234",10901,"Marystown","NL",47.09899,-55.19852,2018-10-27 08:00:00,31,0,31
"42235",10901,"Marystown","NL",47.09899,-55.19852,2018-10-27 09:00:00,32,0,32
"42236",10901,"Marystown","NL",47.09899,-55.19852,2018-10-27 10:00:00,34,0,34
"42237",10901,"Marystown","NL",47.09899,-55.19852,2018-10-27 11:00:00,34,0,34
"42238",10901,"Marystown","NL",47.09899,-55.19852,2018-10-27 12:00:00,34,0,34
"42239",10901,"Marystown","NL",47.09899,-55.19852,2018-10-27 13:00:00,34,0,34
"42240",10901,"Marystown","NL",47.09899,-55.19852,2018-10-27 14:00:00,34,0,34
"42241",10901,"Marystown","NL",47.09899,-55.19852,2018-10-27 15:00:00,34,0,34
"42242",10901,"Marystown","NL",47.09899,-55.19852,2018-10-27 16:00:00,34,0,34
"42243",10901,"Marystown","NL",47.09899,-55.19852,2018-10-27 17:00:00,34,0,34
"42244",10901,"Marystown","NL",47.09899,-55.19852,2018-10-27 18:00:00,33,0,33
"42245",10901,"Marystown","NL",47.09899,-55.19852,2018-10-27 19:00:00,33,0,33
"42246",10901,"Marystown","NL",47.09899,-55.19852,2018-10-27 20:00:00,30,1,31
"42247",10901,"Marystown","NL",47.09899,-55.19852,2018-10-27 21:00:00,25,1,26
"42248",10901,"Marystown","NL",47.09899,-55.19852,2018-10-27 22:00:00,25,0,25
"42249",10901,"Marystown","NL",47.09899,-55.19852,2018-10-27 23:00:00,27,0,27
"42250",10901,"Marystown","NL",47.09899,-55.19852,2018-10-28 00:00:00,21,0,21
"42251",10901,"Marystown","NL",47.09899,-55.19852,2018-10-28 01:00:00,17,0,17
"42252",10901,"Marystown","NL",47.09899,-55.19852,2018-10-28 02:00:00,16,0,16
"42253",10901,"Marystown","NL",47.09899,-55.19852,2018-10-28 03:00:00,17,1,18
"42254",10901,"Marystown","NL",47.09899,-55.19852,2018-10-28 04:00:00,17,1,18
"42255",10901,"Marystown","NL",47.09899,-55.19852,2018-10-28 05:00:00,21,0,21
"42256",10901,"Marystown","NL",47.09899,-55.19852,2018-10-28 06:00:00,27,0,27
"42257",10901,"Marystown","NL",47.09899,-55.19852,2018-10-28 07:00:00,30,0,30
"42258",10901,"Marystown","NL",47.09899,-55.19852,2018-10-28 08:00:00,30,0,30
"42259",10901,"Marystown","NL",47.09899,-55.19852,2018-10-28 09:00:00,31,0,31
"42260",10901,"Marystown","NL",47.09899,-55.19852,2018-10-28 10:00:00,31,1,32
"42261",10901,"Marystown","NL",47.09899,-55.19852,2018-10-28 11:00:00,31,0,31
"42262",10901,"Marystown","NL",47.09899,-55.19852,2018-10-28 12:00:00,30,0,30
"42263",10901,"Marystown","NL",47.09899,-55.19852,2018-10-28 13:00:00,30,0,30
"42264",10901,"Marystown","NL",47.09899,-55.19852,2018-10-28 14:00:00,31,0,31
"42265",10901,"Marystown","NL",47.09899,-55.19852,2018-10-28 15:00:00,33,0,33
"42266",10901,"Marystown","NL",47.09899,-55.19852,2018-10-28 16:00:00,34,0,34
"42267",10901,"Marystown","NL",47.09899,-55.19852,2018-10-28 17:00:00,35,0,35
"42268",10901,"Marystown","NL",47.09899,-55.19852,2018-10-28 18:00:00,36,0,36
"42269",10901,"Marystown","NL",47.09899,-55.19852,2018-10-28 19:00:00,36,0,36
"42270",10901,"Marystown","NL",47.09899,-55.19852,2018-10-28 20:00:00,37,0,37
"42271",10901,"Marystown","NL",47.09899,-55.19852,2018-10-28 21:00:00,37,0,37
"42272",10901,"Marystown","NL",47.09899,-55.19852,2018-10-28 22:00:00,36,0,36
"42273",10901,"Marystown","NL",47.09899,-55.19852,2018-10-28 23:00:00,36,0,36
"42274",10901,"Marystown","NL",47.09899,-55.19852,2018-10-29 00:00:00,36,0,36
"42275",10901,"Marystown","NL",47.09899,-55.19852,2018-10-29 01:00:00,36,0,36
"42276",10901,"Marystown","NL",47.09899,-55.19852,2018-10-29 02:00:00,35,0,35
"42277",10901,"Marystown","NL",47.09899,-55.19852,2018-10-29 03:00:00,34,0,34
"42278",10901,"Marystown","NL",47.09899,-55.19852,2018-10-29 04:00:00,33,0,33
"42279",10901,"Marystown","NL",47.09899,-55.19852,2018-10-29 05:00:00,32,0,32
"42280",10901,"Marystown","NL",47.09899,-55.19852,2018-10-29 06:00:00,32,0,32
"42281",10901,"Marystown","NL",47.09899,-55.19852,2018-10-29 07:00:00,32,0,32
"42282",10901,"Marystown","NL",47.09899,-55.19852,2018-10-29 08:00:00,32,0,32
"42283",10901,"Marystown","NL",47.09899,-55.19852,2018-10-29 09:00:00,31,1,32
"42284",10901,"Marystown","NL",47.09899,-55.19852,2018-10-29 10:00:00,30,0,30
"42285",10901,"Marystown","NL",47.09899,-55.19852,2018-10-29 11:00:00,31,1,32
"42286",10901,"Marystown","NL",47.09899,-55.19852,2018-10-29 12:00:00,29,0,29
"42287",10901,"Marystown","NL",47.09899,-55.19852,2018-10-29 13:00:00,27,0,27
"42288",10901,"Marystown","NL",47.09899,-55.19852,2018-10-29 14:00:00,28,0,28
"42289",10901,"Marystown","NL",47.09899,-55.19852,2018-10-29 15:00:00,26,0,26
"42290",10901,"Marystown","NL",47.09899,-55.19852,2018-10-29 16:00:00,27,0,27
"42291",10901,"Marystown","NL",47.09899,-55.19852,2018-10-29 17:00:00,24,1,25
"42292",10901,"Marystown","NL",47.09899,-55.19852,2018-10-29 18:00:00,21,1,22
"42293",10901,"Marystown","NL",47.09899,-55.19852,2018-10-29 19:00:00,21,1,22
"42294",10901,"Marystown","NL",47.09899,-55.19852,2018-10-29 20:00:00,18,0,18
"42295",10901,"Marystown","NL",47.09899,-55.19852,2018-10-29 21:00:00,15,0,15
"42296",10901,"Marystown","NL",47.09899,-55.19852,2018-10-29 22:00:00,20,0,20
"42297",10901,"Marystown","NL",47.09899,-55.19852,2018-10-29 23:00:00,17,0,17
"42298",10901,"Marystown","NL",47.09899,-55.19852,2018-10-30 00:00:00,15,0,15
"42299",10901,"Marystown","NL",47.09899,-55.19852,2018-10-30 01:00:00,20,0,20
"42300",10901,"Marystown","NL",47.09899,-55.19852,2018-10-30 02:00:00,23,0,23
"42301",10901,"Marystown","NL",47.09899,-55.19852,2018-10-30 03:00:00,22,0,22
"42302",10901,"Marystown","NL",47.09899,-55.19852,2018-10-30 04:00:00,24,0,24
"42303",10901,"Marystown","NL",47.09899,-55.19852,2018-10-30 05:00:00,21,0,21
"42304",10901,"Marystown","NL",47.09899,-55.19852,2018-10-30 06:00:00,23,0,23
"42305",10901,"Marystown","NL",47.09899,-55.19852,2018-10-30 07:00:00,23,1,24
"42306",10901,"Marystown","NL",47.09899,-55.19852,2018-10-30 08:00:00,23,2,25
"42307",10901,"Marystown","NL",47.09899,-55.19852,2018-10-30 09:00:00,22,1,23
"42308",10901,"Marystown","NL",47.09899,-55.19852,2018-10-30 10:00:00,22,1,23
"42309",10901,"Marystown","NL",47.09899,-55.19852,2018-10-30 11:00:00,20,1,21
"42310",10901,"Marystown","NL",47.09899,-55.19852,2018-10-30 12:00:00,20,1,21
"42311",10901,"Marystown","NL",47.09899,-55.19852,2018-10-30 13:00:00,20,1,21
"42312",10901,"Marystown","NL",47.09899,-55.19852,2018-10-30 14:00:00,20,1,21
"42313",10901,"Marystown","NL",47.09899,-55.19852,2018-10-30 15:00:00,21,1,22
"42314",10901,"Marystown","NL",47.09899,-55.19852,2018-10-30 16:00:00,21,1,22
"42315",10901,"Marystown","NL",47.09899,-55.19852,2018-10-30 17:00:00,17,2,19
"42316",10901,"Marystown","NL",47.09899,-55.19852,2018-10-30 18:00:00,17,2,19
"42317",10901,"Marystown","NL",47.09899,-55.19852,2018-10-30 19:00:00,20,0,20
"42318",10901,"Marystown","NL",47.09899,-55.19852,2018-10-30 20:00:00,21,0,21
"42319",10901,"Marystown","NL",47.09899,-55.19852,2018-10-30 21:00:00,20,0,20
"42320",10901,"Marystown","NL",47.09899,-55.19852,2018-10-30 22:00:00,22,0,22
"42321",10901,"Marystown","NL",47.09899,-55.19852,2018-10-30 23:00:00,22,0,22
"42322",10901,"Marystown","NL",47.09899,-55.19852,2018-10-31 00:00:00,22,0,22
"42323",10901,"Marystown","NL",47.09899,-55.19852,2018-10-31 01:00:00,21,0,21
"42324",10901,"Marystown","NL",47.09899,-55.19852,2018-10-31 02:00:00,20,0,20
"42325",10901,"Marystown","NL",47.09899,-55.19852,2018-10-31 03:00:00,22,0,22
"42326",10901,"Marystown","NL",47.09899,-55.19852,2018-10-31 04:00:00,18,0,18
"42327",10901,"Marystown","NL",47.09899,-55.19852,2018-10-31 05:00:00,15,0,15
"42328",10901,"Marystown","NL",47.09899,-55.19852,2018-10-31 06:00:00,18,0,18
"42329",10901,"Marystown","NL",47.09899,-55.19852,2018-10-31 07:00:00,16,1,17
"42330",10901,"Marystown","NL",47.09899,-55.19852,2018-10-31 08:00:00,14,0,14
"42331",10901,"Marystown","NL",47.09899,-55.19852,2018-10-31 09:00:00,16,0,16
"42332",10901,"Marystown","NL",47.09899,-55.19852,2018-10-31 10:00:00,15,0,15
"42333",10901,"Marystown","NL",47.09899,-55.19852,2018-10-31 11:00:00,20,0,20
"42334",10901,"Marystown","NL",47.09899,-55.19852,2018-10-31 12:00:00,23,0,23
"42335",10901,"Marystown","NL",47.09899,-55.19852,2018-10-31 13:00:00,24,0,24
"42336",10901,"Marystown","NL",47.09899,-55.19852,2018-10-31 14:00:00,24,1,25
"42337",10901,"Marystown","NL",47.09899,-55.19852,2018-10-31 15:00:00,24,1,25
"42338",10901,"Marystown","NL",47.09899,-55.19852,2018-10-31 16:00:00,26,0,26
"42339",10901,"Marystown","NL",47.09899,-55.19852,2018-10-31 17:00:00,26,1,27
"42340",10901,"Marystown","NL",47.09899,-55.19852,2018-10-31 18:00:00,27,0,27
"42341",10901,"Marystown","NL",47.09899,-55.19852,2018-10-31 19:00:00,25,0,25
"42342",10901,"Marystown","NL",47.09899,-55.19852,2018-10-31 20:00:00,27,0,27
"42343",10901,"Marystown","NL",47.09899,-55.19852,2018-10-31 21:00:00,28,0,28
"42344",10901,"Marystown","NL",47.09899,-55.19852,2018-10-31 22:00:00,29,0,29
"42345",10901,"Marystown","NL",47.09899,-55.19852,2018-10-31 23:00:00,30,0,30
"42346",10901,"Marystown","NL",47.09899,-55.19852,2018-11-01 00:00:00,32,0,32
"42347",10901,"Marystown","NL",47.09899,-55.19852,2018-11-01 01:00:00,33,0,33
"42348",10901,"Marystown","NL",47.09899,-55.19852,2018-11-01 02:00:00,33,0,33
"42349",10901,"Marystown","NL",47.09899,-55.19852,2018-11-01 03:00:00,33,0,33
"42350",10901,"Marystown","NL",47.09899,-55.19852,2018-11-01 04:00:00,33,0,33
"42351",10901,"Marystown","NL",47.09899,-55.19852,2018-11-01 05:00:00,32,0,32
"42352",10901,"Marystown","NL",47.09899,-55.19852,2018-11-01 06:00:00,33,0,33
"42353",10901,"Marystown","NL",47.09899,-55.19852,2018-11-01 07:00:00,33,0,33
"42354",10901,"Marystown","NL",47.09899,-55.19852,2018-11-01 08:00:00,33,0,33
"42355",10901,"Marystown","NL",47.09899,-55.19852,2018-11-01 09:00:00,33,0,33
"42356",10901,"Marystown","NL",47.09899,-55.19852,2018-11-01 10:00:00,33,0,33
"42357",10901,"Marystown","NL",47.09899,-55.19852,2018-11-01 11:00:00,33,1,34
"42358",10901,"Marystown","NL",47.09899,-55.19852,2018-11-01 12:00:00,29,0,29
"42359",10901,"Marystown","NL",47.09899,-55.19852,2018-11-01 13:00:00,32,1,33
"42360",10901,"Marystown","NL",47.09899,-55.19852,2018-11-01 14:00:00,33,0,33
"42361",10901,"Marystown","NL",47.09899,-55.19852,2018-11-01 15:00:00,32,1,33
"42362",10901,"Marystown","NL",47.09899,-55.19852,2018-11-01 16:00:00,30,1,31
"42363",10901,"Marystown","NL",47.09899,-55.19852,2018-11-01 17:00:00,29,1,30
"42364",10901,"Marystown","NL",47.09899,-55.19852,2018-11-01 18:00:00,25,1,26
"42365",10901,"Marystown","NL",47.09899,-55.19852,2018-11-01 19:00:00,29,1,30
"42366",10901,"Marystown","NL",47.09899,-55.19852,2018-11-01 20:00:00,27,1,28
"42367",10901,"Marystown","NL",47.09899,-55.19852,2018-11-01 21:00:00,21,1,22
"42368",10901,"Marystown","NL",47.09899,-55.19852,2018-11-01 22:00:00,18,1,19
"42369",10901,"Marystown","NL",47.09899,-55.19852,2018-11-01 23:00:00,17,1,18
"42370",10901,"Marystown","NL",47.09899,-55.19852,2018-11-02 00:00:00,15,1,16
"42371",10901,"Marystown","NL",47.09899,-55.19852,2018-11-02 01:00:00,16,1,17
"42372",10901,"Marystown","NL",47.09899,-55.19852,2018-11-02 02:00:00,19,1,20
"42373",10901,"Marystown","NL",47.09899,-55.19852,2018-11-02 03:00:00,21,1,22
"42374",10901,"Marystown","NL",47.09899,-55.19852,2018-11-02 04:00:00,21,1,22
"42375",10901,"Marystown","NL",47.09899,-55.19852,2018-11-02 05:00:00,19,1,20
"42376",10901,"Marystown","NL",47.09899,-55.19852,2018-11-02 06:00:00,21,1,22
"42377",10901,"Marystown","NL",47.09899,-55.19852,2018-11-02 07:00:00,21,1,22
"42378",10901,"Marystown","NL",47.09899,-55.19852,2018-11-02 08:00:00,20,1,21
"42379",10901,"Marystown","NL",47.09899,-55.19852,2018-11-02 09:00:00,20,1,21
"42380",10901,"Marystown","NL",47.09899,-55.19852,2018-11-02 10:00:00,20,0,20
"42381",10901,"Marystown","NL",47.09899,-55.19852,2018-11-02 11:00:00,20,1,21
"42382",10901,"Marystown","NL",47.09899,-55.19852,2018-11-02 12:00:00,21,0,21
"42383",10901,"Marystown","NL",47.09899,-55.19852,2018-11-02 13:00:00,23,0,23
"42384",10901,"Marystown","NL",47.09899,-55.19852,2018-11-02 14:00:00,23,0,23
"42385",10901,"Marystown","NL",47.09899,-55.19852,2018-11-02 15:00:00,23,0,23
"42386",10901,"Marystown","NL",47.09899,-55.19852,2018-11-02 16:00:00,22,0,22
"42387",10901,"Marystown","NL",47.09899,-55.19852,2018-11-02 17:00:00,20,1,21
"42388",10901,"Marystown","NL",47.09899,-55.19852,2018-11-02 18:00:00,17,1,18
"42389",10901,"Marystown","NL",47.09899,-55.19852,2018-11-02 19:00:00,17,1,18
"42390",10901,"Marystown","NL",47.09899,-55.19852,2018-11-02 20:00:00,18,1,19
"42391",10901,"Marystown","NL",47.09899,-55.19852,2018-11-02 21:00:00,23,1,24
"42392",10901,"Marystown","NL",47.09899,-55.19852,2018-11-02 22:00:00,25,0,25
"42393",10901,"Marystown","NL",47.09899,-55.19852,2018-11-02 23:00:00,27,0,27
"42394",10901,"Marystown","NL",47.09899,-55.19852,2018-11-03 00:00:00,28,0,28
"42395",10901,"Marystown","NL",47.09899,-55.19852,2018-11-03 01:00:00,26,0,26
"42396",10901,"Marystown","NL",47.09899,-55.19852,2018-11-03 02:00:00,25,0,25
"42397",10901,"Marystown","NL",47.09899,-55.19852,2018-11-03 03:00:00,25,0,25
"42398",10901,"Marystown","NL",47.09899,-55.19852,2018-11-03 04:00:00,26,0,26
"42399",10901,"Marystown","NL",47.09899,-55.19852,2018-11-03 05:00:00,24,0,24
"42400",10901,"Marystown","NL",47.09899,-55.19852,2018-11-03 06:00:00,23,0,23
"42401",10901,"Marystown","NL",47.09899,-55.19852,2018-11-03 07:00:00,26,0,26
"42402",10901,"Marystown","NL",47.09899,-55.19852,2018-11-03 08:00:00,20,0,20
"42403",10901,"Marystown","NL",47.09899,-55.19852,2018-11-03 09:00:00,22,0,22
"42404",10901,"Marystown","NL",47.09899,-55.19852,2018-11-03 10:00:00,24,0,24
"42405",10901,"Marystown","NL",47.09899,-55.19852,2018-11-03 11:00:00,22,0,22
"42406",10901,"Marystown","NL",47.09899,-55.19852,2018-11-03 12:00:00,22,2,24
"42407",10901,"Marystown","NL",47.09899,-55.19852,2018-11-03 13:00:00,30,0,30
"42408",10901,"Marystown","NL",47.09899,-55.19852,2018-11-03 14:00:00,30,0,30
"42409",10901,"Marystown","NL",47.09899,-55.19852,2018-11-03 15:00:00,30,1,31
"42410",10901,"Marystown","NL",47.09899,-55.19852,2018-11-03 16:00:00,29,1,30
"42411",10901,"Marystown","NL",47.09899,-55.19852,2018-11-03 17:00:00,34,0,34
"42412",10901,"Marystown","NL",47.09899,-55.19852,2018-11-03 18:00:00,35,0,35
"42413",10901,"Marystown","NL",47.09899,-55.19852,2018-11-03 19:00:00,35,0,35
"42414",10901,"Marystown","NL",47.09899,-55.19852,2018-11-03 20:00:00,36,0,36
"42415",10901,"Marystown","NL",47.09899,-55.19852,2018-11-03 21:00:00,36,0,36
"42416",10901,"Marystown","NL",47.09899,-55.19852,2018-11-03 22:00:00,35,0,35
"42417",10901,"Marystown","NL",47.09899,-55.19852,2018-11-03 23:00:00,35,0,35
"42418",10901,"Marystown","NL",47.09899,-55.19852,2018-11-04 00:00:00,35,0,35
"42419",10901,"Marystown","NL",47.09899,-55.19852,2018-11-04 01:00:00,35,0,35
"42420",10901,"Marystown","NL",47.09899,-55.19852,2018-11-04 02:00:00,36,0,36
"42421",10901,"Marystown","NL",47.09899,-55.19852,2018-11-04 03:00:00,38,0,38
"42422",10901,"Marystown","NL",47.09899,-55.19852,2018-11-04 04:00:00,41,0,41
"42423",10901,"Marystown","NL",47.09899,-55.19852,2018-11-04 05:00:00,40,0,40
"42424",10901,"Marystown","NL",47.09899,-55.19852,2018-11-04 06:00:00,33,0,33
"42425",10901,"Marystown","NL",47.09899,-55.19852,2018-11-04 07:00:00,25,1,26
"42426",10901,"Marystown","NL",47.09899,-55.19852,2018-11-04 08:00:00,21,0,21
"42427",10901,"Marystown","NL",47.09899,-55.19852,2018-11-04 09:00:00,19,1,20
"42428",10901,"Marystown","NL",47.09899,-55.19852,2018-11-04 10:00:00,18,0,18
"42429",10901,"Marystown","NL",47.09899,-55.19852,2018-11-04 11:00:00,17,0,17
"42430",10901,"Marystown","NL",47.09899,-55.19852,2018-11-04 12:00:00,16,0,16
"42431",10901,"Marystown","NL",47.09899,-55.19852,2018-11-04 13:00:00,14,0,14
"42432",10901,"Marystown","NL",47.09899,-55.19852,2018-11-04 14:00:00,15,0,15
"42433",10901,"Marystown","NL",47.09899,-55.19852,2018-11-04 15:00:00,18,1,19
"42434",10901,"Marystown","NL",47.09899,-55.19852,2018-11-04 16:00:00,20,0,20
"42435",10901,"Marystown","NL",47.09899,-55.19852,2018-11-04 17:00:00,22,0,22
"42436",10901,"Marystown","NL",47.09899,-55.19852,2018-11-04 18:00:00,22,0,22
"42437",10901,"Marystown","NL",47.09899,-55.19852,2018-11-04 19:00:00,23,0,23
"42438",10901,"Marystown","NL",47.09899,-55.19852,2018-11-04 20:00:00,25,0,25
"42439",10901,"Marystown","NL",47.09899,-55.19852,2018-11-04 21:00:00,25,0,25
"42440",10901,"Marystown","NL",47.09899,-55.19852,2018-11-04 22:00:00,25,0,25
"42441",10901,"Marystown","NL",47.09899,-55.19852,2018-11-04 23:00:00,26,0,26
"42442",10901,"Marystown","NL",47.09899,-55.19852,2018-11-05 00:00:00,25,0,25
"42443",10901,"Marystown","NL",47.09899,-55.19852,2018-11-05 01:00:00,25,0,25
"42444",10901,"Marystown","NL",47.09899,-55.19852,2018-11-05 02:00:00,25,0,25
"42445",10901,"Marystown","NL",47.09899,-55.19852,2018-11-05 03:00:00,25,0,25
"42446",10901,"Marystown","NL",47.09899,-55.19852,2018-11-05 04:00:00,25,0,25
"42447",10901,"Marystown","NL",47.09899,-55.19852,2018-11-05 05:00:00,26,0,26
"42448",10901,"Marystown","NL",47.09899,-55.19852,2018-11-05 06:00:00,27,0,27
"42449",10901,"Marystown","NL",47.09899,-55.19852,2018-11-05 07:00:00,29,0,29
"42450",10901,"Marystown","NL",47.09899,-55.19852,2018-11-05 08:00:00,29,0,29
"42451",10901,"Marystown","NL",47.09899,-55.19852,2018-11-05 09:00:00,29,0,29
"42452",10901,"Marystown","NL",47.09899,-55.19852,2018-11-05 10:00:00,29,0,29
"42453",10901,"Marystown","NL",47.09899,-55.19852,2018-11-05 11:00:00,29,0,29
"42454",10901,"Marystown","NL",47.09899,-55.19852,2018-11-05 12:00:00,31,0,31
"42455",10901,"Marystown","NL",47.09899,-55.19852,2018-11-05 13:00:00,31,0,31
"42456",10901,"Marystown","NL",47.09899,-55.19852,2018-11-05 14:00:00,31,0,31
"42457",10901,"Marystown","NL",47.09899,-55.19852,2018-11-05 15:00:00,31,0,31
"42458",10901,"Marystown","NL",47.09899,-55.19852,2018-11-05 16:00:00,31,0,31
"42459",10901,"Marystown","NL",47.09899,-55.19852,2018-11-05 17:00:00,30,0,30
"42460",10901,"Marystown","NL",47.09899,-55.19852,2018-11-05 18:00:00,21,2,23
"42461",10901,"Marystown","NL",47.09899,-55.19852,2018-11-05 19:00:00,19,2,21
"42462",10901,"Marystown","NL",47.09899,-55.19852,2018-11-05 20:00:00,17,1,18
"42463",10901,"Marystown","NL",47.09899,-55.19852,2018-11-05 21:00:00,13,1,14
"42464",10901,"Marystown","NL",47.09899,-55.19852,2018-11-05 22:00:00,12,1,13
"42465",10901,"Marystown","NL",47.09899,-55.19852,2018-11-05 23:00:00,11,1,12
"42466",10901,"Marystown","NL",47.09899,-55.19852,2018-11-06 00:00:00,11,1,12
"42467",10901,"Marystown","NL",47.09899,-55.19852,2018-11-06 01:00:00,11,1,12
"42468",10901,"Marystown","NL",47.09899,-55.19852,2018-11-06 02:00:00,9,0,9
"42469",10901,"Marystown","NL",47.09899,-55.19852,2018-11-06 03:00:00,9,0,9
"42470",10901,"Marystown","NL",47.09899,-55.19852,2018-11-06 04:00:00,8,0,8
"42471",10901,"Marystown","NL",47.09899,-55.19852,2018-11-06 05:00:00,9,0,9
"42472",10901,"Marystown","NL",47.09899,-55.19852,2018-11-06 06:00:00,9,0,9
"42473",10901,"Marystown","NL",47.09899,-55.19852,2018-11-06 07:00:00,8,0,8
"42474",10901,"Marystown","NL",47.09899,-55.19852,2018-11-06 08:00:00,8,1,9
"42475",10901,"Marystown","NL",47.09899,-55.19852,2018-11-06 09:00:00,11,2,13
"42476",10901,"Marystown","NL",47.09899,-55.19852,2018-11-06 10:00:00,21,1,22
"42477",10901,"Marystown","NL",47.09899,-55.19852,2018-11-06 11:00:00,26,0,26
"42478",10901,"Marystown","NL",47.09899,-55.19852,2018-11-06 12:00:00,28,0,28
"42479",10901,"Marystown","NL",47.09899,-55.19852,2018-11-06 13:00:00,29,1,30
"42480",10901,"Marystown","NL",47.09899,-55.19852,2018-11-06 14:00:00,30,1,31
"42481",10901,"Marystown","NL",47.09899,-55.19852,2018-11-06 15:00:00,30,1,31
"42482",10901,"Marystown","NL",47.09899,-55.19852,2018-11-06 16:00:00,29,1,30
"42483",10901,"Marystown","NL",47.09899,-55.19852,2018-11-06 17:00:00,26,2,28
"42484",10901,"Marystown","NL",47.09899,-55.19852,2018-11-06 18:00:00,25,2,27
"42485",10901,"Marystown","NL",47.09899,-55.19852,2018-11-06 19:00:00,29,1,30
"42486",10901,"Marystown","NL",47.09899,-55.19852,2018-11-06 20:00:00,31,1,32
"42487",10901,"Marystown","NL",47.09899,-55.19852,2018-11-06 21:00:00,31,0,31
"42488",10901,"Marystown","NL",47.09899,-55.19852,2018-11-06 22:00:00,31,0,31
"42489",10901,"Marystown","NL",47.09899,-55.19852,2018-11-06 23:00:00,31,0,31
"42490",10901,"Marystown","NL",47.09899,-55.19852,2018-11-07 00:00:00,32,0,32
